Session,id,phase,trial,correct,react,distance,JR,reward,response,distractor,response_type,domain,choices,length,task,sequence,rightone
1,1,21,1,0,573,1,9,4,5,5,single-choice,spatial-relational,4|5,7,4/5,210001,4
1,1,21,2,1,853,1,3,1,1,2,single-choice,spatial-relational,1|2,7,1/2,210002,1
1,1,21,3,0,584,1,13,6,7,7,single-choice,spatial-relational,6|7,7,6/7,210003,6
1,1,21,4,0,28,1,5,2,3,3,single-choice,spatial-relational,2|3,7,2/3,210004,2
1,1,21,5,1,560,1,7,3,3,4,single-choice,spatial-relational,3|4,7,3/4,210005,3
1,1,21,6,1,513,1,11,5,5,6,single-choice,spatial-relational,5|6,7,5/6,210006,5
1,1,21,7,1,586,1,7,3,3,4,single-choice,spatial-relational,3|4,7,3/4,210007,3
1,1,21,8,0,551,1,5,2,3,3,single-choice,spatial-relational,2|3,7,2/3,210008,2
1,1,21,9,0,550,1,11,5,6,6,single-choice,spatial-relational,5|6,7,5/6,210009,5
1,1,21,10,1,714,1,9,4,4,5,single-choice,spatial-relational,4|5,7,4/5,210010,4
1,1,21,11,0,802,1,13,6,7,7,single-choice,spatial-relational,6|7,7,6/7,210011,6
1,1,21,12,1,682,1,3,1,1,2,single-choice,spatial-relational,1|2,7,1/2,210012,1
1,1,21,13,1,547,1,7,3,3,4,single-choice,spatial-relational,3|4,7,3/4,210013,3
1,1,21,14,0,670,1,13,6,7,7,single-choice,spatial-relational,6|7,7,6/7,210014,6
1,1,21,15,0,646,1,5,2,3,3,single-choice,spatial-relational,2|3,7,2/3,210015,2
1,1,21,16,0,5,1,3,1,2,2,single-choice,spatial-relational,1|2,7,1/2,210016,1
1,1,21,17,0,689,1,13,6,7,7,single-choice,spatial-relational,6|7,7,6/7,210017,6
1,1,21,18,1,517,1,7,3,3,4,single-choice,spatial-relational,3|4,7,3/4,210018,3
1,1,21,19,0,854,1,9,4,5,5,single-choice,spatial-relational,4|5,7,4/5,210019,4
1,1,21,20,1,586,1,3,1,1,2,single-choice,spatial-relational,1|2,7,1/2,210020,1
1,1,21,21,0,722,1,5,2,3,3,single-choice,spatial-relational,2|3,7,2/3,210021,2
1,1,21,22,1,590,1,11,5,5,6,single-choice,spatial-relational,5|6,7,5/6,210022,5
1,1,21,23,1,601,1,11,5,5,6,single-choice,spatial-relational,5|6,7,5/6,210023,5
1,1,21,24,0,694,1,9,4,5,5,single-choice,spatial-relational,4|5,7,4/5,210024,4
1,1,21,25,0,501,1,3,1,2,2,single-choice,spatial-relational,1|2,7,1/2,210025,1
1,1,21,26,0,675,1,5,2,3,3,single-choice,spatial-relational,2|3,7,2/3,210026,2
1,1,21,27,1,673,1,9,4,4,5,single-choice,spatial-relational,4|5,7,4/5,210027,4
1,1,21,28,0,791,1,3,1,2,2,single-choice,spatial-relational,1|2,7,1/2,210028,1
1,1,21,29,0,767,1,9,4,5,5,single-choice,spatial-relational,4|5,7,4/5,210029,4
1,1,21,30,1,6,1,7,3,3,4,single-choice,spatial-relational,3|4,7,3/4,210030,3
1,1,21,31,0,674,1,13,6,7,7,single-choice,spatial-relational,6|7,7,6/7,210031,6
1,1,21,32,1,4,1,11,5,5,6,single-choice,spatial-relational,5|6,7,5/6,210032,5
1,1,21,33,0,833,1,13,6,7,7,single-choice,spatial-relational,6|7,7,6/7,210033,6
1,1,21,34,1,552,1,7,3,3,4,single-choice,spatial-relational,3|4,7,3/4,210034,3
1,1,21,35,0,793,1,5,2,3,3,single-choice,spatial-relational,2|3,7,2/3,210035,2
1,1,21,36,0,23,1,11,5,6,6,single-choice,spatial-relational,5|6,7,5/6,210036,5
1,1,21,37,0,591,1,5,2,3,3,single-choice,spatial-relational,2|3,7,2/3,210037,2
1,1,21,38,1,777,1,3,1,1,2,single-choice,spatial-relational,1|2,7,1/2,210038,1
1,1,21,39,0,715,1,13,6,7,7,single-choice,spatial-relational,6|7,7,6/7,210039,6
1,1,21,40,0,14,1,9,4,5,5,single-choice,spatial-relational,4|5,7,4/5,210040,4
1,1,21,41,1,535,1,7,3,3,4,single-choice,spatial-relational,3|4,7,3/4,210041,3
1,1,21,42,0,714,1,5,2,3,3,single-choice,spatial-relational,2|3,7,2/3,210042,2
1,1,21,43,0,5,1,11,5,6,6,single-choice,spatial-relational,5|6,7,5/6,210043,5
1,1,21,44,0,568,1,13,6,7,7,single-choice,spatial-relational,6|7,7,6/7,210044,6
1,1,21,45,1,520,1,7,3,3,4,single-choice,spatial-relational,3|4,7,3/4,210045,3
1,1,21,46,1,668,1,11,5,5,6,single-choice,spatial-relational,5|6,7,5/6,210046,5
1,1,21,47,0,574,1,9,4,5,5,single-choice,spatial-relational,4|5,7,4/5,210047,4
1,1,21,48,1,591,1,3,1,1,2,single-choice,spatial-relational,1|2,7,1/2,210048,1
1,1,21,49,1,499,1,7,3,3,4,single-choice,spatial-relational,3|4,7,3/4,210049,3
1,1,21,50,0,550,1,5,2,3,3,single-choice,spatial-relational,2|3,7,2/3,210050,2
1,1,21,51,1,523,1,7,3,3,4,single-choice,spatial-relational,3|4,7,3/4,210051,3
1,1,21,52,0,574,1,5,2,3,3,single-choice,spatial-relational,2|3,7,2/3,210052,2
1,1,21,53,1,616,1,3,1,1,2,single-choice,spatial-relational,1|2,7,1/2,210053,1
1,1,21,54,0,764,1,9,4,5,5,single-choice,spatial-relational,4|5,7,4/5,210054,4
1,1,21,55,1,771,1,3,1,1,2,single-choice,spatial-relational,1|2,7,1/2,210055,1
1,1,21,56,0,519,1,13,6,7,7,single-choice,spatial-relational,6|7,7,6/7,210056,6
1,1,21,57,0,615,1,9,4,5,5,single-choice,spatial-relational,4|5,7,4/5,210057,4
1,1,21,58,1,445,1,13,6,6,7,single-choice,spatial-relational,6|7,7,6/7,210058,6
1,1,21,59,1,525,1,11,5,5,6,single-choice,spatial-relational,5|6,7,5/6,210059,5
1,1,21,60,1,604,1,11,5,5,6,single-choice,spatial-relational,5|6,7,5/6,210060,5
1,1,21,61,1,626,1,13,6,6,7,single-choice,spatial-relational,6|7,7,6/7,210061,6
1,1,21,62,1,594,1,11,5,5,6,single-choice,spatial-relational,5|6,7,5/6,210062,5
1,1,21,63,0,769,1,9,4,5,5,single-choice,spatial-relational,4|5,7,4/5,210063,4
1,1,21,64,1,513,1,7,3,3,4,single-choice,spatial-relational,3|4,7,3/4,210064,3
1,1,21,65,0,729,1,3,1,2,2,single-choice,spatial-relational,1|2,7,1/2,210065,1
1,1,21,66,0,582,1,5,2,3,3,single-choice,spatial-relational,2|3,7,2/3,210066,2
1,1,21,67,1,6,1,5,2,2,3,single-choice,spatial-relational,2|3,7,2/3,210067,2
1,1,21,68,0,627,1,13,6,7,7,single-choice,spatial-relational,6|7,7,6/7,210068,6
1,1,21,69,0,533,1,9,4,5,5,single-choice,spatial-relational,4|5,7,4/5,210069,4
1,1,21,70,1,578,1,7,3,3,4,single-choice,spatial-relational,3|4,7,3/4,210070,3
1,1,21,71,1,825,1,3,1,1,2,single-choice,spatial-relational,1|2,7,1/2,210071,1
1,1,21,72,1,751,1,11,5,5,6,single-choice,spatial-relational,5|6,7,5/6,210072,5
1,1,21,73,1,690,1,3,1,1,2,single-choice,spatial-relational,1|2,7,1/2,210073,1
1,1,21,74,0,624,1,9,4,5,5,single-choice,spatial-relational,4|5,7,4/5,210074,4
1,1,21,75,1,460,1,7,3,3,4,single-choice,spatial-relational,3|4,7,3/4,210075,3
1,1,21,76,0,666,1,9,4,5,5,single-choice,spatial-relational,4|5,7,4/5,210076,4
1,1,21,77,1,626,1,11,5,5,6,single-choice,spatial-relational,5|6,7,5/6,210077,5
1,1,21,78,0,1089,1,11,5,6,6,single-choice,spatial-relational,5|6,7,5/6,210078,5
1,1,21,79,1,656,1,3,1,1,2,single-choice,spatial-relational,1|2,7,1/2,210079,1
1,1,21,80,0,484,1,5,2,3,3,single-choice,spatial-relational,2|3,7,2/3,210080,2
1,1,21,81,0,79,1,13,6,7,7,single-choice,spatial-relational,6|7,7,6/7,210081,6
1,1,21,82,0,593,1,5,2,3,3,single-choice,spatial-relational,2|3,7,2/3,210082,2
1,1,21,83,1,534,1,7,3,3,4,single-choice,spatial-relational,3|4,7,3/4,210083,3
1,1,21,84,1,751,1,13,6,6,7,single-choice,spatial-relational,6|7,7,6/7,210084,6
1,1,21,85,0,555,1,9,4,5,5,single-choice,spatial-relational,4|5,7,4/5,210085,4
1,1,21,86,0,597,1,5,2,3,3,single-choice,spatial-relational,2|3,7,2/3,210086,2
1,1,21,87,1,524,1,7,3,3,4,single-choice,spatial-relational,3|4,7,3/4,210087,3
1,1,21,88,1,805,1,13,6,6,7,single-choice,spatial-relational,6|7,7,6/7,210088,6
1,1,21,89,0,684,1,9,4,5,5,single-choice,spatial-relational,4|5,7,4/5,210089,4
1,1,21,90,1,619,1,13,6,6,7,single-choice,spatial-relational,6|7,7,6/7,210090,6
1,1,21,91,1,834,1,3,1,1,2,single-choice,spatial-relational,1|2,7,1/2,210091,1
1,1,21,92,0,713,1,3,1,2,2,single-choice,spatial-relational,1|2,7,1/2,210092,1
1,1,21,93,0,671,1,11,5,6,6,single-choice,spatial-relational,5|6,7,5/6,210093,5
1,1,21,94,0,555,1,5,2,3,3,single-choice,spatial-relational,2|3,7,2/3,210094,2
1,1,21,95,1,515,1,7,3,3,4,single-choice,spatial-relational,3|4,7,3/4,210095,3
1,1,21,96,1,668,1,11,5,5,6,single-choice,spatial-relational,5|6,7,5/6,210096,5
1,1,21,97,0,835,1,13,6,7,7,single-choice,spatial-relational,6|7,7,6/7,210097,6
1,1,21,98,0,736,1,11,5,6,6,single-choice,spatial-relational,5|6,7,5/6,210098,5
1,1,21,99,0,700,1,9,4,5,5,single-choice,spatial-relational,4|5,7,4/5,210099,4
1,1,21,100,0,630,1,5,2,3,3,single-choice,spatial-relational,2|3,7,2/3,210100,2
1,1,21,101,1,553,1,7,3,3,4,single-choice,spatial-relational,3|4,7,3/4,210101,3
1,1,21,102,0,764,1,9,4,5,5,single-choice,spatial-relational,4|5,7,4/5,210102,4
1,1,21,103,0,580,1,5,2,3,3,single-choice,spatial-relational,2|3,7,2/3,210103,2
1,1,21,104,1,577,1,7,3,3,4,single-choice,spatial-relational,3|4,7,3/4,210104,3
1,1,21,105,0,933,1,3,1,2,2,single-choice,spatial-relational,1|2,7,1/2,210105,1
1,1,21,106,0,766,1,11,5,6,6,single-choice,spatial-relational,5|6,7,5/6,210106,5
1,1,21,107,1,716,1,13,6,6,7,single-choice,spatial-relational,6|7,7,6/7,210107,6
1,1,21,108,1,952,1,3,1,1,2,single-choice,spatial-relational,1|2,7,1/2,210108,1
1,1,21,109,0,589,1,5,2,3,3,single-choice,spatial-relational,2|3,7,2/3,210109,2
1,1,21,110,0,658,1,11,5,6,6,single-choice,spatial-relational,5|6,7,5/6,210110,5
1,1,21,111,1,857,1,9,4,4,5,single-choice,spatial-relational,4|5,7,4/5,210111,4
1,1,21,112,0,641,1,5,2,3,3,single-choice,spatial-relational,2|3,7,2/3,210112,2
1,1,21,113,1,549,1,7,3,3,4,single-choice,spatial-relational,3|4,7,3/4,210113,3
1,1,21,114,1,721,1,3,1,1,2,single-choice,spatial-relational,1|2,7,1/2,210114,1
1,1,21,115,0,534,1,9,4,5,5,single-choice,spatial-relational,4|5,7,4/5,210115,4
1,1,21,116,1,783,1,13,6,6,7,single-choice,spatial-relational,6|7,7,6/7,210116,6
1,1,21,117,1,1033,1,13,6,6,7,single-choice,spatial-relational,6|7,7,6/7,210117,6
1,1,21,118,0,762,1,11,5,6,6,single-choice,spatial-relational,5|6,7,5/6,210118,5
1,1,21,119,1,599,1,7,3,3,4,single-choice,spatial-relational,3|4,7,3/4,210119,3
1,1,21,120,1,872,1,3,1,1,2,single-choice,spatial-relational,1|2,7,1/2,210120,1
1,1,21,121,0,526,1,5,2,3,3,single-choice,spatial-relational,2|3,7,2/3,210121,2
1,1,21,122,0,674,1,11,5,6,6,single-choice,spatial-relational,5|6,7,5/6,210122,5
1,1,21,123,0,701,1,9,4,5,5,single-choice,spatial-relational,4|5,7,4/5,210123,4
1,1,21,124,1,1256,1,3,1,1,2,single-choice,spatial-relational,1|2,7,1/2,210124,1
1,1,21,125,1,796,1,7,3,3,4,single-choice,spatial-relational,3|4,7,3/4,210125,3
1,1,21,126,1,708,1,13,6,6,7,single-choice,spatial-relational,6|7,7,6/7,210126,6
1,1,21,127,1,925,1,3,1,1,2,single-choice,spatial-relational,1|2,7,1/2,210127,1
1,1,21,128,1,620,1,13,6,6,7,single-choice,spatial-relational,6|7,7,6/7,210128,6
1,1,21,129,0,777,1,5,2,3,3,single-choice,spatial-relational,2|3,7,2/3,210129,2
1,1,21,130,0,617,1,11,5,6,6,single-choice,spatial-relational,5|6,7,5/6,210130,5
1,1,21,131,1,564,1,7,3,3,4,single-choice,spatial-relational,3|4,7,3/4,210131,3
1,1,21,132,0,738,1,9,4,5,5,single-choice,spatial-relational,4|5,7,4/5,210132,4
1,1,21,133,1,832,1,9,4,4,5,single-choice,spatial-relational,4|5,7,4/5,210133,4
1,1,21,134,0,824,1,5,2,3,3,single-choice,spatial-relational,2|3,7,2/3,210134,2
1,1,21,135,1,763,1,9,4,4,5,single-choice,spatial-relational,4|5,7,4/5,210135,4
1,1,21,136,1,910,1,13,6,6,7,single-choice,spatial-relational,6|7,7,6/7,210136,6
1,1,21,137,0,813,1,11,5,6,6,single-choice,spatial-relational,5|6,7,5/6,210137,5
1,1,21,138,1,592,1,3,1,1,2,single-choice,spatial-relational,1|2,7,1/2,210138,1
1,1,21,139,1,648,1,13,6,6,7,single-choice,spatial-relational,6|7,7,6/7,210139,6
1,1,21,140,0,918,1,5,2,3,3,single-choice,spatial-relational,2|3,7,2/3,210140,2
1,1,21,141,1,576,1,3,1,1,2,single-choice,spatial-relational,1|2,7,1/2,210141,1
1,1,21,142,0,831,1,11,5,6,6,single-choice,spatial-relational,5|6,7,5/6,210142,5
1,1,21,143,1,539,1,7,3,3,4,single-choice,spatial-relational,3|4,7,3/4,210143,3
1,1,21,144,1,582,1,7,3,3,4,single-choice,spatial-relational,3|4,7,3/4,210144,3
1,1,21,145,0,873,1,5,2,3,3,single-choice,spatial-relational,2|3,7,2/3,210145,2
1,1,21,146,0,669,1,5,2,3,3,single-choice,spatial-relational,2|3,7,2/3,210146,2
1,1,21,147,0,677,1,11,5,6,6,single-choice,spatial-relational,5|6,7,5/6,210147,5
1,1,21,148,1,958,1,9,4,4,5,single-choice,spatial-relational,4|5,7,4/5,210148,4
1,1,21,149,1,750,1,13,6,6,7,single-choice,spatial-relational,6|7,7,6/7,210149,6
1,1,21,150,1,774,1,3,1,1,2,single-choice,spatial-relational,1|2,7,1/2,210150,1
1,1,21,151,0,637,1,11,5,6,6,single-choice,spatial-relational,5|6,7,5/6,210151,5
1,1,21,152,0,854,1,9,4,5,5,single-choice,spatial-relational,4|5,7,4/5,210152,4
1,1,21,153,1,555,1,3,1,1,2,single-choice,spatial-relational,1|2,7,1/2,210153,1
1,1,21,154,1,598,1,7,3,3,4,single-choice,spatial-relational,3|4,7,3/4,210154,3
1,1,21,155,1,860,1,7,3,3,4,single-choice,spatial-relational,3|4,7,3/4,210155,3
1,1,21,156,1,813,1,13,6,6,7,single-choice,spatial-relational,6|7,7,6/7,210156,6
1,1,21,157,1,810,1,13,6,6,7,single-choice,spatial-relational,6|7,7,6/7,210157,6
1,1,21,158,1,613,1,7,3,3,4,single-choice,spatial-relational,3|4,7,3/4,210158,3
1,1,21,159,0,740,1,9,4,5,5,single-choice,spatial-relational,4|5,7,4/5,210159,4
1,1,21,160,0,794,1,5,2,3,3,single-choice,spatial-relational,2|3,7,2/3,210160,2
1,1,21,161,0,727,1,5,2,3,3,single-choice,spatial-relational,2|3,7,2/3,210161,2
1,1,21,162,1,703,1,7,3,3,4,single-choice,spatial-relational,3|4,7,3/4,210162,3
1,1,21,163,0,660,1,11,5,6,6,single-choice,spatial-relational,5|6,7,5/6,210163,5
1,1,21,164,1,772,1,13,6,6,7,single-choice,spatial-relational,6|7,7,6/7,210164,6
1,1,21,165,0,833,1,9,4,5,5,single-choice,spatial-relational,4|5,7,4/5,210165,4
1,1,21,166,0,632,1,11,5,6,6,single-choice,spatial-relational,5|6,7,5/6,210166,5
1,1,21,167,1,661,1,3,1,1,2,single-choice,spatial-relational,1|2,7,1/2,210167,1
1,1,21,168,1,762,1,3,1,1,2,single-choice,spatial-relational,1|2,7,1/2,210168,1
1,1,21,169,0,687,1,5,2,3,3,single-choice,spatial-relational,2|3,7,2/3,210169,2
1,1,21,170,0,777,1,5,2,3,3,single-choice,spatial-relational,2|3,7,2/3,210170,2
1,1,21,171,1,680,1,3,1,1,2,single-choice,spatial-relational,1|2,7,1/2,210171,1
1,1,21,172,0,598,1,9,4,5,5,single-choice,spatial-relational,4|5,7,4/5,210172,4
1,1,21,173,1,861,1,13,6,6,7,single-choice,spatial-relational,6|7,7,6/7,210173,6
1,1,21,174,1,776,1,3,1,1,2,single-choice,spatial-relational,1|2,7,1/2,210174,1
1,1,21,175,1,685,1,13,6,6,7,single-choice,spatial-relational,6|7,7,6/7,210175,6
1,1,21,176,0,809,1,11,5,6,6,single-choice,spatial-relational,5|6,7,5/6,210176,5
1,1,21,177,1,945,1,7,3,3,4,single-choice,spatial-relational,3|4,7,3/4,210177,3
1,1,21,178,0,810,1,11,5,6,6,single-choice,spatial-relational,5|6,7,5/6,210178,5
1,1,21,179,1,784,1,9,4,4,5,single-choice,spatial-relational,4|5,7,4/5,210179,4
1,1,21,180,0,1265,1,7,3,4,4,single-choice,spatial-relational,3|4,7,3/4,210180,3
1,1,21,181,1,693,1,3,1,1,2,single-choice,spatial-relational,1|2,7,1/2,210181,1
1,1,21,182,0,682,1,5,2,3,3,single-choice,spatial-relational,2|3,7,2/3,210182,2
1,1,21,183,0,645,1,11,5,6,6,single-choice,spatial-relational,5|6,7,5/6,210183,5
1,1,21,184,0,805,1,11,5,6,6,single-choice,spatial-relational,5|6,7,5/6,210184,5
1,1,21,185,1,659,1,13,6,6,7,single-choice,spatial-relational,6|7,7,6/7,210185,6
1,1,21,186,1,1049,1,9,4,4,5,single-choice,spatial-relational,4|5,7,4/5,210186,4
1,1,21,187,1,716,1,7,3,3,4,single-choice,spatial-relational,3|4,7,3/4,210187,3
1,1,21,188,0,703,1,9,4,5,5,single-choice,spatial-relational,4|5,7,4/5,210188,4
1,1,21,189,1,737,1,7,3,3,4,single-choice,spatial-relational,3|4,7,3/4,210189,3
1,1,21,190,1,891,1,13,6,6,7,single-choice,spatial-relational,6|7,7,6/7,210190,6
1,1,21,191,0,1019,1,5,2,3,3,single-choice,spatial-relational,2|3,7,2/3,210191,2
1,1,21,192,1,709,1,3,1,1,2,single-choice,spatial-relational,1|2,7,1/2,210192,1
1,1,21,193,0,797,1,7,3,4,4,single-choice,spatial-relational,3|4,7,3/4,210193,3
1,1,21,194,1,698,1,3,1,1,2,single-choice,spatial-relational,1|2,7,1/2,210194,1
1,1,21,195,0,738,1,11,5,6,6,single-choice,spatial-relational,5|6,7,5/6,210195,5
1,1,21,196,1,754,1,13,6,6,7,single-choice,spatial-relational,6|7,7,6/7,210196,6
1,1,21,197,1,1081,1,3,1,1,2,single-choice,spatial-relational,1|2,7,1/2,210197,1
1,1,21,198,0,1333,1,5,2,3,3,single-choice,spatial-relational,2|3,7,2/3,210198,2
1,1,21,199,1,1000,1,9,4,4,5,single-choice,spatial-relational,4|5,7,4/5,210199,4
1,1,21,200,1,815,1,7,3,3,4,single-choice,spatial-relational,3|4,7,3/4,210200,3
1,1,21,201,1,761,1,9,4,4,5,single-choice,spatial-relational,4|5,7,4/5,210201,4
1,1,21,202,1,832,1,13,6,6,7,single-choice,spatial-relational,6|7,7,6/7,210202,6
1,1,21,203,0,697,1,11,5,6,6,single-choice,spatial-relational,5|6,7,5/6,210203,5
1,1,21,204,0,16,1,5,2,3,3,single-choice,spatial-relational,2|3,7,2/3,210204,2
1,1,21,205,1,795,1,13,6,6,7,single-choice,spatial-relational,6|7,7,6/7,210205,6
1,1,21,206,1,1449,1,7,3,3,4,single-choice,spatial-relational,3|4,7,3/4,210206,3
1,1,21,207,1,797,1,3,1,1,2,single-choice,spatial-relational,1|2,7,1/2,210207,1
1,1,21,208,0,939,1,9,4,5,5,single-choice,spatial-relational,4|5,7,4/5,210208,4
1,1,21,209,0,795,1,5,2,3,3,single-choice,spatial-relational,2|3,7,2/3,210209,2
1,1,21,210,1,1066,1,7,3,3,4,single-choice,spatial-relational,3|4,7,3/4,210210,3
1,1,21,211,1,681,1,13,6,6,7,single-choice,spatial-relational,6|7,7,6/7,210211,6
1,1,21,212,0,759,1,11,5,6,6,single-choice,spatial-relational,5|6,7,5/6,210212,5
1,1,21,213,0,766,1,5,2,3,3,single-choice,spatial-relational,2|3,7,2/3,210213,2
1,1,21,214,0,757,1,11,5,6,6,single-choice,spatial-relational,5|6,7,5/6,210214,5
1,1,21,215,1,767,1,9,4,4,5,single-choice,spatial-relational,4|5,7,4/5,210215,4
1,1,21,216,1,836,1,3,1,1,2,single-choice,spatial-relational,1|2,7,1/2,210216,1
1,1,21,217,1,743,1,3,1,1,2,single-choice,spatial-relational,1|2,7,1/2,210217,1
1,1,21,218,1,657,1,13,6,6,7,single-choice,spatial-relational,6|7,7,6/7,210218,6
1,1,21,219,1,746,1,13,6,6,7,single-choice,spatial-relational,6|7,7,6/7,210219,6
1,1,21,220,1,884,1,9,4,4,5,single-choice,spatial-relational,4|5,7,4/5,210220,4
1,1,21,221,1,852,1,7,3,3,4,single-choice,spatial-relational,3|4,7,3/4,210221,3
1,1,21,222,1,806,1,5,2,2,3,single-choice,spatial-relational,2|3,7,2/3,210222,2
1,1,21,223,1,574,1,3,1,1,2,single-choice,spatial-relational,1|2,7,1/2,210223,1
1,1,21,224,0,674,1,5,2,3,3,single-choice,spatial-relational,2|3,7,2/3,210224,2
1,1,21,225,0,613,1,11,5,6,6,single-choice,spatial-relational,5|6,7,5/6,210225,5
1,1,21,226,0,941,1,7,3,4,4,single-choice,spatial-relational,3|4,7,3/4,210226,3
1,1,21,227,0,664,1,11,5,6,6,single-choice,spatial-relational,5|6,7,5/6,210227,5
1,1,21,228,1,846,1,9,4,4,5,single-choice,spatial-relational,4|5,7,4/5,210228,4
1,1,21,229,1,816,1,13,6,6,7,single-choice,spatial-relational,6|7,7,6/7,210229,6
1,1,21,230,1,600,1,3,1,1,2,single-choice,spatial-relational,1|2,7,1/2,210230,1
1,1,21,231,1,709,1,13,6,6,7,single-choice,spatial-relational,6|7,7,6/7,210231,6
1,1,21,232,0,761,1,11,5,6,6,single-choice,spatial-relational,5|6,7,5/6,210232,5
1,1,21,233,0,913,1,5,2,3,3,single-choice,spatial-relational,2|3,7,2/3,210233,2
1,1,21,234,1,730,1,7,3,3,4,single-choice,spatial-relational,3|4,7,3/4,210234,3
1,1,21,235,1,741,1,9,4,4,5,single-choice,spatial-relational,4|5,7,4/5,210235,4
1,1,21,236,0,801,1,11,5,6,6,single-choice,spatial-relational,5|6,7,5/6,210236,5
1,1,21,237,1,683,1,3,1,1,2,single-choice,spatial-relational,1|2,7,1/2,210237,1
1,1,21,238,0,602,1,5,2,3,3,single-choice,spatial-relational,2|3,7,2/3,210238,2
1,1,21,239,0,1266,1,7,3,4,4,single-choice,spatial-relational,3|4,7,3/4,210239,3
1,1,21,240,1,887,1,9,4,4,5,single-choice,spatial-relational,4|5,7,4/5,210240,4
1,1,21,241,1,770,1,3,1,1,2,single-choice,spatial-relational,1|2,7,1/2,210241,1
1,1,21,242,0,725,1,7,3,4,4,single-choice,spatial-relational,3|4,7,3/4,210242,3
1,1,21,243,1,1090,1,13,6,6,7,single-choice,spatial-relational,6|7,7,6/7,210243,6
1,1,21,244,1,900,1,9,4,4,5,single-choice,spatial-relational,4|5,7,4/5,210244,4
1,1,21,245,1,638,1,13,6,6,7,single-choice,spatial-relational,6|7,7,6/7,210245,6
1,1,21,246,1,788,1,3,1,1,2,single-choice,spatial-relational,1|2,7,1/2,210246,1
1,1,21,247,0,638,1,11,5,6,6,single-choice,spatial-relational,5|6,7,5/6,210247,5
1,1,21,248,0,956,1,5,2,3,3,single-choice,spatial-relational,2|3,7,2/3,210248,2
1,1,21,249,0,784,1,11,5,6,6,single-choice,spatial-relational,5|6,7,5/6,210249,5
1,1,21,250,0,746,1,5,2,3,3,single-choice,spatial-relational,2|3,7,2/3,210250,2
1,1,21,251,1,871,1,7,3,3,4,single-choice,spatial-relational,3|4,7,3/4,210251,3
1,1,21,252,1,888,1,9,4,4,5,single-choice,spatial-relational,4|5,7,4/5,210252,4
1,1,21,253,1,811,1,3,1,1,2,single-choice,spatial-relational,1|2,7,1/2,210253,1
1,1,21,254,0,640,1,11,5,6,6,single-choice,spatial-relational,5|6,7,5/6,210254,5
1,1,21,255,1,867,1,9,4,4,5,single-choice,spatial-relational,4|5,7,4/5,210255,4
1,1,21,256,1,1018,1,7,3,3,4,single-choice,spatial-relational,3|4,7,3/4,210256,3
1,1,21,257,0,933,1,5,2,3,3,single-choice,spatial-relational,2|3,7,2/3,210257,2
1,1,21,258,0,882,1,7,3,4,4,single-choice,spatial-relational,3|4,7,3/4,210258,3
1,1,21,259,1,807,1,13,6,6,7,single-choice,spatial-relational,6|7,7,6/7,210259,6
1,1,21,260,1,781,1,9,4,4,5,single-choice,spatial-relational,4|5,7,4/5,210260,4
1,1,21,261,1,781,1,3,1,1,2,single-choice,spatial-relational,1|2,7,1/2,210261,1
1,1,21,262,1,833,1,5,2,2,3,single-choice,spatial-relational,2|3,7,2/3,210262,2
1,1,21,263,1,606,1,13,6,6,7,single-choice,spatial-relational,6|7,7,6/7,210263,6
1,1,21,264,0,747,1,11,5,6,6,single-choice,spatial-relational,5|6,7,5/6,210264,5
1,1,21,265,1,919,1,13,6,6,7,single-choice,spatial-relational,6|7,7,6/7,210265,6
1,1,21,266,1,828,1,9,4,4,5,single-choice,spatial-relational,4|5,7,4/5,210266,4
1,1,21,267,1,803,1,3,1,1,2,single-choice,spatial-relational,1|2,7,1/2,210267,1
1,1,21,268,0,600,1,11,5,6,6,single-choice,spatial-relational,5|6,7,5/6,210268,5
1,1,21,269,1,932,1,13,6,6,7,single-choice,spatial-relational,6|7,7,6/7,210269,6
1,1,21,270,0,735,1,11,5,6,6,single-choice,spatial-relational,5|6,7,5/6,210270,5
1,1,21,271,0,794,1,7,3,4,4,single-choice,spatial-relational,3|4,7,3/4,210271,3
1,1,21,272,0,1537,1,7,3,4,4,single-choice,spatial-relational,3|4,7,3/4,210272,3
1,1,21,273,0,905,1,5,2,3,3,single-choice,spatial-relational,2|3,7,2/3,210273,2
1,1,21,274,1,629,1,3,1,1,2,single-choice,spatial-relational,1|2,7,1/2,210274,1
1,1,21,275,1,915,1,9,4,4,5,single-choice,spatial-relational,4|5,7,4/5,210275,4
1,1,21,276,1,1025,1,5,2,2,3,single-choice,spatial-relational,2|3,7,2/3,210276,2
1,1,21,277,0,1150,1,5,2,3,3,single-choice,spatial-relational,2|3,7,2/3,210277,2
1,1,21,278,1,754,1,9,4,4,5,single-choice,spatial-relational,4|5,7,4/5,210278,4
1,1,21,279,0,751,1,11,5,6,6,single-choice,spatial-relational,5|6,7,5/6,210279,5
1,1,21,280,0,72,1,5,2,3,3,single-choice,spatial-relational,2|3,7,2/3,210280,2
1,1,21,281,0,764,1,11,5,6,6,single-choice,spatial-relational,5|6,7,5/6,210281,5
1,1,21,282,1,750,1,13,6,6,7,single-choice,spatial-relational,6|7,7,6/7,210282,6
1,1,21,283,1,954,1,7,3,3,4,single-choice,spatial-relational,3|4,7,3/4,210283,3
1,1,21,284,1,690,1,3,1,1,2,single-choice,spatial-relational,1|2,7,1/2,210284,1
1,1,21,285,0,786,1,7,3,4,4,single-choice,spatial-relational,3|4,7,3/4,210285,3
1,1,21,286,1,828,1,9,4,4,5,single-choice,spatial-relational,4|5,7,4/5,210286,4
1,1,21,287,1,836,1,13,6,6,7,single-choice,spatial-relational,6|7,7,6/7,210287,6
1,1,21,288,1,853,1,3,1,1,2,single-choice,spatial-relational,1|2,7,1/2,210288,1
1,1,21,289,1,713,1,7,3,3,4,single-choice,spatial-relational,3|4,7,3/4,210289,3
1,1,21,290,0,853,1,5,2,3,3,single-choice,spatial-relational,2|3,7,2/3,210290,2
1,1,21,291,1,903,1,9,4,4,5,single-choice,spatial-relational,4|5,7,4/5,210291,4
1,1,21,292,0,734,1,11,5,6,6,single-choice,spatial-relational,5|6,7,5/6,210292,5
1,1,21,293,1,738,1,3,1,1,2,single-choice,spatial-relational,1|2,7,1/2,210293,1
1,1,21,294,1,699,1,9,4,4,5,single-choice,spatial-relational,4|5,7,4/5,210294,4
1,1,21,295,1,670,1,13,6,6,7,single-choice,spatial-relational,6|7,7,6/7,210295,6
1,1,21,296,0,808,1,5,2,3,3,single-choice,spatial-relational,2|3,7,2/3,210296,2
1,1,21,297,0,615,1,11,5,6,6,single-choice,spatial-relational,5|6,7,5/6,210297,5
1,1,21,298,1,708,1,13,6,6,7,single-choice,spatial-relational,6|7,7,6/7,210298,6
1,1,21,299,1,800,1,3,1,1,2,single-choice,spatial-relational,1|2,7,1/2,210299,1
1,1,21,300,0,897,1,7,3,4,4,single-choice,spatial-relational,3|4,7,3/4,210300,3
1,1,21,301,0,718,1,11,5,6,6,single-choice,spatial-relational,5|6,7,5/6,210301,5
1,1,21,302,0,909,1,5,2,3,3,single-choice,spatial-relational,2|3,7,2/3,210302,2
1,1,21,303,0,684,1,5,2,3,3,single-choice,spatial-relational,2|3,7,2/3,210303,2
1,1,21,304,1,577,1,3,1,1,2,single-choice,spatial-relational,1|2,7,1/2,210304,1
1,1,21,305,1,619,1,7,3,3,4,single-choice,spatial-relational,3|4,7,3/4,210305,3
1,1,21,306,1,785,1,3,1,1,2,single-choice,spatial-relational,1|2,7,1/2,210306,1
1,1,21,307,0,646,1,11,5,6,6,single-choice,spatial-relational,5|6,7,5/6,210307,5
1,1,21,308,1,817,1,9,4,4,5,single-choice,spatial-relational,4|5,7,4/5,210308,4
1,1,21,309,0,935,1,7,3,4,4,single-choice,spatial-relational,3|4,7,3/4,210309,3
1,1,21,310,1,721,1,13,6,6,7,single-choice,spatial-relational,6|7,7,6/7,210310,6
1,1,21,311,1,1097,1,9,4,4,5,single-choice,spatial-relational,4|5,7,4/5,210311,4
1,1,21,312,1,694,1,13,6,6,7,single-choice,spatial-relational,6|7,7,6/7,210312,6
1,1,21,313,1,610,1,3,1,1,2,single-choice,spatial-relational,1|2,7,1/2,210313,1
1,1,21,314,1,674,1,9,4,4,5,single-choice,spatial-relational,4|5,7,4/5,210314,4
1,1,21,315,0,610,1,11,5,6,6,single-choice,spatial-relational,5|6,7,5/6,210315,5
1,1,21,316,0,698,1,7,3,4,4,single-choice,spatial-relational,3|4,7,3/4,210316,3
1,1,21,317,0,624,1,11,5,6,6,single-choice,spatial-relational,5|6,7,5/6,210317,5
1,1,21,318,0,1012,1,5,2,3,3,single-choice,spatial-relational,2|3,7,2/3,210318,2
1,1,21,319,1,822,1,3,1,1,2,single-choice,spatial-relational,1|2,7,1/2,210319,1
1,1,21,320,1,649,1,9,4,4,5,single-choice,spatial-relational,4|5,7,4/5,210320,4
1,1,21,321,0,1612,1,13,6,7,7,single-choice,spatial-relational,6|7,7,6/7,210321,6
1,1,21,322,1,893,1,5,2,2,3,single-choice,spatial-relational,2|3,7,2/3,210322,2
1,1,21,323,1,751,1,7,3,3,4,single-choice,spatial-relational,3|4,7,3/4,210323,3
1,1,21,324,1,871,1,13,6,6,7,single-choice,spatial-relational,6|7,7,6/7,210324,6
1,1,21,325,0,1081,1,5,2,3,3,single-choice,spatial-relational,2|3,7,2/3,210325,2
1,1,21,326,1,617,1,3,1,1,2,single-choice,spatial-relational,1|2,7,1/2,210326,1
1,1,21,327,1,678,1,7,3,3,4,single-choice,spatial-relational,3|4,7,3/4,210327,3
1,1,21,328,1,1016,1,5,2,2,3,single-choice,spatial-relational,2|3,7,2/3,210328,2
1,1,21,329,1,762,1,9,4,4,5,single-choice,spatial-relational,4|5,7,4/5,210329,4
1,1,21,330,0,734,1,11,5,6,6,single-choice,spatial-relational,5|6,7,5/6,210330,5
1,1,21,331,0,849,1,7,3,4,4,single-choice,spatial-relational,3|4,7,3/4,210331,3
1,1,21,332,1,892,1,9,4,4,5,single-choice,spatial-relational,4|5,7,4/5,210332,4
1,1,21,333,0,654,1,11,5,6,6,single-choice,spatial-relational,5|6,7,5/6,210333,5
1,1,21,334,1,880,1,13,6,6,7,single-choice,spatial-relational,6|7,7,6/7,210334,6
1,1,21,335,1,724,1,13,6,6,7,single-choice,spatial-relational,6|7,7,6/7,210335,6
1,1,21,336,1,764,1,3,1,1,2,single-choice,spatial-relational,1|2,7,1/2,210336,1
1,1,21,337,0,614,1,11,5,6,6,single-choice,spatial-relational,5|6,7,5/6,210337,5
1,1,21,338,0,1027,1,5,2,3,3,single-choice,spatial-relational,2|3,7,2/3,210338,2
1,1,21,339,1,1017,1,13,6,6,7,single-choice,spatial-relational,6|7,7,6/7,210339,6
1,1,21,340,0,781,1,11,5,6,6,single-choice,spatial-relational,5|6,7,5/6,210340,5
1,1,21,341,0,917,1,7,3,4,4,single-choice,spatial-relational,3|4,7,3/4,210341,3
1,1,21,342,1,618,1,13,6,6,7,single-choice,spatial-relational,6|7,7,6/7,210342,6
1,1,21,343,1,958,1,9,4,4,5,single-choice,spatial-relational,4|5,7,4/5,210343,4
1,1,21,344,1,874,1,5,2,2,3,single-choice,spatial-relational,2|3,7,2/3,210344,2
1,1,21,345,1,819,1,9,4,4,5,single-choice,spatial-relational,4|5,7,4/5,210345,4
1,1,21,346,1,765,1,7,3,3,4,single-choice,spatial-relational,3|4,7,3/4,210346,3
1,1,21,347,1,631,1,3,1,1,2,single-choice,spatial-relational,1|2,7,1/2,210347,1
1,1,21,348,1,665,1,3,1,1,2,single-choice,spatial-relational,1|2,7,1/2,210348,1
1,1,21,349,1,752,1,5,2,2,3,single-choice,spatial-relational,2|3,7,2/3,210349,2
1,1,21,350,0,677,1,9,4,5,5,single-choice,spatial-relational,4|5,7,4/5,210350,4
1,1,21,351,0,1209,1,5,2,3,3,single-choice,spatial-relational,2|3,7,2/3,210351,2
1,1,21,352,1,648,1,3,1,1,2,single-choice,spatial-relational,1|2,7,1/2,210352,1
1,1,21,353,0,599,1,11,5,6,6,single-choice,spatial-relational,5|6,7,5/6,210353,5
1,1,21,354,0,760,1,7,3,4,4,single-choice,spatial-relational,3|4,7,3/4,210354,3
1,1,21,355,1,769,1,13,6,6,7,single-choice,spatial-relational,6|7,7,6/7,210355,6
1,1,21,356,1,914,1,3,1,1,2,single-choice,spatial-relational,1|2,7,1/2,210356,1
1,1,21,357,1,610,1,7,3,3,4,single-choice,spatial-relational,3|4,7,3/4,210357,3
1,1,21,358,1,729,1,9,4,4,5,single-choice,spatial-relational,4|5,7,4/5,210358,4
1,1,21,359,0,607,1,11,5,6,6,single-choice,spatial-relational,5|6,7,5/6,210359,5
1,1,21,360,1,573,1,13,6,6,7,single-choice,spatial-relational,6|7,7,6/7,210360,6
1,1,21,361,0,631,1,11,5,6,6,single-choice,spatial-relational,5|6,7,5/6,210361,5
1,1,21,362,1,14,1,9,4,4,5,single-choice,spatial-relational,4|5,7,4/5,210362,4
1,1,21,363,1,720,1,13,6,6,7,single-choice,spatial-relational,6|7,7,6/7,210363,6
1,1,21,364,1,640,1,7,3,3,4,single-choice,spatial-relational,3|4,7,3/4,210364,3
1,1,21,365,0,613,1,11,5,6,6,single-choice,spatial-relational,5|6,7,5/6,210365,5
1,1,21,366,0,884,1,5,2,3,3,single-choice,spatial-relational,2|3,7,2/3,210366,2
1,1,21,367,1,579,1,3,1,1,2,single-choice,spatial-relational,1|2,7,1/2,210367,1
1,1,21,368,1,632,1,9,4,4,5,single-choice,spatial-relational,4|5,7,4/5,210368,4
1,1,21,369,1,977,1,5,2,2,3,single-choice,spatial-relational,2|3,7,2/3,210369,2
1,1,21,370,0,566,1,7,3,4,4,single-choice,spatial-relational,3|4,7,3/4,210370,3
1,1,21,371,1,778,1,13,6,6,7,single-choice,spatial-relational,6|7,7,6/7,210371,6
1,1,21,372,1,784,1,3,1,1,2,single-choice,spatial-relational,1|2,7,1/2,210372,1
1,1,21,373,1,708,1,3,1,1,2,single-choice,spatial-relational,1|2,7,1/2,210373,1
1,1,21,374,0,559,1,5,2,3,3,single-choice,spatial-relational,2|3,7,2/3,210374,2
1,1,21,375,1,888,1,7,3,3,4,single-choice,spatial-relational,3|4,7,3/4,210375,3
1,1,21,376,0,628,1,11,5,6,6,single-choice,spatial-relational,5|6,7,5/6,210376,5
1,1,21,377,0,692,1,11,5,6,6,single-choice,spatial-relational,5|6,7,5/6,210377,5
1,1,21,378,1,735,1,9,4,4,5,single-choice,spatial-relational,4|5,7,4/5,210378,4
1,1,21,379,1,774,1,13,6,6,7,single-choice,spatial-relational,6|7,7,6/7,210379,6
1,1,21,380,1,1030,1,5,2,2,3,single-choice,spatial-relational,2|3,7,2/3,210380,2
1,1,21,381,1,695,1,9,4,4,5,single-choice,spatial-relational,4|5,7,4/5,210381,4
1,1,21,382,1,752,1,3,1,1,2,single-choice,spatial-relational,1|2,7,1/2,210382,1
1,1,21,383,1,678,1,13,6,6,7,single-choice,spatial-relational,6|7,7,6/7,210383,6
1,1,21,384,0,790,1,7,3,4,4,single-choice,spatial-relational,3|4,7,3/4,210384,3
1,1,21,385,0,733,1,11,5,6,6,single-choice,spatial-relational,5|6,7,5/6,210385,5
1,1,21,386,1,894,1,13,6,6,7,single-choice,spatial-relational,6|7,7,6/7,210386,6
1,1,21,387,0,807,1,7,3,4,4,single-choice,spatial-relational,3|4,7,3/4,210387,3
1,1,21,388,0,708,1,11,5,6,6,single-choice,spatial-relational,5|6,7,5/6,210388,5
1,1,21,389,1,720,1,13,6,6,7,single-choice,spatial-relational,6|7,7,6/7,210389,6
1,1,21,390,1,769,1,3,1,1,2,single-choice,spatial-relational,1|2,7,1/2,210390,1
1,1,21,391,1,542,1,3,1,1,2,single-choice,spatial-relational,1|2,7,1/2,210391,1
1,1,21,392,0,692,1,5,2,3,3,single-choice,spatial-relational,2|3,7,2/3,210392,2
1,1,21,393,1,738,1,9,4,4,5,single-choice,spatial-relational,4|5,7,4/5,210393,4
1,1,21,394,1,928,1,5,2,2,3,single-choice,spatial-relational,2|3,7,2/3,210394,2
1,1,21,395,1,652,1,7,3,3,4,single-choice,spatial-relational,3|4,7,3/4,210395,3
1,1,21,396,1,751,1,9,4,4,5,single-choice,spatial-relational,4|5,7,4/5,210396,4
1,1,21,397,0,666,1,11,5,6,6,single-choice,spatial-relational,5|6,7,5/6,210397,5
1,1,21,398,1,688,1,9,4,4,5,single-choice,spatial-relational,4|5,7,4/5,210398,4
1,1,21,399,0,1178,1,7,3,4,4,single-choice,spatial-relational,3|4,7,3/4,210399,3
1,1,21,400,1,678,1,13,6,6,7,single-choice,spatial-relational,6|7,7,6/7,210400,6
1,1,21,401,1,702,1,3,1,1,2,single-choice,spatial-relational,1|2,7,1/2,210401,1
1,1,21,402,1,705,1,7,3,3,4,single-choice,spatial-relational,3|4,7,3/4,210402,3
1,1,21,403,1,811,1,13,6,6,7,single-choice,spatial-relational,6|7,7,6/7,210403,6
1,1,21,404,1,801,1,3,1,1,2,single-choice,spatial-relational,1|2,7,1/2,210404,1
1,1,21,405,0,824,1,5,2,3,3,single-choice,spatial-relational,2|3,7,2/3,210405,2
1,1,21,406,1,968,1,5,2,2,3,single-choice,spatial-relational,2|3,7,2/3,210406,2
1,1,21,407,1,637,1,9,4,4,5,single-choice,spatial-relational,4|5,7,4/5,210407,4
1,1,21,408,0,724,1,11,5,6,6,single-choice,spatial-relational,5|6,7,5/6,210408,5
1,1,21,409,1,900,1,5,2,2,3,single-choice,spatial-relational,2|3,7,2/3,210409,2
1,1,21,410,1,694,1,9,4,4,5,single-choice,spatial-relational,4|5,7,4/5,210410,4
1,1,21,411,0,699,1,11,5,6,6,single-choice,spatial-relational,5|6,7,5/6,210411,5
1,1,21,412,0,959,1,7,3,4,4,single-choice,spatial-relational,3|4,7,3/4,210412,3
1,1,21,413,1,656,1,3,1,1,2,single-choice,spatial-relational,1|2,7,1/2,210413,1
1,1,21,414,1,665,1,13,6,6,7,single-choice,spatial-relational,6|7,7,6/7,210414,6
1,1,21,415,1,1112,1,13,6,6,7,single-choice,spatial-relational,6|7,7,6/7,210415,6
1,1,21,416,0,780,1,5,2,3,3,single-choice,spatial-relational,2|3,7,2/3,210416,2
1,1,21,417,0,807,1,7,3,4,4,single-choice,spatial-relational,3|4,7,3/4,210417,3
1,1,21,418,0,1380,1,11,5,6,6,single-choice,spatial-relational,5|6,7,5/6,210418,5
1,1,21,419,1,562,1,3,1,1,2,single-choice,spatial-relational,1|2,7,1/2,210419,1
1,1,21,420,1,732,1,9,4,4,5,single-choice,spatial-relational,4|5,7,4/5,210420,4
1,1,21,421,0,789,1,7,3,4,4,single-choice,spatial-relational,3|4,7,3/4,210421,3
1,1,21,422,0,734,1,5,2,3,3,single-choice,spatial-relational,2|3,7,2/3,210422,2
1,1,21,423,1,686,1,13,6,6,7,single-choice,spatial-relational,6|7,7,6/7,210423,6
1,1,21,424,0,717,1,11,5,6,6,single-choice,spatial-relational,5|6,7,5/6,210424,5
1,1,21,425,1,680,1,13,6,6,7,single-choice,spatial-relational,6|7,7,6/7,210425,6
1,1,21,426,1,876,1,3,1,1,2,single-choice,spatial-relational,1|2,7,1/2,210426,1
1,1,21,427,1,618,1,3,1,1,2,single-choice,spatial-relational,1|2,7,1/2,210427,1
1,1,21,428,1,770,1,7,3,3,4,single-choice,spatial-relational,3|4,7,3/4,210428,3
1,1,21,429,1,768,1,9,4,4,5,single-choice,spatial-relational,4|5,7,4/5,210429,4
1,1,21,430,0,679,1,11,5,6,6,single-choice,spatial-relational,5|6,7,5/6,210430,5
1,1,21,431,1,1076,1,5,2,2,3,single-choice,spatial-relational,2|3,7,2/3,210431,2
1,1,21,432,1,846,1,9,4,4,5,single-choice,spatial-relational,4|5,7,4/5,210432,4
1,1,21,433,1,686,1,9,4,4,5,single-choice,spatial-relational,4|5,7,4/5,210433,4
1,1,21,434,1,824,1,9,4,4,5,single-choice,spatial-relational,4|5,7,4/5,210434,4
1,1,21,435,1,925,1,13,6,6,7,single-choice,spatial-relational,6|7,7,6/7,210435,6
1,1,21,436,1,682,1,3,1,1,2,single-choice,spatial-relational,1|2,7,1/2,210436,1
1,1,21,437,0,743,1,7,3,4,4,single-choice,spatial-relational,3|4,7,3/4,210437,3
1,1,21,438,0,704,1,7,3,4,4,single-choice,spatial-relational,3|4,7,3/4,210438,3
1,1,21,439,1,572,1,13,6,6,7,single-choice,spatial-relational,6|7,7,6/7,210439,6
1,1,21,440,1,812,1,3,1,1,2,single-choice,spatial-relational,1|2,7,1/2,210440,1
1,1,21,441,0,625,1,11,5,6,6,single-choice,spatial-relational,5|6,7,5/6,210441,5
1,1,21,442,0,813,1,11,5,6,6,single-choice,spatial-relational,5|6,7,5/6,210442,5
1,1,21,443,0,849,1,5,2,3,3,single-choice,spatial-relational,2|3,7,2/3,210443,2
1,1,21,444,1,706,1,5,2,2,3,single-choice,spatial-relational,2|3,7,2/3,210444,2
1,1,21,445,1,1013,1,5,2,2,3,single-choice,spatial-relational,2|3,7,2/3,210445,2
1,1,21,446,1,739,1,3,1,1,2,single-choice,spatial-relational,1|2,7,1/2,210446,1
1,1,21,447,1,498,1,9,4,4,5,single-choice,spatial-relational,4|5,7,4/5,210447,4
1,1,21,448,1,871,1,13,6,6,7,single-choice,spatial-relational,6|7,7,6/7,210448,6
1,1,21,449,0,705,1,11,5,6,6,single-choice,spatial-relational,5|6,7,5/6,210449,5
1,1,21,450,0,637,1,7,3,4,4,single-choice,spatial-relational,3|4,7,3/4,210450,3
1,1,21,451,0,708,1,7,3,4,4,single-choice,spatial-relational,3|4,7,3/4,210451,3
1,1,21,452,1,583,1,13,6,6,7,single-choice,spatial-relational,6|7,7,6/7,210452,6
1,1,21,453,0,729,1,11,5,6,6,single-choice,spatial-relational,5|6,7,5/6,210453,5
1,1,21,454,0,637,1,5,2,3,3,single-choice,spatial-relational,2|3,7,2/3,210454,2
1,1,21,455,1,661,1,9,4,4,5,single-choice,spatial-relational,4|5,7,4/5,210455,4
1,1,21,456,1,1229,1,3,1,1,2,single-choice,spatial-relational,1|2,7,1/2,210456,1
1,1,21,457,1,636,1,9,4,4,5,single-choice,spatial-relational,4|5,7,4/5,210457,4
1,1,21,458,1,760,1,3,1,1,2,single-choice,spatial-relational,1|2,7,1/2,210458,1
1,1,21,459,0,601,1,7,3,4,4,single-choice,spatial-relational,3|4,7,3/4,210459,3
1,1,21,460,1,870,1,13,6,6,7,single-choice,spatial-relational,6|7,7,6/7,210460,6
1,1,21,461,1,989,1,5,2,2,3,single-choice,spatial-relational,2|3,7,2/3,210461,2
1,1,21,462,1,767,1,9,4,4,5,single-choice,spatial-relational,4|5,7,4/5,210462,4
1,1,21,463,1,619,1,13,6,6,7,single-choice,spatial-relational,6|7,7,6/7,210463,6
1,1,21,464,1,799,1,7,3,3,4,single-choice,spatial-relational,3|4,7,3/4,210464,3
1,1,21,465,0,566,1,11,5,6,6,single-choice,spatial-relational,5|6,7,5/6,210465,5
1,1,21,466,0,668,1,11,5,6,6,single-choice,spatial-relational,5|6,7,5/6,210466,5
1,1,21,467,0,1130,1,5,2,3,3,single-choice,spatial-relational,2|3,7,2/3,210467,2
1,1,21,468,1,673,1,3,1,1,2,single-choice,spatial-relational,1|2,7,1/2,210468,1
1,1,21,469,0,568,1,11,5,6,6,single-choice,spatial-relational,5|6,7,5/6,210469,5
1,1,21,470,1,670,1,3,1,1,2,single-choice,spatial-relational,1|2,7,1/2,210470,1
1,1,21,471,1,682,1,7,3,3,4,single-choice,spatial-relational,3|4,7,3/4,210471,3
1,1,21,472,0,797,1,11,5,6,6,single-choice,spatial-relational,5|6,7,5/6,210472,5
1,1,21,473,1,617,1,13,6,6,7,single-choice,spatial-relational,6|7,7,6/7,210473,6
1,1,21,474,0,1257,1,5,2,3,3,single-choice,spatial-relational,2|3,7,2/3,210474,2
1,1,21,475,1,783,1,5,2,2,3,single-choice,spatial-relational,2|3,7,2/3,210475,2
1,1,21,476,1,671,1,9,4,4,5,single-choice,spatial-relational,4|5,7,4/5,210476,4
1,1,21,477,0,1291,1,7,3,4,4,single-choice,spatial-relational,3|4,7,3/4,210477,3
1,1,21,478,1,611,1,3,1,1,2,single-choice,spatial-relational,1|2,7,1/2,210478,1
1,1,21,479,1,901,1,13,6,6,7,single-choice,spatial-relational,6|7,7,6/7,210479,6
1,1,21,480,1,729,1,9,4,4,5,single-choice,spatial-relational,4|5,7,4/5,210480,4
1,1,21,481,1,860,1,9,4,4,5,single-choice,spatial-relational,4|5,7,4/5,210481,4
1,1,21,482,0,943,1,5,2,3,3,single-choice,spatial-relational,2|3,7,2/3,210482,2
1,1,21,483,1,639,1,3,1,1,2,single-choice,spatial-relational,1|2,7,1/2,210483,1
1,1,21,484,0,596,1,11,5,6,6,single-choice,spatial-relational,5|6,7,5/6,210484,5
1,1,21,485,1,709,1,3,1,1,2,single-choice,spatial-relational,1|2,7,1/2,210485,1
1,1,21,486,0,690,1,13,6,7,7,single-choice,spatial-relational,6|7,7,6/7,210486,6
1,1,21,487,1,631,1,13,6,6,7,single-choice,spatial-relational,6|7,7,6/7,210487,6
1,1,21,488,1,843,1,7,3,3,4,single-choice,spatial-relational,3|4,7,3/4,210488,3
1,1,21,489,0,602,1,11,5,6,6,single-choice,spatial-relational,5|6,7,5/6,210489,5
1,1,21,490,1,721,1,5,2,2,3,single-choice,spatial-relational,2|3,7,2/3,210490,2
1,1,21,491,0,785,1,7,3,4,4,single-choice,spatial-relational,3|4,7,3/4,210491,3
1,1,21,492,1,768,1,9,4,4,5,single-choice,spatial-relational,4|5,7,4/5,210492,4
1,1,21,493,1,846,1,5,2,2,3,single-choice,spatial-relational,2|3,7,2/3,210493,2
1,1,21,494,0,809,1,11,5,6,6,single-choice,spatial-relational,5|6,7,5/6,210494,5
1,1,21,495,1,792,1,13,6,6,7,single-choice,spatial-relational,6|7,7,6/7,210495,6
1,1,21,496,1,881,1,9,4,4,5,single-choice,spatial-relational,4|5,7,4/5,210496,4
1,1,21,497,1,961,1,3,1,1,2,single-choice,spatial-relational,1|2,7,1/2,210497,1
1,1,21,498,1,777,1,9,4,4,5,single-choice,spatial-relational,4|5,7,4/5,210498,4
1,1,21,499,0,1123,1,7,3,4,4,single-choice,spatial-relational,3|4,7,3/4,210499,3
1,1,21,500,0,781,1,7,3,4,4,single-choice,spatial-relational,3|4,7,3/4,210500,3
1,1,21,501,1,1511,1,5,2,2,3,single-choice,spatial-relational,2|3,7,2/3,210501,2
1,1,21,502,1,710,1,3,1,1,2,single-choice,spatial-relational,1|2,7,1/2,210502,1
1,1,21,503,0,662,1,11,5,6,6,single-choice,spatial-relational,5|6,7,5/6,210503,5
1,1,21,504,1,682,1,13,6,6,7,single-choice,spatial-relational,6|7,7,6/7,210504,6
1,1,21,505,1,898,1,3,1,1,2,single-choice,spatial-relational,1|2,7,1/2,210505,1
1,1,21,506,1,746,1,9,4,4,5,single-choice,spatial-relational,4|5,7,4/5,210506,4
1,1,21,507,1,869,1,7,3,3,4,single-choice,spatial-relational,3|4,7,3/4,210507,3
1,1,21,508,1,762,1,13,6,6,7,single-choice,spatial-relational,6|7,7,6/7,210508,6
1,1,21,509,0,714,1,11,5,6,6,single-choice,spatial-relational,5|6,7,5/6,210509,5
1,1,21,510,1,856,1,5,2,2,3,single-choice,spatial-relational,2|3,7,2/3,210510,2
1,1,21,511,0,646,1,7,3,4,4,single-choice,spatial-relational,3|4,7,3/4,210511,3
1,1,21,512,1,602,1,3,1,1,2,single-choice,spatial-relational,1|2,7,1/2,210512,1
1,1,21,513,1,1048,1,13,6,6,7,single-choice,spatial-relational,6|7,7,6/7,210513,6
1,1,21,514,1,805,1,9,4,4,5,single-choice,spatial-relational,4|5,7,4/5,210514,4
1,1,21,515,0,634,1,11,5,6,6,single-choice,spatial-relational,5|6,7,5/6,210515,5
1,1,21,516,1,779,1,5,2,2,3,single-choice,spatial-relational,2|3,7,2/3,210516,2
1,1,21,517,1,723,1,7,3,3,4,single-choice,spatial-relational,3|4,7,3/4,210517,3
1,1,21,518,1,673,1,3,1,1,2,single-choice,spatial-relational,1|2,7,1/2,210518,1
1,1,21,519,0,577,1,11,5,6,6,single-choice,spatial-relational,5|6,7,5/6,210519,5
1,1,21,520,1,736,1,9,4,4,5,single-choice,spatial-relational,4|5,7,4/5,210520,4
1,1,21,521,1,758,1,9,4,4,5,single-choice,spatial-relational,4|5,7,4/5,210521,4
1,1,21,522,1,811,1,3,1,1,2,single-choice,spatial-relational,1|2,7,1/2,210522,1
1,1,21,523,1,914,1,13,6,6,7,single-choice,spatial-relational,6|7,7,6/7,210523,6
1,1,21,524,0,698,1,11,5,6,6,single-choice,spatial-relational,5|6,7,5/6,210524,5
1,1,21,525,0,793,1,7,3,4,4,single-choice,spatial-relational,3|4,7,3/4,210525,3
1,1,21,526,1,732,1,5,2,2,3,single-choice,spatial-relational,2|3,7,2/3,210526,2
1,1,21,527,0,793,1,13,6,7,7,single-choice,spatial-relational,6|7,7,6/7,210527,6
1,1,21,528,1,1167,1,5,2,2,3,single-choice,spatial-relational,2|3,7,2/3,210528,2
1,1,21,529,1,697,1,13,6,6,7,single-choice,spatial-relational,6|7,7,6/7,210529,6
1,1,21,530,0,854,1,7,3,4,4,single-choice,spatial-relational,3|4,7,3/4,210530,3
1,1,21,531,1,798,1,9,4,4,5,single-choice,spatial-relational,4|5,7,4/5,210531,4
1,1,21,532,0,815,1,11,5,6,6,single-choice,spatial-relational,5|6,7,5/6,210532,5
1,1,21,533,1,772,1,9,4,4,5,single-choice,spatial-relational,4|5,7,4/5,210533,4
1,1,21,534,0,1363,1,3,1,2,2,single-choice,spatial-relational,1|2,7,1/2,210534,1
1,1,21,535,0,744,1,7,3,4,4,single-choice,spatial-relational,3|4,7,3/4,210535,3
1,1,21,536,1,804,1,5,2,2,3,single-choice,spatial-relational,2|3,7,2/3,210536,2
1,1,21,537,0,680,1,11,5,6,6,single-choice,spatial-relational,5|6,7,5/6,210537,5
1,1,21,538,1,741,1,13,6,6,7,single-choice,spatial-relational,6|7,7,6/7,210538,6
1,1,21,539,1,979,1,5,2,2,3,single-choice,spatial-relational,2|3,7,2/3,210539,2
1,1,21,540,1,661,1,3,1,1,2,single-choice,spatial-relational,1|2,7,1/2,210540,1
1,1,21,541,1,658,1,7,3,3,4,single-choice,spatial-relational,3|4,7,3/4,210541,3
1,1,21,542,1,1008,1,5,2,2,3,single-choice,spatial-relational,2|3,7,2/3,210542,2
1,1,21,543,0,887,1,3,1,2,2,single-choice,spatial-relational,1|2,7,1/2,210543,1
1,1,21,544,0,573,1,11,5,6,6,single-choice,spatial-relational,5|6,7,5/6,210544,5
1,1,21,545,0,815,1,7,3,4,4,single-choice,spatial-relational,3|4,7,3/4,210545,3
1,1,21,546,1,855,1,9,4,4,5,single-choice,spatial-relational,4|5,7,4/5,210546,4
1,1,21,547,0,801,1,5,2,3,3,single-choice,spatial-relational,2|3,7,2/3,210547,2
1,1,21,548,1,951,1,13,6,6,7,single-choice,spatial-relational,6|7,7,6/7,210548,6
1,1,21,549,1,875,1,9,4,4,5,single-choice,spatial-relational,4|5,7,4/5,210549,4
1,1,21,550,1,543,1,3,1,1,2,single-choice,spatial-relational,1|2,7,1/2,210550,1
1,1,21,551,0,633,1,11,5,6,6,single-choice,spatial-relational,5|6,7,5/6,210551,5
1,1,21,552,1,574,1,13,6,6,7,single-choice,spatial-relational,6|7,7,6/7,210552,6
1,1,21,553,1,888,1,3,1,1,2,single-choice,spatial-relational,1|2,7,1/2,210553,1
1,1,21,554,0,634,1,5,2,3,3,single-choice,spatial-relational,2|3,7,2/3,210554,2
1,1,21,555,1,572,1,3,1,1,2,single-choice,spatial-relational,1|2,7,1/2,210555,1
1,1,21,556,1,642,1,13,6,6,7,single-choice,spatial-relational,6|7,7,6/7,210556,6
1,1,21,557,1,729,1,9,4,4,5,single-choice,spatial-relational,4|5,7,4/5,210557,4
1,1,21,558,0,941,1,11,5,6,6,single-choice,spatial-relational,5|6,7,5/6,210558,5
1,1,21,559,1,713,1,5,2,2,3,single-choice,spatial-relational,2|3,7,2/3,210559,2
1,1,21,560,1,680,1,9,4,4,5,single-choice,spatial-relational,4|5,7,4/5,210560,4
1,1,21,561,1,630,1,13,6,6,7,single-choice,spatial-relational,6|7,7,6/7,210561,6
1,1,21,562,0,678,1,11,5,6,6,single-choice,spatial-relational,5|6,7,5/6,210562,5
1,1,21,563,0,641,1,7,3,4,4,single-choice,spatial-relational,3|4,7,3/4,210563,3
1,1,21,564,0,795,1,7,3,4,4,single-choice,spatial-relational,3|4,7,3/4,210564,3
1,1,21,565,1,603,1,9,4,4,5,single-choice,spatial-relational,4|5,7,4/5,210565,4
1,1,21,566,0,552,1,11,5,6,6,single-choice,spatial-relational,5|6,7,5/6,210566,5
1,1,21,567,1,560,1,13,6,6,7,single-choice,spatial-relational,6|7,7,6/7,210567,6
1,1,21,568,1,816,1,13,6,6,7,single-choice,spatial-relational,6|7,7,6/7,210568,6
1,1,21,569,0,613,1,11,5,6,6,single-choice,spatial-relational,5|6,7,5/6,210569,5
1,1,21,570,1,740,1,5,2,2,3,single-choice,spatial-relational,2|3,7,2/3,210570,2
1,1,21,571,0,708,1,7,3,4,4,single-choice,spatial-relational,3|4,7,3/4,210571,3
1,1,21,572,1,623,1,3,1,1,2,single-choice,spatial-relational,1|2,7,1/2,210572,1
1,1,21,573,0,476,1,5,2,3,3,single-choice,spatial-relational,2|3,7,2/3,210573,2
1,1,21,574,1,731,1,3,1,1,2,single-choice,spatial-relational,1|2,7,1/2,210574,1
1,1,21,575,1,730,1,9,4,4,5,single-choice,spatial-relational,4|5,7,4/5,210575,4
1,1,21,576,1,845,1,7,3,3,4,single-choice,spatial-relational,3|4,7,3/4,210576,3
1,1,21,577,1,721,1,5,2,2,3,single-choice,spatial-relational,2|3,7,2/3,210577,2
1,1,21,578,1,679,1,3,1,1,2,single-choice,spatial-relational,1|2,7,1/2,210578,1
1,1,21,579,1,478,1,13,6,6,7,single-choice,spatial-relational,6|7,7,6/7,210579,6
1,1,21,580,0,675,1,11,5,6,6,single-choice,spatial-relational,5|6,7,5/6,210580,5
1,1,21,581,0,540,1,11,5,6,6,single-choice,spatial-relational,5|6,7,5/6,210581,5
1,1,21,582,1,525,1,9,4,4,5,single-choice,spatial-relational,4|5,7,4/5,210582,4
1,1,21,583,0,776,1,5,2,3,3,single-choice,spatial-relational,2|3,7,2/3,210583,2
1,1,21,584,0,778,1,7,3,4,4,single-choice,spatial-relational,3|4,7,3/4,210584,3
1,1,21,585,0,757,1,7,3,4,4,single-choice,spatial-relational,3|4,7,3/4,210585,3
1,1,21,586,1,531,1,3,1,1,2,single-choice,spatial-relational,1|2,7,1/2,210586,1
1,1,21,587,1,723,1,13,6,6,7,single-choice,spatial-relational,6|7,7,6/7,210587,6
1,1,21,588,1,800,1,9,4,4,5,single-choice,spatial-relational,4|5,7,4/5,210588,4
1,1,21,589,0,727,1,5,2,3,3,single-choice,spatial-relational,2|3,7,2/3,210589,2
1,1,21,590,1,801,1,13,6,6,7,single-choice,spatial-relational,6|7,7,6/7,210590,6
1,1,21,591,0,722,1,11,5,6,6,single-choice,spatial-relational,5|6,7,5/6,210591,5
1,1,21,592,1,554,1,3,1,1,2,single-choice,spatial-relational,1|2,7,1/2,210592,1
1,1,21,593,0,725,1,7,3,4,4,single-choice,spatial-relational,3|4,7,3/4,210593,3
1,1,21,594,0,1327,1,7,3,4,4,single-choice,spatial-relational,3|4,7,3/4,210594,3
1,1,21,595,1,756,1,9,4,4,5,single-choice,spatial-relational,4|5,7,4/5,210595,4
1,1,21,596,1,708,1,13,6,6,7,single-choice,spatial-relational,6|7,7,6/7,210596,6
1,1,21,597,1,1168,1,5,2,2,3,single-choice,spatial-relational,2|3,7,2/3,210597,2
1,1,21,598,1,686,1,3,1,1,2,single-choice,spatial-relational,1|2,7,1/2,210598,1
1,1,21,599,0,504,1,11,5,6,6,single-choice,spatial-relational,5|6,7,5/6,210599,5
1,1,21,600,1,682,1,9,4,4,5,single-choice,spatial-relational,4|5,7,4/5,210600,4
2,1,21,1,1,783,1,3,1,1,2,single-choice,spatial-relational,1|2,7,1/2,210001,1
2,1,21,2,0,449,1,5,2,3,3,single-choice,spatial-relational,2|3,7,2/3,210002,2
2,1,21,3,1,632,1,13,6,6,7,single-choice,spatial-relational,6|7,7,6/7,210003,6
2,1,21,4,1,802,1,7,3,3,4,single-choice,spatial-relational,3|4,7,3/4,210004,3
2,1,21,5,0,683,1,13,6,7,7,single-choice,spatial-relational,6|7,7,6/7,210005,6
2,1,21,6,0,639,1,11,5,6,6,single-choice,spatial-relational,5|6,7,5/6,210006,5
2,1,21,7,0,546,1,5,2,3,3,single-choice,spatial-relational,2|3,7,2/3,210007,2
2,1,21,8,1,603,1,9,4,4,5,single-choice,spatial-relational,4|5,7,4/5,210008,4
2,1,21,9,0,744,1,3,1,2,2,single-choice,spatial-relational,1|2,7,1/2,210009,1
2,1,21,10,1,299,1,7,3,3,4,single-choice,spatial-relational,3|4,7,3/4,210010,3
2,1,21,11,0,690,1,11,5,6,6,single-choice,spatial-relational,5|6,7,5/6,210011,5
2,1,21,12,1,627,1,9,4,4,5,single-choice,spatial-relational,4|5,7,4/5,210012,4
2,1,21,13,0,818,1,11,5,6,6,single-choice,spatial-relational,5|6,7,5/6,210013,5
2,1,21,14,0,1181,1,11,5,6,6,single-choice,spatial-relational,5|6,7,5/6,210014,5
2,1,21,15,0,631,1,7,3,4,4,single-choice,spatial-relational,3|4,7,3/4,210015,3
2,1,21,16,1,734,1,3,1,1,2,single-choice,spatial-relational,1|2,7,1/2,210016,1
2,1,21,17,1,706,1,13,6,6,7,single-choice,spatial-relational,6|7,7,6/7,210017,6
2,1,21,18,0,577,1,5,2,3,3,single-choice,spatial-relational,2|3,7,2/3,210018,2
2,1,21,19,0,562,1,13,6,7,7,single-choice,spatial-relational,6|7,7,6/7,210019,6
2,1,21,20,1,670,1,9,4,4,5,single-choice,spatial-relational,4|5,7,4/5,210020,4
2,1,21,21,0,741,1,7,3,4,4,single-choice,spatial-relational,3|4,7,3/4,210021,3
2,1,21,22,1,496,1,3,1,1,2,single-choice,spatial-relational,1|2,7,1/2,210022,1
2,1,21,23,0,1227,1,9,4,5,5,single-choice,spatial-relational,4|5,7,4/5,210023,4
2,1,21,24,0,86,1,5,2,3,3,single-choice,spatial-relational,2|3,7,2/3,210024,2
2,1,21,25,0,514,1,7,3,4,4,single-choice,spatial-relational,3|4,7,3/4,210025,3
2,1,21,26,1,86,1,5,2,2,3,single-choice,spatial-relational,2|3,7,2/3,210026,2
2,1,21,27,0,650,1,13,6,7,7,single-choice,spatial-relational,6|7,7,6/7,210027,6
2,1,21,28,0,592,1,9,4,5,5,single-choice,spatial-relational,4|5,7,4/5,210028,4
2,1,21,29,1,495,1,3,1,1,2,single-choice,spatial-relational,1|2,7,1/2,210029,1
2,1,21,30,1,565,1,7,3,3,4,single-choice,spatial-relational,3|4,7,3/4,210030,3
2,1,21,31,1,505,1,3,1,1,2,single-choice,spatial-relational,1|2,7,1/2,210031,1
2,1,21,32,0,810,1,13,6,7,7,single-choice,spatial-relational,6|7,7,6/7,210032,6
2,1,21,33,0,524,1,5,2,3,3,single-choice,spatial-relational,2|3,7,2/3,210033,2
2,1,21,34,0,696,1,11,5,6,6,single-choice,spatial-relational,5|6,7,5/6,210034,5
2,1,21,35,0,826,1,9,4,5,5,single-choice,spatial-relational,4|5,7,4/5,210035,4
2,1,21,36,0,1107,1,11,5,6,6,single-choice,spatial-relational,5|6,7,5/6,210036,5
2,1,21,37,1,842,1,7,3,3,4,single-choice,spatial-relational,3|4,7,3/4,210037,3
2,1,21,38,0,788,1,9,4,5,5,single-choice,spatial-relational,4|5,7,4/5,210038,4
2,1,21,39,0,927,1,5,2,3,3,single-choice,spatial-relational,2|3,7,2/3,210039,2
2,1,21,40,0,810,1,13,6,7,7,single-choice,spatial-relational,6|7,7,6/7,210040,6
2,1,21,41,1,831,1,13,6,6,7,single-choice,spatial-relational,6|7,7,6/7,210041,6
2,1,21,42,0,1078,1,11,5,6,6,single-choice,spatial-relational,5|6,7,5/6,210042,5
2,1,21,43,1,1153,1,3,1,1,2,single-choice,spatial-relational,1|2,7,1/2,210043,1
2,1,21,44,1,922,1,5,2,2,3,single-choice,spatial-relational,2|3,7,2/3,210044,2
2,1,21,45,0,724,1,11,5,6,6,single-choice,spatial-relational,5|6,7,5/6,210045,5
2,1,21,46,0,779,1,9,4,5,5,single-choice,spatial-relational,4|5,7,4/5,210046,4
2,1,21,47,0,1288,1,9,4,5,5,single-choice,spatial-relational,4|5,7,4/5,210047,4
2,1,21,48,1,846,1,3,1,1,2,single-choice,spatial-relational,1|2,7,1/2,210048,1
2,1,21,49,1,996,1,11,5,5,6,single-choice,spatial-relational,5|6,7,5/6,210049,5
2,1,21,50,0,1053,1,9,4,5,5,single-choice,spatial-relational,4|5,7,4/5,210050,4
2,1,21,51,1,692,1,13,6,6,7,single-choice,spatial-relational,6|7,7,6/7,210051,6
2,1,21,52,0,720,1,7,3,4,4,single-choice,spatial-relational,3|4,7,3/4,210052,3
2,1,21,53,1,901,1,11,5,5,6,single-choice,spatial-relational,5|6,7,5/6,210053,5
2,1,21,54,1,741,1,13,6,6,7,single-choice,spatial-relational,6|7,7,6/7,210054,6
2,1,21,55,0,692,1,5,2,3,3,single-choice,spatial-relational,2|3,7,2/3,210055,2
2,1,21,56,0,607,1,5,2,3,3,single-choice,spatial-relational,2|3,7,2/3,210056,2
2,1,21,57,0,933,1,7,3,4,4,single-choice,spatial-relational,3|4,7,3/4,210057,3
2,1,21,58,0,702,1,3,1,2,2,single-choice,spatial-relational,1|2,7,1/2,210058,1
2,1,21,59,0,1401,1,7,3,4,4,single-choice,spatial-relational,3|4,7,3/4,210059,3
2,1,21,60,1,816,1,13,6,6,7,single-choice,spatial-relational,6|7,7,6/7,210060,6
2,1,21,61,0,622,1,5,2,3,3,single-choice,spatial-relational,2|3,7,2/3,210061,2
2,1,21,62,1,586,1,3,1,1,2,single-choice,spatial-relational,1|2,7,1/2,210062,1
2,1,21,63,1,1086,1,11,5,5,6,single-choice,spatial-relational,5|6,7,5/6,210063,5
2,1,21,64,1,952,1,13,6,6,7,single-choice,spatial-relational,6|7,7,6/7,210064,6
2,1,21,65,0,821,1,7,3,4,4,single-choice,spatial-relational,3|4,7,3/4,210065,3
2,1,21,66,1,1138,1,11,5,5,6,single-choice,spatial-relational,5|6,7,5/6,210066,5
2,1,21,67,0,982,1,5,2,3,3,single-choice,spatial-relational,2|3,7,2/3,210067,2
2,1,21,68,1,28,1,11,5,5,6,single-choice,spatial-relational,5|6,7,5/6,210068,5
2,1,21,69,0,665,1,13,6,7,7,single-choice,spatial-relational,6|7,7,6/7,210069,6
2,1,21,70,0,558,1,11,5,6,6,single-choice,spatial-relational,5|6,7,5/6,210070,5
2,1,21,71,1,809,1,7,3,3,4,single-choice,spatial-relational,3|4,7,3/4,210071,3
2,1,21,72,1,587,1,5,2,2,3,single-choice,spatial-relational,2|3,7,2/3,210072,2
2,1,21,73,1,514,1,7,3,3,4,single-choice,spatial-relational,3|4,7,3/4,210073,3
2,1,21,74,0,61,1,9,4,5,5,single-choice,spatial-relational,4|5,7,4/5,210074,4
2,1,21,75,1,548,1,13,6,6,7,single-choice,spatial-relational,6|7,7,6/7,210075,6
2,1,21,76,1,616,1,9,4,4,5,single-choice,spatial-relational,4|5,7,4/5,210076,4
2,1,21,77,1,1568,1,3,1,1,2,single-choice,spatial-relational,1|2,7,1/2,210077,1
2,1,21,78,0,573,1,5,2,3,3,single-choice,spatial-relational,2|3,7,2/3,210078,2
2,1,21,79,1,596,1,3,1,1,2,single-choice,spatial-relational,1|2,7,1/2,210079,1
2,1,21,80,1,527,1,3,1,1,2,single-choice,spatial-relational,1|2,7,1/2,210080,1
2,1,21,81,0,661,1,5,2,3,3,single-choice,spatial-relational,2|3,7,2/3,210081,2
2,1,21,82,0,528,1,5,2,3,3,single-choice,spatial-relational,2|3,7,2/3,210082,2
2,1,21,83,1,548,1,9,4,4,5,single-choice,spatial-relational,4|5,7,4/5,210083,4
2,1,21,84,1,49,1,11,5,5,6,single-choice,spatial-relational,5|6,7,5/6,210084,5
2,1,21,85,1,803,1,9,4,4,5,single-choice,spatial-relational,4|5,7,4/5,210085,4
2,1,21,86,1,716,1,7,3,3,4,single-choice,spatial-relational,3|4,7,3/4,210086,3
2,1,21,87,1,703,1,13,6,6,7,single-choice,spatial-relational,6|7,7,6/7,210087,6
2,1,21,88,0,504,1,11,5,6,6,single-choice,spatial-relational,5|6,7,5/6,210088,5
2,1,21,89,0,689,1,7,3,4,4,single-choice,spatial-relational,3|4,7,3/4,210089,3
2,1,21,90,1,617,1,3,1,1,2,single-choice,spatial-relational,1|2,7,1/2,210090,1
2,1,21,91,1,637,1,13,6,6,7,single-choice,spatial-relational,6|7,7,6/7,210091,6
2,1,21,92,1,56,1,9,4,4,5,single-choice,spatial-relational,4|5,7,4/5,210092,4
2,1,21,93,0,771,1,7,3,4,4,single-choice,spatial-relational,3|4,7,3/4,210093,3
2,1,21,94,0,608,1,5,2,3,3,single-choice,spatial-relational,2|3,7,2/3,210094,2
2,1,21,95,0,1337,1,13,6,7,7,single-choice,spatial-relational,6|7,7,6/7,210095,6
2,1,21,96,1,613,1,9,4,4,5,single-choice,spatial-relational,4|5,7,4/5,210096,4
2,1,21,97,1,720,1,11,5,5,6,single-choice,spatial-relational,5|6,7,5/6,210097,5
2,1,21,98,0,48,1,13,6,7,7,single-choice,spatial-relational,6|7,7,6/7,210098,6
2,1,21,99,0,578,1,5,2,3,3,single-choice,spatial-relational,2|3,7,2/3,210099,2
2,1,21,100,0,531,1,11,5,6,6,single-choice,spatial-relational,5|6,7,5/6,210100,5
2,1,21,101,1,648,1,3,1,1,2,single-choice,spatial-relational,1|2,7,1/2,210101,1
2,1,21,102,1,667,1,7,3,3,4,single-choice,spatial-relational,3|4,7,3/4,210102,3
2,1,21,103,1,700,1,3,1,1,2,single-choice,spatial-relational,1|2,7,1/2,210103,1
2,1,21,104,0,73,1,11,5,6,6,single-choice,spatial-relational,5|6,7,5/6,210104,5
2,1,21,105,0,1126,1,5,2,3,3,single-choice,spatial-relational,2|3,7,2/3,210105,2
2,1,21,106,1,609,1,3,1,1,2,single-choice,spatial-relational,1|2,7,1/2,210106,1
2,1,21,107,1,123,1,9,4,4,5,single-choice,spatial-relational,4|5,7,4/5,210107,4
2,1,21,108,1,49,1,5,2,2,3,single-choice,spatial-relational,2|3,7,2/3,210108,2
2,1,21,109,0,565,1,13,6,7,7,single-choice,spatial-relational,6|7,7,6/7,210109,6
2,1,21,110,0,696,1,9,4,5,5,single-choice,spatial-relational,4|5,7,4/5,210110,4
2,1,21,111,0,750,1,3,1,2,2,single-choice,spatial-relational,1|2,7,1/2,210111,1
2,1,21,112,1,587,1,7,3,3,4,single-choice,spatial-relational,3|4,7,3/4,210112,3
2,1,21,113,0,980,1,7,3,4,4,single-choice,spatial-relational,3|4,7,3/4,210113,3
2,1,21,114,0,966,1,11,5,6,6,single-choice,spatial-relational,5|6,7,5/6,210114,5
2,1,21,115,1,645,1,13,6,6,7,single-choice,spatial-relational,6|7,7,6/7,210115,6
2,1,21,116,1,943,1,3,1,1,2,single-choice,spatial-relational,1|2,7,1/2,210116,1
2,1,21,117,1,544,1,5,2,2,3,single-choice,spatial-relational,2|3,7,2/3,210117,2
2,1,21,118,0,654,1,11,5,6,6,single-choice,spatial-relational,5|6,7,5/6,210118,5
2,1,21,119,0,667,1,7,3,4,4,single-choice,spatial-relational,3|4,7,3/4,210119,3
2,1,21,120,0,377,1,9,4,5,5,single-choice,spatial-relational,4|5,7,4/5,210120,4
2,1,21,121,1,678,1,13,6,6,7,single-choice,spatial-relational,6|7,7,6/7,210121,6
2,1,21,122,0,756,1,11,5,6,6,single-choice,spatial-relational,5|6,7,5/6,210122,5
2,1,21,123,1,829,1,9,4,4,5,single-choice,spatial-relational,4|5,7,4/5,210123,4
2,1,21,124,0,526,1,13,6,7,7,single-choice,spatial-relational,6|7,7,6/7,210124,6
2,1,21,125,1,663,1,3,1,1,2,single-choice,spatial-relational,1|2,7,1/2,210125,1
2,1,21,126,1,53,1,7,3,3,4,single-choice,spatial-relational,3|4,7,3/4,210126,3
2,1,21,127,0,411,1,5,2,3,3,single-choice,spatial-relational,2|3,7,2/3,210127,2
2,1,21,128,1,53,1,9,4,4,5,single-choice,spatial-relational,4|5,7,4/5,210128,4
2,1,21,129,1,742,1,11,5,5,6,single-choice,spatial-relational,5|6,7,5/6,210129,5
2,1,21,130,0,64,1,7,3,4,4,single-choice,spatial-relational,3|4,7,3/4,210130,3
2,1,21,131,1,496,1,13,6,6,7,single-choice,spatial-relational,6|7,7,6/7,210131,6
2,1,21,132,1,39,1,13,6,6,7,single-choice,spatial-relational,6|7,7,6/7,210132,6
2,1,21,133,1,1068,1,9,4,4,5,single-choice,spatial-relational,4|5,7,4/5,210133,4
2,1,21,134,1,612,1,7,3,3,4,single-choice,spatial-relational,3|4,7,3/4,210134,3
2,1,21,135,0,32,1,5,2,3,3,single-choice,spatial-relational,2|3,7,2/3,210135,2
2,1,21,136,1,56,1,3,1,1,2,single-choice,spatial-relational,1|2,7,1/2,210136,1
2,1,21,137,0,548,1,11,5,6,6,single-choice,spatial-relational,5|6,7,5/6,210137,5
2,1,21,138,1,44,1,5,2,2,3,single-choice,spatial-relational,2|3,7,2/3,210138,2
2,1,21,139,1,601,1,3,1,1,2,single-choice,spatial-relational,1|2,7,1/2,210139,1
2,1,21,140,1,522,1,13,6,6,7,single-choice,spatial-relational,6|7,7,6/7,210140,6
2,1,21,141,1,44,1,11,5,5,6,single-choice,spatial-relational,5|6,7,5/6,210141,5
2,1,21,142,0,518,1,13,6,7,7,single-choice,spatial-relational,6|7,7,6/7,210142,6
2,1,21,143,0,767,1,5,2,3,3,single-choice,spatial-relational,2|3,7,2/3,210143,2
2,1,21,144,0,684,1,7,3,4,4,single-choice,spatial-relational,3|4,7,3/4,210144,3
2,1,21,145,1,677,1,9,4,4,5,single-choice,spatial-relational,4|5,7,4/5,210145,4
2,1,21,146,1,732,1,3,1,1,2,single-choice,spatial-relational,1|2,7,1/2,210146,1
2,1,21,147,1,494,1,3,1,1,2,single-choice,spatial-relational,1|2,7,1/2,210147,1
2,1,21,148,1,488,1,7,3,3,4,single-choice,spatial-relational,3|4,7,3/4,210148,3
2,1,21,149,1,44,1,9,4,4,5,single-choice,spatial-relational,4|5,7,4/5,210149,4
2,1,21,150,0,463,1,5,2,3,3,single-choice,spatial-relational,2|3,7,2/3,210150,2
2,1,21,151,0,522,1,11,5,6,6,single-choice,spatial-relational,5|6,7,5/6,210151,5
2,1,21,152,0,52,1,13,6,7,7,single-choice,spatial-relational,6|7,7,6/7,210152,6
2,1,21,153,0,40,1,13,6,7,7,single-choice,spatial-relational,6|7,7,6/7,210153,6
2,1,21,154,1,743,1,7,3,3,4,single-choice,spatial-relational,3|4,7,3/4,210154,3
2,1,21,155,0,691,1,5,2,3,3,single-choice,spatial-relational,2|3,7,2/3,210155,2
2,1,21,156,1,99,1,3,1,1,2,single-choice,spatial-relational,1|2,7,1/2,210156,1
2,1,21,157,1,52,1,11,5,5,6,single-choice,spatial-relational,5|6,7,5/6,210157,5
2,1,21,158,0,372,1,7,3,4,4,single-choice,spatial-relational,3|4,7,3/4,210158,3
2,1,21,159,1,644,1,9,4,4,5,single-choice,spatial-relational,4|5,7,4/5,210159,4
2,1,21,160,1,96,1,5,2,2,3,single-choice,spatial-relational,2|3,7,2/3,210160,2
2,1,21,161,1,44,1,9,4,4,5,single-choice,spatial-relational,4|5,7,4/5,210161,4
2,1,21,162,0,445,1,11,5,6,6,single-choice,spatial-relational,5|6,7,5/6,210162,5
2,1,21,163,1,599,1,3,1,1,2,single-choice,spatial-relational,1|2,7,1/2,210163,1
2,1,21,164,0,774,1,5,2,3,3,single-choice,spatial-relational,2|3,7,2/3,210164,2
2,1,21,165,1,56,1,13,6,6,7,single-choice,spatial-relational,6|7,7,6/7,210165,6
2,1,21,166,0,508,1,9,4,5,5,single-choice,spatial-relational,4|5,7,4/5,210166,4
2,1,21,167,0,521,1,11,5,6,6,single-choice,spatial-relational,5|6,7,5/6,210167,5
2,1,21,168,1,162,1,7,3,3,4,single-choice,spatial-relational,3|4,7,3/4,210168,3
2,1,21,169,1,861,1,3,1,1,2,single-choice,spatial-relational,1|2,7,1/2,210169,1
2,1,21,170,0,621,1,11,5,6,6,single-choice,spatial-relational,5|6,7,5/6,210170,5
2,1,21,171,1,1356,1,9,4,4,5,single-choice,spatial-relational,4|5,7,4/5,210171,4
2,1,21,172,1,834,1,5,2,2,3,single-choice,spatial-relational,2|3,7,2/3,210172,2
2,1,21,173,1,468,1,3,1,1,2,single-choice,spatial-relational,1|2,7,1/2,210173,1
2,1,21,174,0,824,1,13,6,7,7,single-choice,spatial-relational,6|7,7,6/7,210174,6
2,1,21,175,0,629,1,7,3,4,4,single-choice,spatial-relational,3|4,7,3/4,210175,3
2,1,21,176,1,794,1,5,2,2,3,single-choice,spatial-relational,2|3,7,2/3,210176,2
2,1,21,177,0,93,1,13,6,7,7,single-choice,spatial-relational,6|7,7,6/7,210177,6
2,1,21,178,0,1445,1,7,3,4,4,single-choice,spatial-relational,3|4,7,3/4,210178,3
2,1,21,179,1,590,1,3,1,1,2,single-choice,spatial-relational,1|2,7,1/2,210179,1
2,1,21,180,0,602,1,5,2,3,3,single-choice,spatial-relational,2|3,7,2/3,210180,2
2,1,21,181,1,522,1,11,5,5,6,single-choice,spatial-relational,5|6,7,5/6,210181,5
2,1,21,182,1,754,1,13,6,6,7,single-choice,spatial-relational,6|7,7,6/7,210182,6
2,1,21,183,1,519,1,9,4,4,5,single-choice,spatial-relational,4|5,7,4/5,210183,4
2,1,21,184,0,49,1,11,5,6,6,single-choice,spatial-relational,5|6,7,5/6,210184,5
2,1,21,185,0,995,1,9,4,5,5,single-choice,spatial-relational,4|5,7,4/5,210185,4
2,1,21,186,0,1115,1,7,3,4,4,single-choice,spatial-relational,3|4,7,3/4,210186,3
2,1,21,187,1,80,1,3,1,1,2,single-choice,spatial-relational,1|2,7,1/2,210187,1
2,1,21,188,0,1288,1,7,3,4,4,single-choice,spatial-relational,3|4,7,3/4,210188,3
2,1,21,189,0,1339,1,3,1,2,2,single-choice,spatial-relational,1|2,7,1/2,210189,1
2,1,21,190,0,1274,1,5,2,3,3,single-choice,spatial-relational,2|3,7,2/3,210190,2
2,1,21,191,0,566,1,3,1,2,2,single-choice,spatial-relational,1|2,7,1/2,210191,1
2,1,21,192,0,5061,1,9,4,5,5,single-choice,spatial-relational,4|5,7,4/5,210192,4
2,1,21,193,0,40,1,13,6,7,7,single-choice,spatial-relational,6|7,7,6/7,210193,6
2,1,21,194,0,74,1,9,4,5,5,single-choice,spatial-relational,4|5,7,4/5,210194,4
2,1,21,195,1,659,1,5,2,2,3,single-choice,spatial-relational,2|3,7,2/3,210195,2
2,1,21,196,0,728,1,11,5,6,6,single-choice,spatial-relational,5|6,7,5/6,210196,5
2,1,21,197,1,87,1,7,3,3,4,single-choice,spatial-relational,3|4,7,3/4,210197,3
2,1,21,198,1,617,1,13,6,6,7,single-choice,spatial-relational,6|7,7,6/7,210198,6
2,1,21,199,0,675,1,11,5,6,6,single-choice,spatial-relational,5|6,7,5/6,210199,5
2,1,21,200,0,868,1,5,2,3,3,single-choice,spatial-relational,2|3,7,2/3,210200,2
2,1,21,201,1,599,1,13,6,6,7,single-choice,spatial-relational,6|7,7,6/7,210201,6
2,1,21,202,0,690,1,3,1,2,2,single-choice,spatial-relational,1|2,7,1/2,210202,1
2,1,21,203,1,835,1,3,1,1,2,single-choice,spatial-relational,1|2,7,1/2,210203,1
2,1,21,204,0,558,1,11,5,6,6,single-choice,spatial-relational,5|6,7,5/6,210204,5
2,1,21,205,1,173,1,9,4,4,5,single-choice,spatial-relational,4|5,7,4/5,210205,4
2,1,21,206,0,111,1,9,4,5,5,single-choice,spatial-relational,4|5,7,4/5,210206,4
2,1,21,207,1,28,1,7,3,3,4,single-choice,spatial-relational,3|4,7,3/4,210207,3
2,1,21,208,0,51,1,13,6,7,7,single-choice,spatial-relational,6|7,7,6/7,210208,6
2,1,21,209,0,92,1,7,3,4,4,single-choice,spatial-relational,3|4,7,3/4,210209,3
2,1,21,210,0,486,1,11,5,6,6,single-choice,spatial-relational,5|6,7,5/6,210210,5
2,1,21,211,1,479,1,5,2,2,3,single-choice,spatial-relational,2|3,7,2/3,210211,2
2,1,21,212,0,1162,1,5,2,3,3,single-choice,spatial-relational,2|3,7,2/3,210212,2
2,1,21,213,0,57,1,7,3,4,4,single-choice,spatial-relational,3|4,7,3/4,210213,3
2,1,21,214,0,722,1,13,6,7,7,single-choice,spatial-relational,6|7,7,6/7,210214,6
2,1,21,215,0,800,1,11,5,6,6,single-choice,spatial-relational,5|6,7,5/6,210215,5
2,1,21,216,1,129,1,9,4,4,5,single-choice,spatial-relational,4|5,7,4/5,210216,4
2,1,21,217,0,449,1,5,2,3,3,single-choice,spatial-relational,2|3,7,2/3,210217,2
2,1,21,218,1,1146,1,3,1,1,2,single-choice,spatial-relational,1|2,7,1/2,210218,1
2,1,21,219,0,582,1,3,1,2,2,single-choice,spatial-relational,1|2,7,1/2,210219,1
2,1,21,220,1,783,1,13,6,6,7,single-choice,spatial-relational,6|7,7,6/7,210220,6
2,1,21,221,1,639,1,7,3,3,4,single-choice,spatial-relational,3|4,7,3/4,210221,3
2,1,21,222,0,48,1,9,4,5,5,single-choice,spatial-relational,4|5,7,4/5,210222,4
2,1,21,223,1,228,1,11,5,5,6,single-choice,spatial-relational,5|6,7,5/6,210223,5
2,1,21,224,1,831,1,9,4,4,5,single-choice,spatial-relational,4|5,7,4/5,210224,4
2,1,21,225,0,550,1,5,2,3,3,single-choice,spatial-relational,2|3,7,2/3,210225,2
2,1,21,226,1,842,1,3,1,1,2,single-choice,spatial-relational,1|2,7,1/2,210226,1
2,1,21,227,1,8493,1,7,3,3,4,single-choice,spatial-relational,3|4,7,3/4,210227,3
2,1,21,228,0,712,1,7,3,4,4,single-choice,spatial-relational,3|4,7,3/4,210228,3
2,1,21,229,0,2028,1,13,6,7,7,single-choice,spatial-relational,6|7,7,6/7,210229,6
2,1,21,230,0,53,1,13,6,7,7,single-choice,spatial-relational,6|7,7,6/7,210230,6
2,1,21,231,1,41,1,11,5,5,6,single-choice,spatial-relational,5|6,7,5/6,210231,5
2,1,21,232,0,32,1,11,5,6,6,single-choice,spatial-relational,5|6,7,5/6,210232,5
2,1,21,233,1,40,1,9,4,4,5,single-choice,spatial-relational,4|5,7,4/5,210233,4
2,1,21,234,0,597,1,3,1,2,2,single-choice,spatial-relational,1|2,7,1/2,210234,1
2,1,21,235,0,570,1,5,2,3,3,single-choice,spatial-relational,2|3,7,2/3,210235,2
2,1,21,236,0,68,1,3,1,2,2,single-choice,spatial-relational,1|2,7,1/2,210236,1
2,1,21,237,1,17828,1,5,2,2,3,single-choice,spatial-relational,2|3,7,2/3,210237,2
2,1,21,238,1,820,1,7,3,3,4,single-choice,spatial-relational,3|4,7,3/4,210238,3
2,1,21,239,1,395,1,11,5,5,6,single-choice,spatial-relational,5|6,7,5/6,210239,5
2,1,21,240,0,56,1,11,5,6,6,single-choice,spatial-relational,5|6,7,5/6,210240,5
2,1,21,241,1,1073,1,9,4,4,5,single-choice,spatial-relational,4|5,7,4/5,210241,4
2,1,21,242,1,56,1,3,1,1,2,single-choice,spatial-relational,1|2,7,1/2,210242,1
2,1,21,243,1,709,1,13,6,6,7,single-choice,spatial-relational,6|7,7,6/7,210243,6
2,1,21,244,1,393,1,9,4,4,5,single-choice,spatial-relational,4|5,7,4/5,210244,4
2,1,21,245,0,708,1,5,2,3,3,single-choice,spatial-relational,2|3,7,2/3,210245,2
2,1,21,246,0,696,1,7,3,4,4,single-choice,spatial-relational,3|4,7,3/4,210246,3
2,1,21,247,0,36,1,13,6,7,7,single-choice,spatial-relational,6|7,7,6/7,210247,6
2,1,21,248,0,1520,1,7,3,4,4,single-choice,spatial-relational,3|4,7,3/4,210248,3
2,1,21,249,1,137,1,9,4,4,5,single-choice,spatial-relational,4|5,7,4/5,210249,4
2,1,21,250,1,693,1,7,3,3,4,single-choice,spatial-relational,3|4,7,3/4,210250,3
2,1,21,251,0,428,1,13,6,7,7,single-choice,spatial-relational,6|7,7,6/7,210251,6
2,1,21,252,1,287,1,3,1,1,2,single-choice,spatial-relational,1|2,7,1/2,210252,1
2,1,21,253,1,83,1,11,5,5,6,single-choice,spatial-relational,5|6,7,5/6,210253,5
2,1,21,254,1,910,1,3,1,1,2,single-choice,spatial-relational,1|2,7,1/2,210254,1
2,1,21,255,1,3211,1,5,2,2,3,single-choice,spatial-relational,2|3,7,2/3,210255,2
2,1,21,256,0,36,1,9,4,5,5,single-choice,spatial-relational,4|5,7,4/5,210256,4
2,1,21,257,0,674,1,11,5,6,6,single-choice,spatial-relational,5|6,7,5/6,210257,5
2,1,21,258,0,773,1,5,2,3,3,single-choice,spatial-relational,2|3,7,2/3,210258,2
2,1,21,259,1,588,1,13,6,6,7,single-choice,spatial-relational,6|7,7,6/7,210259,6
2,1,21,260,1,1630,1,9,4,4,5,single-choice,spatial-relational,4|5,7,4/5,210260,4
2,1,21,261,0,1560,1,7,3,4,4,single-choice,spatial-relational,3|4,7,3/4,210261,3
2,1,21,262,1,600,1,9,4,4,5,single-choice,spatial-relational,4|5,7,4/5,210262,4
2,1,21,263,0,816,1,5,2,3,3,single-choice,spatial-relational,2|3,7,2/3,210263,2
2,1,21,264,0,56,1,5,2,3,3,single-choice,spatial-relational,2|3,7,2/3,210264,2
2,1,21,265,0,295,1,3,1,2,2,single-choice,spatial-relational,1|2,7,1/2,210265,1
2,1,21,266,0,1232,1,11,5,6,6,single-choice,spatial-relational,5|6,7,5/6,210266,5
2,1,21,267,1,664,1,13,6,6,7,single-choice,spatial-relational,6|7,7,6/7,210267,6
2,1,21,268,1,727,1,3,1,1,2,single-choice,spatial-relational,1|2,7,1/2,210268,1
2,1,21,269,1,1032,1,13,6,6,7,single-choice,spatial-relational,6|7,7,6/7,210269,6
2,1,21,270,0,679,1,7,3,4,4,single-choice,spatial-relational,3|4,7,3/4,210270,3
2,1,21,271,1,94,1,11,5,5,6,single-choice,spatial-relational,5|6,7,5/6,210271,5
2,1,21,272,1,737,1,7,3,3,4,single-choice,spatial-relational,3|4,7,3/4,210272,3
2,1,21,273,0,617,1,3,1,2,2,single-choice,spatial-relational,1|2,7,1/2,210273,1
2,1,21,274,0,775,1,5,2,3,3,single-choice,spatial-relational,2|3,7,2/3,210274,2
2,1,21,275,0,5140,1,9,4,5,5,single-choice,spatial-relational,4|5,7,4/5,210275,4
2,1,21,276,0,762,1,11,5,6,6,single-choice,spatial-relational,5|6,7,5/6,210276,5
2,1,21,277,1,576,1,9,4,4,5,single-choice,spatial-relational,4|5,7,4/5,210277,4
2,1,21,278,1,478,1,3,1,1,2,single-choice,spatial-relational,1|2,7,1/2,210278,1
2,1,21,279,0,591,1,7,3,4,4,single-choice,spatial-relational,3|4,7,3/4,210279,3
2,1,21,280,1,605,1,13,6,6,7,single-choice,spatial-relational,6|7,7,6/7,210280,6
2,1,21,281,0,506,1,11,5,6,6,single-choice,spatial-relational,5|6,7,5/6,210281,5
2,1,21,282,0,68,1,13,6,7,7,single-choice,spatial-relational,6|7,7,6/7,210282,6
2,1,21,283,0,587,1,5,2,3,3,single-choice,spatial-relational,2|3,7,2/3,210283,2
2,1,21,284,0,819,1,7,3,4,4,single-choice,spatial-relational,3|4,7,3/4,210284,3
2,1,21,285,0,724,1,9,4,5,5,single-choice,spatial-relational,4|5,7,4/5,210285,4
2,1,21,286,0,586,1,11,5,6,6,single-choice,spatial-relational,5|6,7,5/6,210286,5
2,1,21,287,0,76,1,5,2,3,3,single-choice,spatial-relational,2|3,7,2/3,210287,2
2,1,21,288,1,60,1,3,1,1,2,single-choice,spatial-relational,1|2,7,1/2,210288,1
2,1,21,289,1,967,1,3,1,1,2,single-choice,spatial-relational,1|2,7,1/2,210289,1
2,1,21,290,1,472,1,7,3,3,4,single-choice,spatial-relational,3|4,7,3/4,210290,3
2,1,21,291,1,343,1,9,4,4,5,single-choice,spatial-relational,4|5,7,4/5,210291,4
2,1,21,292,1,521,1,13,6,6,7,single-choice,spatial-relational,6|7,7,6/7,210292,6
2,1,21,293,1,52,1,5,2,2,3,single-choice,spatial-relational,2|3,7,2/3,210293,2
2,1,21,294,0,439,1,13,6,7,7,single-choice,spatial-relational,6|7,7,6/7,210294,6
2,1,21,295,1,36,1,11,5,5,6,single-choice,spatial-relational,5|6,7,5/6,210295,5
2,1,21,296,0,559,1,13,6,7,7,single-choice,spatial-relational,6|7,7,6/7,210296,6
2,1,21,297,0,533,1,3,1,2,2,single-choice,spatial-relational,1|2,7,1/2,210297,1
2,1,21,298,1,790,1,11,5,5,6,single-choice,spatial-relational,5|6,7,5/6,210298,5
2,1,21,299,0,1389,1,3,1,2,2,single-choice,spatial-relational,1|2,7,1/2,210299,1
2,1,21,300,1,624,1,5,2,2,3,single-choice,spatial-relational,2|3,7,2/3,210300,2
2,1,21,301,1,399,1,13,6,6,7,single-choice,spatial-relational,6|7,7,6/7,210301,6
2,1,21,302,1,32,1,7,3,3,4,single-choice,spatial-relational,3|4,7,3/4,210302,3
2,1,21,303,0,737,1,9,4,5,5,single-choice,spatial-relational,4|5,7,4/5,210303,4
2,1,21,304,1,389,1,7,3,3,4,single-choice,spatial-relational,3|4,7,3/4,210304,3
2,1,21,305,1,103,1,9,4,4,5,single-choice,spatial-relational,4|5,7,4/5,210305,4
2,1,21,306,0,542,1,11,5,6,6,single-choice,spatial-relational,5|6,7,5/6,210306,5
2,1,21,307,0,52,1,5,2,3,3,single-choice,spatial-relational,2|3,7,2/3,210307,2
2,1,21,308,0,758,1,9,4,5,5,single-choice,spatial-relational,4|5,7,4/5,210308,4
2,1,21,309,1,73,1,11,5,5,6,single-choice,spatial-relational,5|6,7,5/6,210309,5
2,1,21,310,0,36,1,13,6,7,7,single-choice,spatial-relational,6|7,7,6/7,210310,6
2,1,21,311,0,580,1,11,5,6,6,single-choice,spatial-relational,5|6,7,5/6,210311,5
2,1,21,312,1,314,1,5,2,2,3,single-choice,spatial-relational,2|3,7,2/3,210312,2
2,1,21,313,0,707,1,7,3,4,4,single-choice,spatial-relational,3|4,7,3/4,210313,3
2,1,21,314,1,4965,1,5,2,2,3,single-choice,spatial-relational,2|3,7,2/3,210314,2
2,1,21,315,1,44,1,7,3,3,4,single-choice,spatial-relational,3|4,7,3/4,210315,3
2,1,21,316,0,555,1,3,1,2,2,single-choice,spatial-relational,1|2,7,1/2,210316,1
2,1,21,317,1,465,1,3,1,1,2,single-choice,spatial-relational,1|2,7,1/2,210317,1
2,1,21,318,1,695,1,13,6,6,7,single-choice,spatial-relational,6|7,7,6/7,210318,6
2,1,21,319,0,726,1,9,4,5,5,single-choice,spatial-relational,4|5,7,4/5,210319,4
2,1,21,320,1,557,1,11,5,5,6,single-choice,spatial-relational,5|6,7,5/6,210320,5
2,1,21,321,1,48,1,3,1,1,2,single-choice,spatial-relational,1|2,7,1/2,210321,1
2,1,21,322,1,823,1,3,1,1,2,single-choice,spatial-relational,1|2,7,1/2,210322,1
2,1,21,323,1,2470,1,9,4,4,5,single-choice,spatial-relational,4|5,7,4/5,210323,4
2,1,21,324,1,650,1,7,3,3,4,single-choice,spatial-relational,3|4,7,3/4,210324,3
2,1,21,325,0,549,1,11,5,6,6,single-choice,spatial-relational,5|6,7,5/6,210325,5
2,1,21,326,1,620,1,9,4,4,5,single-choice,spatial-relational,4|5,7,4/5,210326,4
2,1,21,327,0,576,1,7,3,4,4,single-choice,spatial-relational,3|4,7,3/4,210327,3
2,1,21,328,0,48,1,5,2,3,3,single-choice,spatial-relational,2|3,7,2/3,210328,2
2,1,21,329,1,57,1,5,2,2,3,single-choice,spatial-relational,2|3,7,2/3,210329,2
2,1,21,330,1,520,1,13,6,6,7,single-choice,spatial-relational,6|7,7,6/7,210330,6
2,1,21,331,1,662,1,13,6,6,7,single-choice,spatial-relational,6|7,7,6/7,210331,6
2,1,21,332,1,1240,1,13,6,6,7,single-choice,spatial-relational,6|7,7,6/7,210332,6
2,1,21,333,1,15072,1,11,5,5,6,single-choice,spatial-relational,5|6,7,5/6,210333,5
2,1,21,334,0,522,1,5,2,3,3,single-choice,spatial-relational,2|3,7,2/3,210334,2
2,1,21,335,0,1033,1,5,2,3,3,single-choice,spatial-relational,2|3,7,2/3,210335,2
2,1,21,336,0,48,1,13,6,7,7,single-choice,spatial-relational,6|7,7,6/7,210336,6
2,1,21,337,1,56,1,3,1,1,2,single-choice,spatial-relational,1|2,7,1/2,210337,1
2,1,21,338,1,13194,1,9,4,4,5,single-choice,spatial-relational,4|5,7,4/5,210338,4
2,1,21,339,0,568,1,7,3,4,4,single-choice,spatial-relational,3|4,7,3/4,210339,3
2,1,21,340,1,464,1,9,4,4,5,single-choice,spatial-relational,4|5,7,4/5,210340,4
2,1,21,341,1,491,1,7,3,3,4,single-choice,spatial-relational,3|4,7,3/4,210341,3
2,1,21,342,0,443,1,3,1,2,2,single-choice,spatial-relational,1|2,7,1/2,210342,1
2,1,21,343,0,513,1,11,5,6,6,single-choice,spatial-relational,5|6,7,5/6,210343,5
2,1,21,344,0,601,1,5,2,3,3,single-choice,spatial-relational,2|3,7,2/3,210344,2
2,1,21,345,0,464,1,11,5,6,6,single-choice,spatial-relational,5|6,7,5/6,210345,5
2,1,21,346,1,523,1,9,4,4,5,single-choice,spatial-relational,4|5,7,4/5,210346,4
2,1,21,347,0,471,1,7,3,4,4,single-choice,spatial-relational,3|4,7,3/4,210347,3
2,1,21,348,1,471,1,13,6,6,7,single-choice,spatial-relational,6|7,7,6/7,210348,6
2,1,21,349,1,451,1,7,3,3,4,single-choice,spatial-relational,3|4,7,3/4,210349,3
2,1,21,350,0,330,1,3,1,2,2,single-choice,spatial-relational,1|2,7,1/2,210350,1
2,1,21,351,0,20,1,5,2,3,3,single-choice,spatial-relational,2|3,7,2/3,210351,2
2,1,21,352,1,531,1,13,6,6,7,single-choice,spatial-relational,6|7,7,6/7,210352,6
2,1,21,353,1,50,1,3,1,1,2,single-choice,spatial-relational,1|2,7,1/2,210353,1
2,1,21,354,1,63,1,9,4,4,5,single-choice,spatial-relational,4|5,7,4/5,210354,4
2,1,21,355,1,1117,1,11,5,5,6,single-choice,spatial-relational,5|6,7,5/6,210355,5
2,1,21,356,0,580,1,7,3,4,4,single-choice,spatial-relational,3|4,7,3/4,210356,3
2,1,21,357,0,28037,1,11,5,6,6,single-choice,spatial-relational,5|6,7,5/6,210357,5
2,1,21,358,1,19518,1,5,2,2,3,single-choice,spatial-relational,2|3,7,2/3,210358,2
2,1,21,359,1,550,1,5,2,2,3,single-choice,spatial-relational,2|3,7,2/3,210359,2
2,1,21,360,0,544,1,11,5,6,6,single-choice,spatial-relational,5|6,7,5/6,210360,5
2,1,21,361,1,329,1,3,1,1,2,single-choice,spatial-relational,1|2,7,1/2,210361,1
2,1,21,362,0,559,1,7,3,4,4,single-choice,spatial-relational,3|4,7,3/4,210362,3
2,1,21,363,1,530,1,9,4,4,5,single-choice,spatial-relational,4|5,7,4/5,210363,4
2,1,21,364,0,12,1,7,3,4,4,single-choice,spatial-relational,3|4,7,3/4,210364,3
2,1,21,365,0,467,1,11,5,6,6,single-choice,spatial-relational,5|6,7,5/6,210365,5
2,1,21,366,1,566,1,3,1,1,2,single-choice,spatial-relational,1|2,7,1/2,210366,1
2,1,21,367,1,472,1,9,4,4,5,single-choice,spatial-relational,4|5,7,4/5,210367,4
2,1,21,368,1,605,1,13,6,6,7,single-choice,spatial-relational,6|7,7,6/7,210368,6
2,1,21,369,1,660,1,3,1,1,2,single-choice,spatial-relational,1|2,7,1/2,210369,1
2,1,21,370,0,494,1,5,2,3,3,single-choice,spatial-relational,2|3,7,2/3,210370,2
2,1,21,371,0,474,1,11,5,6,6,single-choice,spatial-relational,5|6,7,5/6,210371,5
2,1,21,372,0,480,1,5,2,3,3,single-choice,spatial-relational,2|3,7,2/3,210372,2
2,1,21,373,1,477,1,13,6,6,7,single-choice,spatial-relational,6|7,7,6/7,210373,6
2,1,21,374,1,563,1,3,1,1,2,single-choice,spatial-relational,1|2,7,1/2,210374,1
2,1,21,375,1,628,1,7,3,3,4,single-choice,spatial-relational,3|4,7,3/4,210375,3
2,1,21,376,1,625,1,3,1,1,2,single-choice,spatial-relational,1|2,7,1/2,210376,1
2,1,21,377,1,609,1,9,4,4,5,single-choice,spatial-relational,4|5,7,4/5,210377,4
2,1,21,378,0,444,1,11,5,6,6,single-choice,spatial-relational,5|6,7,5/6,210378,5
2,1,21,379,0,480,1,11,5,6,6,single-choice,spatial-relational,5|6,7,5/6,210379,5
2,1,21,380,0,508,1,5,2,3,3,single-choice,spatial-relational,2|3,7,2/3,210380,2
2,1,21,381,1,538,1,9,4,4,5,single-choice,spatial-relational,4|5,7,4/5,210381,4
2,1,21,382,0,586,1,5,2,3,3,single-choice,spatial-relational,2|3,7,2/3,210382,2
2,1,21,383,1,508,1,13,6,6,7,single-choice,spatial-relational,6|7,7,6/7,210383,6
2,1,21,384,0,688,1,7,3,4,4,single-choice,spatial-relational,3|4,7,3/4,210384,3
2,1,21,385,1,44,1,13,6,6,7,single-choice,spatial-relational,6|7,7,6/7,210385,6
2,1,21,386,1,687,1,9,4,4,5,single-choice,spatial-relational,4|5,7,4/5,210386,4
2,1,21,387,0,711,1,5,2,3,3,single-choice,spatial-relational,2|3,7,2/3,210387,2
2,1,21,388,1,579,1,5,2,2,3,single-choice,spatial-relational,2|3,7,2/3,210388,2
2,1,21,389,0,523,1,11,5,6,6,single-choice,spatial-relational,5|6,7,5/6,210389,5
2,1,21,390,0,562,1,7,3,4,4,single-choice,spatial-relational,3|4,7,3/4,210390,3
2,1,21,391,1,539,1,9,4,4,5,single-choice,spatial-relational,4|5,7,4/5,210391,4
2,1,21,392,1,593,1,13,6,6,7,single-choice,spatial-relational,6|7,7,6/7,210392,6
2,1,21,393,0,723,1,11,5,6,6,single-choice,spatial-relational,5|6,7,5/6,210393,5
2,1,21,394,0,32,1,3,1,2,2,single-choice,spatial-relational,1|2,7,1/2,210394,1
2,1,21,395,0,502,1,7,3,4,4,single-choice,spatial-relational,3|4,7,3/4,210395,3
2,1,21,396,1,446,1,13,6,6,7,single-choice,spatial-relational,6|7,7,6/7,210396,6
2,1,21,397,1,624,1,3,1,1,2,single-choice,spatial-relational,1|2,7,1/2,210397,1
2,1,21,398,1,455,1,13,6,6,7,single-choice,spatial-relational,6|7,7,6/7,210398,6
2,1,21,399,0,632,1,11,5,6,6,single-choice,spatial-relational,5|6,7,5/6,210399,5
2,1,21,400,0,479,1,5,2,3,3,single-choice,spatial-relational,2|3,7,2/3,210400,2
2,1,21,401,0,494,1,7,3,4,4,single-choice,spatial-relational,3|4,7,3/4,210401,3
2,1,21,402,0,497,1,11,5,6,6,single-choice,spatial-relational,5|6,7,5/6,210402,5
2,1,21,403,1,497,1,9,4,4,5,single-choice,spatial-relational,4|5,7,4/5,210403,4
2,1,21,404,0,753,1,7,3,4,4,single-choice,spatial-relational,3|4,7,3/4,210404,3
2,1,21,405,1,493,1,9,4,4,5,single-choice,spatial-relational,4|5,7,4/5,210405,4
2,1,21,406,1,624,1,3,1,1,2,single-choice,spatial-relational,1|2,7,1/2,210406,1
2,1,21,407,1,494,1,3,1,1,2,single-choice,spatial-relational,1|2,7,1/2,210407,1
2,1,21,408,1,460,1,13,6,6,7,single-choice,spatial-relational,6|7,7,6/7,210408,6
2,1,21,409,0,681,1,5,2,3,3,single-choice,spatial-relational,2|3,7,2/3,210409,2
2,1,21,410,0,449,1,11,5,6,6,single-choice,spatial-relational,5|6,7,5/6,210410,5
2,1,21,411,0,438,1,11,5,6,6,single-choice,spatial-relational,5|6,7,5/6,210411,5
2,1,21,412,0,506,1,5,2,3,3,single-choice,spatial-relational,2|3,7,2/3,210412,2
2,1,21,413,1,465,1,9,4,4,5,single-choice,spatial-relational,4|5,7,4/5,210413,4
2,1,21,414,0,699,1,7,3,4,4,single-choice,spatial-relational,3|4,7,3/4,210414,3
2,1,21,415,1,488,1,3,1,1,2,single-choice,spatial-relational,1|2,7,1/2,210415,1
2,1,21,416,0,687,1,5,2,3,3,single-choice,spatial-relational,2|3,7,2/3,210416,2
2,1,21,417,1,516,1,13,6,6,7,single-choice,spatial-relational,6|7,7,6/7,210417,6
2,1,21,418,1,808,1,9,4,4,5,single-choice,spatial-relational,4|5,7,4/5,210418,4
2,1,21,419,0,618,1,7,3,4,4,single-choice,spatial-relational,3|4,7,3/4,210419,3
2,1,21,420,1,501,1,13,6,6,7,single-choice,spatial-relational,6|7,7,6/7,210420,6
2,1,21,421,1,633,1,3,1,1,2,single-choice,spatial-relational,1|2,7,1/2,210421,1
2,1,21,422,1,491,1,13,6,6,7,single-choice,spatial-relational,6|7,7,6/7,210422,6
2,1,21,423,0,621,1,11,5,6,6,single-choice,spatial-relational,5|6,7,5/6,210423,5
2,1,21,424,1,591,1,9,4,4,5,single-choice,spatial-relational,4|5,7,4/5,210424,4
2,1,21,425,1,561,1,9,4,4,5,single-choice,spatial-relational,4|5,7,4/5,210425,4
2,1,21,426,0,641,1,11,5,6,6,single-choice,spatial-relational,5|6,7,5/6,210426,5
2,1,21,427,1,729,1,5,2,2,3,single-choice,spatial-relational,2|3,7,2/3,210427,2
2,1,21,428,1,502,1,3,1,1,2,single-choice,spatial-relational,1|2,7,1/2,210428,1
2,1,21,429,0,693,1,5,2,3,3,single-choice,spatial-relational,2|3,7,2/3,210429,2
2,1,21,430,1,487,1,13,6,6,7,single-choice,spatial-relational,6|7,7,6/7,210430,6
2,1,21,431,1,708,1,3,1,1,2,single-choice,spatial-relational,1|2,7,1/2,210431,1
2,1,21,432,0,567,1,7,3,4,4,single-choice,spatial-relational,3|4,7,3/4,210432,3
2,1,21,433,0,484,1,7,3,4,4,single-choice,spatial-relational,3|4,7,3/4,210433,3
2,1,21,434,0,625,1,5,2,3,3,single-choice,spatial-relational,2|3,7,2/3,210434,2
2,1,21,435,1,469,1,9,4,4,5,single-choice,spatial-relational,4|5,7,4/5,210435,4
2,1,21,436,0,599,1,11,5,6,6,single-choice,spatial-relational,5|6,7,5/6,210436,5
2,1,21,437,0,511,1,7,3,4,4,single-choice,spatial-relational,3|4,7,3/4,210437,3
2,1,21,438,0,481,1,11,5,6,6,single-choice,spatial-relational,5|6,7,5/6,210438,5
2,1,21,439,1,464,1,3,1,1,2,single-choice,spatial-relational,1|2,7,1/2,210439,1
2,1,21,440,1,560,1,13,6,6,7,single-choice,spatial-relational,6|7,7,6/7,210440,6
2,1,21,441,1,958,1,5,2,2,3,single-choice,spatial-relational,2|3,7,2/3,210441,2
2,1,21,442,0,537,1,7,3,4,4,single-choice,spatial-relational,3|4,7,3/4,210442,3
2,1,21,443,1,466,1,3,1,1,2,single-choice,spatial-relational,1|2,7,1/2,210443,1
2,1,21,444,1,525,1,9,4,4,5,single-choice,spatial-relational,4|5,7,4/5,210444,4
2,1,21,445,1,661,1,13,6,6,7,single-choice,spatial-relational,6|7,7,6/7,210445,6
2,1,21,446,0,542,1,11,5,6,6,single-choice,spatial-relational,5|6,7,5/6,210446,5
2,1,21,447,1,503,1,9,4,4,5,single-choice,spatial-relational,4|5,7,4/5,210447,4
2,1,21,448,0,591,1,11,5,6,6,single-choice,spatial-relational,5|6,7,5/6,210448,5
2,1,21,449,1,447,1,13,6,6,7,single-choice,spatial-relational,6|7,7,6/7,210449,6
2,1,21,450,0,612,1,5,2,3,3,single-choice,spatial-relational,2|3,7,2/3,210450,2
2,1,21,451,0,475,1,7,3,4,4,single-choice,spatial-relational,3|4,7,3/4,210451,3
2,1,21,452,1,475,1,3,1,1,2,single-choice,spatial-relational,1|2,7,1/2,210452,1
2,1,21,453,1,540,1,9,4,4,5,single-choice,spatial-relational,4|5,7,4/5,210453,4
2,1,21,454,0,647,1,7,3,4,4,single-choice,spatial-relational,3|4,7,3/4,210454,3
2,1,21,455,1,509,1,13,6,6,7,single-choice,spatial-relational,6|7,7,6/7,210455,6
2,1,21,456,1,659,1,3,1,1,2,single-choice,spatial-relational,1|2,7,1/2,210456,1
2,1,21,457,1,813,1,5,2,2,3,single-choice,spatial-relational,2|3,7,2/3,210457,2
2,1,21,458,0,576,1,5,2,3,3,single-choice,spatial-relational,2|3,7,2/3,210458,2
2,1,21,459,1,691,1,5,2,2,3,single-choice,spatial-relational,2|3,7,2/3,210459,2
2,1,21,460,0,537,1,11,5,6,6,single-choice,spatial-relational,5|6,7,5/6,210460,5
2,1,21,461,1,568,1,9,4,4,5,single-choice,spatial-relational,4|5,7,4/5,210461,4
2,1,21,462,0,661,1,11,5,6,6,single-choice,spatial-relational,5|6,7,5/6,210462,5
2,1,21,463,1,508,1,3,1,1,2,single-choice,spatial-relational,1|2,7,1/2,210463,1
2,1,21,464,1,470,1,9,4,4,5,single-choice,spatial-relational,4|5,7,4/5,210464,4
2,1,21,465,1,944,1,7,3,3,4,single-choice,spatial-relational,3|4,7,3/4,210465,3
2,1,21,466,1,658,1,13,6,6,7,single-choice,spatial-relational,6|7,7,6/7,210466,6
2,1,21,467,1,733,1,3,1,1,2,single-choice,spatial-relational,1|2,7,1/2,210467,1
2,1,21,468,1,534,1,13,6,6,7,single-choice,spatial-relational,6|7,7,6/7,210468,6
2,1,21,469,0,623,1,7,3,4,4,single-choice,spatial-relational,3|4,7,3/4,210469,3
2,1,21,470,1,470,1,13,6,6,7,single-choice,spatial-relational,6|7,7,6/7,210470,6
2,1,21,471,0,775,1,7,3,4,4,single-choice,spatial-relational,3|4,7,3/4,210471,3
2,1,21,472,1,532,1,9,4,4,5,single-choice,spatial-relational,4|5,7,4/5,210472,4
2,1,21,473,1,734,1,9,4,4,5,single-choice,spatial-relational,4|5,7,4/5,210473,4
2,1,21,474,1,1109,1,7,3,3,4,single-choice,spatial-relational,3|4,7,3/4,210474,3
2,1,21,475,0,618,1,5,2,3,3,single-choice,spatial-relational,2|3,7,2/3,210475,2
2,1,21,476,1,668,1,5,2,2,3,single-choice,spatial-relational,2|3,7,2/3,210476,2
2,1,21,477,1,598,1,13,6,6,7,single-choice,spatial-relational,6|7,7,6/7,210477,6
2,1,21,478,1,658,1,3,1,1,2,single-choice,spatial-relational,1|2,7,1/2,210478,1
2,1,21,479,0,498,1,11,5,6,6,single-choice,spatial-relational,5|6,7,5/6,210479,5
2,1,21,480,0,441,1,11,5,6,6,single-choice,spatial-relational,5|6,7,5/6,210480,5
2,1,21,481,1,505,1,3,1,1,2,single-choice,spatial-relational,1|2,7,1/2,210481,1
2,1,21,482,1,817,1,7,3,3,4,single-choice,spatial-relational,3|4,7,3/4,210482,3
2,1,21,483,1,1181,1,5,2,2,3,single-choice,spatial-relational,2|3,7,2/3,210483,2
2,1,21,484,0,503,1,11,5,6,6,single-choice,spatial-relational,5|6,7,5/6,210484,5
2,1,21,485,1,919,1,5,2,2,3,single-choice,spatial-relational,2|3,7,2/3,210485,2
2,1,21,486,0,491,1,11,5,6,6,single-choice,spatial-relational,5|6,7,5/6,210486,5
2,1,21,487,1,598,1,9,4,4,5,single-choice,spatial-relational,4|5,7,4/5,210487,4
2,1,21,488,1,1277,1,3,1,1,2,single-choice,spatial-relational,1|2,7,1/2,210488,1
2,1,21,489,1,654,1,13,6,6,7,single-choice,spatial-relational,6|7,7,6/7,210489,6
2,1,21,490,1,516,1,3,1,1,2,single-choice,spatial-relational,1|2,7,1/2,210490,1
2,1,21,491,1,515,1,13,6,6,7,single-choice,spatial-relational,6|7,7,6/7,210491,6
2,1,21,492,1,732,1,9,4,4,5,single-choice,spatial-relational,4|5,7,4/5,210492,4
2,1,21,493,0,616,1,7,3,4,4,single-choice,spatial-relational,3|4,7,3/4,210493,3
2,1,21,494,1,684,1,5,2,2,3,single-choice,spatial-relational,2|3,7,2/3,210494,2
2,1,21,495,0,502,1,7,3,4,4,single-choice,spatial-relational,3|4,7,3/4,210495,3
2,1,21,496,1,512,1,3,1,1,2,single-choice,spatial-relational,1|2,7,1/2,210496,1
2,1,21,497,1,476,1,3,1,1,2,single-choice,spatial-relational,1|2,7,1/2,210497,1
2,1,21,498,1,588,1,9,4,4,5,single-choice,spatial-relational,4|5,7,4/5,210498,4
2,1,21,499,0,667,1,7,3,4,4,single-choice,spatial-relational,3|4,7,3/4,210499,3
2,1,21,500,1,483,1,13,6,6,7,single-choice,spatial-relational,6|7,7,6/7,210500,6
2,1,21,501,0,738,1,5,2,3,3,single-choice,spatial-relational,2|3,7,2/3,210501,2
2,1,21,502,1,525,1,9,4,4,5,single-choice,spatial-relational,4|5,7,4/5,210502,4
2,1,21,503,0,666,1,11,5,6,6,single-choice,spatial-relational,5|6,7,5/6,210503,5
2,1,21,504,1,507,1,13,6,6,7,single-choice,spatial-relational,6|7,7,6/7,210504,6
2,1,21,505,0,788,1,11,5,6,6,single-choice,spatial-relational,5|6,7,5/6,210505,5
2,1,21,506,1,526,1,13,6,6,7,single-choice,spatial-relational,6|7,7,6/7,210506,6
2,1,21,507,1,626,1,9,4,4,5,single-choice,spatial-relational,4|5,7,4/5,210507,4
2,1,21,508,1,819,1,7,3,3,4,single-choice,spatial-relational,3|4,7,3/4,210508,3
2,1,21,509,0,544,1,11,5,6,6,single-choice,spatial-relational,5|6,7,5/6,210509,5
2,1,21,510,0,507,1,7,3,4,4,single-choice,spatial-relational,3|4,7,3/4,210510,3
2,1,21,511,0,931,1,5,2,3,3,single-choice,spatial-relational,2|3,7,2/3,210511,2
2,1,21,512,1,494,1,3,1,1,2,single-choice,spatial-relational,1|2,7,1/2,210512,1
2,1,21,513,1,594,1,13,6,6,7,single-choice,spatial-relational,6|7,7,6/7,210513,6
2,1,21,514,1,639,1,3,1,1,2,single-choice,spatial-relational,1|2,7,1/2,210514,1
2,1,21,515,1,481,1,9,4,4,5,single-choice,spatial-relational,4|5,7,4/5,210515,4
2,1,21,516,0,688,1,5,2,3,3,single-choice,spatial-relational,2|3,7,2/3,210516,2
2,1,21,517,0,471,1,11,5,6,6,single-choice,spatial-relational,5|6,7,5/6,210517,5
2,1,21,518,0,540,1,7,3,4,4,single-choice,spatial-relational,3|4,7,3/4,210518,3
2,1,21,519,1,437,1,13,6,6,7,single-choice,spatial-relational,6|7,7,6/7,210519,6
2,1,21,520,1,704,1,3,1,1,2,single-choice,spatial-relational,1|2,7,1/2,210520,1
2,1,21,521,0,509,1,7,3,4,4,single-choice,spatial-relational,3|4,7,3/4,210521,3
2,1,21,522,0,466,1,11,5,6,6,single-choice,spatial-relational,5|6,7,5/6,210522,5
2,1,21,523,1,824,1,5,2,2,3,single-choice,spatial-relational,2|3,7,2/3,210523,2
2,1,21,524,1,614,1,3,1,1,2,single-choice,spatial-relational,1|2,7,1/2,210524,1
2,1,21,525,1,530,1,9,4,4,5,single-choice,spatial-relational,4|5,7,4/5,210525,4
2,1,21,526,1,795,1,5,2,2,3,single-choice,spatial-relational,2|3,7,2/3,210526,2
2,1,21,527,1,549,1,13,6,6,7,single-choice,spatial-relational,6|7,7,6/7,210527,6
2,1,21,528,0,673,1,11,5,6,6,single-choice,spatial-relational,5|6,7,5/6,210528,5
2,1,21,529,1,541,1,9,4,4,5,single-choice,spatial-relational,4|5,7,4/5,210529,4
2,1,21,530,0,726,1,7,3,4,4,single-choice,spatial-relational,3|4,7,3/4,210530,3
2,1,21,531,0,484,1,7,3,4,4,single-choice,spatial-relational,3|4,7,3/4,210531,3
2,1,21,532,1,736,1,5,2,2,3,single-choice,spatial-relational,2|3,7,2/3,210532,2
2,1,21,533,0,544,1,11,5,6,6,single-choice,spatial-relational,5|6,7,5/6,210533,5
2,1,21,534,1,530,1,9,4,4,5,single-choice,spatial-relational,4|5,7,4/5,210534,4
2,1,21,535,0,718,1,11,5,6,6,single-choice,spatial-relational,5|6,7,5/6,210535,5
2,1,21,536,1,800,1,5,2,2,3,single-choice,spatial-relational,2|3,7,2/3,210536,2
2,1,21,537,1,622,1,13,6,6,7,single-choice,spatial-relational,6|7,7,6/7,210537,6
2,1,21,538,1,601,1,3,1,1,2,single-choice,spatial-relational,1|2,7,1/2,210538,1
2,1,21,539,1,575,1,3,1,1,2,single-choice,spatial-relational,1|2,7,1/2,210539,1
2,1,21,540,1,550,1,9,4,4,5,single-choice,spatial-relational,4|5,7,4/5,210540,4
2,1,21,541,1,667,1,13,6,6,7,single-choice,spatial-relational,6|7,7,6/7,210541,6
2,1,21,542,1,635,1,9,4,4,5,single-choice,spatial-relational,4|5,7,4/5,210542,4
2,1,21,543,0,619,1,11,5,6,6,single-choice,spatial-relational,5|6,7,5/6,210543,5
2,1,21,544,1,521,1,9,4,4,5,single-choice,spatial-relational,4|5,7,4/5,210544,4
2,1,21,545,0,715,1,11,5,6,6,single-choice,spatial-relational,5|6,7,5/6,210545,5
2,1,21,546,1,723,1,5,2,2,3,single-choice,spatial-relational,2|3,7,2/3,210546,2
2,1,21,547,1,884,1,7,3,3,4,single-choice,spatial-relational,3|4,7,3/4,210547,3
2,1,21,548,1,808,1,5,2,2,3,single-choice,spatial-relational,2|3,7,2/3,210548,2
2,1,21,549,1,507,1,3,1,1,2,single-choice,spatial-relational,1|2,7,1/2,210549,1
2,1,21,550,0,542,1,7,3,4,4,single-choice,spatial-relational,3|4,7,3/4,210550,3
2,1,21,551,1,439,1,13,6,6,7,single-choice,spatial-relational,6|7,7,6/7,210551,6
2,1,21,552,1,660,1,13,6,6,7,single-choice,spatial-relational,6|7,7,6/7,210552,6
2,1,21,553,1,604,1,3,1,1,2,single-choice,spatial-relational,1|2,7,1/2,210553,1
2,1,21,554,1,103,1,7,3,3,4,single-choice,spatial-relational,3|4,7,3/4,210554,3
2,1,21,555,0,643,1,5,2,3,3,single-choice,spatial-relational,2|3,7,2/3,210555,2
2,1,21,556,1,452,1,13,6,6,7,single-choice,spatial-relational,6|7,7,6/7,210556,6
2,1,21,557,0,615,1,11,5,6,6,single-choice,spatial-relational,5|6,7,5/6,210557,5
2,1,21,558,1,523,1,9,4,4,5,single-choice,spatial-relational,4|5,7,4/5,210558,4
2,1,21,559,1,688,1,9,4,4,5,single-choice,spatial-relational,4|5,7,4/5,210559,4
2,1,21,560,0,670,1,7,3,4,4,single-choice,spatial-relational,3|4,7,3/4,210560,3
2,1,21,561,1,510,1,13,6,6,7,single-choice,spatial-relational,6|7,7,6/7,210561,6
2,1,21,562,1,665,1,3,1,1,2,single-choice,spatial-relational,1|2,7,1/2,210562,1
2,1,21,563,1,560,1,5,2,2,3,single-choice,spatial-relational,2|3,7,2/3,210563,2
2,1,21,564,1,500,1,3,1,1,2,single-choice,spatial-relational,1|2,7,1/2,210564,1
2,1,21,565,0,472,1,11,5,6,6,single-choice,spatial-relational,5|6,7,5/6,210565,5
2,1,21,566,1,494,1,3,1,1,2,single-choice,spatial-relational,1|2,7,1/2,210566,1
2,1,21,567,0,580,1,7,3,4,4,single-choice,spatial-relational,3|4,7,3/4,210567,3
2,1,21,568,1,600,1,3,1,1,2,single-choice,spatial-relational,1|2,7,1/2,210568,1
2,1,21,569,1,715,1,13,6,6,7,single-choice,spatial-relational,6|7,7,6/7,210569,6
2,1,21,570,0,672,1,11,5,6,6,single-choice,spatial-relational,5|6,7,5/6,210570,5
2,1,21,571,1,744,1,5,2,2,3,single-choice,spatial-relational,2|3,7,2/3,210571,2
2,1,21,572,0,574,1,11,5,6,6,single-choice,spatial-relational,5|6,7,5/6,210572,5
2,1,21,573,0,640,1,7,3,4,4,single-choice,spatial-relational,3|4,7,3/4,210573,3
2,1,21,574,1,503,1,13,6,6,7,single-choice,spatial-relational,6|7,7,6/7,210574,6
2,1,21,575,1,656,1,9,4,4,5,single-choice,spatial-relational,4|5,7,4/5,210575,4
2,1,21,576,0,729,1,5,2,3,3,single-choice,spatial-relational,2|3,7,2/3,210576,2
2,1,21,577,1,548,1,9,4,4,5,single-choice,spatial-relational,4|5,7,4/5,210577,4
2,1,21,578,0,576,1,7,3,4,4,single-choice,spatial-relational,3|4,7,3/4,210578,3
2,1,21,579,1,526,1,13,6,6,7,single-choice,spatial-relational,6|7,7,6/7,210579,6
2,1,21,580,1,656,1,9,4,4,5,single-choice,spatial-relational,4|5,7,4/5,210580,4
2,1,21,581,1,735,1,3,1,1,2,single-choice,spatial-relational,1|2,7,1/2,210581,1
2,1,21,582,1,770,1,5,2,2,3,single-choice,spatial-relational,2|3,7,2/3,210582,2
2,1,21,583,0,614,1,5,2,3,3,single-choice,spatial-relational,2|3,7,2/3,210583,2
2,1,21,584,0,504,1,11,5,6,6,single-choice,spatial-relational,5|6,7,5/6,210584,5
2,1,21,585,0,536,1,7,3,4,4,single-choice,spatial-relational,3|4,7,3/4,210585,3
2,1,21,586,0,501,1,11,5,6,6,single-choice,spatial-relational,5|6,7,5/6,210586,5
2,1,21,587,1,757,1,13,6,6,7,single-choice,spatial-relational,6|7,7,6/7,210587,6
2,1,21,588,1,604,1,3,1,1,2,single-choice,spatial-relational,1|2,7,1/2,210588,1
2,1,21,589,1,567,1,9,4,4,5,single-choice,spatial-relational,4|5,7,4/5,210589,4
2,1,21,590,0,865,1,11,5,6,6,single-choice,spatial-relational,5|6,7,5/6,210590,5
2,1,21,591,1,667,1,3,1,1,2,single-choice,spatial-relational,1|2,7,1/2,210591,1
2,1,21,592,1,657,1,13,6,6,7,single-choice,spatial-relational,6|7,7,6/7,210592,6
2,1,21,593,1,801,1,7,3,3,4,single-choice,spatial-relational,3|4,7,3/4,210593,3
2,1,21,594,0,585,1,7,3,4,4,single-choice,spatial-relational,3|4,7,3/4,210594,3
2,1,21,595,0,994,1,5,2,3,3,single-choice,spatial-relational,2|3,7,2/3,210595,2
2,1,21,596,1,513,1,3,1,1,2,single-choice,spatial-relational,1|2,7,1/2,210596,1
2,1,21,597,0,657,1,11,5,6,6,single-choice,spatial-relational,5|6,7,5/6,210597,5
2,1,21,598,1,525,1,9,4,4,5,single-choice,spatial-relational,4|5,7,4/5,210598,4
2,1,21,599,1,860,1,5,2,2,3,single-choice,spatial-relational,2|3,7,2/3,210599,2
2,1,21,600,1,808,1,13,6,6,7,single-choice,spatial-relational,6|7,7,6/7,210600,6
2,1,21,601,1,549,1,9,4,4,5,single-choice,spatial-relational,4|5,7,4/5,210601,4
2,1,21,602,0,656,1,7,3,4,4,single-choice,spatial-relational,3|4,7,3/4,210602,3
2,1,21,603,1,750,1,5,2,2,3,single-choice,spatial-relational,2|3,7,2/3,210603,2
2,1,21,604,1,650,1,5,2,2,3,single-choice,spatial-relational,2|3,7,2/3,210604,2
2,1,21,605,1,514,1,3,1,1,2,single-choice,spatial-relational,1|2,7,1/2,210605,1
2,1,21,606,1,635,1,13,6,6,7,single-choice,spatial-relational,6|7,7,6/7,210606,6
2,1,21,607,1,552,1,9,4,4,5,single-choice,spatial-relational,4|5,7,4/5,210607,4
2,1,21,608,0,615,1,11,5,6,6,single-choice,spatial-relational,5|6,7,5/6,210608,5
2,1,21,609,0,517,1,11,5,6,6,single-choice,spatial-relational,5|6,7,5/6,210609,5
2,1,21,610,1,505,1,3,1,1,2,single-choice,spatial-relational,1|2,7,1/2,210610,1
2,1,21,611,1,641,1,13,6,6,7,single-choice,spatial-relational,6|7,7,6/7,210611,6
2,1,21,612,1,795,1,7,3,3,4,single-choice,spatial-relational,3|4,7,3/4,210612,3
2,1,21,613,1,553,1,9,4,4,5,single-choice,spatial-relational,4|5,7,4/5,210613,4
2,1,21,614,1,1029,1,13,6,6,7,single-choice,spatial-relational,6|7,7,6/7,210614,6
2,1,21,615,1,556,1,13,6,6,7,single-choice,spatial-relational,6|7,7,6/7,210615,6
2,1,21,616,0,584,1,11,5,6,6,single-choice,spatial-relational,5|6,7,5/6,210616,5
2,1,21,617,1,558,1,3,1,1,2,single-choice,spatial-relational,1|2,7,1/2,210617,1
2,1,21,618,1,618,1,5,2,2,3,single-choice,spatial-relational,2|3,7,2/3,210618,2
2,1,21,619,0,667,1,5,2,3,3,single-choice,spatial-relational,2|3,7,2/3,210619,2
2,1,21,620,1,564,1,9,4,4,5,single-choice,spatial-relational,4|5,7,4/5,210620,4
2,1,21,621,0,846,1,7,3,4,4,single-choice,spatial-relational,3|4,7,3/4,210621,3
2,1,21,622,1,553,1,9,4,4,5,single-choice,spatial-relational,4|5,7,4/5,210622,4
2,1,21,623,1,921,1,7,3,3,4,single-choice,spatial-relational,3|4,7,3/4,210623,3
2,1,21,624,0,621,1,11,5,6,6,single-choice,spatial-relational,5|6,7,5/6,210624,5
2,1,21,625,1,579,1,3,1,1,2,single-choice,spatial-relational,1|2,7,1/2,210625,1
2,1,21,626,1,591,1,5,2,2,3,single-choice,spatial-relational,2|3,7,2/3,210626,2
2,1,21,627,0,508,1,7,3,4,4,single-choice,spatial-relational,3|4,7,3/4,210627,3
2,1,21,628,1,533,1,13,6,6,7,single-choice,spatial-relational,6|7,7,6/7,210628,6
2,1,21,629,1,722,1,13,6,6,7,single-choice,spatial-relational,6|7,7,6/7,210629,6
2,1,21,630,0,779,1,11,5,6,6,single-choice,spatial-relational,5|6,7,5/6,210630,5
2,1,21,631,1,551,1,9,4,4,5,single-choice,spatial-relational,4|5,7,4/5,210631,4
2,1,21,632,0,835,1,7,3,4,4,single-choice,spatial-relational,3|4,7,3/4,210632,3
2,1,21,633,0,44,1,5,2,3,3,single-choice,spatial-relational,2|3,7,2/3,210633,2
2,1,21,634,0,470,1,11,5,6,6,single-choice,spatial-relational,5|6,7,5/6,210634,5
2,1,21,635,1,539,1,3,1,1,2,single-choice,spatial-relational,1|2,7,1/2,210635,1
2,1,21,636,1,484,1,3,1,1,2,single-choice,spatial-relational,1|2,7,1/2,210636,1
2,1,21,637,1,586,1,9,4,4,5,single-choice,spatial-relational,4|5,7,4/5,210637,4
2,1,21,638,1,708,1,13,6,6,7,single-choice,spatial-relational,6|7,7,6/7,210638,6
2,1,21,639,0,545,1,11,5,6,6,single-choice,spatial-relational,5|6,7,5/6,210639,5
2,1,21,640,1,684,1,3,1,1,2,single-choice,spatial-relational,1|2,7,1/2,210640,1
2,1,21,641,1,602,1,5,2,2,3,single-choice,spatial-relational,2|3,7,2/3,210641,2
2,1,21,642,0,546,1,7,3,4,4,single-choice,spatial-relational,3|4,7,3/4,210642,3
2,1,21,643,0,559,1,7,3,4,4,single-choice,spatial-relational,3|4,7,3/4,210643,3
2,1,21,644,1,863,1,5,2,2,3,single-choice,spatial-relational,2|3,7,2/3,210644,2
2,1,21,645,1,588,1,13,6,6,7,single-choice,spatial-relational,6|7,7,6/7,210645,6
2,1,21,646,1,681,1,9,4,4,5,single-choice,spatial-relational,4|5,7,4/5,210646,4
2,1,21,647,1,509,1,3,1,1,2,single-choice,spatial-relational,1|2,7,1/2,210647,1
2,1,21,648,1,620,1,9,4,4,5,single-choice,spatial-relational,4|5,7,4/5,210648,4
2,1,21,649,0,630,1,11,5,6,6,single-choice,spatial-relational,5|6,7,5/6,210649,5
2,1,21,650,1,44,1,13,6,6,7,single-choice,spatial-relational,6|7,7,6/7,210650,6
2,1,21,651,1,635,1,9,4,4,5,single-choice,spatial-relational,4|5,7,4/5,210651,4
2,1,21,652,1,775,1,7,3,3,4,single-choice,spatial-relational,3|4,7,3/4,210652,3
2,1,21,653,0,688,1,5,2,3,3,single-choice,spatial-relational,2|3,7,2/3,210653,2
2,1,21,654,1,670,1,5,2,2,3,single-choice,spatial-relational,2|3,7,2/3,210654,2
2,1,21,655,0,487,1,7,3,4,4,single-choice,spatial-relational,3|4,7,3/4,210655,3
2,1,21,656,1,513,1,9,4,4,5,single-choice,spatial-relational,4|5,7,4/5,210656,4
2,1,21,657,1,626,1,13,6,6,7,single-choice,spatial-relational,6|7,7,6/7,210657,6
2,1,21,658,1,573,1,3,1,1,2,single-choice,spatial-relational,1|2,7,1/2,210658,1
2,1,21,659,0,513,1,11,5,6,6,single-choice,spatial-relational,5|6,7,5/6,210659,5
2,1,21,660,0,548,1,11,5,6,6,single-choice,spatial-relational,5|6,7,5/6,210660,5
2,1,21,661,1,539,1,3,1,1,2,single-choice,spatial-relational,1|2,7,1/2,210661,1
2,1,21,662,0,592,1,7,3,4,4,single-choice,spatial-relational,3|4,7,3/4,210662,3
2,1,21,663,1,519,1,3,1,1,2,single-choice,spatial-relational,1|2,7,1/2,210663,1
2,1,21,664,0,519,1,11,5,6,6,single-choice,spatial-relational,5|6,7,5/6,210664,5
2,1,21,665,0,474,1,11,5,6,6,single-choice,spatial-relational,5|6,7,5/6,210665,5
2,1,21,666,1,549,1,9,4,4,5,single-choice,spatial-relational,4|5,7,4/5,210666,4
2,1,21,667,1,710,1,9,4,4,5,single-choice,spatial-relational,4|5,7,4/5,210667,4
2,1,21,668,1,839,1,13,6,6,7,single-choice,spatial-relational,6|7,7,6/7,210668,6
2,1,21,669,1,655,1,3,1,1,2,single-choice,spatial-relational,1|2,7,1/2,210669,1
2,1,21,670,1,642,1,5,2,2,3,single-choice,spatial-relational,2|3,7,2/3,210670,2
2,1,21,671,0,586,1,5,2,3,3,single-choice,spatial-relational,2|3,7,2/3,210671,2
2,1,21,672,1,483,1,13,6,6,7,single-choice,spatial-relational,6|7,7,6/7,210672,6
2,1,21,673,0,603,1,7,3,4,4,single-choice,spatial-relational,3|4,7,3/4,210673,3
2,1,21,674,0,524,1,11,5,6,6,single-choice,spatial-relational,5|6,7,5/6,210674,5
2,1,21,675,1,646,1,5,2,2,3,single-choice,spatial-relational,2|3,7,2/3,210675,2
2,1,21,676,0,854,1,7,3,4,4,single-choice,spatial-relational,3|4,7,3/4,210676,3
2,1,21,677,1,505,1,9,4,4,5,single-choice,spatial-relational,4|5,7,4/5,210677,4
2,1,21,678,0,707,1,11,5,6,6,single-choice,spatial-relational,5|6,7,5/6,210678,5
2,1,21,679,1,553,1,3,1,1,2,single-choice,spatial-relational,1|2,7,1/2,210679,1
2,1,21,680,1,544,1,3,1,1,2,single-choice,spatial-relational,1|2,7,1/2,210680,1
2,1,21,681,0,576,1,7,3,4,4,single-choice,spatial-relational,3|4,7,3/4,210681,3
2,1,21,682,1,702,1,13,6,6,7,single-choice,spatial-relational,6|7,7,6/7,210682,6
2,1,21,683,1,565,1,13,6,6,7,single-choice,spatial-relational,6|7,7,6/7,210683,6
2,1,21,684,0,636,1,5,2,3,3,single-choice,spatial-relational,2|3,7,2/3,210684,2
2,1,21,685,1,463,1,9,4,4,5,single-choice,spatial-relational,4|5,7,4/5,210685,4
2,1,21,686,0,901,1,7,3,4,4,single-choice,spatial-relational,3|4,7,3/4,210686,3
2,1,21,687,1,583,1,13,6,6,7,single-choice,spatial-relational,6|7,7,6/7,210687,6
2,1,21,688,1,640,1,3,1,1,2,single-choice,spatial-relational,1|2,7,1/2,210688,1
2,1,21,689,0,565,1,7,3,4,4,single-choice,spatial-relational,3|4,7,3/4,210689,3
2,1,21,690,1,539,1,9,4,4,5,single-choice,spatial-relational,4|5,7,4/5,210690,4
2,1,21,691,0,703,1,5,2,3,3,single-choice,spatial-relational,2|3,7,2/3,210691,2
2,1,21,692,1,517,1,13,6,6,7,single-choice,spatial-relational,6|7,7,6/7,210692,6
2,1,21,693,0,652,1,11,5,6,6,single-choice,spatial-relational,5|6,7,5/6,210693,5
2,1,21,694,1,626,1,5,2,2,3,single-choice,spatial-relational,2|3,7,2/3,210694,2
2,1,21,695,1,502,1,9,4,4,5,single-choice,spatial-relational,4|5,7,4/5,210695,4
2,1,21,696,0,743,1,11,5,6,6,single-choice,spatial-relational,5|6,7,5/6,210696,5
2,1,21,697,1,526,1,3,1,1,2,single-choice,spatial-relational,1|2,7,1/2,210697,1
2,1,21,698,1,558,1,9,4,4,5,single-choice,spatial-relational,4|5,7,4/5,210698,4
2,1,21,699,0,744,1,13,6,7,7,single-choice,spatial-relational,6|7,7,6/7,210699,6
2,1,21,700,1,674,1,13,6,6,7,single-choice,spatial-relational,6|7,7,6/7,210700,6
2,1,21,701,1,721,1,9,4,4,5,single-choice,spatial-relational,4|5,7,4/5,210701,4
2,1,21,702,1,604,1,3,1,1,2,single-choice,spatial-relational,1|2,7,1/2,210702,1
2,1,21,703,1,632,1,5,2,2,3,single-choice,spatial-relational,2|3,7,2/3,210703,2
2,1,21,704,1,572,1,3,1,1,2,single-choice,spatial-relational,1|2,7,1/2,210704,1
2,1,21,705,0,583,1,5,2,3,3,single-choice,spatial-relational,2|3,7,2/3,210705,2
2,1,21,706,0,506,1,11,5,6,6,single-choice,spatial-relational,5|6,7,5/6,210706,5
2,1,21,707,0,512,1,11,5,6,6,single-choice,spatial-relational,5|6,7,5/6,210707,5
2,1,21,708,0,521,1,7,3,4,4,single-choice,spatial-relational,3|4,7,3/4,210708,3
2,1,21,709,0,514,1,7,3,4,4,single-choice,spatial-relational,3|4,7,3/4,210709,3
2,1,21,710,1,459,1,3,1,1,2,single-choice,spatial-relational,1|2,7,1/2,210710,1
2,1,21,711,1,638,1,13,6,6,7,single-choice,spatial-relational,6|7,7,6/7,210711,6
2,1,21,712,1,789,1,5,2,2,3,single-choice,spatial-relational,2|3,7,2/3,210712,2
2,1,21,713,1,1161,1,9,4,4,5,single-choice,spatial-relational,4|5,7,4/5,210713,4
2,1,21,714,1,906,1,13,6,6,7,single-choice,spatial-relational,6|7,7,6/7,210714,6
2,1,21,715,0,621,1,7,3,4,4,single-choice,spatial-relational,3|4,7,3/4,210715,3
2,1,21,716,0,445,1,11,5,6,6,single-choice,spatial-relational,5|6,7,5/6,210716,5
2,1,21,717,1,545,1,3,1,1,2,single-choice,spatial-relational,1|2,7,1/2,210717,1
2,1,21,718,0,495,1,7,3,4,4,single-choice,spatial-relational,3|4,7,3/4,210718,3
2,1,21,719,0,525,1,11,5,6,6,single-choice,spatial-relational,5|6,7,5/6,210719,5
2,1,21,720,1,719,1,5,2,2,3,single-choice,spatial-relational,2|3,7,2/3,210720,2
2,1,21,721,1,622,1,9,4,4,5,single-choice,spatial-relational,4|5,7,4/5,210721,4
2,1,21,722,1,626,1,9,4,4,5,single-choice,spatial-relational,4|5,7,4/5,210722,4
2,1,21,723,1,535,1,3,1,1,2,single-choice,spatial-relational,1|2,7,1/2,210723,1
2,1,21,724,1,617,1,13,6,6,7,single-choice,spatial-relational,6|7,7,6/7,210724,6
2,1,21,725,1,592,1,3,1,1,2,single-choice,spatial-relational,1|2,7,1/2,210725,1
2,1,21,726,0,608,1,7,3,4,4,single-choice,spatial-relational,3|4,7,3/4,210726,3
2,1,21,727,1,586,1,13,6,6,7,single-choice,spatial-relational,6|7,7,6/7,210727,6
2,1,21,728,1,729,1,9,4,4,5,single-choice,spatial-relational,4|5,7,4/5,210728,4
2,1,21,729,1,693,1,5,2,2,3,single-choice,spatial-relational,2|3,7,2/3,210729,2
2,1,21,730,0,478,1,11,5,6,6,single-choice,spatial-relational,5|6,7,5/6,210730,5
2,1,21,731,1,738,1,5,2,2,3,single-choice,spatial-relational,2|3,7,2/3,210731,2
2,1,21,732,0,595,1,11,5,6,6,single-choice,spatial-relational,5|6,7,5/6,210732,5
2,1,21,733,0,515,1,7,3,4,4,single-choice,spatial-relational,3|4,7,3/4,210733,3
2,1,21,734,0,467,1,7,3,4,4,single-choice,spatial-relational,3|4,7,3/4,210734,3
2,1,21,735,1,608,1,9,4,4,5,single-choice,spatial-relational,4|5,7,4/5,210735,4
2,1,21,736,1,610,1,3,1,1,2,single-choice,spatial-relational,1|2,7,1/2,210736,1
2,1,21,737,0,702,1,5,2,3,3,single-choice,spatial-relational,2|3,7,2/3,210737,2
2,1,21,738,1,555,1,9,4,4,5,single-choice,spatial-relational,4|5,7,4/5,210738,4
2,1,21,739,1,795,1,3,1,1,2,single-choice,spatial-relational,1|2,7,1/2,210739,1
2,1,21,740,1,559,1,5,2,2,3,single-choice,spatial-relational,2|3,7,2/3,210740,2
2,1,21,741,1,551,1,13,6,6,7,single-choice,spatial-relational,6|7,7,6/7,210741,6
2,1,21,742,0,620,1,11,5,6,6,single-choice,spatial-relational,5|6,7,5/6,210742,5
2,1,21,743,0,482,1,11,5,6,6,single-choice,spatial-relational,5|6,7,5/6,210743,5
2,1,21,744,1,798,1,13,6,6,7,single-choice,spatial-relational,6|7,7,6/7,210744,6
2,1,21,745,0,722,1,7,3,4,4,single-choice,spatial-relational,3|4,7,3/4,210745,3
2,1,21,746,0,622,1,11,5,6,6,single-choice,spatial-relational,5|6,7,5/6,210746,5
2,1,21,747,1,648,1,3,1,1,2,single-choice,spatial-relational,1|2,7,1/2,210747,1
2,1,21,748,0,571,1,7,3,4,4,single-choice,spatial-relational,3|4,7,3/4,210748,3
2,1,21,749,0,520,1,7,3,4,4,single-choice,spatial-relational,3|4,7,3/4,210749,3
2,1,21,750,1,563,1,3,1,1,2,single-choice,spatial-relational,1|2,7,1/2,210750,1
2,1,21,751,1,632,1,5,2,2,3,single-choice,spatial-relational,2|3,7,2/3,210751,2
2,1,21,752,0,662,1,5,2,3,3,single-choice,spatial-relational,2|3,7,2/3,210752,2
2,1,21,753,1,509,1,9,4,4,5,single-choice,spatial-relational,4|5,7,4/5,210753,4
2,1,21,754,1,725,1,13,6,6,7,single-choice,spatial-relational,6|7,7,6/7,210754,6
2,1,21,755,0,772,1,11,5,6,6,single-choice,spatial-relational,5|6,7,5/6,210755,5
2,1,21,756,1,488,1,9,4,4,5,single-choice,spatial-relational,4|5,7,4/5,210756,4
2,1,21,757,1,551,1,13,6,6,7,single-choice,spatial-relational,6|7,7,6/7,210757,6
2,1,21,758,1,435,1,13,6,6,7,single-choice,spatial-relational,6|7,7,6/7,210758,6
2,1,21,759,0,666,1,11,5,6,6,single-choice,spatial-relational,5|6,7,5/6,210759,5
2,1,21,760,1,657,1,5,2,2,3,single-choice,spatial-relational,2|3,7,2/3,210760,2
2,1,21,761,0,539,1,11,5,6,6,single-choice,spatial-relational,5|6,7,5/6,210761,5
2,1,21,762,1,498,1,9,4,4,5,single-choice,spatial-relational,4|5,7,4/5,210762,4
2,1,21,763,0,671,1,5,2,3,3,single-choice,spatial-relational,2|3,7,2/3,210763,2
2,1,21,764,1,511,1,13,6,6,7,single-choice,spatial-relational,6|7,7,6/7,210764,6
2,1,21,765,1,525,1,3,1,1,2,single-choice,spatial-relational,1|2,7,1/2,210765,1
2,1,21,766,0,501,1,7,3,4,4,single-choice,spatial-relational,3|4,7,3/4,210766,3
2,1,21,767,1,62,1,7,3,3,4,single-choice,spatial-relational,3|4,7,3/4,210767,3
2,1,21,768,1,436,1,3,1,1,2,single-choice,spatial-relational,1|2,7,1/2,210768,1
2,1,21,769,1,515,1,9,4,4,5,single-choice,spatial-relational,4|5,7,4/5,210769,4
2,1,21,770,0,551,1,7,3,4,4,single-choice,spatial-relational,3|4,7,3/4,210770,3
2,1,21,771,0,554,1,5,2,3,3,single-choice,spatial-relational,2|3,7,2/3,210771,2
2,1,21,772,1,440,1,3,1,1,2,single-choice,spatial-relational,1|2,7,1/2,210772,1
2,1,21,773,0,522,1,11,5,6,6,single-choice,spatial-relational,5|6,7,5/6,210773,5
2,1,21,774,1,514,1,3,1,1,2,single-choice,spatial-relational,1|2,7,1/2,210774,1
2,1,21,775,1,756,1,13,6,6,7,single-choice,spatial-relational,6|7,7,6/7,210775,6
2,1,21,776,1,603,1,9,4,4,5,single-choice,spatial-relational,4|5,7,4/5,210776,4
2,1,21,777,0,627,1,11,5,6,6,single-choice,spatial-relational,5|6,7,5/6,210777,5
2,1,21,778,0,509,1,7,3,4,4,single-choice,spatial-relational,3|4,7,3/4,210778,3
2,1,21,779,1,503,1,13,6,6,7,single-choice,spatial-relational,6|7,7,6/7,210779,6
2,1,21,780,1,694,1,9,4,4,5,single-choice,spatial-relational,4|5,7,4/5,210780,4
2,1,21,781,1,747,1,5,2,2,3,single-choice,spatial-relational,2|3,7,2/3,210781,2
2,1,21,782,0,478,1,7,3,4,4,single-choice,spatial-relational,3|4,7,3/4,210782,3
2,1,21,783,1,571,1,5,2,2,3,single-choice,spatial-relational,2|3,7,2/3,210783,2
2,1,21,784,1,565,1,9,4,4,5,single-choice,spatial-relational,4|5,7,4/5,210784,4
2,1,21,785,1,1009,1,13,6,6,7,single-choice,spatial-relational,6|7,7,6/7,210785,6
2,1,21,786,1,697,1,3,1,1,2,single-choice,spatial-relational,1|2,7,1/2,210786,1
2,1,21,787,1,643,1,5,2,2,3,single-choice,spatial-relational,2|3,7,2/3,210787,2
2,1,21,788,1,592,1,13,6,6,7,single-choice,spatial-relational,6|7,7,6/7,210788,6
2,1,21,789,1,654,1,3,1,1,2,single-choice,spatial-relational,1|2,7,1/2,210789,1
2,1,21,790,0,512,1,11,5,6,6,single-choice,spatial-relational,5|6,7,5/6,210790,5
2,1,21,791,1,566,1,9,4,4,5,single-choice,spatial-relational,4|5,7,4/5,210791,4
2,1,21,792,0,622,1,11,5,6,6,single-choice,spatial-relational,5|6,7,5/6,210792,5
2,1,21,793,0,521,1,7,3,4,4,single-choice,spatial-relational,3|4,7,3/4,210793,3
2,1,21,794,1,510,1,13,6,6,7,single-choice,spatial-relational,6|7,7,6/7,210794,6
2,1,21,795,1,713,1,13,6,6,7,single-choice,spatial-relational,6|7,7,6/7,210795,6
2,1,21,796,1,742,1,5,2,2,3,single-choice,spatial-relational,2|3,7,2/3,210796,2
2,1,21,797,0,585,1,11,5,6,6,single-choice,spatial-relational,5|6,7,5/6,210797,5
2,1,21,798,1,532,1,9,4,4,5,single-choice,spatial-relational,4|5,7,4/5,210798,4
2,1,21,799,0,674,1,5,2,3,3,single-choice,spatial-relational,2|3,7,2/3,210799,2
2,1,21,800,0,529,1,11,5,6,6,single-choice,spatial-relational,5|6,7,5/6,210800,5
2,1,21,801,1,597,1,3,1,1,2,single-choice,spatial-relational,1|2,7,1/2,210801,1
2,1,21,802,1,529,1,9,4,4,5,single-choice,spatial-relational,4|5,7,4/5,210802,4
2,1,21,803,0,1115,1,3,1,2,2,single-choice,spatial-relational,1|2,7,1/2,210803,1
2,1,21,804,0,515,1,7,3,4,4,single-choice,spatial-relational,3|4,7,3/4,210804,3
2,1,21,805,0,520,1,7,3,4,4,single-choice,spatial-relational,3|4,7,3/4,210805,3
2,1,21,806,0,541,1,11,5,6,6,single-choice,spatial-relational,5|6,7,5/6,210806,5
2,1,21,807,1,557,1,9,4,4,5,single-choice,spatial-relational,4|5,7,4/5,210807,4
2,1,21,808,1,621,1,3,1,1,2,single-choice,spatial-relational,1|2,7,1/2,210808,1
2,1,21,809,1,508,1,3,1,1,2,single-choice,spatial-relational,1|2,7,1/2,210809,1
2,1,21,810,1,636,1,5,2,2,3,single-choice,spatial-relational,2|3,7,2/3,210810,2
2,1,21,811,0,589,1,7,3,4,4,single-choice,spatial-relational,3|4,7,3/4,210811,3
2,1,21,812,1,695,1,5,2,2,3,single-choice,spatial-relational,2|3,7,2/3,210812,2
2,1,21,813,1,662,1,13,6,6,7,single-choice,spatial-relational,6|7,7,6/7,210813,6
2,1,21,814,0,808,1,11,5,6,6,single-choice,spatial-relational,5|6,7,5/6,210814,5
2,1,21,815,0,508,1,7,3,4,4,single-choice,spatial-relational,3|4,7,3/4,210815,3
2,1,21,816,1,563,1,9,4,4,5,single-choice,spatial-relational,4|5,7,4/5,210816,4
2,1,21,817,1,1499,1,13,6,6,7,single-choice,spatial-relational,6|7,7,6/7,210817,6
2,1,21,818,0,794,1,5,2,3,3,single-choice,spatial-relational,2|3,7,2/3,210818,2
2,1,21,819,1,632,1,5,2,2,3,single-choice,spatial-relational,2|3,7,2/3,210819,2
2,1,21,820,1,532,1,13,6,6,7,single-choice,spatial-relational,6|7,7,6/7,210820,6
2,1,21,821,1,648,1,9,4,4,5,single-choice,spatial-relational,4|5,7,4/5,210821,4
2,1,21,822,0,604,1,7,3,4,4,single-choice,spatial-relational,3|4,7,3/4,210822,3
2,1,21,823,0,555,1,11,5,6,6,single-choice,spatial-relational,5|6,7,5/6,210823,5
2,1,21,824,1,608,1,3,1,1,2,single-choice,spatial-relational,1|2,7,1/2,210824,1
2,1,21,825,1,1023,1,3,1,1,2,single-choice,spatial-relational,1|2,7,1/2,210825,1
2,1,21,826,0,570,1,7,3,4,4,single-choice,spatial-relational,3|4,7,3/4,210826,3
2,1,21,827,0,656,1,11,5,6,6,single-choice,spatial-relational,5|6,7,5/6,210827,5
2,1,21,828,1,514,1,13,6,6,7,single-choice,spatial-relational,6|7,7,6/7,210828,6
2,1,21,829,1,701,1,9,4,4,5,single-choice,spatial-relational,4|5,7,4/5,210829,4
2,1,21,830,1,819,1,5,2,2,3,single-choice,spatial-relational,2|3,7,2/3,210830,2
2,1,21,831,0,809,1,5,2,3,3,single-choice,spatial-relational,2|3,7,2/3,210831,2
2,1,21,832,1,545,1,9,4,4,5,single-choice,spatial-relational,4|5,7,4/5,210832,4
2,1,21,833,0,671,1,11,5,6,6,single-choice,spatial-relational,5|6,7,5/6,210833,5
2,1,21,834,0,534,1,7,3,4,4,single-choice,spatial-relational,3|4,7,3/4,210834,3
2,1,21,835,1,636,1,3,1,1,2,single-choice,spatial-relational,1|2,7,1/2,210835,1
2,1,21,836,1,530,1,13,6,6,7,single-choice,spatial-relational,6|7,7,6/7,210836,6
2,1,21,837,1,1148,1,7,3,3,4,single-choice,spatial-relational,3|4,7,3/4,210837,3
2,1,21,838,1,643,1,9,4,4,5,single-choice,spatial-relational,4|5,7,4/5,210838,4
2,1,21,839,0,601,1,11,5,6,6,single-choice,spatial-relational,5|6,7,5/6,210839,5
2,1,21,840,1,541,1,13,6,6,7,single-choice,spatial-relational,6|7,7,6/7,210840,6
2,1,21,841,1,778,1,3,1,1,2,single-choice,spatial-relational,1|2,7,1/2,210841,1
2,1,21,842,1,553,1,9,4,4,5,single-choice,spatial-relational,4|5,7,4/5,210842,4
2,1,21,843,0,555,1,7,3,4,4,single-choice,spatial-relational,3|4,7,3/4,210843,3
2,1,21,844,1,642,1,13,6,6,7,single-choice,spatial-relational,6|7,7,6/7,210844,6
2,1,21,845,0,647,1,7,3,4,4,single-choice,spatial-relational,3|4,7,3/4,210845,3
2,1,21,846,1,632,1,5,2,2,3,single-choice,spatial-relational,2|3,7,2/3,210846,2
2,1,21,847,1,196,1,3,1,1,2,single-choice,spatial-relational,1|2,7,1/2,210847,1
2,1,21,848,0,514,1,11,5,6,6,single-choice,spatial-relational,5|6,7,5/6,210848,5
2,1,21,849,1,569,1,13,6,6,7,single-choice,spatial-relational,6|7,7,6/7,210849,6
2,1,21,850,0,831,1,3,1,2,2,single-choice,spatial-relational,1|2,7,1/2,210850,1
2,1,21,851,1,567,1,9,4,4,5,single-choice,spatial-relational,4|5,7,4/5,210851,4
2,1,21,852,0,728,1,5,2,3,3,single-choice,spatial-relational,2|3,7,2/3,210852,2
2,1,21,853,0,554,1,11,5,6,6,single-choice,spatial-relational,5|6,7,5/6,210853,5
2,1,21,854,1,576,1,3,1,1,2,single-choice,spatial-relational,1|2,7,1/2,210854,1
2,1,21,855,1,620,1,3,1,1,2,single-choice,spatial-relational,1|2,7,1/2,210855,1
2,1,21,856,0,553,1,11,5,6,6,single-choice,spatial-relational,5|6,7,5/6,210856,5
2,1,21,857,1,583,1,5,2,2,3,single-choice,spatial-relational,2|3,7,2/3,210857,2
2,1,21,858,1,659,1,13,6,6,7,single-choice,spatial-relational,6|7,7,6/7,210858,6
2,1,21,859,0,704,1,7,3,4,4,single-choice,spatial-relational,3|4,7,3/4,210859,3
2,1,21,860,0,525,1,11,5,6,6,single-choice,spatial-relational,5|6,7,5/6,210860,5
2,1,21,861,1,725,1,9,4,4,5,single-choice,spatial-relational,4|5,7,4/5,210861,4
2,1,21,862,1,713,1,9,4,4,5,single-choice,spatial-relational,4|5,7,4/5,210862,4
2,1,21,863,1,886,1,13,6,6,7,single-choice,spatial-relational,6|7,7,6/7,210863,6
2,1,21,864,1,933,1,7,3,3,4,single-choice,spatial-relational,3|4,7,3/4,210864,3
2,1,21,865,0,579,1,5,2,3,3,single-choice,spatial-relational,2|3,7,2/3,210865,2
2,1,21,866,1,542,1,9,4,4,5,single-choice,spatial-relational,4|5,7,4/5,210866,4
2,1,21,867,0,748,1,7,3,4,4,single-choice,spatial-relational,3|4,7,3/4,210867,3
2,1,21,868,0,502,1,11,5,6,6,single-choice,spatial-relational,5|6,7,5/6,210868,5
2,1,21,869,1,596,1,3,1,1,2,single-choice,spatial-relational,1|2,7,1/2,210869,1
2,1,21,870,1,553,1,9,4,4,5,single-choice,spatial-relational,4|5,7,4/5,210870,4
2,1,21,871,0,894,1,5,2,3,3,single-choice,spatial-relational,2|3,7,2/3,210871,2
2,1,21,872,1,635,1,5,2,2,3,single-choice,spatial-relational,2|3,7,2/3,210872,2
2,1,21,873,0,727,1,7,3,4,4,single-choice,spatial-relational,3|4,7,3/4,210873,3
2,1,21,874,1,636,1,13,6,6,7,single-choice,spatial-relational,6|7,7,6/7,210874,6
2,1,21,875,0,1160,1,13,6,7,7,single-choice,spatial-relational,6|7,7,6/7,210875,6
2,1,21,876,0,468,1,11,5,6,6,single-choice,spatial-relational,5|6,7,5/6,210876,5
2,1,21,877,1,606,1,3,1,1,2,single-choice,spatial-relational,1|2,7,1/2,210877,1
2,1,21,878,1,554,1,13,6,6,7,single-choice,spatial-relational,6|7,7,6/7,210878,6
2,1,21,879,1,633,1,9,4,4,5,single-choice,spatial-relational,4|5,7,4/5,210879,4
2,1,21,880,1,1112,1,13,6,6,7,single-choice,spatial-relational,6|7,7,6/7,210880,6
2,1,21,881,1,875,1,7,3,3,4,single-choice,spatial-relational,3|4,7,3/4,210881,3
2,1,21,882,0,600,1,11,5,6,6,single-choice,spatial-relational,5|6,7,5/6,210882,5
2,1,21,883,1,651,1,9,4,4,5,single-choice,spatial-relational,4|5,7,4/5,210883,4
2,1,21,884,0,867,1,3,1,2,2,single-choice,spatial-relational,1|2,7,1/2,210884,1
2,1,21,885,1,593,1,5,2,2,3,single-choice,spatial-relational,2|3,7,2/3,210885,2
2,1,21,886,1,576,1,3,1,1,2,single-choice,spatial-relational,1|2,7,1/2,210886,1
2,1,21,887,0,497,1,7,3,4,4,single-choice,spatial-relational,3|4,7,3/4,210887,3
2,1,21,888,0,555,1,11,5,6,6,single-choice,spatial-relational,5|6,7,5/6,210888,5
2,1,21,889,1,707,1,5,2,2,3,single-choice,spatial-relational,2|3,7,2/3,210889,2
2,1,21,890,1,649,1,9,4,4,5,single-choice,spatial-relational,4|5,7,4/5,210890,4
2,1,21,891,0,807,1,13,6,7,7,single-choice,spatial-relational,6|7,7,6/7,210891,6
2,1,21,892,1,587,1,5,2,2,3,single-choice,spatial-relational,2|3,7,2/3,210892,2
2,1,21,893,0,504,1,11,5,6,6,single-choice,spatial-relational,5|6,7,5/6,210893,5
2,1,21,894,1,549,1,13,6,6,7,single-choice,spatial-relational,6|7,7,6/7,210894,6
2,1,21,895,1,791,1,9,4,4,5,single-choice,spatial-relational,4|5,7,4/5,210895,4
2,1,21,896,0,712,1,5,2,3,3,single-choice,spatial-relational,2|3,7,2/3,210896,2
2,1,21,897,0,549,1,11,5,6,6,single-choice,spatial-relational,5|6,7,5/6,210897,5
2,1,21,898,0,545,1,7,3,4,4,single-choice,spatial-relational,3|4,7,3/4,210898,3
2,1,21,899,1,650,1,3,1,1,2,single-choice,spatial-relational,1|2,7,1/2,210899,1
2,1,21,900,0,541,1,7,3,4,4,single-choice,spatial-relational,3|4,7,3/4,210900,3
2,1,21,901,1,746,1,3,1,1,2,single-choice,spatial-relational,1|2,7,1/2,210901,1
2,1,21,902,1,564,1,13,6,6,7,single-choice,spatial-relational,6|7,7,6/7,210902,6
2,1,21,903,0,621,1,11,5,6,6,single-choice,spatial-relational,5|6,7,5/6,210903,5
2,1,21,904,1,638,1,5,2,2,3,single-choice,spatial-relational,2|3,7,2/3,210904,2
2,1,21,905,1,546,1,9,4,4,5,single-choice,spatial-relational,4|5,7,4/5,210905,4
2,1,21,906,1,656,1,9,4,4,5,single-choice,spatial-relational,4|5,7,4/5,210906,4
2,1,21,907,0,605,1,11,5,6,6,single-choice,spatial-relational,5|6,7,5/6,210907,5
2,1,21,908,1,680,1,13,6,6,7,single-choice,spatial-relational,6|7,7,6/7,210908,6
2,1,21,909,0,557,1,7,3,4,4,single-choice,spatial-relational,3|4,7,3/4,210909,3
2,1,21,910,1,748,1,5,2,2,3,single-choice,spatial-relational,2|3,7,2/3,210910,2
2,1,21,911,0,991,1,3,1,2,2,single-choice,spatial-relational,1|2,7,1/2,210911,1
2,1,21,912,1,559,1,3,1,1,2,single-choice,spatial-relational,1|2,7,1/2,210912,1
2,1,21,913,0,550,1,7,3,4,4,single-choice,spatial-relational,3|4,7,3/4,210913,3
2,1,21,914,0,446,1,7,3,4,4,single-choice,spatial-relational,3|4,7,3/4,210914,3
2,1,21,915,1,562,1,9,4,4,5,single-choice,spatial-relational,4|5,7,4/5,210915,4
2,1,21,916,1,703,1,5,2,2,3,single-choice,spatial-relational,2|3,7,2/3,210916,2
2,1,21,917,1,1027,1,13,6,6,7,single-choice,spatial-relational,6|7,7,6/7,210917,6
2,1,21,918,0,852,1,5,2,3,3,single-choice,spatial-relational,2|3,7,2/3,210918,2
2,1,21,919,1,583,1,9,4,4,5,single-choice,spatial-relational,4|5,7,4/5,210919,4
2,1,21,920,0,713,1,11,5,6,6,single-choice,spatial-relational,5|6,7,5/6,210920,5
2,1,21,921,0,635,1,7,3,4,4,single-choice,spatial-relational,3|4,7,3/4,210921,3
2,1,21,922,0,606,1,11,5,6,6,single-choice,spatial-relational,5|6,7,5/6,210922,5
2,1,21,923,1,577,1,13,6,6,7,single-choice,spatial-relational,6|7,7,6/7,210923,6
2,1,21,924,0,1206,1,3,1,2,2,single-choice,spatial-relational,1|2,7,1/2,210924,1
2,1,21,925,1,663,1,3,1,1,2,single-choice,spatial-relational,1|2,7,1/2,210925,1
2,1,21,926,1,790,1,5,2,2,3,single-choice,spatial-relational,2|3,7,2/3,210926,2
2,1,21,927,0,550,1,11,5,6,6,single-choice,spatial-relational,5|6,7,5/6,210927,5
2,1,21,928,1,531,1,13,6,6,7,single-choice,spatial-relational,6|7,7,6/7,210928,6
2,1,21,929,1,841,1,5,2,2,3,single-choice,spatial-relational,2|3,7,2/3,210929,2
2,1,21,930,0,545,1,11,5,6,6,single-choice,spatial-relational,5|6,7,5/6,210930,5
2,1,21,931,0,503,1,7,3,4,4,single-choice,spatial-relational,3|4,7,3/4,210931,3
2,1,21,932,0,961,1,7,3,4,4,single-choice,spatial-relational,3|4,7,3/4,210932,3
2,1,21,933,1,578,1,3,1,1,2,single-choice,spatial-relational,1|2,7,1/2,210933,1
2,1,21,934,1,627,1,13,6,6,7,single-choice,spatial-relational,6|7,7,6/7,210934,6
2,1,21,935,1,1071,1,3,1,1,2,single-choice,spatial-relational,1|2,7,1/2,210935,1
2,1,21,936,1,638,1,9,4,4,5,single-choice,spatial-relational,4|5,7,4/5,210936,4
2,1,21,937,1,592,1,9,4,4,5,single-choice,spatial-relational,4|5,7,4/5,210937,4
2,1,21,938,0,636,1,7,3,4,4,single-choice,spatial-relational,3|4,7,3/4,210938,3
2,1,21,939,0,570,1,11,5,6,6,single-choice,spatial-relational,5|6,7,5/6,210939,5
2,1,21,940,1,943,1,7,3,3,4,single-choice,spatial-relational,3|4,7,3/4,210940,3
2,1,21,941,1,926,1,13,6,6,7,single-choice,spatial-relational,6|7,7,6/7,210941,6
2,1,21,942,1,721,1,13,6,6,7,single-choice,spatial-relational,6|7,7,6/7,210942,6
2,1,21,943,0,574,1,11,5,6,6,single-choice,spatial-relational,5|6,7,5/6,210943,5
2,1,21,944,1,758,1,5,2,2,3,single-choice,spatial-relational,2|3,7,2/3,210944,2
2,1,21,945,1,548,1,9,4,4,5,single-choice,spatial-relational,4|5,7,4/5,210945,4
2,1,21,946,1,731,1,9,4,4,5,single-choice,spatial-relational,4|5,7,4/5,210946,4
2,1,21,947,1,613,1,3,1,1,2,single-choice,spatial-relational,1|2,7,1/2,210947,1
2,1,21,948,1,637,1,3,1,1,2,single-choice,spatial-relational,1|2,7,1/2,210948,1
2,1,21,949,1,658,1,5,2,2,3,single-choice,spatial-relational,2|3,7,2/3,210949,2
2,1,21,950,0,691,1,3,1,2,2,single-choice,spatial-relational,1|2,7,1/2,210950,1
2,1,21,951,0,771,1,7,3,4,4,single-choice,spatial-relational,3|4,7,3/4,210951,3
2,1,21,952,0,638,1,7,3,4,4,single-choice,spatial-relational,3|4,7,3/4,210952,3
2,1,21,953,0,680,1,11,5,6,6,single-choice,spatial-relational,5|6,7,5/6,210953,5
2,1,21,954,1,669,1,5,2,2,3,single-choice,spatial-relational,2|3,7,2/3,210954,2
2,1,21,955,1,587,1,9,4,4,5,single-choice,spatial-relational,4|5,7,4/5,210955,4
2,1,21,956,1,794,1,5,2,2,3,single-choice,spatial-relational,2|3,7,2/3,210956,2
2,1,21,957,1,553,1,13,6,6,7,single-choice,spatial-relational,6|7,7,6/7,210957,6
2,1,21,958,1,569,1,9,4,4,5,single-choice,spatial-relational,4|5,7,4/5,210958,4
2,1,21,959,1,773,1,3,1,1,2,single-choice,spatial-relational,1|2,7,1/2,210959,1
2,1,21,960,1,771,1,13,6,6,7,single-choice,spatial-relational,6|7,7,6/7,210960,6
2,1,21,961,0,635,1,11,5,6,6,single-choice,spatial-relational,5|6,7,5/6,210961,5
3,1,21,1,0,28,1,9,4,5,5,single-choice,spatial-relational,4|5,7,4/5,210001,4
3,1,21,2,1,737,1,5,2,2,3,single-choice,spatial-relational,2|3,7,2/3,210002,2
3,1,21,3,1,503,1,13,6,6,7,single-choice,spatial-relational,6|7,7,6/7,210003,6
3,1,21,4,1,852,1,13,6,6,7,single-choice,spatial-relational,6|7,7,6/7,210004,6
3,1,21,5,1,786,1,5,2,2,3,single-choice,spatial-relational,2|3,7,2/3,210005,2
3,1,21,6,0,671,1,7,3,4,4,single-choice,spatial-relational,3|4,7,3/4,210006,3
3,1,21,7,1,1491,1,9,4,4,5,single-choice,spatial-relational,4|5,7,4/5,210007,4
3,1,21,8,1,659,1,3,1,1,2,single-choice,spatial-relational,1|2,7,1/2,210008,1
3,1,21,9,0,519,1,11,5,6,6,single-choice,spatial-relational,5|6,7,5/6,210009,5
3,1,21,10,1,480,1,3,1,1,2,single-choice,spatial-relational,1|2,7,1/2,210010,1
3,1,21,11,0,501,1,7,3,4,4,single-choice,spatial-relational,3|4,7,3/4,210011,3
3,1,21,12,0,488,1,11,5,6,6,single-choice,spatial-relational,5|6,7,5/6,210012,5
3,1,21,13,0,686,1,5,2,3,3,single-choice,spatial-relational,2|3,7,2/3,210013,2
3,1,21,14,1,554,1,9,4,4,5,single-choice,spatial-relational,4|5,7,4/5,210014,4
3,1,21,15,0,497,1,7,3,4,4,single-choice,spatial-relational,3|4,7,3/4,210015,3
3,1,21,16,1,523,1,13,6,6,7,single-choice,spatial-relational,6|7,7,6/7,210016,6
3,1,21,17,0,668,1,11,5,6,6,single-choice,spatial-relational,5|6,7,5/6,210017,5
3,1,21,18,1,530,1,3,1,1,2,single-choice,spatial-relational,1|2,7,1/2,210018,1
3,1,21,19,0,467,1,11,5,6,6,single-choice,spatial-relational,5|6,7,5/6,210019,5
3,1,21,20,1,628,1,5,2,2,3,single-choice,spatial-relational,2|3,7,2/3,210020,2
3,1,21,21,1,834,1,3,1,1,2,single-choice,spatial-relational,1|2,7,1/2,210021,1
3,1,21,22,1,527,1,9,4,4,5,single-choice,spatial-relational,4|5,7,4/5,210022,4
3,1,21,23,1,593,1,13,6,6,7,single-choice,spatial-relational,6|7,7,6/7,210023,6
3,1,21,24,0,574,1,7,3,4,4,single-choice,spatial-relational,3|4,7,3/4,210024,3
3,1,21,25,1,650,1,5,2,2,3,single-choice,spatial-relational,2|3,7,2/3,210025,2
3,1,21,26,0,657,1,7,3,4,4,single-choice,spatial-relational,3|4,7,3/4,210026,3
3,1,21,27,0,388,1,11,5,6,6,single-choice,spatial-relational,5|6,7,5/6,210027,5
3,1,21,28,1,645,1,3,1,1,2,single-choice,spatial-relational,1|2,7,1/2,210028,1
3,1,21,29,0,489,1,5,2,3,3,single-choice,spatial-relational,2|3,7,2/3,210029,2
3,1,21,30,1,566,1,13,6,6,7,single-choice,spatial-relational,6|7,7,6/7,210030,6
3,1,21,31,0,712,1,7,3,4,4,single-choice,spatial-relational,3|4,7,3/4,210031,3
3,1,21,32,1,466,1,9,4,4,5,single-choice,spatial-relational,4|5,7,4/5,210032,4
3,1,21,33,1,595,1,3,1,1,2,single-choice,spatial-relational,1|2,7,1/2,210033,1
3,1,21,34,1,462,1,13,6,6,7,single-choice,spatial-relational,6|7,7,6/7,210034,6
3,1,21,35,0,615,1,11,5,6,6,single-choice,spatial-relational,5|6,7,5/6,210035,5
3,1,21,36,1,536,1,9,4,4,5,single-choice,spatial-relational,4|5,7,4/5,210036,4
3,1,21,37,0,540,1,11,5,6,6,single-choice,spatial-relational,5|6,7,5/6,210037,5
3,1,21,38,1,606,1,3,1,1,2,single-choice,spatial-relational,1|2,7,1/2,210038,1
3,1,21,39,1,471,1,13,6,6,7,single-choice,spatial-relational,6|7,7,6/7,210039,6
3,1,21,40,0,599,1,7,3,4,4,single-choice,spatial-relational,3|4,7,3/4,210040,3
3,1,21,41,1,476,1,13,6,6,7,single-choice,spatial-relational,6|7,7,6/7,210041,6
3,1,21,42,1,681,1,9,4,4,5,single-choice,spatial-relational,4|5,7,4/5,210042,4
3,1,21,43,0,623,1,7,3,4,4,single-choice,spatial-relational,3|4,7,3/4,210043,3
3,1,21,44,0,447,1,11,5,6,6,single-choice,spatial-relational,5|6,7,5/6,210044,5
3,1,21,45,1,525,1,9,4,4,5,single-choice,spatial-relational,4|5,7,4/5,210045,4
3,1,21,46,1,685,1,3,1,1,2,single-choice,spatial-relational,1|2,7,1/2,210046,1
3,1,21,47,0,592,1,5,2,3,3,single-choice,spatial-relational,2|3,7,2/3,210047,2
3,1,21,48,1,618,1,5,2,2,3,single-choice,spatial-relational,2|3,7,2/3,210048,2
3,1,21,49,1,479,1,3,1,1,2,single-choice,spatial-relational,1|2,7,1/2,210049,1
3,1,21,50,0,481,1,11,5,6,6,single-choice,spatial-relational,5|6,7,5/6,210050,5
3,1,21,51,1,586,1,5,2,2,3,single-choice,spatial-relational,2|3,7,2/3,210051,2
3,1,21,52,1,509,1,13,6,6,7,single-choice,spatial-relational,6|7,7,6/7,210052,6
3,1,21,53,0,788,1,7,3,4,4,single-choice,spatial-relational,3|4,7,3/4,210053,3
3,1,21,54,1,466,1,9,4,4,5,single-choice,spatial-relational,4|5,7,4/5,210054,4
3,1,21,55,0,702,1,5,2,3,3,single-choice,spatial-relational,2|3,7,2/3,210055,2
3,1,21,56,1,494,1,9,4,4,5,single-choice,spatial-relational,4|5,7,4/5,210056,4
3,1,21,57,1,698,1,13,6,6,7,single-choice,spatial-relational,6|7,7,6/7,210057,6
3,1,21,58,1,665,1,3,1,1,2,single-choice,spatial-relational,1|2,7,1/2,210058,1
3,1,21,59,0,441,1,7,3,4,4,single-choice,spatial-relational,3|4,7,3/4,210059,3
3,1,21,60,0,442,1,11,5,6,6,single-choice,spatial-relational,5|6,7,5/6,210060,5
3,1,21,61,0,479,1,11,5,6,6,single-choice,spatial-relational,5|6,7,5/6,210061,5
3,1,21,62,1,690,1,3,1,1,2,single-choice,spatial-relational,1|2,7,1/2,210062,1
3,1,21,63,1,507,1,9,4,4,5,single-choice,spatial-relational,4|5,7,4/5,210063,4
3,1,21,64,1,671,1,13,6,6,7,single-choice,spatial-relational,6|7,7,6/7,210064,6
3,1,21,65,1,656,1,3,1,1,2,single-choice,spatial-relational,1|2,7,1/2,210065,1
3,1,21,66,1,451,1,9,4,4,5,single-choice,spatial-relational,4|5,7,4/5,210066,4
3,1,21,67,0,573,1,7,3,4,4,single-choice,spatial-relational,3|4,7,3/4,210067,3
3,1,21,68,1,611,1,5,2,2,3,single-choice,spatial-relational,2|3,7,2/3,210068,2
3,1,21,69,1,481,1,13,6,6,7,single-choice,spatial-relational,6|7,7,6/7,210069,6
3,1,21,70,0,658,1,5,2,3,3,single-choice,spatial-relational,2|3,7,2/3,210070,2
3,1,21,71,0,495,1,7,3,4,4,single-choice,spatial-relational,3|4,7,3/4,210071,3
3,1,21,72,0,450,1,11,5,6,6,single-choice,spatial-relational,5|6,7,5/6,210072,5
3,1,21,73,0,36,1,9,4,5,5,single-choice,spatial-relational,4|5,7,4/5,210073,4
3,1,21,74,1,603,1,5,2,2,3,single-choice,spatial-relational,2|3,7,2/3,210074,2
3,1,21,75,0,668,1,5,2,3,3,single-choice,spatial-relational,2|3,7,2/3,210075,2
3,1,21,76,1,464,1,9,4,4,5,single-choice,spatial-relational,4|5,7,4/5,210076,4
3,1,21,77,0,679,1,11,5,6,6,single-choice,spatial-relational,5|6,7,5/6,210077,5
3,1,21,78,1,559,1,3,1,1,2,single-choice,spatial-relational,1|2,7,1/2,210078,1
3,1,21,79,1,437,1,13,6,6,7,single-choice,spatial-relational,6|7,7,6/7,210079,6
3,1,21,80,1,551,1,13,6,6,7,single-choice,spatial-relational,6|7,7,6/7,210080,6
3,1,21,81,0,617,1,7,3,4,4,single-choice,spatial-relational,3|4,7,3/4,210081,3
3,1,21,82,0,477,1,11,5,6,6,single-choice,spatial-relational,5|6,7,5/6,210082,5
3,1,21,83,1,768,1,3,1,1,2,single-choice,spatial-relational,1|2,7,1/2,210083,1
3,1,21,84,0,456,1,7,3,4,4,single-choice,spatial-relational,3|4,7,3/4,210084,3
3,1,21,85,1,645,1,13,6,6,7,single-choice,spatial-relational,6|7,7,6/7,210085,6
3,1,21,86,1,725,1,9,4,4,5,single-choice,spatial-relational,4|5,7,4/5,210086,4
3,1,21,87,1,575,1,3,1,1,2,single-choice,spatial-relational,1|2,7,1/2,210087,1
3,1,21,88,0,483,1,7,3,4,4,single-choice,spatial-relational,3|4,7,3/4,210088,3
3,1,21,89,1,505,1,13,6,6,7,single-choice,spatial-relational,6|7,7,6/7,210089,6
3,1,21,90,0,717,1,5,2,3,3,single-choice,spatial-relational,2|3,7,2/3,210090,2
3,1,21,91,1,529,1,5,2,2,3,single-choice,spatial-relational,2|3,7,2/3,210091,2
3,1,21,92,0,509,1,11,5,6,6,single-choice,spatial-relational,5|6,7,5/6,210092,5
3,1,21,93,0,514,1,11,5,6,6,single-choice,spatial-relational,5|6,7,5/6,210093,5
3,1,21,94,0,510,1,7,3,4,4,single-choice,spatial-relational,3|4,7,3/4,210094,3
3,1,21,95,1,618,1,9,4,4,5,single-choice,spatial-relational,4|5,7,4/5,210095,4
3,1,21,96,1,947,1,3,1,1,2,single-choice,spatial-relational,1|2,7,1/2,210096,1
3,1,21,97,1,534,1,9,4,4,5,single-choice,spatial-relational,4|5,7,4/5,210097,4
3,1,21,98,0,569,1,7,3,4,4,single-choice,spatial-relational,3|4,7,3/4,210098,3
3,1,21,99,1,543,1,13,6,6,7,single-choice,spatial-relational,6|7,7,6/7,210099,6
3,1,21,100,1,808,1,13,6,6,7,single-choice,spatial-relational,6|7,7,6/7,210100,6
3,1,21,101,0,741,1,5,2,3,3,single-choice,spatial-relational,2|3,7,2/3,210101,2
3,1,21,102,0,597,1,11,5,6,6,single-choice,spatial-relational,5|6,7,5/6,210102,5
3,1,21,103,1,677,1,3,1,1,2,single-choice,spatial-relational,1|2,7,1/2,210103,1
3,1,21,104,0,436,1,11,5,6,6,single-choice,spatial-relational,5|6,7,5/6,210104,5
3,1,21,105,1,679,1,5,2,2,3,single-choice,spatial-relational,2|3,7,2/3,210105,2
3,1,21,106,0,538,1,7,3,4,4,single-choice,spatial-relational,3|4,7,3/4,210106,3
3,1,21,107,1,490,1,9,4,4,5,single-choice,spatial-relational,4|5,7,4/5,210107,4
3,1,21,108,0,811,1,3,1,2,2,single-choice,spatial-relational,1|2,7,1/2,210108,1
3,1,21,109,1,507,1,3,1,1,2,single-choice,spatial-relational,1|2,7,1/2,210109,1
3,1,21,110,0,515,1,11,5,6,6,single-choice,spatial-relational,5|6,7,5/6,210110,5
3,1,21,111,1,716,1,9,4,4,5,single-choice,spatial-relational,4|5,7,4/5,210111,4
3,1,21,112,0,741,1,3,1,2,2,single-choice,spatial-relational,1|2,7,1/2,210112,1
3,1,21,113,0,898,1,7,3,4,4,single-choice,spatial-relational,3|4,7,3/4,210113,3
3,1,21,114,1,504,1,13,6,6,7,single-choice,spatial-relational,6|7,7,6/7,210114,6
3,1,21,115,1,672,1,13,6,6,7,single-choice,spatial-relational,6|7,7,6/7,210115,6
3,1,21,116,0,739,1,5,2,3,3,single-choice,spatial-relational,2|3,7,2/3,210116,2
3,1,21,117,0,467,1,7,3,4,4,single-choice,spatial-relational,3|4,7,3/4,210117,3
3,1,21,118,1,596,1,9,4,4,5,single-choice,spatial-relational,4|5,7,4/5,210118,4
3,1,21,119,0,636,1,11,5,6,6,single-choice,spatial-relational,5|6,7,5/6,210119,5
3,1,21,120,1,661,1,5,2,2,3,single-choice,spatial-relational,2|3,7,2/3,210120,2
3,1,21,121,0,523,1,11,5,6,6,single-choice,spatial-relational,5|6,7,5/6,210121,5
3,1,21,122,1,649,1,3,1,1,2,single-choice,spatial-relational,1|2,7,1/2,210122,1
3,1,21,123,1,644,1,5,2,2,3,single-choice,spatial-relational,2|3,7,2/3,210123,2
3,1,21,124,0,529,1,7,3,4,4,single-choice,spatial-relational,3|4,7,3/4,210124,3
3,1,21,125,1,542,1,13,6,6,7,single-choice,spatial-relational,6|7,7,6/7,210125,6
3,1,21,126,0,671,1,7,3,4,4,single-choice,spatial-relational,3|4,7,3/4,210126,3
3,1,21,127,1,702,1,9,4,4,5,single-choice,spatial-relational,4|5,7,4/5,210127,4
3,1,21,128,0,896,1,3,1,2,2,single-choice,spatial-relational,1|2,7,1/2,210128,1
3,1,21,129,1,751,1,5,2,2,3,single-choice,spatial-relational,2|3,7,2/3,210129,2
3,1,21,130,0,558,1,11,5,6,6,single-choice,spatial-relational,5|6,7,5/6,210130,5
3,1,21,131,1,487,1,13,6,6,7,single-choice,spatial-relational,6|7,7,6/7,210131,6
3,1,21,132,1,687,1,9,4,4,5,single-choice,spatial-relational,4|5,7,4/5,210132,4
3,1,21,133,1,501,1,13,6,6,7,single-choice,spatial-relational,6|7,7,6/7,210133,6
3,1,21,134,1,802,1,5,2,2,3,single-choice,spatial-relational,2|3,7,2/3,210134,2
3,1,21,135,0,479,1,11,5,6,6,single-choice,spatial-relational,5|6,7,5/6,210135,5
3,1,21,136,1,512,1,9,4,4,5,single-choice,spatial-relational,4|5,7,4/5,210136,4
3,1,21,137,1,592,1,9,4,4,5,single-choice,spatial-relational,4|5,7,4/5,210137,4
3,1,21,138,0,735,1,11,5,6,6,single-choice,spatial-relational,5|6,7,5/6,210138,5
3,1,21,139,0,530,1,7,3,4,4,single-choice,spatial-relational,3|4,7,3/4,210139,3
3,1,21,140,0,513,1,7,3,4,4,single-choice,spatial-relational,3|4,7,3/4,210140,3
3,1,21,141,1,670,1,5,2,2,3,single-choice,spatial-relational,2|3,7,2/3,210141,2
3,1,21,142,1,524,1,13,6,6,7,single-choice,spatial-relational,6|7,7,6/7,210142,6
3,1,21,143,0,804,1,3,1,2,2,single-choice,spatial-relational,1|2,7,1/2,210143,1
3,1,21,144,0,729,1,3,1,2,2,single-choice,spatial-relational,1|2,7,1/2,210144,1
3,1,21,145,1,479,1,13,6,6,7,single-choice,spatial-relational,6|7,7,6/7,210145,6
3,1,21,146,0,672,1,11,5,6,6,single-choice,spatial-relational,5|6,7,5/6,210146,5
3,1,21,147,1,564,1,9,4,4,5,single-choice,spatial-relational,4|5,7,4/5,210147,4
3,1,21,148,0,810,1,3,1,2,2,single-choice,spatial-relational,1|2,7,1/2,210148,1
3,1,21,149,1,640,1,5,2,2,3,single-choice,spatial-relational,2|3,7,2/3,210149,2
3,1,21,150,1,772,1,5,2,2,3,single-choice,spatial-relational,2|3,7,2/3,210150,2
3,1,21,151,0,534,1,7,3,4,4,single-choice,spatial-relational,3|4,7,3/4,210151,3
3,1,21,152,0,660,1,3,1,2,2,single-choice,spatial-relational,1|2,7,1/2,210152,1
3,1,21,153,0,484,1,11,5,6,6,single-choice,spatial-relational,5|6,7,5/6,210153,5
3,1,21,154,0,526,1,7,3,4,4,single-choice,spatial-relational,3|4,7,3/4,210154,3
3,1,21,155,1,569,1,9,4,4,5,single-choice,spatial-relational,4|5,7,4/5,210155,4
3,1,21,156,1,831,1,13,6,6,7,single-choice,spatial-relational,6|7,7,6/7,210156,6
3,1,21,157,0,610,1,7,3,4,4,single-choice,spatial-relational,3|4,7,3/4,210157,3
3,1,21,158,1,702,1,13,6,6,7,single-choice,spatial-relational,6|7,7,6/7,210158,6
3,1,21,159,0,832,1,5,2,3,3,single-choice,spatial-relational,2|3,7,2/3,210159,2
3,1,21,160,0,537,1,7,3,4,4,single-choice,spatial-relational,3|4,7,3/4,210160,3
3,1,21,161,1,665,1,9,4,4,5,single-choice,spatial-relational,4|5,7,4/5,210161,4
3,1,21,162,0,652,1,11,5,6,6,single-choice,spatial-relational,5|6,7,5/6,210162,5
3,1,21,163,0,811,1,3,1,2,2,single-choice,spatial-relational,1|2,7,1/2,210163,1
3,1,21,164,1,600,1,13,6,6,7,single-choice,spatial-relational,6|7,7,6/7,210164,6
3,1,21,165,1,843,1,9,4,4,5,single-choice,spatial-relational,4|5,7,4/5,210165,4
3,1,21,166,1,804,1,5,2,2,3,single-choice,spatial-relational,2|3,7,2/3,210166,2
3,1,21,167,0,507,1,11,5,6,6,single-choice,spatial-relational,5|6,7,5/6,210167,5
3,1,21,168,0,937,1,3,1,2,2,single-choice,spatial-relational,1|2,7,1/2,210168,1
3,1,21,169,0,524,1,11,5,6,6,single-choice,spatial-relational,5|6,7,5/6,210169,5
3,1,21,170,0,531,1,7,3,4,4,single-choice,spatial-relational,3|4,7,3/4,210170,3
3,1,21,171,1,578,1,9,4,4,5,single-choice,spatial-relational,4|5,7,4/5,210171,4
3,1,21,172,0,861,1,3,1,2,2,single-choice,spatial-relational,1|2,7,1/2,210172,1
3,1,21,173,0,779,1,3,1,2,2,single-choice,spatial-relational,1|2,7,1/2,210173,1
3,1,21,174,0,533,1,7,3,4,4,single-choice,spatial-relational,3|4,7,3/4,210174,3
3,1,21,175,1,724,1,5,2,2,3,single-choice,spatial-relational,2|3,7,2/3,210175,2
3,1,21,176,0,566,1,11,5,6,6,single-choice,spatial-relational,5|6,7,5/6,210176,5
3,1,21,177,1,655,1,9,4,4,5,single-choice,spatial-relational,4|5,7,4/5,210177,4
3,1,21,178,1,851,1,13,6,6,7,single-choice,spatial-relational,6|7,7,6/7,210178,6
3,1,21,179,1,853,1,5,2,2,3,single-choice,spatial-relational,2|3,7,2/3,210179,2
3,1,21,180,1,569,1,13,6,6,7,single-choice,spatial-relational,6|7,7,6/7,210180,6
3,1,21,181,1,640,1,9,4,4,5,single-choice,spatial-relational,4|5,7,4/5,210181,4
3,1,21,182,0,662,1,7,3,4,4,single-choice,spatial-relational,3|4,7,3/4,210182,3
3,1,21,183,1,746,1,13,6,6,7,single-choice,spatial-relational,6|7,7,6/7,210183,6
3,1,21,184,0,697,1,11,5,6,6,single-choice,spatial-relational,5|6,7,5/6,210184,5
3,1,21,185,1,754,1,5,2,2,3,single-choice,spatial-relational,2|3,7,2/3,210185,2
3,1,21,186,1,586,1,9,4,4,5,single-choice,spatial-relational,4|5,7,4/5,210186,4
3,1,21,187,1,1363,1,13,6,6,7,single-choice,spatial-relational,6|7,7,6/7,210187,6
3,1,21,188,0,815,1,3,1,2,2,single-choice,spatial-relational,1|2,7,1/2,210188,1
3,1,21,189,0,560,1,7,3,4,4,single-choice,spatial-relational,3|4,7,3/4,210189,3
3,1,21,190,1,623,1,3,1,1,2,single-choice,spatial-relational,1|2,7,1/2,210190,1
3,1,21,191,1,619,1,5,2,2,3,single-choice,spatial-relational,2|3,7,2/3,210191,2
3,1,21,192,0,517,1,11,5,6,6,single-choice,spatial-relational,5|6,7,5/6,210192,5
3,1,21,193,0,505,1,7,3,4,4,single-choice,spatial-relational,3|4,7,3/4,210193,3
3,1,21,194,1,577,1,13,6,6,7,single-choice,spatial-relational,6|7,7,6/7,210194,6
3,1,21,195,1,764,1,3,1,1,2,single-choice,spatial-relational,1|2,7,1/2,210195,1
3,1,21,196,1,612,1,5,2,2,3,single-choice,spatial-relational,2|3,7,2/3,210196,2
3,1,21,197,0,548,1,7,3,4,4,single-choice,spatial-relational,3|4,7,3/4,210197,3
3,1,21,198,1,521,1,13,6,6,7,single-choice,spatial-relational,6|7,7,6/7,210198,6
3,1,21,199,0,715,1,11,5,6,6,single-choice,spatial-relational,5|6,7,5/6,210199,5
3,1,21,200,1,839,1,9,4,4,5,single-choice,spatial-relational,4|5,7,4/5,210200,4
3,1,21,201,0,852,1,5,2,3,3,single-choice,spatial-relational,2|3,7,2/3,210201,2
3,1,21,202,1,640,1,9,4,4,5,single-choice,spatial-relational,4|5,7,4/5,210202,4
3,1,21,203,0,834,1,3,1,2,2,single-choice,spatial-relational,1|2,7,1/2,210203,1
3,1,21,204,0,544,1,11,5,6,6,single-choice,spatial-relational,5|6,7,5/6,210204,5
3,1,21,205,0,787,1,3,1,2,2,single-choice,spatial-relational,1|2,7,1/2,210205,1
3,1,21,206,0,533,1,7,3,4,4,single-choice,spatial-relational,3|4,7,3/4,210206,3
3,1,21,207,1,680,1,5,2,2,3,single-choice,spatial-relational,2|3,7,2/3,210207,2
3,1,21,208,0,613,1,11,5,6,6,single-choice,spatial-relational,5|6,7,5/6,210208,5
3,1,21,209,0,625,1,7,3,4,4,single-choice,spatial-relational,3|4,7,3/4,210209,3
3,1,21,210,1,714,1,5,2,2,3,single-choice,spatial-relational,2|3,7,2/3,210210,2
3,1,21,211,1,643,1,13,6,6,7,single-choice,spatial-relational,6|7,7,6/7,210211,6
3,1,21,212,1,695,1,9,4,4,5,single-choice,spatial-relational,4|5,7,4/5,210212,4
3,1,21,213,1,620,1,9,4,4,5,single-choice,spatial-relational,4|5,7,4/5,210213,4
3,1,21,214,0,737,1,11,5,6,6,single-choice,spatial-relational,5|6,7,5/6,210214,5
3,1,21,215,1,810,1,13,6,6,7,single-choice,spatial-relational,6|7,7,6/7,210215,6
3,1,21,216,0,919,1,3,1,2,2,single-choice,spatial-relational,1|2,7,1/2,210216,1
3,1,21,217,0,790,1,3,1,2,2,single-choice,spatial-relational,1|2,7,1/2,210217,1
3,1,21,218,0,903,1,7,3,4,4,single-choice,spatial-relational,3|4,7,3/4,210218,3
3,1,21,219,0,620,1,11,5,6,6,single-choice,spatial-relational,5|6,7,5/6,210219,5
3,1,21,220,1,689,1,13,6,6,7,single-choice,spatial-relational,6|7,7,6/7,210220,6
3,1,21,221,1,835,1,13,6,6,7,single-choice,spatial-relational,6|7,7,6/7,210221,6
3,1,21,222,0,821,1,5,2,3,3,single-choice,spatial-relational,2|3,7,2/3,210222,2
3,1,21,223,1,684,1,5,2,2,3,single-choice,spatial-relational,2|3,7,2/3,210223,2
3,1,21,224,0,531,1,11,5,6,6,single-choice,spatial-relational,5|6,7,5/6,210224,5
3,1,21,225,1,552,1,9,4,4,5,single-choice,spatial-relational,4|5,7,4/5,210225,4
3,1,21,226,1,840,1,9,4,4,5,single-choice,spatial-relational,4|5,7,4/5,210226,4
3,1,21,227,0,743,1,7,3,4,4,single-choice,spatial-relational,3|4,7,3/4,210227,3
3,1,21,228,0,739,1,3,1,2,2,single-choice,spatial-relational,1|2,7,1/2,210228,1
3,1,21,229,0,543,1,11,5,6,6,single-choice,spatial-relational,5|6,7,5/6,210229,5
3,1,21,230,1,693,1,5,2,2,3,single-choice,spatial-relational,2|3,7,2/3,210230,2
3,1,21,231,1,760,1,3,1,1,2,single-choice,spatial-relational,1|2,7,1/2,210231,1
3,1,21,232,0,640,1,7,3,4,4,single-choice,spatial-relational,3|4,7,3/4,210232,3
3,1,21,233,1,653,1,5,2,2,3,single-choice,spatial-relational,2|3,7,2/3,210233,2
3,1,21,234,1,542,1,9,4,4,5,single-choice,spatial-relational,4|5,7,4/5,210234,4
3,1,21,235,0,1175,1,3,1,2,2,single-choice,spatial-relational,1|2,7,1/2,210235,1
3,1,21,236,0,580,1,7,3,4,4,single-choice,spatial-relational,3|4,7,3/4,210236,3
3,1,21,237,1,726,1,13,6,6,7,single-choice,spatial-relational,6|7,7,6/7,210237,6
3,1,21,238,1,679,1,13,6,6,7,single-choice,spatial-relational,6|7,7,6/7,210238,6
3,1,21,239,1,743,1,9,4,4,5,single-choice,spatial-relational,4|5,7,4/5,210239,4
3,1,21,240,0,711,1,11,5,6,6,single-choice,spatial-relational,5|6,7,5/6,210240,5
3,1,21,241,0,670,1,3,1,2,2,single-choice,spatial-relational,1|2,7,1/2,210241,1
3,1,21,242,0,536,1,11,5,6,6,single-choice,spatial-relational,5|6,7,5/6,210242,5
3,1,21,243,0,860,1,7,3,4,4,single-choice,spatial-relational,3|4,7,3/4,210243,3
3,1,21,244,1,645,1,5,2,2,3,single-choice,spatial-relational,2|3,7,2/3,210244,2
3,1,21,245,1,629,1,9,4,4,5,single-choice,spatial-relational,4|5,7,4/5,210245,4
3,1,21,246,0,567,1,11,5,6,6,single-choice,spatial-relational,5|6,7,5/6,210246,5
3,1,21,247,1,647,1,5,2,2,3,single-choice,spatial-relational,2|3,7,2/3,210247,2
3,1,21,248,1,842,1,13,6,6,7,single-choice,spatial-relational,6|7,7,6/7,210248,6
3,1,21,249,1,845,1,3,1,1,2,single-choice,spatial-relational,1|2,7,1/2,210249,1
3,1,21,250,0,503,1,7,3,4,4,single-choice,spatial-relational,3|4,7,3/4,210250,3
3,1,21,251,1,749,1,13,6,6,7,single-choice,spatial-relational,6|7,7,6/7,210251,6
3,1,21,252,1,681,1,9,4,4,5,single-choice,spatial-relational,4|5,7,4/5,210252,4
3,1,21,253,0,741,1,11,5,6,6,single-choice,spatial-relational,5|6,7,5/6,210253,5
3,1,21,254,1,829,1,9,4,4,5,single-choice,spatial-relational,4|5,7,4/5,210254,4
3,1,21,255,1,754,1,5,2,2,3,single-choice,spatial-relational,2|3,7,2/3,210255,2
3,1,21,256,0,537,1,7,3,4,4,single-choice,spatial-relational,3|4,7,3/4,210256,3
3,1,21,257,1,686,1,5,2,2,3,single-choice,spatial-relational,2|3,7,2/3,210257,2
3,1,21,258,1,966,1,7,3,3,4,single-choice,spatial-relational,3|4,7,3/4,210258,3
3,1,21,259,1,637,1,9,4,4,5,single-choice,spatial-relational,4|5,7,4/5,210259,4
3,1,21,260,1,878,1,3,1,1,2,single-choice,spatial-relational,1|2,7,1/2,210260,1
3,1,21,261,1,912,1,13,6,6,7,single-choice,spatial-relational,6|7,7,6/7,210261,6
3,1,21,262,0,1009,1,3,1,2,2,single-choice,spatial-relational,1|2,7,1/2,210262,1
3,1,21,263,0,580,1,11,5,6,6,single-choice,spatial-relational,5|6,7,5/6,210263,5
3,1,21,264,1,638,1,13,6,6,7,single-choice,spatial-relational,6|7,7,6/7,210264,6
3,1,21,265,0,741,1,7,3,4,4,single-choice,spatial-relational,3|4,7,3/4,210265,3
3,1,21,266,1,665,1,13,6,6,7,single-choice,spatial-relational,6|7,7,6/7,210266,6
3,1,21,267,1,901,1,5,2,2,3,single-choice,spatial-relational,2|3,7,2/3,210267,2
3,1,21,268,0,741,1,3,1,2,2,single-choice,spatial-relational,1|2,7,1/2,210268,1
3,1,21,269,0,1015,1,9,4,5,5,single-choice,spatial-relational,4|5,7,4/5,210269,4
3,1,21,270,0,555,1,11,5,6,6,single-choice,spatial-relational,5|6,7,5/6,210270,5
3,1,21,271,1,603,1,9,4,4,5,single-choice,spatial-relational,4|5,7,4/5,210271,4
3,1,21,272,0,809,1,7,3,4,4,single-choice,spatial-relational,3|4,7,3/4,210272,3
3,1,21,273,1,732,1,13,6,6,7,single-choice,spatial-relational,6|7,7,6/7,210273,6
3,1,21,274,0,743,1,11,5,6,6,single-choice,spatial-relational,5|6,7,5/6,210274,5
3,1,21,275,1,846,1,5,2,2,3,single-choice,spatial-relational,2|3,7,2/3,210275,2
3,1,21,276,0,965,1,3,1,2,2,single-choice,spatial-relational,1|2,7,1/2,210276,1
3,1,21,277,1,924,1,9,4,4,5,single-choice,spatial-relational,4|5,7,4/5,210277,4
3,1,21,278,0,819,1,3,1,2,2,single-choice,spatial-relational,1|2,7,1/2,210278,1
3,1,21,279,1,874,1,13,6,6,7,single-choice,spatial-relational,6|7,7,6/7,210279,6
3,1,21,280,0,973,1,5,2,3,3,single-choice,spatial-relational,2|3,7,2/3,210280,2
3,1,21,281,1,719,1,5,2,2,3,single-choice,spatial-relational,2|3,7,2/3,210281,2
3,1,21,282,1,568,1,13,6,6,7,single-choice,spatial-relational,6|7,7,6/7,210282,6
3,1,21,283,0,809,1,7,3,4,4,single-choice,spatial-relational,3|4,7,3/4,210283,3
3,1,21,284,0,947,1,3,1,2,2,single-choice,spatial-relational,1|2,7,1/2,210284,1
3,1,21,285,0,529,1,11,5,6,6,single-choice,spatial-relational,5|6,7,5/6,210285,5
3,1,21,286,1,779,1,9,4,4,5,single-choice,spatial-relational,4|5,7,4/5,210286,4
3,1,21,287,0,734,1,11,5,6,6,single-choice,spatial-relational,5|6,7,5/6,210287,5
3,1,21,288,0,640,1,7,3,4,4,single-choice,spatial-relational,3|4,7,3/4,210288,3
3,1,21,289,1,659,1,13,6,6,7,single-choice,spatial-relational,6|7,7,6/7,210289,6
3,1,21,290,0,754,1,5,2,3,3,single-choice,spatial-relational,2|3,7,2/3,210290,2
3,1,21,291,1,700,1,9,4,4,5,single-choice,spatial-relational,4|5,7,4/5,210291,4
3,1,21,292,0,747,1,7,3,4,4,single-choice,spatial-relational,3|4,7,3/4,210292,3
3,1,21,293,1,772,1,3,1,1,2,single-choice,spatial-relational,1|2,7,1/2,210293,1
3,1,21,294,1,559,1,9,4,4,5,single-choice,spatial-relational,4|5,7,4/5,210294,4
3,1,21,295,0,796,1,13,6,7,7,single-choice,spatial-relational,6|7,7,6/7,210295,6
3,1,21,296,0,710,1,3,1,2,2,single-choice,spatial-relational,1|2,7,1/2,210296,1
3,1,21,297,0,592,1,7,3,4,4,single-choice,spatial-relational,3|4,7,3/4,210297,3
3,1,21,298,1,617,1,5,2,2,3,single-choice,spatial-relational,2|3,7,2/3,210298,2
3,1,21,299,0,556,1,11,5,6,6,single-choice,spatial-relational,5|6,7,5/6,210299,5
3,1,21,300,0,520,1,11,5,6,6,single-choice,spatial-relational,5|6,7,5/6,210300,5
3,1,21,301,0,618,1,7,3,4,4,single-choice,spatial-relational,3|4,7,3/4,210301,3
3,1,21,302,1,746,1,13,6,6,7,single-choice,spatial-relational,6|7,7,6/7,210302,6
3,1,21,303,0,1670,1,3,1,2,2,single-choice,spatial-relational,1|2,7,1/2,210303,1
3,1,21,304,1,675,1,13,6,6,7,single-choice,spatial-relational,6|7,7,6/7,210304,6
3,1,21,305,0,743,1,11,5,6,6,single-choice,spatial-relational,5|6,7,5/6,210305,5
3,1,21,306,1,830,1,9,4,4,5,single-choice,spatial-relational,4|5,7,4/5,210306,4
3,1,21,307,0,861,1,7,3,4,4,single-choice,spatial-relational,3|4,7,3/4,210307,3
3,1,21,308,1,553,1,5,2,2,3,single-choice,spatial-relational,2|3,7,2/3,210308,2
3,1,21,309,1,754,1,3,1,1,2,single-choice,spatial-relational,1|2,7,1/2,210309,1
3,1,21,310,0,507,1,11,5,6,6,single-choice,spatial-relational,5|6,7,5/6,210310,5
3,1,21,311,1,773,1,9,4,4,5,single-choice,spatial-relational,4|5,7,4/5,210311,4
3,1,21,312,0,879,1,5,2,3,3,single-choice,spatial-relational,2|3,7,2/3,210312,2
3,1,21,313,1,680,1,9,4,4,5,single-choice,spatial-relational,4|5,7,4/5,210313,4
3,1,21,314,0,749,1,13,6,7,7,single-choice,spatial-relational,6|7,7,6/7,210314,6
3,1,21,315,1,816,1,13,6,6,7,single-choice,spatial-relational,6|7,7,6/7,210315,6
3,1,21,316,0,772,1,11,5,6,6,single-choice,spatial-relational,5|6,7,5/6,210316,5
3,1,21,317,1,790,1,3,1,1,2,single-choice,spatial-relational,1|2,7,1/2,210317,1
3,1,21,318,0,544,1,7,3,4,4,single-choice,spatial-relational,3|4,7,3/4,210318,3
3,1,21,319,0,701,1,3,1,2,2,single-choice,spatial-relational,1|2,7,1/2,210319,1
3,1,21,320,0,482,1,7,3,4,4,single-choice,spatial-relational,3|4,7,3/4,210320,3
3,1,21,321,1,485,1,9,4,4,5,single-choice,spatial-relational,4|5,7,4/5,210321,4
3,1,21,322,0,1294,1,11,5,6,6,single-choice,spatial-relational,5|6,7,5/6,210322,5
3,1,21,323,1,528,1,5,2,2,3,single-choice,spatial-relational,2|3,7,2/3,210323,2
3,1,21,324,0,670,1,5,2,3,3,single-choice,spatial-relational,2|3,7,2/3,210324,2
3,1,21,325,0,504,1,11,5,6,6,single-choice,spatial-relational,5|6,7,5/6,210325,5
3,1,21,326,1,551,1,9,4,4,5,single-choice,spatial-relational,4|5,7,4/5,210326,4
3,1,21,327,0,607,1,7,3,4,4,single-choice,spatial-relational,3|4,7,3/4,210327,3
3,1,21,328,1,670,1,3,1,1,2,single-choice,spatial-relational,1|2,7,1/2,210328,1
3,1,21,329,0,466,1,11,5,6,6,single-choice,spatial-relational,5|6,7,5/6,210329,5
3,1,21,330,1,486,1,9,4,4,5,single-choice,spatial-relational,4|5,7,4/5,210330,4
3,1,21,331,0,835,1,3,1,2,2,single-choice,spatial-relational,1|2,7,1/2,210331,1
3,1,21,332,0,541,1,7,3,4,4,single-choice,spatial-relational,3|4,7,3/4,210332,3
3,1,21,333,1,743,1,5,2,2,3,single-choice,spatial-relational,2|3,7,2/3,210333,2
3,1,21,334,1,562,1,5,2,2,3,single-choice,spatial-relational,2|3,7,2/3,210334,2
3,1,21,335,1,805,1,13,6,6,7,single-choice,spatial-relational,6|7,7,6/7,210335,6
3,1,21,336,0,787,1,13,6,7,7,single-choice,spatial-relational,6|7,7,6/7,210336,6
3,1,21,337,0,758,1,7,3,4,4,single-choice,spatial-relational,3|4,7,3/4,210337,3
3,1,21,338,1,504,1,3,1,1,2,single-choice,spatial-relational,1|2,7,1/2,210338,1
3,1,21,339,0,505,1,11,5,6,6,single-choice,spatial-relational,5|6,7,5/6,210339,5
3,1,21,340,1,465,1,13,6,6,7,single-choice,spatial-relational,6|7,7,6/7,210340,6
3,1,21,341,1,500,1,9,4,4,5,single-choice,spatial-relational,4|5,7,4/5,210341,4
3,1,21,342,0,674,1,5,2,3,3,single-choice,spatial-relational,2|3,7,2/3,210342,2
3,1,21,343,1,563,1,5,2,2,3,single-choice,spatial-relational,2|3,7,2/3,210343,2
3,1,21,344,1,536,1,13,6,6,7,single-choice,spatial-relational,6|7,7,6/7,210344,6
3,1,21,345,0,638,1,11,5,6,6,single-choice,spatial-relational,5|6,7,5/6,210345,5
3,1,21,346,1,693,1,9,4,4,5,single-choice,spatial-relational,4|5,7,4/5,210346,4
3,1,21,347,0,685,1,7,3,4,4,single-choice,spatial-relational,3|4,7,3/4,210347,3
3,1,21,348,0,773,1,3,1,2,2,single-choice,spatial-relational,1|2,7,1/2,210348,1
3,1,21,349,1,472,1,13,6,6,7,single-choice,spatial-relational,6|7,7,6/7,210349,6
3,1,21,350,0,598,1,7,3,4,4,single-choice,spatial-relational,3|4,7,3/4,210350,3
3,1,21,351,1,534,1,13,6,6,7,single-choice,spatial-relational,6|7,7,6/7,210351,6
3,1,21,352,0,589,1,11,5,6,6,single-choice,spatial-relational,5|6,7,5/6,210352,5
3,1,21,353,1,694,1,5,2,2,3,single-choice,spatial-relational,2|3,7,2/3,210353,2
3,1,21,354,1,650,1,3,1,1,2,single-choice,spatial-relational,1|2,7,1/2,210354,1
3,1,21,355,0,485,1,7,3,4,4,single-choice,spatial-relational,3|4,7,3/4,210355,3
3,1,21,356,1,654,1,9,4,4,5,single-choice,spatial-relational,4|5,7,4/5,210356,4
3,1,21,357,0,593,1,11,5,6,6,single-choice,spatial-relational,5|6,7,5/6,210357,5
3,1,21,358,1,521,1,9,4,4,5,single-choice,spatial-relational,4|5,7,4/5,210358,4
3,1,21,359,0,794,1,3,1,2,2,single-choice,spatial-relational,1|2,7,1/2,210359,1
3,1,21,360,1,20,1,5,2,2,3,single-choice,spatial-relational,2|3,7,2/3,210360,2
3,1,21,361,0,612,1,3,1,2,2,single-choice,spatial-relational,1|2,7,1/2,210361,1
3,1,21,362,1,506,1,9,4,4,5,single-choice,spatial-relational,4|5,7,4/5,210362,4
3,1,21,363,1,929,1,13,6,6,7,single-choice,spatial-relational,6|7,7,6/7,210363,6
3,1,21,364,0,600,1,11,5,6,6,single-choice,spatial-relational,5|6,7,5/6,210364,5
3,1,21,365,0,1150,1,7,3,4,4,single-choice,spatial-relational,3|4,7,3/4,210365,3
3,1,21,366,1,879,1,5,2,2,3,single-choice,spatial-relational,2|3,7,2/3,210366,2
3,1,21,367,1,696,1,5,2,2,3,single-choice,spatial-relational,2|3,7,2/3,210367,2
3,1,21,368,1,572,1,13,6,6,7,single-choice,spatial-relational,6|7,7,6/7,210368,6
3,1,21,369,0,548,1,7,3,4,4,single-choice,spatial-relational,3|4,7,3/4,210369,3
3,1,21,370,0,590,1,3,1,2,2,single-choice,spatial-relational,1|2,7,1/2,210370,1
3,1,21,371,0,457,1,11,5,6,6,single-choice,spatial-relational,5|6,7,5/6,210371,5
3,1,21,372,1,36,1,9,4,4,5,single-choice,spatial-relational,4|5,7,4/5,210372,4
3,1,21,373,0,605,1,11,5,6,6,single-choice,spatial-relational,5|6,7,5/6,210373,5
3,1,21,374,1,688,1,9,4,4,5,single-choice,spatial-relational,4|5,7,4/5,210374,4
3,1,21,375,0,692,1,7,3,4,4,single-choice,spatial-relational,3|4,7,3/4,210375,3
3,1,21,376,1,566,1,9,4,4,5,single-choice,spatial-relational,4|5,7,4/5,210376,4
3,1,21,377,1,646,1,5,2,2,3,single-choice,spatial-relational,2|3,7,2/3,210377,2
3,1,21,378,0,546,1,11,5,6,6,single-choice,spatial-relational,5|6,7,5/6,210378,5
3,1,21,379,1,664,1,5,2,2,3,single-choice,spatial-relational,2|3,7,2/3,210379,2
3,1,21,380,1,899,1,13,6,6,7,single-choice,spatial-relational,6|7,7,6/7,210380,6
3,1,21,381,0,735,1,3,1,2,2,single-choice,spatial-relational,1|2,7,1/2,210381,1
3,1,21,382,0,470,1,7,3,4,4,single-choice,spatial-relational,3|4,7,3/4,210382,3
3,1,21,383,1,757,1,13,6,6,7,single-choice,spatial-relational,6|7,7,6/7,210383,6
3,1,21,384,0,715,1,3,1,2,2,single-choice,spatial-relational,1|2,7,1/2,210384,1
3,1,21,385,0,1602,1,3,1,2,2,single-choice,spatial-relational,1|2,7,1/2,210385,1
3,1,21,386,1,459,1,9,4,4,5,single-choice,spatial-relational,4|5,7,4/5,210386,4
3,1,21,387,1,1193,1,13,6,6,7,single-choice,spatial-relational,6|7,7,6/7,210387,6
3,1,21,388,1,800,1,5,2,2,3,single-choice,spatial-relational,2|3,7,2/3,210388,2
3,1,21,389,0,530,1,7,3,4,4,single-choice,spatial-relational,3|4,7,3/4,210389,3
3,1,21,390,0,697,1,7,3,4,4,single-choice,spatial-relational,3|4,7,3/4,210390,3
3,1,21,391,0,572,1,3,1,2,2,single-choice,spatial-relational,1|2,7,1/2,210391,1
3,1,21,392,1,613,1,5,2,2,3,single-choice,spatial-relational,2|3,7,2/3,210392,2
3,1,21,393,1,532,1,9,4,4,5,single-choice,spatial-relational,4|5,7,4/5,210393,4
3,1,21,394,0,633,1,11,5,6,6,single-choice,spatial-relational,5|6,7,5/6,210394,5
3,1,21,395,0,503,1,11,5,6,6,single-choice,spatial-relational,5|6,7,5/6,210395,5
3,1,21,396,1,40,1,13,6,6,7,single-choice,spatial-relational,6|7,7,6/7,210396,6
3,1,21,397,1,664,1,13,6,6,7,single-choice,spatial-relational,6|7,7,6/7,210397,6
3,1,21,398,0,636,1,7,3,4,4,single-choice,spatial-relational,3|4,7,3/4,210398,3
3,1,21,399,1,1297,1,5,2,2,3,single-choice,spatial-relational,2|3,7,2/3,210399,2
3,1,21,400,0,456,1,11,5,6,6,single-choice,spatial-relational,5|6,7,5/6,210400,5
3,1,21,401,0,510,1,11,5,6,6,single-choice,spatial-relational,5|6,7,5/6,210401,5
3,1,21,402,1,701,1,13,6,6,7,single-choice,spatial-relational,6|7,7,6/7,210402,6
3,1,21,403,1,712,1,3,1,1,2,single-choice,spatial-relational,1|2,7,1/2,210403,1
3,1,21,404,1,662,1,5,2,2,3,single-choice,spatial-relational,2|3,7,2/3,210404,2
3,1,21,405,1,576,1,9,4,4,5,single-choice,spatial-relational,4|5,7,4/5,210405,4
3,1,21,406,1,588,1,9,4,4,5,single-choice,spatial-relational,4|5,7,4/5,210406,4
3,1,21,407,0,670,1,3,1,2,2,single-choice,spatial-relational,1|2,7,1/2,210407,1
3,1,21,408,0,801,1,7,3,4,4,single-choice,spatial-relational,3|4,7,3/4,210408,3
3,1,21,409,1,674,1,5,2,2,3,single-choice,spatial-relational,2|3,7,2/3,210409,2
3,1,21,410,0,576,1,7,3,4,4,single-choice,spatial-relational,3|4,7,3/4,210410,3
3,1,21,411,0,552,1,11,5,6,6,single-choice,spatial-relational,5|6,7,5/6,210411,5
3,1,21,412,1,774,1,13,6,6,7,single-choice,spatial-relational,6|7,7,6/7,210412,6
3,1,21,413,0,720,1,3,1,2,2,single-choice,spatial-relational,1|2,7,1/2,210413,1
3,1,21,414,0,738,1,7,3,4,4,single-choice,spatial-relational,3|4,7,3/4,210414,3
3,1,21,415,0,496,1,11,5,6,6,single-choice,spatial-relational,5|6,7,5/6,210415,5
3,1,21,416,1,468,1,9,4,4,5,single-choice,spatial-relational,4|5,7,4/5,210416,4
3,1,21,417,1,724,1,5,2,2,3,single-choice,spatial-relational,2|3,7,2/3,210417,2
3,1,21,418,1,510,1,9,4,4,5,single-choice,spatial-relational,4|5,7,4/5,210418,4
3,1,21,419,0,862,1,3,1,2,2,single-choice,spatial-relational,1|2,7,1/2,210419,1
3,1,21,420,1,498,1,13,6,6,7,single-choice,spatial-relational,6|7,7,6/7,210420,6
3,1,21,421,0,868,1,7,3,4,4,single-choice,spatial-relational,3|4,7,3/4,210421,3
3,1,21,422,1,791,1,5,2,2,3,single-choice,spatial-relational,2|3,7,2/3,210422,2
3,1,21,423,1,813,1,13,6,6,7,single-choice,spatial-relational,6|7,7,6/7,210423,6
3,1,21,424,1,1004,1,3,1,1,2,single-choice,spatial-relational,1|2,7,1/2,210424,1
3,1,21,425,0,604,1,3,1,2,2,single-choice,spatial-relational,1|2,7,1/2,210425,1
3,1,21,426,1,808,1,13,6,6,7,single-choice,spatial-relational,6|7,7,6/7,210426,6
3,1,21,427,1,763,1,5,2,2,3,single-choice,spatial-relational,2|3,7,2/3,210427,2
3,1,21,428,1,554,1,9,4,4,5,single-choice,spatial-relational,4|5,7,4/5,210428,4
3,1,21,429,0,681,1,11,5,6,6,single-choice,spatial-relational,5|6,7,5/6,210429,5
3,1,21,430,0,710,1,11,5,6,6,single-choice,spatial-relational,5|6,7,5/6,210430,5
3,1,21,431,0,535,1,7,3,4,4,single-choice,spatial-relational,3|4,7,3/4,210431,3
3,1,21,432,1,509,1,9,4,4,5,single-choice,spatial-relational,4|5,7,4/5,210432,4
3,1,21,433,1,832,1,5,2,2,3,single-choice,spatial-relational,2|3,7,2/3,210433,2
3,1,21,434,1,564,1,9,4,4,5,single-choice,spatial-relational,4|5,7,4/5,210434,4
3,1,21,435,0,884,1,7,3,4,4,single-choice,spatial-relational,3|4,7,3/4,210435,3
3,1,21,436,0,807,1,9,4,5,5,single-choice,spatial-relational,4|5,7,4/5,210436,4
3,1,21,437,0,612,1,3,1,2,2,single-choice,spatial-relational,1|2,7,1/2,210437,1
3,1,21,438,1,499,1,5,2,2,3,single-choice,spatial-relational,2|3,7,2/3,210438,2
3,1,21,439,0,591,1,11,5,6,6,single-choice,spatial-relational,5|6,7,5/6,210439,5
3,1,21,440,0,518,1,11,5,6,6,single-choice,spatial-relational,5|6,7,5/6,210440,5
3,1,21,441,1,877,1,13,6,6,7,single-choice,spatial-relational,6|7,7,6/7,210441,6
3,1,21,442,1,961,1,13,6,6,7,single-choice,spatial-relational,6|7,7,6/7,210442,6
3,1,21,443,0,680,1,7,3,4,4,single-choice,spatial-relational,3|4,7,3/4,210443,3
3,1,21,444,0,748,1,3,1,2,2,single-choice,spatial-relational,1|2,7,1/2,210444,1
3,1,21,445,1,797,1,9,4,4,5,single-choice,spatial-relational,4|5,7,4/5,210445,4
3,1,21,446,1,1008,1,13,6,6,7,single-choice,spatial-relational,6|7,7,6/7,210446,6
3,1,21,447,0,681,1,11,5,6,6,single-choice,spatial-relational,5|6,7,5/6,210447,5
3,1,21,448,0,603,1,7,3,4,4,single-choice,spatial-relational,3|4,7,3/4,210448,3
3,1,21,449,0,588,1,3,1,2,2,single-choice,spatial-relational,1|2,7,1/2,210449,1
3,1,21,450,0,1714,1,11,5,6,6,single-choice,spatial-relational,5|6,7,5/6,210450,5
3,1,21,451,1,712,1,9,4,4,5,single-choice,spatial-relational,4|5,7,4/5,210451,4
3,1,21,452,0,946,1,7,3,4,4,single-choice,spatial-relational,3|4,7,3/4,210452,3
3,1,21,453,1,824,1,13,6,6,7,single-choice,spatial-relational,6|7,7,6/7,210453,6
3,1,21,454,0,1388,1,3,1,2,2,single-choice,spatial-relational,1|2,7,1/2,210454,1
3,1,21,455,1,75,1,5,2,2,3,single-choice,spatial-relational,2|3,7,2/3,210455,2
3,1,21,456,0,678,1,5,2,3,3,single-choice,spatial-relational,2|3,7,2/3,210456,2
3,1,21,457,1,792,1,9,4,4,5,single-choice,spatial-relational,4|5,7,4/5,210457,4
3,1,21,458,0,745,1,13,6,7,7,single-choice,spatial-relational,6|7,7,6/7,210458,6
3,1,21,459,1,678,1,5,2,2,3,single-choice,spatial-relational,2|3,7,2/3,210459,2
3,1,21,460,0,601,1,11,5,6,6,single-choice,spatial-relational,5|6,7,5/6,210460,5
3,1,21,461,1,855,1,9,4,4,5,single-choice,spatial-relational,4|5,7,4/5,210461,4
3,1,21,462,1,1272,1,5,2,2,3,single-choice,spatial-relational,2|3,7,2/3,210462,2
3,1,21,463,0,812,1,7,3,4,4,single-choice,spatial-relational,3|4,7,3/4,210463,3
3,1,21,464,0,753,1,3,1,2,2,single-choice,spatial-relational,1|2,7,1/2,210464,1
3,1,21,465,1,461,1,3,1,1,2,single-choice,spatial-relational,1|2,7,1/2,210465,1
3,1,21,466,0,558,1,7,3,4,4,single-choice,spatial-relational,3|4,7,3/4,210466,3
3,1,21,467,1,502,1,13,6,6,7,single-choice,spatial-relational,6|7,7,6/7,210467,6
3,1,21,468,0,778,1,11,5,6,6,single-choice,spatial-relational,5|6,7,5/6,210468,5
3,1,21,469,0,622,1,7,3,4,4,single-choice,spatial-relational,3|4,7,3/4,210469,3
3,1,21,470,1,651,1,13,6,6,7,single-choice,spatial-relational,6|7,7,6/7,210470,6
3,1,21,471,1,742,1,9,4,4,5,single-choice,spatial-relational,4|5,7,4/5,210471,4
3,1,21,472,1,807,1,3,1,1,2,single-choice,spatial-relational,1|2,7,1/2,210472,1
3,1,21,473,0,16097,1,3,1,2,2,single-choice,spatial-relational,1|2,7,1/2,210473,1
3,1,21,474,0,1188,1,7,3,4,4,single-choice,spatial-relational,3|4,7,3/4,210474,3
3,1,21,475,1,677,1,13,6,6,7,single-choice,spatial-relational,6|7,7,6/7,210475,6
3,1,21,476,1,774,1,5,2,2,3,single-choice,spatial-relational,2|3,7,2/3,210476,2
3,1,21,477,0,537,1,11,5,6,6,single-choice,spatial-relational,5|6,7,5/6,210477,5
3,1,21,478,1,586,1,5,2,2,3,single-choice,spatial-relational,2|3,7,2/3,210478,2
3,1,21,479,1,529,1,9,4,4,5,single-choice,spatial-relational,4|5,7,4/5,210479,4
3,1,21,480,0,667,1,11,5,6,6,single-choice,spatial-relational,5|6,7,5/6,210480,5
3,1,21,481,1,521,1,13,6,6,7,single-choice,spatial-relational,6|7,7,6/7,210481,6
3,1,21,482,1,730,1,9,4,4,5,single-choice,spatial-relational,4|5,7,4/5,210482,4
3,1,21,483,1,665,1,9,4,4,5,single-choice,spatial-relational,4|5,7,4/5,210483,4
3,1,21,484,0,931,1,3,1,2,2,single-choice,spatial-relational,1|2,7,1/2,210484,1
3,1,21,485,0,862,1,7,3,4,4,single-choice,spatial-relational,3|4,7,3/4,210485,3
3,1,21,486,1,541,1,5,2,2,3,single-choice,spatial-relational,2|3,7,2/3,210486,2
3,1,21,487,0,589,1,3,1,2,2,single-choice,spatial-relational,1|2,7,1/2,210487,1
3,1,21,488,0,556,1,11,5,6,6,single-choice,spatial-relational,5|6,7,5/6,210488,5
3,1,21,489,1,1571,1,5,2,2,3,single-choice,spatial-relational,2|3,7,2/3,210489,2
3,1,21,490,0,500,1,7,3,4,4,single-choice,spatial-relational,3|4,7,3/4,210490,3
3,1,21,491,1,587,1,13,6,6,7,single-choice,spatial-relational,6|7,7,6/7,210491,6
3,1,21,492,0,540,1,11,5,6,6,single-choice,spatial-relational,5|6,7,5/6,210492,5
3,1,21,493,0,488,1,7,3,4,4,single-choice,spatial-relational,3|4,7,3/4,210493,3
3,1,21,494,0,560,1,7,3,4,4,single-choice,spatial-relational,3|4,7,3/4,210494,3
3,1,21,495,1,631,1,13,6,6,7,single-choice,spatial-relational,6|7,7,6/7,210495,6
3,1,21,496,1,738,1,9,4,4,5,single-choice,spatial-relational,4|5,7,4/5,210496,4
3,1,21,497,0,610,1,11,5,6,6,single-choice,spatial-relational,5|6,7,5/6,210497,5
3,1,21,498,1,636,1,5,2,2,3,single-choice,spatial-relational,2|3,7,2/3,210498,2
3,1,21,499,1,740,1,5,2,2,3,single-choice,spatial-relational,2|3,7,2/3,210499,2
3,1,21,500,0,538,1,11,5,6,6,single-choice,spatial-relational,5|6,7,5/6,210500,5
3,1,21,501,1,739,1,13,6,6,7,single-choice,spatial-relational,6|7,7,6/7,210501,6
3,1,21,502,0,768,1,3,1,2,2,single-choice,spatial-relational,1|2,7,1/2,210502,1
3,1,21,503,1,827,1,9,4,4,5,single-choice,spatial-relational,4|5,7,4/5,210503,4
3,1,21,504,1,956,1,3,1,1,2,single-choice,spatial-relational,1|2,7,1/2,210504,1
3,1,21,505,0,577,1,3,1,2,2,single-choice,spatial-relational,1|2,7,1/2,210505,1
3,1,21,506,1,769,1,5,2,2,3,single-choice,spatial-relational,2|3,7,2/3,210506,2
3,1,21,507,0,718,1,3,1,2,2,single-choice,spatial-relational,1|2,7,1/2,210507,1
3,1,21,508,0,583,1,7,3,4,4,single-choice,spatial-relational,3|4,7,3/4,210508,3
3,1,21,509,0,584,1,7,3,4,4,single-choice,spatial-relational,3|4,7,3/4,210509,3
3,1,21,510,1,555,1,9,4,4,5,single-choice,spatial-relational,4|5,7,4/5,210510,4
3,1,21,511,0,658,1,11,5,6,6,single-choice,spatial-relational,5|6,7,5/6,210511,5
3,1,21,512,1,817,1,13,6,6,7,single-choice,spatial-relational,6|7,7,6/7,210512,6
3,1,21,513,1,901,1,13,6,6,7,single-choice,spatial-relational,6|7,7,6/7,210513,6
3,1,21,514,1,810,1,9,4,4,5,single-choice,spatial-relational,4|5,7,4/5,210514,4
3,1,21,515,1,655,1,5,2,2,3,single-choice,spatial-relational,2|3,7,2/3,210515,2
3,1,21,516,0,530,1,11,5,6,6,single-choice,spatial-relational,5|6,7,5/6,210516,5
3,1,21,517,0,552,1,11,5,6,6,single-choice,spatial-relational,5|6,7,5/6,210517,5
3,1,21,518,1,48,1,3,1,1,2,single-choice,spatial-relational,1|2,7,1/2,210518,1
3,1,21,519,0,731,1,3,1,2,2,single-choice,spatial-relational,1|2,7,1/2,210519,1
3,1,21,520,0,644,1,7,3,4,4,single-choice,spatial-relational,3|4,7,3/4,210520,3
3,1,21,521,1,660,1,9,4,4,5,single-choice,spatial-relational,4|5,7,4/5,210521,4
3,1,21,522,0,798,1,13,6,7,7,single-choice,spatial-relational,6|7,7,6/7,210522,6
3,1,21,523,1,657,1,5,2,2,3,single-choice,spatial-relational,2|3,7,2/3,210523,2
3,1,21,524,0,667,1,11,5,6,6,single-choice,spatial-relational,5|6,7,5/6,210524,5
3,1,21,525,1,714,1,5,2,2,3,single-choice,spatial-relational,2|3,7,2/3,210525,2
3,1,21,526,0,708,1,13,6,7,7,single-choice,spatial-relational,6|7,7,6/7,210526,6
3,1,21,527,0,857,1,7,3,4,4,single-choice,spatial-relational,3|4,7,3/4,210527,3
3,1,21,528,1,483,1,9,4,4,5,single-choice,spatial-relational,4|5,7,4/5,210528,4
3,1,21,529,0,998,1,7,3,4,4,single-choice,spatial-relational,3|4,7,3/4,210529,3
3,1,21,530,1,687,1,13,6,6,7,single-choice,spatial-relational,6|7,7,6/7,210530,6
3,1,21,531,0,806,1,11,5,6,6,single-choice,spatial-relational,5|6,7,5/6,210531,5
3,1,21,532,0,563,1,7,3,4,4,single-choice,spatial-relational,3|4,7,3/4,210532,3
3,1,21,533,1,553,1,5,2,2,3,single-choice,spatial-relational,2|3,7,2/3,210533,2
3,1,21,534,0,636,1,3,1,2,2,single-choice,spatial-relational,1|2,7,1/2,210534,1
3,1,21,535,1,665,1,9,4,4,5,single-choice,spatial-relational,4|5,7,4/5,210535,4
3,1,21,536,0,743,1,11,5,6,6,single-choice,spatial-relational,5|6,7,5/6,210536,5
3,1,21,537,0,707,1,3,1,2,2,single-choice,spatial-relational,1|2,7,1/2,210537,1
3,1,21,538,1,668,1,5,2,2,3,single-choice,spatial-relational,2|3,7,2/3,210538,2
3,1,21,539,1,597,1,9,4,4,5,single-choice,spatial-relational,4|5,7,4/5,210539,4
3,1,21,540,0,900,1,13,6,7,7,single-choice,spatial-relational,6|7,7,6/7,210540,6
3,1,21,541,1,729,1,5,2,2,3,single-choice,spatial-relational,2|3,7,2/3,210541,2
3,1,21,542,1,601,1,9,4,4,5,single-choice,spatial-relational,4|5,7,4/5,210542,4
3,1,21,543,1,729,1,13,6,6,7,single-choice,spatial-relational,6|7,7,6/7,210543,6
3,1,21,544,0,652,1,11,5,6,6,single-choice,spatial-relational,5|6,7,5/6,210544,5
3,1,21,545,0,586,1,11,5,6,6,single-choice,spatial-relational,5|6,7,5/6,210545,5
3,1,21,546,1,742,1,13,6,6,7,single-choice,spatial-relational,6|7,7,6/7,210546,6
3,1,21,547,1,790,1,5,2,2,3,single-choice,spatial-relational,2|3,7,2/3,210547,2
3,1,21,548,0,653,1,3,1,2,2,single-choice,spatial-relational,1|2,7,1/2,210548,1
3,1,21,549,0,734,1,3,1,2,2,single-choice,spatial-relational,1|2,7,1/2,210549,1
3,1,21,550,0,574,1,7,3,4,4,single-choice,spatial-relational,3|4,7,3/4,210550,3
3,1,21,551,1,642,1,9,4,4,5,single-choice,spatial-relational,4|5,7,4/5,210551,4
3,1,21,552,0,806,1,7,3,4,4,single-choice,spatial-relational,3|4,7,3/4,210552,3
3,1,21,553,0,705,1,3,1,2,2,single-choice,spatial-relational,1|2,7,1/2,210553,1
3,1,21,554,0,813,1,7,3,4,4,single-choice,spatial-relational,3|4,7,3/4,210554,3
3,1,21,555,1,796,1,13,6,6,7,single-choice,spatial-relational,6|7,7,6/7,210555,6
3,1,21,556,1,748,1,9,4,4,5,single-choice,spatial-relational,4|5,7,4/5,210556,4
3,1,21,557,0,701,1,11,5,6,6,single-choice,spatial-relational,5|6,7,5/6,210557,5
3,1,21,558,0,690,1,3,1,2,2,single-choice,spatial-relational,1|2,7,1/2,210558,1
3,1,21,559,1,646,1,9,4,4,5,single-choice,spatial-relational,4|5,7,4/5,210559,4
3,1,21,560,1,963,1,13,6,6,7,single-choice,spatial-relational,6|7,7,6/7,210560,6
3,1,21,561,0,756,1,11,5,6,6,single-choice,spatial-relational,5|6,7,5/6,210561,5
3,1,21,562,1,438,1,5,2,2,3,single-choice,spatial-relational,2|3,7,2/3,210562,2
3,1,21,563,1,625,1,5,2,2,3,single-choice,spatial-relational,2|3,7,2/3,210563,2
3,1,21,564,0,543,1,7,3,4,4,single-choice,spatial-relational,3|4,7,3/4,210564,3
3,1,21,565,0,705,1,11,5,6,6,single-choice,spatial-relational,5|6,7,5/6,210565,5
3,1,21,566,0,643,1,3,1,2,2,single-choice,spatial-relational,1|2,7,1/2,210566,1
3,1,21,567,0,715,1,3,1,2,2,single-choice,spatial-relational,1|2,7,1/2,210567,1
3,1,21,568,1,501,1,9,4,4,5,single-choice,spatial-relational,4|5,7,4/5,210568,4
3,1,21,569,0,676,1,7,3,4,4,single-choice,spatial-relational,3|4,7,3/4,210569,3
3,1,21,570,0,572,1,7,3,4,4,single-choice,spatial-relational,3|4,7,3/4,210570,3
3,1,21,571,1,746,1,5,2,2,3,single-choice,spatial-relational,2|3,7,2/3,210571,2
3,1,21,572,0,539,1,11,5,6,6,single-choice,spatial-relational,5|6,7,5/6,210572,5
3,1,21,573,1,799,1,13,6,6,7,single-choice,spatial-relational,6|7,7,6/7,210573,6
3,1,21,574,1,853,1,5,2,2,3,single-choice,spatial-relational,2|3,7,2/3,210574,2
3,1,21,575,1,569,1,9,4,4,5,single-choice,spatial-relational,4|5,7,4/5,210575,4
3,1,21,576,1,890,1,13,6,6,7,single-choice,spatial-relational,6|7,7,6/7,210576,6
3,1,21,577,1,765,1,9,4,4,5,single-choice,spatial-relational,4|5,7,4/5,210577,4
3,1,21,578,1,642,1,9,4,4,5,single-choice,spatial-relational,4|5,7,4/5,210578,4
3,1,21,579,0,801,1,5,2,3,3,single-choice,spatial-relational,2|3,7,2/3,210579,2
3,1,21,580,1,459,1,13,6,6,7,single-choice,spatial-relational,6|7,7,6/7,210580,6
3,1,21,581,0,877,1,11,5,6,6,single-choice,spatial-relational,5|6,7,5/6,210581,5
3,1,21,582,1,694,1,5,2,2,3,single-choice,spatial-relational,2|3,7,2/3,210582,2
3,1,21,583,0,620,1,11,5,6,6,single-choice,spatial-relational,5|6,7,5/6,210583,5
3,1,21,584,0,632,1,3,1,2,2,single-choice,spatial-relational,1|2,7,1/2,210584,1
3,1,21,585,0,622,1,7,3,4,4,single-choice,spatial-relational,3|4,7,3/4,210585,3
3,1,21,586,0,1385,1,3,1,2,2,single-choice,spatial-relational,1|2,7,1/2,210586,1
3,1,21,587,1,1023,1,13,6,6,7,single-choice,spatial-relational,6|7,7,6/7,210587,6
3,1,21,588,0,742,1,7,3,4,4,single-choice,spatial-relational,3|4,7,3/4,210588,3
3,1,21,589,1,1342,1,5,2,2,3,single-choice,spatial-relational,2|3,7,2/3,210589,2
3,1,21,590,0,698,1,7,3,4,4,single-choice,spatial-relational,3|4,7,3/4,210590,3
3,1,21,591,0,503,1,7,3,4,4,single-choice,spatial-relational,3|4,7,3/4,210591,3
3,1,21,592,1,759,1,13,6,6,7,single-choice,spatial-relational,6|7,7,6/7,210592,6
3,1,21,593,1,699,1,9,4,4,5,single-choice,spatial-relational,4|5,7,4/5,210593,4
3,1,21,594,0,10975,1,3,1,2,2,single-choice,spatial-relational,1|2,7,1/2,210594,1
3,1,21,595,0,1664,1,9,4,5,5,single-choice,spatial-relational,4|5,7,4/5,210595,4
3,1,21,596,1,568,1,5,2,2,3,single-choice,spatial-relational,2|3,7,2/3,210596,2
3,1,21,597,0,2602,1,13,6,7,7,single-choice,spatial-relational,6|7,7,6/7,210597,6
3,1,21,598,0,627,1,3,1,2,2,single-choice,spatial-relational,1|2,7,1/2,210598,1
3,1,21,599,0,1446,1,11,5,6,6,single-choice,spatial-relational,5|6,7,5/6,210599,5
3,1,21,600,0,620,1,11,5,6,6,single-choice,spatial-relational,5|6,7,5/6,210600,5
4,1,21,1,0,710,1,7,3,4,4,single-choice,spatial-relational,3|4,7,3/4,210001,3
4,1,21,2,1,1438,1,3,1,1,2,single-choice,spatial-relational,1|2,7,1/2,210002,1
4,1,21,3,1,6,1,9,4,4,5,single-choice,spatial-relational,4|5,7,4/5,210003,4
4,1,21,4,1,557,1,9,4,4,5,single-choice,spatial-relational,4|5,7,4/5,210004,4
4,1,21,5,0,503,1,11,5,6,6,single-choice,spatial-relational,5|6,7,5/6,210005,5
4,1,21,6,0,612,1,7,3,4,4,single-choice,spatial-relational,3|4,7,3/4,210006,3
4,1,21,7,0,601,1,5,2,3,3,single-choice,spatial-relational,2|3,7,2/3,210007,2
4,1,21,8,1,641,1,13,6,6,7,single-choice,spatial-relational,6|7,7,6/7,210008,6
4,1,21,9,0,588,1,5,2,3,3,single-choice,spatial-relational,2|3,7,2/3,210009,2
4,1,21,10,0,17,1,13,6,7,7,single-choice,spatial-relational,6|7,7,6/7,210010,6
4,1,21,11,1,699,1,3,1,1,2,single-choice,spatial-relational,1|2,7,1/2,210011,1
4,1,21,12,0,16,1,11,5,6,6,single-choice,spatial-relational,5|6,7,5/6,210012,5
4,1,21,13,1,592,1,9,4,4,5,single-choice,spatial-relational,4|5,7,4/5,210013,4
4,1,21,14,0,16,1,9,4,5,5,single-choice,spatial-relational,4|5,7,4/5,210014,4
4,1,21,15,1,11,1,5,2,2,3,single-choice,spatial-relational,2|3,7,2/3,210015,2
4,1,21,16,0,523,1,11,5,6,6,single-choice,spatial-relational,5|6,7,5/6,210016,5
4,1,21,17,0,569,1,11,5,6,6,single-choice,spatial-relational,5|6,7,5/6,210017,5
4,1,21,18,1,816,1,13,6,6,7,single-choice,spatial-relational,6|7,7,6/7,210018,6
4,1,21,19,0,611,1,5,2,3,3,single-choice,spatial-relational,2|3,7,2/3,210019,2
4,1,21,20,0,788,1,7,3,4,4,single-choice,spatial-relational,3|4,7,3/4,210020,3
4,1,21,21,1,697,1,3,1,1,2,single-choice,spatial-relational,1|2,7,1/2,210021,1
4,1,21,22,1,728,1,3,1,1,2,single-choice,spatial-relational,1|2,7,1/2,210022,1
4,1,21,23,0,673,1,7,3,4,4,single-choice,spatial-relational,3|4,7,3/4,210023,3
4,1,21,24,0,700,1,13,6,7,7,single-choice,spatial-relational,6|7,7,6/7,210024,6
4,1,21,25,0,739,1,3,1,2,2,single-choice,spatial-relational,1|2,7,1/2,210025,1
4,1,21,26,0,744,1,11,5,6,6,single-choice,spatial-relational,5|6,7,5/6,210026,5
4,1,21,27,0,844,1,3,1,2,2,single-choice,spatial-relational,1|2,7,1/2,210027,1
4,1,21,28,1,1055,1,13,6,6,7,single-choice,spatial-relational,6|7,7,6/7,210028,6
4,1,21,29,0,790,1,11,5,6,6,single-choice,spatial-relational,5|6,7,5/6,210029,5
4,1,21,30,0,744,1,5,2,3,3,single-choice,spatial-relational,2|3,7,2/3,210030,2
4,1,21,31,0,639,1,7,3,4,4,single-choice,spatial-relational,3|4,7,3/4,210031,3
4,1,21,32,1,688,1,9,4,4,5,single-choice,spatial-relational,4|5,7,4/5,210032,4
4,1,21,33,1,847,1,5,2,2,3,single-choice,spatial-relational,2|3,7,2/3,210033,2
4,1,21,34,1,624,1,9,4,4,5,single-choice,spatial-relational,4|5,7,4/5,210034,4
4,1,21,35,1,973,1,13,6,6,7,single-choice,spatial-relational,6|7,7,6/7,210035,6
4,1,21,36,0,779,1,7,3,4,4,single-choice,spatial-relational,3|4,7,3/4,210036,3
4,1,21,37,1,641,1,9,4,4,5,single-choice,spatial-relational,4|5,7,4/5,210037,4
4,1,21,38,0,791,1,11,5,6,6,single-choice,spatial-relational,5|6,7,5/6,210038,5
4,1,21,39,1,638,1,13,6,6,7,single-choice,spatial-relational,6|7,7,6/7,210039,6
4,1,21,40,0,823,1,5,2,3,3,single-choice,spatial-relational,2|3,7,2/3,210040,2
4,1,21,41,0,734,1,3,1,2,2,single-choice,spatial-relational,1|2,7,1/2,210041,1
4,1,21,42,0,558,1,11,5,6,6,single-choice,spatial-relational,5|6,7,5/6,210042,5
4,1,21,43,1,671,1,13,6,6,7,single-choice,spatial-relational,6|7,7,6/7,210043,6
4,1,21,44,0,739,1,7,3,4,4,single-choice,spatial-relational,3|4,7,3/4,210044,3
4,1,21,45,0,788,1,3,1,2,2,single-choice,spatial-relational,1|2,7,1/2,210045,1
4,1,21,46,1,738,1,5,2,2,3,single-choice,spatial-relational,2|3,7,2/3,210046,2
4,1,21,47,1,526,1,9,4,4,5,single-choice,spatial-relational,4|5,7,4/5,210047,4
4,1,21,48,0,830,1,7,3,4,4,single-choice,spatial-relational,3|4,7,3/4,210048,3
4,1,21,49,1,803,1,5,2,2,3,single-choice,spatial-relational,2|3,7,2/3,210049,2
4,1,21,50,1,666,1,9,4,4,5,single-choice,spatial-relational,4|5,7,4/5,210050,4
4,1,21,51,1,676,1,11,5,5,6,single-choice,spatial-relational,5|6,7,5/6,210051,5
4,1,21,52,1,739,1,13,6,6,7,single-choice,spatial-relational,6|7,7,6/7,210052,6
4,1,21,53,1,658,1,9,4,4,5,single-choice,spatial-relational,4|5,7,4/5,210053,4
4,1,21,54,0,595,1,7,3,4,4,single-choice,spatial-relational,3|4,7,3/4,210054,3
4,1,21,55,1,665,1,13,6,6,7,single-choice,spatial-relational,6|7,7,6/7,210055,6
4,1,21,56,0,664,1,11,5,6,6,single-choice,spatial-relational,5|6,7,5/6,210056,5
4,1,21,57,0,793,1,3,1,2,2,single-choice,spatial-relational,1|2,7,1/2,210057,1
4,1,21,58,0,745,1,3,1,2,2,single-choice,spatial-relational,1|2,7,1/2,210058,1
4,1,21,59,0,657,1,7,3,4,4,single-choice,spatial-relational,3|4,7,3/4,210059,3
4,1,21,60,1,608,1,5,2,2,3,single-choice,spatial-relational,2|3,7,2/3,210060,2
4,1,21,61,1,520,1,9,4,4,5,single-choice,spatial-relational,4|5,7,4/5,210061,4
4,1,21,62,0,672,1,11,5,6,6,single-choice,spatial-relational,5|6,7,5/6,210062,5
4,1,21,63,0,759,1,3,1,2,2,single-choice,spatial-relational,1|2,7,1/2,210063,1
4,1,21,64,1,709,1,13,6,6,7,single-choice,spatial-relational,6|7,7,6/7,210064,6
4,1,21,65,0,648,1,7,3,4,4,single-choice,spatial-relational,3|4,7,3/4,210065,3
4,1,21,66,0,591,1,7,3,4,4,single-choice,spatial-relational,3|4,7,3/4,210066,3
4,1,21,67,1,739,1,13,6,6,7,single-choice,spatial-relational,6|7,7,6/7,210067,6
4,1,21,68,0,886,1,5,2,3,3,single-choice,spatial-relational,2|3,7,2/3,210068,2
4,1,21,69,0,723,1,11,5,6,6,single-choice,spatial-relational,5|6,7,5/6,210069,5
4,1,21,70,0,823,1,3,1,2,2,single-choice,spatial-relational,1|2,7,1/2,210070,1
4,1,21,71,1,609,1,9,4,4,5,single-choice,spatial-relational,4|5,7,4/5,210071,4
4,1,21,72,0,761,1,5,2,3,3,single-choice,spatial-relational,2|3,7,2/3,210072,2
4,1,21,73,1,760,1,13,6,6,7,single-choice,spatial-relational,6|7,7,6/7,210073,6
4,1,21,74,1,1296,1,3,1,1,2,single-choice,spatial-relational,1|2,7,1/2,210074,1
4,1,21,75,0,690,1,13,6,7,7,single-choice,spatial-relational,6|7,7,6/7,210075,6
4,1,21,76,0,788,1,9,4,5,5,single-choice,spatial-relational,4|5,7,4/5,210076,4
4,1,21,77,1,823,1,7,3,3,4,single-choice,spatial-relational,3|4,7,3/4,210077,3
4,1,21,78,1,944,1,11,5,5,6,single-choice,spatial-relational,5|6,7,5/6,210078,5
4,1,21,79,0,892,1,5,2,3,3,single-choice,spatial-relational,2|3,7,2/3,210079,2
4,1,21,80,0,860,1,11,5,6,6,single-choice,spatial-relational,5|6,7,5/6,210080,5
4,1,21,81,1,654,1,5,2,2,3,single-choice,spatial-relational,2|3,7,2/3,210081,2
4,1,21,82,1,694,1,9,4,4,5,single-choice,spatial-relational,4|5,7,4/5,210082,4
4,1,21,83,0,1081,1,7,3,4,4,single-choice,spatial-relational,3|4,7,3/4,210083,3
4,1,21,84,0,743,1,3,1,2,2,single-choice,spatial-relational,1|2,7,1/2,210084,1
4,1,21,85,1,882,1,13,6,6,7,single-choice,spatial-relational,6|7,7,6/7,210085,6
4,1,21,86,1,767,1,3,1,1,2,single-choice,spatial-relational,1|2,7,1/2,210086,1
4,1,21,87,0,581,1,11,5,6,6,single-choice,spatial-relational,5|6,7,5/6,210087,5
4,1,21,88,1,826,1,13,6,6,7,single-choice,spatial-relational,6|7,7,6/7,210088,6
4,1,21,89,1,705,1,5,2,2,3,single-choice,spatial-relational,2|3,7,2/3,210089,2
4,1,21,90,1,722,1,3,1,1,2,single-choice,spatial-relational,1|2,7,1/2,210090,1
4,1,21,91,0,511,1,11,5,6,6,single-choice,spatial-relational,5|6,7,5/6,210091,5
4,1,21,92,0,723,1,9,4,5,5,single-choice,spatial-relational,4|5,7,4/5,210092,4
4,1,21,93,0,595,1,7,3,4,4,single-choice,spatial-relational,3|4,7,3/4,210093,3
4,1,21,94,1,595,1,9,4,4,5,single-choice,spatial-relational,4|5,7,4/5,210094,4
4,1,21,95,0,685,1,5,2,3,3,single-choice,spatial-relational,2|3,7,2/3,210095,2
4,1,21,96,1,777,1,7,3,3,4,single-choice,spatial-relational,3|4,7,3/4,210096,3
4,1,21,97,1,740,1,9,4,4,5,single-choice,spatial-relational,4|5,7,4/5,210097,4
4,1,21,98,0,537,1,7,3,4,4,single-choice,spatial-relational,3|4,7,3/4,210098,3
4,1,21,99,0,800,1,5,2,3,3,single-choice,spatial-relational,2|3,7,2/3,210099,2
4,1,21,100,0,651,1,7,3,4,4,single-choice,spatial-relational,3|4,7,3/4,210100,3
4,1,21,101,1,691,1,5,2,2,3,single-choice,spatial-relational,2|3,7,2/3,210101,2
4,1,21,102,0,667,1,11,5,6,6,single-choice,spatial-relational,5|6,7,5/6,210102,5
4,1,21,103,0,744,1,9,4,5,5,single-choice,spatial-relational,4|5,7,4/5,210103,4
4,1,21,104,0,738,1,3,1,2,2,single-choice,spatial-relational,1|2,7,1/2,210104,1
4,1,21,105,1,791,1,13,6,6,7,single-choice,spatial-relational,6|7,7,6/7,210105,6
4,1,21,106,0,1006,1,11,5,6,6,single-choice,spatial-relational,5|6,7,5/6,210106,5
4,1,21,107,0,745,1,3,1,2,2,single-choice,spatial-relational,1|2,7,1/2,210107,1
4,1,21,108,1,697,1,13,6,6,7,single-choice,spatial-relational,6|7,7,6/7,210108,6
4,1,21,109,0,781,1,3,1,2,2,single-choice,spatial-relational,1|2,7,1/2,210109,1
4,1,21,110,0,800,1,3,1,2,2,single-choice,spatial-relational,1|2,7,1/2,210110,1
4,1,21,111,1,737,1,9,4,4,5,single-choice,spatial-relational,4|5,7,4/5,210111,4
4,1,21,112,0,730,1,13,6,7,7,single-choice,spatial-relational,6|7,7,6/7,210112,6
4,1,21,113,0,829,1,11,5,6,6,single-choice,spatial-relational,5|6,7,5/6,210113,5
4,1,21,114,1,804,1,5,2,2,3,single-choice,spatial-relational,2|3,7,2/3,210114,2
4,1,21,115,0,609,1,7,3,4,4,single-choice,spatial-relational,3|4,7,3/4,210115,3
4,1,21,116,1,879,1,7,3,3,4,single-choice,spatial-relational,3|4,7,3/4,210116,3
4,1,21,117,0,810,1,5,2,3,3,single-choice,spatial-relational,2|3,7,2/3,210117,2
4,1,21,118,1,1036,1,9,4,4,5,single-choice,spatial-relational,4|5,7,4/5,210118,4
4,1,21,119,1,1042,1,11,5,5,6,single-choice,spatial-relational,5|6,7,5/6,210119,5
4,1,21,120,0,894,1,13,6,7,7,single-choice,spatial-relational,6|7,7,6/7,210120,6
4,1,21,121,0,984,1,11,5,6,6,single-choice,spatial-relational,5|6,7,5/6,210121,5
4,1,21,122,1,955,1,13,6,6,7,single-choice,spatial-relational,6|7,7,6/7,210122,6
4,1,21,123,0,773,1,7,3,4,4,single-choice,spatial-relational,3|4,7,3/4,210123,3
4,1,21,124,1,1040,1,7,3,3,4,single-choice,spatial-relational,3|4,7,3/4,210124,3
4,1,21,125,1,775,1,5,2,2,3,single-choice,spatial-relational,2|3,7,2/3,210125,2
4,1,21,126,1,1042,1,9,4,4,5,single-choice,spatial-relational,4|5,7,4/5,210126,4
4,1,21,127,1,881,1,3,1,1,2,single-choice,spatial-relational,1|2,7,1/2,210127,1
4,1,21,128,1,1038,1,13,6,6,7,single-choice,spatial-relational,6|7,7,6/7,210128,6
4,1,21,129,0,711,1,3,1,2,2,single-choice,spatial-relational,1|2,7,1/2,210129,1
4,1,21,130,0,785,1,5,2,3,3,single-choice,spatial-relational,2|3,7,2/3,210130,2
4,1,21,131,1,911,1,9,4,4,5,single-choice,spatial-relational,4|5,7,4/5,210131,4
4,1,21,132,0,837,1,11,5,6,6,single-choice,spatial-relational,5|6,7,5/6,210132,5
4,1,21,133,1,866,1,5,2,2,3,single-choice,spatial-relational,2|3,7,2/3,210133,2
4,1,21,134,1,735,1,11,5,5,6,single-choice,spatial-relational,5|6,7,5/6,210134,5
4,1,21,135,1,1035,1,9,4,4,5,single-choice,spatial-relational,4|5,7,4/5,210135,4
4,1,21,136,1,653,1,9,4,4,5,single-choice,spatial-relational,4|5,7,4/5,210136,4
4,1,21,137,0,698,1,7,3,4,4,single-choice,spatial-relational,3|4,7,3/4,210137,3
4,1,21,138,0,793,1,3,1,2,2,single-choice,spatial-relational,1|2,7,1/2,210138,1
4,1,21,139,1,870,1,7,3,3,4,single-choice,spatial-relational,3|4,7,3/4,210139,3
4,1,21,140,1,1067,1,5,2,2,3,single-choice,spatial-relational,2|3,7,2/3,210140,2
4,1,21,141,0,604,1,11,5,6,6,single-choice,spatial-relational,5|6,7,5/6,210141,5
4,1,21,142,1,1062,1,13,6,6,7,single-choice,spatial-relational,6|7,7,6/7,210142,6
4,1,21,143,0,938,1,13,6,7,7,single-choice,spatial-relational,6|7,7,6/7,210143,6
4,1,21,144,0,785,1,3,1,2,2,single-choice,spatial-relational,1|2,7,1/2,210144,1
4,1,21,145,1,814,1,13,6,6,7,single-choice,spatial-relational,6|7,7,6/7,210145,6
4,1,21,146,1,1052,1,9,4,4,5,single-choice,spatial-relational,4|5,7,4/5,210146,4
4,1,21,147,0,957,1,7,3,4,4,single-choice,spatial-relational,3|4,7,3/4,210147,3
4,1,21,148,1,782,1,5,2,2,3,single-choice,spatial-relational,2|3,7,2/3,210148,2
4,1,21,149,1,634,1,9,4,4,5,single-choice,spatial-relational,4|5,7,4/5,210149,4
4,1,21,150,1,951,1,13,6,6,7,single-choice,spatial-relational,6|7,7,6/7,210150,6
4,1,21,151,1,733,1,3,1,1,2,single-choice,spatial-relational,1|2,7,1/2,210151,1
4,1,21,152,0,820,1,11,5,6,6,single-choice,spatial-relational,5|6,7,5/6,210152,5
4,1,21,153,0,733,1,7,3,4,4,single-choice,spatial-relational,3|4,7,3/4,210153,3
4,1,21,154,1,1019,1,5,2,2,3,single-choice,spatial-relational,2|3,7,2/3,210154,2
4,1,21,155,0,738,1,11,5,6,6,single-choice,spatial-relational,5|6,7,5/6,210155,5
4,1,21,156,0,817,1,3,1,2,2,single-choice,spatial-relational,1|2,7,1/2,210156,1
4,1,21,157,0,740,1,3,1,2,2,single-choice,spatial-relational,1|2,7,1/2,210157,1
4,1,21,158,0,932,1,13,6,7,7,single-choice,spatial-relational,6|7,7,6/7,210158,6
4,1,21,159,0,1172,1,11,5,6,6,single-choice,spatial-relational,5|6,7,5/6,210159,5
4,1,21,160,0,1019,1,7,3,4,4,single-choice,spatial-relational,3|4,7,3/4,210160,3
4,1,21,161,0,1041,1,9,4,5,5,single-choice,spatial-relational,4|5,7,4/5,210161,4
4,1,21,162,0,1008,1,3,1,2,2,single-choice,spatial-relational,1|2,7,1/2,210162,1
4,1,21,163,1,852,1,9,4,4,5,single-choice,spatial-relational,4|5,7,4/5,210163,4
4,1,21,164,1,843,1,11,5,5,6,single-choice,spatial-relational,5|6,7,5/6,210164,5
4,1,21,165,0,1005,1,5,2,3,3,single-choice,spatial-relational,2|3,7,2/3,210165,2
4,1,21,166,1,1120,1,13,6,6,7,single-choice,spatial-relational,6|7,7,6/7,210166,6
4,1,21,167,1,860,1,5,2,2,3,single-choice,spatial-relational,2|3,7,2/3,210167,2
4,1,21,168,0,588,1,7,3,4,4,single-choice,spatial-relational,3|4,7,3/4,210168,3
4,1,21,169,1,914,1,5,2,2,3,single-choice,spatial-relational,2|3,7,2/3,210169,2
4,1,21,170,0,690,1,7,3,4,4,single-choice,spatial-relational,3|4,7,3/4,210170,3
4,1,21,171,0,915,1,11,5,6,6,single-choice,spatial-relational,5|6,7,5/6,210171,5
4,1,21,172,1,817,1,13,6,6,7,single-choice,spatial-relational,6|7,7,6/7,210172,6
4,1,21,173,1,1058,1,9,4,4,5,single-choice,spatial-relational,4|5,7,4/5,210173,4
4,1,21,174,0,688,1,7,3,4,4,single-choice,spatial-relational,3|4,7,3/4,210174,3
4,1,21,175,1,790,1,3,1,1,2,single-choice,spatial-relational,1|2,7,1/2,210175,1
4,1,21,176,0,695,1,3,1,2,2,single-choice,spatial-relational,1|2,7,1/2,210176,1
4,1,21,177,0,877,1,11,5,6,6,single-choice,spatial-relational,5|6,7,5/6,210177,5
4,1,21,178,0,871,1,13,6,7,7,single-choice,spatial-relational,6|7,7,6/7,210178,6
4,1,21,179,1,1062,1,5,2,2,3,single-choice,spatial-relational,2|3,7,2/3,210179,2
4,1,21,180,1,686,1,9,4,4,5,single-choice,spatial-relational,4|5,7,4/5,210180,4
4,1,21,181,0,859,1,3,1,2,2,single-choice,spatial-relational,1|2,7,1/2,210181,1
4,1,21,182,1,858,1,13,6,6,7,single-choice,spatial-relational,6|7,7,6/7,210182,6
4,1,21,183,0,1638,1,11,5,6,6,single-choice,spatial-relational,5|6,7,5/6,210183,5
4,1,21,184,1,923,1,13,6,6,7,single-choice,spatial-relational,6|7,7,6/7,210184,6
4,1,21,185,1,1038,1,5,2,2,3,single-choice,spatial-relational,2|3,7,2/3,210185,2
4,1,21,186,1,726,1,9,4,4,5,single-choice,spatial-relational,4|5,7,4/5,210186,4
4,1,21,187,1,1077,1,11,5,5,6,single-choice,spatial-relational,5|6,7,5/6,210187,5
4,1,21,188,0,988,1,5,2,3,3,single-choice,spatial-relational,2|3,7,2/3,210188,2
4,1,21,189,1,943,1,7,3,3,4,single-choice,spatial-relational,3|4,7,3/4,210189,3
4,1,21,190,0,1324,1,3,1,2,2,single-choice,spatial-relational,1|2,7,1/2,210190,1
4,1,21,191,1,1110,1,7,3,3,4,single-choice,spatial-relational,3|4,7,3/4,210191,3
4,1,21,192,1,726,1,9,4,4,5,single-choice,spatial-relational,4|5,7,4/5,210192,4
4,1,21,193,0,777,1,3,1,2,2,single-choice,spatial-relational,1|2,7,1/2,210193,1
4,1,21,194,1,847,1,7,3,3,4,single-choice,spatial-relational,3|4,7,3/4,210194,3
4,1,21,195,0,793,1,5,2,3,3,single-choice,spatial-relational,2|3,7,2/3,210195,2
4,1,21,196,1,984,1,11,5,5,6,single-choice,spatial-relational,5|6,7,5/6,210196,5
4,1,21,197,0,855,1,13,6,7,7,single-choice,spatial-relational,6|7,7,6/7,210197,6
4,1,21,198,1,1035,1,11,5,5,6,single-choice,spatial-relational,5|6,7,5/6,210198,5
4,1,21,199,0,1201,1,3,1,2,2,single-choice,spatial-relational,1|2,7,1/2,210199,1
4,1,21,200,1,987,1,5,2,2,3,single-choice,spatial-relational,2|3,7,2/3,210200,2
4,1,21,201,0,664,1,7,3,4,4,single-choice,spatial-relational,3|4,7,3/4,210201,3
4,1,21,202,1,931,1,9,4,4,5,single-choice,spatial-relational,4|5,7,4/5,210202,4
4,1,21,203,0,1312,1,9,4,5,5,single-choice,spatial-relational,4|5,7,4/5,210203,4
4,1,21,204,1,1006,1,13,6,6,7,single-choice,spatial-relational,6|7,7,6/7,210204,6
4,1,21,205,1,1008,1,11,5,5,6,single-choice,spatial-relational,5|6,7,5/6,210205,5
4,1,21,206,0,706,1,7,3,4,4,single-choice,spatial-relational,3|4,7,3/4,210206,3
4,1,21,207,0,902,1,5,2,3,3,single-choice,spatial-relational,2|3,7,2/3,210207,2
4,1,21,208,1,867,1,13,6,6,7,single-choice,spatial-relational,6|7,7,6/7,210208,6
4,1,21,209,0,996,1,13,6,7,7,single-choice,spatial-relational,6|7,7,6/7,210209,6
4,1,21,210,0,1038,1,3,1,2,2,single-choice,spatial-relational,1|2,7,1/2,210210,1
4,1,21,211,0,640,1,3,1,2,2,single-choice,spatial-relational,1|2,7,1/2,210211,1
4,1,21,212,0,783,1,11,5,6,6,single-choice,spatial-relational,5|6,7,5/6,210212,5
4,1,21,213,1,917,1,9,4,4,5,single-choice,spatial-relational,4|5,7,4/5,210213,4
4,1,21,214,1,849,1,5,2,2,3,single-choice,spatial-relational,2|3,7,2/3,210214,2
4,1,21,215,1,668,1,7,3,3,4,single-choice,spatial-relational,3|4,7,3/4,210215,3
4,1,21,216,0,788,1,9,4,5,5,single-choice,spatial-relational,4|5,7,4/5,210216,4
4,1,21,217,1,1046,1,9,4,4,5,single-choice,spatial-relational,4|5,7,4/5,210217,4
4,1,21,218,0,840,1,13,6,7,7,single-choice,spatial-relational,6|7,7,6/7,210218,6
4,1,21,219,0,830,1,5,2,3,3,single-choice,spatial-relational,2|3,7,2/3,210219,2
4,1,21,220,1,699,1,9,4,4,5,single-choice,spatial-relational,4|5,7,4/5,210220,4
4,1,21,221,0,809,1,7,3,4,4,single-choice,spatial-relational,3|4,7,3/4,210221,3
4,1,21,222,0,1296,1,11,5,6,6,single-choice,spatial-relational,5|6,7,5/6,210222,5
4,1,21,223,0,762,1,3,1,2,2,single-choice,spatial-relational,1|2,7,1/2,210223,1
4,1,21,224,0,828,1,3,1,2,2,single-choice,spatial-relational,1|2,7,1/2,210224,1
4,1,21,225,1,872,1,13,6,6,7,single-choice,spatial-relational,6|7,7,6/7,210225,6
4,1,21,226,1,876,1,5,2,2,3,single-choice,spatial-relational,2|3,7,2/3,210226,2
4,1,21,227,0,576,1,7,3,4,4,single-choice,spatial-relational,3|4,7,3/4,210227,3
4,1,21,228,1,1447,1,11,5,5,6,single-choice,spatial-relational,5|6,7,5/6,210228,5
4,1,21,229,0,713,1,3,1,2,2,single-choice,spatial-relational,1|2,7,1/2,210229,1
4,1,21,230,1,964,1,7,3,3,4,single-choice,spatial-relational,3|4,7,3/4,210230,3
4,1,21,231,1,754,1,3,1,1,2,single-choice,spatial-relational,1|2,7,1/2,210231,1
4,1,21,232,1,624,1,13,6,6,7,single-choice,spatial-relational,6|7,7,6/7,210232,6
4,1,21,233,1,736,1,5,2,2,3,single-choice,spatial-relational,2|3,7,2/3,210233,2
4,1,21,234,0,553,1,7,3,4,4,single-choice,spatial-relational,3|4,7,3/4,210234,3
4,1,21,235,1,1027,1,9,4,4,5,single-choice,spatial-relational,4|5,7,4/5,210235,4
4,1,21,236,0,856,1,11,5,6,6,single-choice,spatial-relational,5|6,7,5/6,210236,5
4,1,21,237,0,790,1,5,2,3,3,single-choice,spatial-relational,2|3,7,2/3,210237,2
4,1,21,238,1,945,1,13,6,6,7,single-choice,spatial-relational,6|7,7,6/7,210238,6
4,1,21,239,0,1248,1,11,5,6,6,single-choice,spatial-relational,5|6,7,5/6,210239,5
4,1,21,240,1,887,1,9,4,4,5,single-choice,spatial-relational,4|5,7,4/5,210240,4
4,1,21,241,0,971,1,11,5,6,6,single-choice,spatial-relational,5|6,7,5/6,210241,5
4,1,21,242,0,1001,1,11,5,6,6,single-choice,spatial-relational,5|6,7,5/6,210242,5
4,1,21,243,0,940,1,3,1,2,2,single-choice,spatial-relational,1|2,7,1/2,210243,1
4,1,21,244,1,929,1,9,4,4,5,single-choice,spatial-relational,4|5,7,4/5,210244,4
4,1,21,245,0,820,1,5,2,3,3,single-choice,spatial-relational,2|3,7,2/3,210245,2
4,1,21,246,1,944,1,13,6,6,7,single-choice,spatial-relational,6|7,7,6/7,210246,6
4,1,21,247,1,915,1,13,6,6,7,single-choice,spatial-relational,6|7,7,6/7,210247,6
4,1,21,248,0,837,1,9,4,5,5,single-choice,spatial-relational,4|5,7,4/5,210248,4
4,1,21,249,0,1173,1,3,1,2,2,single-choice,spatial-relational,1|2,7,1/2,210249,1
4,1,21,250,1,860,1,5,2,2,3,single-choice,spatial-relational,2|3,7,2/3,210250,2
4,1,21,251,0,579,1,7,3,4,4,single-choice,spatial-relational,3|4,7,3/4,210251,3
4,1,21,252,1,1062,1,7,3,3,4,single-choice,spatial-relational,3|4,7,3/4,210252,3
4,1,21,253,0,728,1,5,2,3,3,single-choice,spatial-relational,2|3,7,2/3,210253,2
4,1,21,254,1,881,1,3,1,1,2,single-choice,spatial-relational,1|2,7,1/2,210254,1
4,1,21,255,1,797,1,9,4,4,5,single-choice,spatial-relational,4|5,7,4/5,210255,4
4,1,21,256,0,751,1,3,1,2,2,single-choice,spatial-relational,1|2,7,1/2,210256,1
4,1,21,257,1,1089,1,7,3,3,4,single-choice,spatial-relational,3|4,7,3/4,210257,3
4,1,21,258,1,1160,1,13,6,6,7,single-choice,spatial-relational,6|7,7,6/7,210258,6
4,1,21,259,0,1107,1,7,3,4,4,single-choice,spatial-relational,3|4,7,3/4,210259,3
4,1,21,260,1,815,1,13,6,6,7,single-choice,spatial-relational,6|7,7,6/7,210260,6
4,1,21,261,1,924,1,9,4,4,5,single-choice,spatial-relational,4|5,7,4/5,210261,4
4,1,21,262,1,822,1,5,2,2,3,single-choice,spatial-relational,2|3,7,2/3,210262,2
4,1,21,263,1,787,1,11,5,5,6,single-choice,spatial-relational,5|6,7,5/6,210263,5
4,1,21,264,0,890,1,11,5,6,6,single-choice,spatial-relational,5|6,7,5/6,210264,5
4,1,21,265,0,974,1,11,5,6,6,single-choice,spatial-relational,5|6,7,5/6,210265,5
4,1,21,266,1,1060,1,13,6,6,7,single-choice,spatial-relational,6|7,7,6/7,210266,6
4,1,21,267,0,757,1,7,3,4,4,single-choice,spatial-relational,3|4,7,3/4,210267,3
4,1,21,268,0,1517,1,5,2,3,3,single-choice,spatial-relational,2|3,7,2/3,210268,2
4,1,21,269,0,1142,1,11,5,6,6,single-choice,spatial-relational,5|6,7,5/6,210269,5
4,1,21,270,1,1014,1,7,3,3,4,single-choice,spatial-relational,3|4,7,3/4,210270,3
4,1,21,271,0,777,1,9,4,5,5,single-choice,spatial-relational,4|5,7,4/5,210271,4
4,1,21,272,1,1087,1,3,1,1,2,single-choice,spatial-relational,1|2,7,1/2,210272,1
4,1,21,273,0,775,1,3,1,2,2,single-choice,spatial-relational,1|2,7,1/2,210273,1
4,1,21,274,1,69,1,9,4,4,5,single-choice,spatial-relational,4|5,7,4/5,210274,4
4,1,21,275,0,895,1,13,6,7,7,single-choice,spatial-relational,6|7,7,6/7,210275,6
4,1,21,276,1,824,1,5,2,2,3,single-choice,spatial-relational,2|3,7,2/3,210276,2
4,1,21,277,1,716,1,11,5,5,6,single-choice,spatial-relational,5|6,7,5/6,210277,5
4,1,21,278,0,842,1,9,4,5,5,single-choice,spatial-relational,4|5,7,4/5,210278,4
4,1,21,279,1,968,1,11,5,5,6,single-choice,spatial-relational,5|6,7,5/6,210279,5
4,1,21,280,0,979,1,5,2,3,3,single-choice,spatial-relational,2|3,7,2/3,210280,2
4,1,21,281,1,1013,1,13,6,6,7,single-choice,spatial-relational,6|7,7,6/7,210281,6
4,1,21,282,0,896,1,7,3,4,4,single-choice,spatial-relational,3|4,7,3/4,210282,3
4,1,21,283,0,882,1,3,1,2,2,single-choice,spatial-relational,1|2,7,1/2,210283,1
4,1,21,284,1,858,1,9,4,4,5,single-choice,spatial-relational,4|5,7,4/5,210284,4
4,1,21,285,1,821,1,5,2,2,3,single-choice,spatial-relational,2|3,7,2/3,210285,2
4,1,21,286,1,929,1,3,1,1,2,single-choice,spatial-relational,1|2,7,1/2,210286,1
4,1,21,287,1,876,1,7,3,3,4,single-choice,spatial-relational,3|4,7,3/4,210287,3
4,1,21,288,1,867,1,13,6,6,7,single-choice,spatial-relational,6|7,7,6/7,210288,6
4,1,21,289,1,808,1,11,5,5,6,single-choice,spatial-relational,5|6,7,5/6,210289,5
4,1,21,290,1,837,1,13,6,6,7,single-choice,spatial-relational,6|7,7,6/7,210290,6
4,1,21,291,0,713,1,5,2,3,3,single-choice,spatial-relational,2|3,7,2/3,210291,2
4,1,21,292,1,837,1,7,3,3,4,single-choice,spatial-relational,3|4,7,3/4,210292,3
4,1,21,293,1,729,1,9,4,4,5,single-choice,spatial-relational,4|5,7,4/5,210293,4
4,1,21,294,0,1001,1,11,5,6,6,single-choice,spatial-relational,5|6,7,5/6,210294,5
4,1,21,295,1,1048,1,9,4,4,5,single-choice,spatial-relational,4|5,7,4/5,210295,4
4,1,21,296,0,804,1,13,6,7,7,single-choice,spatial-relational,6|7,7,6/7,210296,6
4,1,21,297,1,1139,1,5,2,2,3,single-choice,spatial-relational,2|3,7,2/3,210297,2
4,1,21,298,0,614,1,7,3,4,4,single-choice,spatial-relational,3|4,7,3/4,210298,3
4,1,21,299,1,976,1,3,1,1,2,single-choice,spatial-relational,1|2,7,1/2,210299,1
4,1,21,300,1,661,1,3,1,1,2,single-choice,spatial-relational,1|2,7,1/2,210300,1
4,1,21,301,0,1235,1,3,1,2,2,single-choice,spatial-relational,1|2,7,1/2,210301,1
4,1,21,302,0,853,1,3,1,2,2,single-choice,spatial-relational,1|2,7,1/2,210302,1
4,1,21,303,0,790,1,11,5,6,6,single-choice,spatial-relational,5|6,7,5/6,210303,5
4,1,21,304,1,862,1,9,4,4,5,single-choice,spatial-relational,4|5,7,4/5,210304,4
4,1,21,305,0,930,1,13,6,7,7,single-choice,spatial-relational,6|7,7,6/7,210305,6
4,1,21,306,0,923,1,11,5,6,6,single-choice,spatial-relational,5|6,7,5/6,210306,5
4,1,21,307,1,864,1,9,4,4,5,single-choice,spatial-relational,4|5,7,4/5,210307,4
4,1,21,308,0,840,1,7,3,4,4,single-choice,spatial-relational,3|4,7,3/4,210308,3
4,1,21,309,1,947,1,13,6,6,7,single-choice,spatial-relational,6|7,7,6/7,210309,6
4,1,21,310,1,1374,1,7,3,3,4,single-choice,spatial-relational,3|4,7,3/4,210310,3
4,1,21,311,1,823,1,5,2,2,3,single-choice,spatial-relational,2|3,7,2/3,210311,2
4,1,21,312,1,800,1,5,2,2,3,single-choice,spatial-relational,2|3,7,2/3,210312,2
4,1,21,313,1,699,1,13,6,6,7,single-choice,spatial-relational,6|7,7,6/7,210313,6
4,1,21,314,0,677,1,3,1,2,2,single-choice,spatial-relational,1|2,7,1/2,210314,1
4,1,21,315,1,1139,1,9,4,4,5,single-choice,spatial-relational,4|5,7,4/5,210315,4
4,1,21,316,1,869,1,3,1,1,2,single-choice,spatial-relational,1|2,7,1/2,210316,1
4,1,21,317,0,672,1,5,2,3,3,single-choice,spatial-relational,2|3,7,2/3,210317,2
4,1,21,318,1,1291,1,7,3,3,4,single-choice,spatial-relational,3|4,7,3/4,210318,3
4,1,21,319,1,872,1,13,6,6,7,single-choice,spatial-relational,6|7,7,6/7,210319,6
4,1,21,320,0,1162,1,7,3,4,4,single-choice,spatial-relational,3|4,7,3/4,210320,3
4,1,21,321,0,926,1,5,2,3,3,single-choice,spatial-relational,2|3,7,2/3,210321,2
4,1,21,322,0,951,1,9,4,5,5,single-choice,spatial-relational,4|5,7,4/5,210322,4
4,1,21,323,0,959,1,11,5,6,6,single-choice,spatial-relational,5|6,7,5/6,210323,5
4,1,21,324,1,1037,1,11,5,5,6,single-choice,spatial-relational,5|6,7,5/6,210324,5
4,1,21,325,1,836,1,9,4,4,5,single-choice,spatial-relational,4|5,7,4/5,210325,4
4,1,21,326,1,920,1,9,4,4,5,single-choice,spatial-relational,4|5,7,4/5,210326,4
4,1,21,327,0,719,1,3,1,2,2,single-choice,spatial-relational,1|2,7,1/2,210327,1
4,1,21,328,0,1006,1,3,1,2,2,single-choice,spatial-relational,1|2,7,1/2,210328,1
4,1,21,329,1,963,1,13,6,6,7,single-choice,spatial-relational,6|7,7,6/7,210329,6
4,1,21,330,0,1096,1,11,5,6,6,single-choice,spatial-relational,5|6,7,5/6,210330,5
4,1,21,331,0,976,1,5,2,3,3,single-choice,spatial-relational,2|3,7,2/3,210331,2
4,1,21,332,0,1098,1,7,3,4,4,single-choice,spatial-relational,3|4,7,3/4,210332,3
4,1,21,333,1,815,1,5,2,2,3,single-choice,spatial-relational,2|3,7,2/3,210333,2
4,1,21,334,0,820,1,7,3,4,4,single-choice,spatial-relational,3|4,7,3/4,210334,3
4,1,21,335,1,1032,1,13,6,6,7,single-choice,spatial-relational,6|7,7,6/7,210335,6
4,1,21,336,0,1355,1,11,5,6,6,single-choice,spatial-relational,5|6,7,5/6,210336,5
4,1,21,337,1,906,1,7,3,3,4,single-choice,spatial-relational,3|4,7,3/4,210337,3
4,1,21,338,1,816,1,9,4,4,5,single-choice,spatial-relational,4|5,7,4/5,210338,4
4,1,21,339,1,968,1,5,2,2,3,single-choice,spatial-relational,2|3,7,2/3,210339,2
4,1,21,340,1,643,1,11,5,5,6,single-choice,spatial-relational,5|6,7,5/6,210340,5
4,1,21,341,1,726,1,3,1,1,2,single-choice,spatial-relational,1|2,7,1/2,210341,1
4,1,21,342,0,743,1,3,1,2,2,single-choice,spatial-relational,1|2,7,1/2,210342,1
4,1,21,343,0,889,1,13,6,7,7,single-choice,spatial-relational,6|7,7,6/7,210343,6
4,1,21,344,0,1137,1,7,3,4,4,single-choice,spatial-relational,3|4,7,3/4,210344,3
4,1,21,345,1,930,1,13,6,6,7,single-choice,spatial-relational,6|7,7,6/7,210345,6
4,1,21,346,0,1125,1,9,4,5,5,single-choice,spatial-relational,4|5,7,4/5,210346,4
4,1,21,347,0,982,1,11,5,6,6,single-choice,spatial-relational,5|6,7,5/6,210347,5
4,1,21,348,0,973,1,5,2,3,3,single-choice,spatial-relational,2|3,7,2/3,210348,2
4,1,21,349,0,1151,1,11,5,6,6,single-choice,spatial-relational,5|6,7,5/6,210349,5
4,1,21,350,1,935,1,7,3,3,4,single-choice,spatial-relational,3|4,7,3/4,210350,3
4,1,21,351,0,831,1,13,6,7,7,single-choice,spatial-relational,6|7,7,6/7,210351,6
4,1,21,352,1,1068,1,9,4,4,5,single-choice,spatial-relational,4|5,7,4/5,210352,4
4,1,21,353,0,1246,1,3,1,2,2,single-choice,spatial-relational,1|2,7,1/2,210353,1
4,1,21,354,0,842,1,9,4,5,5,single-choice,spatial-relational,4|5,7,4/5,210354,4
4,1,21,355,0,1075,1,5,2,3,3,single-choice,spatial-relational,2|3,7,2/3,210355,2
4,1,21,356,1,872,1,13,6,6,7,single-choice,spatial-relational,6|7,7,6/7,210356,6
4,1,21,357,0,892,1,5,2,3,3,single-choice,spatial-relational,2|3,7,2/3,210357,2
4,1,21,358,0,963,1,3,1,2,2,single-choice,spatial-relational,1|2,7,1/2,210358,1
4,1,21,359,0,1049,1,11,5,6,6,single-choice,spatial-relational,5|6,7,5/6,210359,5
4,1,21,360,1,1095,1,7,3,3,4,single-choice,spatial-relational,3|4,7,3/4,210360,3
4,1,21,361,0,914,1,9,4,5,5,single-choice,spatial-relational,4|5,7,4/5,210361,4
4,1,21,362,0,16,1,11,5,6,6,single-choice,spatial-relational,5|6,7,5/6,210362,5
4,1,21,363,1,779,1,7,3,3,4,single-choice,spatial-relational,3|4,7,3/4,210363,3
4,1,21,364,1,930,1,13,6,6,7,single-choice,spatial-relational,6|7,7,6/7,210364,6
4,1,21,365,0,803,1,11,5,6,6,single-choice,spatial-relational,5|6,7,5/6,210365,5
4,1,21,366,0,952,1,3,1,2,2,single-choice,spatial-relational,1|2,7,1/2,210366,1
4,1,21,367,1,1107,1,9,4,4,5,single-choice,spatial-relational,4|5,7,4/5,210367,4
4,1,21,368,1,1054,1,3,1,1,2,single-choice,spatial-relational,1|2,7,1/2,210368,1
4,1,21,369,1,586,1,13,6,6,7,single-choice,spatial-relational,6|7,7,6/7,210369,6
4,1,21,370,0,762,1,5,2,3,3,single-choice,spatial-relational,2|3,7,2/3,210370,2
4,1,21,371,0,1254,1,5,2,3,3,single-choice,spatial-relational,2|3,7,2/3,210371,2
4,1,21,372,1,1195,1,7,3,3,4,single-choice,spatial-relational,3|4,7,3/4,210372,3
4,1,21,373,1,802,1,9,4,4,5,single-choice,spatial-relational,4|5,7,4/5,210373,4
4,1,21,374,0,864,1,3,1,2,2,single-choice,spatial-relational,1|2,7,1/2,210374,1
4,1,21,375,1,888,1,13,6,6,7,single-choice,spatial-relational,6|7,7,6/7,210375,6
4,1,21,376,1,995,1,9,4,4,5,single-choice,spatial-relational,4|5,7,4/5,210376,4
4,1,21,377,0,846,1,11,5,6,6,single-choice,spatial-relational,5|6,7,5/6,210377,5
4,1,21,378,1,1207,1,3,1,1,2,single-choice,spatial-relational,1|2,7,1/2,210378,1
4,1,21,379,0,1434,1,5,2,3,3,single-choice,spatial-relational,2|3,7,2/3,210379,2
4,1,21,380,1,838,1,7,3,3,4,single-choice,spatial-relational,3|4,7,3/4,210380,3
4,1,21,381,0,820,1,5,2,3,3,single-choice,spatial-relational,2|3,7,2/3,210381,2
4,1,21,382,1,844,1,13,6,6,7,single-choice,spatial-relational,6|7,7,6/7,210382,6
4,1,21,383,0,1018,1,11,5,6,6,single-choice,spatial-relational,5|6,7,5/6,210383,5
4,1,21,384,0,1144,1,7,3,4,4,single-choice,spatial-relational,3|4,7,3/4,210384,3
4,1,21,385,1,935,1,3,1,1,2,single-choice,spatial-relational,1|2,7,1/2,210385,1
4,1,21,386,1,750,1,9,4,4,5,single-choice,spatial-relational,4|5,7,4/5,210386,4
4,1,21,387,0,1266,1,7,3,4,4,single-choice,spatial-relational,3|4,7,3/4,210387,3
4,1,21,388,1,942,1,13,6,6,7,single-choice,spatial-relational,6|7,7,6/7,210388,6
4,1,21,389,0,768,1,5,2,3,3,single-choice,spatial-relational,2|3,7,2/3,210389,2
4,1,21,390,0,979,1,5,2,3,3,single-choice,spatial-relational,2|3,7,2/3,210390,2
4,1,21,391,1,1434,1,9,4,4,5,single-choice,spatial-relational,4|5,7,4/5,210391,4
4,1,21,392,1,783,1,11,5,5,6,single-choice,spatial-relational,5|6,7,5/6,210392,5
4,1,21,393,1,956,1,13,6,6,7,single-choice,spatial-relational,6|7,7,6/7,210393,6
4,1,21,394,0,801,1,7,3,4,4,single-choice,spatial-relational,3|4,7,3/4,210394,3
4,1,21,395,1,1528,1,11,5,5,6,single-choice,spatial-relational,5|6,7,5/6,210395,5
4,1,21,396,1,1620,1,3,1,1,2,single-choice,spatial-relational,1|2,7,1/2,210396,1
4,1,21,397,1,1613,1,9,4,4,5,single-choice,spatial-relational,4|5,7,4/5,210397,4
4,1,21,398,1,900,1,5,2,2,3,single-choice,spatial-relational,2|3,7,2/3,210398,2
4,1,21,399,1,588,1,9,4,4,5,single-choice,spatial-relational,4|5,7,4/5,210399,4
4,1,21,400,0,912,1,7,3,4,4,single-choice,spatial-relational,3|4,7,3/4,210400,3
4,1,21,401,1,932,1,3,1,1,2,single-choice,spatial-relational,1|2,7,1/2,210401,1
4,1,21,402,1,1306,1,7,3,3,4,single-choice,spatial-relational,3|4,7,3/4,210402,3
4,1,21,403,1,790,1,13,6,6,7,single-choice,spatial-relational,6|7,7,6/7,210403,6
4,1,21,404,1,855,1,3,1,1,2,single-choice,spatial-relational,1|2,7,1/2,210404,1
4,1,21,405,0,740,1,5,2,3,3,single-choice,spatial-relational,2|3,7,2/3,210405,2
4,1,21,406,0,911,1,11,5,6,6,single-choice,spatial-relational,5|6,7,5/6,210406,5
4,1,21,407,0,1037,1,11,5,6,6,single-choice,spatial-relational,5|6,7,5/6,210407,5
4,1,21,408,1,8988,1,13,6,6,7,single-choice,spatial-relational,6|7,7,6/7,210408,6
4,1,21,409,0,768,1,3,1,2,2,single-choice,spatial-relational,1|2,7,1/2,210409,1
4,1,21,410,1,1240,1,3,1,1,2,single-choice,spatial-relational,1|2,7,1/2,210410,1
4,1,21,411,0,648,1,5,2,3,3,single-choice,spatial-relational,2|3,7,2/3,210411,2
4,1,21,412,1,883,1,7,3,3,4,single-choice,spatial-relational,3|4,7,3/4,210412,3
4,1,21,413,0,716,1,7,3,4,4,single-choice,spatial-relational,3|4,7,3/4,210413,3
4,1,21,414,0,1159,1,11,5,6,6,single-choice,spatial-relational,5|6,7,5/6,210414,5
4,1,21,415,1,982,1,9,4,4,5,single-choice,spatial-relational,4|5,7,4/5,210415,4
4,1,21,416,1,971,1,5,2,2,3,single-choice,spatial-relational,2|3,7,2/3,210416,2
4,1,21,417,1,683,1,9,4,4,5,single-choice,spatial-relational,4|5,7,4/5,210417,4
4,1,21,418,1,900,1,11,5,5,6,single-choice,spatial-relational,5|6,7,5/6,210418,5
4,1,21,419,0,836,1,13,6,7,7,single-choice,spatial-relational,6|7,7,6/7,210419,6
4,1,21,420,1,987,1,13,6,6,7,single-choice,spatial-relational,6|7,7,6/7,210420,6
4,1,21,421,0,828,1,7,3,4,4,single-choice,spatial-relational,3|4,7,3/4,210421,3
4,1,21,422,0,859,1,5,2,3,3,single-choice,spatial-relational,2|3,7,2/3,210422,2
4,1,21,423,0,941,1,11,5,6,6,single-choice,spatial-relational,5|6,7,5/6,210423,5
4,1,21,424,1,1159,1,9,4,4,5,single-choice,spatial-relational,4|5,7,4/5,210424,4
4,1,21,425,1,886,1,13,6,6,7,single-choice,spatial-relational,6|7,7,6/7,210425,6
4,1,21,426,1,790,1,13,6,6,7,single-choice,spatial-relational,6|7,7,6/7,210426,6
4,1,21,427,1,684,1,3,1,1,2,single-choice,spatial-relational,1|2,7,1/2,210427,1
4,1,21,428,1,775,1,9,4,4,5,single-choice,spatial-relational,4|5,7,4/5,210428,4
4,1,21,429,1,924,1,5,2,2,3,single-choice,spatial-relational,2|3,7,2/3,210429,2
4,1,21,430,0,707,1,3,1,2,2,single-choice,spatial-relational,1|2,7,1/2,210430,1
4,1,21,431,0,939,1,11,5,6,6,single-choice,spatial-relational,5|6,7,5/6,210431,5
4,1,21,432,1,906,1,7,3,3,4,single-choice,spatial-relational,3|4,7,3/4,210432,3
4,1,21,433,0,982,1,5,2,3,3,single-choice,spatial-relational,2|3,7,2/3,210433,2
4,1,21,434,1,1239,1,11,5,5,6,single-choice,spatial-relational,5|6,7,5/6,210434,5
4,1,21,435,1,1163,1,13,6,6,7,single-choice,spatial-relational,6|7,7,6/7,210435,6
4,1,21,436,1,898,1,5,2,2,3,single-choice,spatial-relational,2|3,7,2/3,210436,2
4,1,21,437,1,672,1,9,4,4,5,single-choice,spatial-relational,4|5,7,4/5,210437,4
4,1,21,438,1,668,1,9,4,4,5,single-choice,spatial-relational,4|5,7,4/5,210438,4
4,1,21,439,1,706,1,3,1,1,2,single-choice,spatial-relational,1|2,7,1/2,210439,1
4,1,21,440,0,727,1,3,1,2,2,single-choice,spatial-relational,1|2,7,1/2,210440,1
4,1,21,441,1,7,1,11,5,5,6,single-choice,spatial-relational,5|6,7,5/6,210441,5
4,1,21,442,0,820,1,7,3,4,4,single-choice,spatial-relational,3|4,7,3/4,210442,3
4,1,21,443,0,1041,1,13,6,7,7,single-choice,spatial-relational,6|7,7,6/7,210443,6
4,1,21,444,1,866,1,7,3,3,4,single-choice,spatial-relational,3|4,7,3/4,210444,3
4,1,21,445,0,697,1,7,3,4,4,single-choice,spatial-relational,3|4,7,3/4,210445,3
4,1,21,446,1,1040,1,13,6,6,7,single-choice,spatial-relational,6|7,7,6/7,210446,6
4,1,21,447,0,916,1,9,4,5,5,single-choice,spatial-relational,4|5,7,4/5,210447,4
4,1,21,448,1,1377,1,11,5,5,6,single-choice,spatial-relational,5|6,7,5/6,210448,5
4,1,21,449,1,796,1,3,1,1,2,single-choice,spatial-relational,1|2,7,1/2,210449,1
4,1,21,450,0,627,1,7,3,4,4,single-choice,spatial-relational,3|4,7,3/4,210450,3
4,1,21,451,1,1196,1,5,2,2,3,single-choice,spatial-relational,2|3,7,2/3,210451,2
4,1,21,452,0,1305,1,5,2,3,3,single-choice,spatial-relational,2|3,7,2/3,210452,2
4,1,21,453,0,1060,1,11,5,6,6,single-choice,spatial-relational,5|6,7,5/6,210453,5
4,1,21,454,1,945,1,3,1,1,2,single-choice,spatial-relational,1|2,7,1/2,210454,1
4,1,21,455,1,951,1,13,6,6,7,single-choice,spatial-relational,6|7,7,6/7,210455,6
4,1,21,456,1,908,1,9,4,4,5,single-choice,spatial-relational,4|5,7,4/5,210456,4
4,1,21,457,0,755,1,5,2,3,3,single-choice,spatial-relational,2|3,7,2/3,210457,2
4,1,21,458,0,1051,1,11,5,6,6,single-choice,spatial-relational,5|6,7,5/6,210458,5
4,1,21,459,1,1009,1,13,6,6,7,single-choice,spatial-relational,6|7,7,6/7,210459,6
4,1,21,460,1,780,1,3,1,1,2,single-choice,spatial-relational,1|2,7,1/2,210460,1
4,1,21,461,0,1148,1,7,3,4,4,single-choice,spatial-relational,3|4,7,3/4,210461,3
4,1,21,462,0,772,1,9,4,5,5,single-choice,spatial-relational,4|5,7,4/5,210462,4
4,1,21,463,1,959,1,9,4,4,5,single-choice,spatial-relational,4|5,7,4/5,210463,4
4,1,21,464,1,1226,1,3,1,1,2,single-choice,spatial-relational,1|2,7,1/2,210464,1
4,1,21,465,1,902,1,5,2,2,3,single-choice,spatial-relational,2|3,7,2/3,210465,2
4,1,21,466,0,576,1,11,5,6,6,single-choice,spatial-relational,5|6,7,5/6,210466,5
4,1,21,467,1,858,1,13,6,6,7,single-choice,spatial-relational,6|7,7,6/7,210467,6
4,1,21,468,0,1310,1,7,3,4,4,single-choice,spatial-relational,3|4,7,3/4,210468,3
4,1,21,469,1,1217,1,13,6,6,7,single-choice,spatial-relational,6|7,7,6/7,210469,6
4,1,21,470,1,1103,1,11,5,5,6,single-choice,spatial-relational,5|6,7,5/6,210470,5
4,1,21,471,1,877,1,5,2,2,3,single-choice,spatial-relational,2|3,7,2/3,210471,2
4,1,21,472,1,848,1,9,4,4,5,single-choice,spatial-relational,4|5,7,4/5,210472,4
4,1,21,473,1,983,1,7,3,3,4,single-choice,spatial-relational,3|4,7,3/4,210473,3
4,1,21,474,0,716,1,3,1,2,2,single-choice,spatial-relational,1|2,7,1/2,210474,1
4,1,21,475,1,972,1,5,2,2,3,single-choice,spatial-relational,2|3,7,2/3,210475,2
4,1,21,476,0,655,1,11,5,6,6,single-choice,spatial-relational,5|6,7,5/6,210476,5
4,1,21,477,1,975,1,13,6,6,7,single-choice,spatial-relational,6|7,7,6/7,210477,6
4,1,21,478,0,1371,1,7,3,4,4,single-choice,spatial-relational,3|4,7,3/4,210478,3
4,1,21,479,0,1130,1,9,4,5,5,single-choice,spatial-relational,4|5,7,4/5,210479,4
4,1,21,480,1,880,1,3,1,1,2,single-choice,spatial-relational,1|2,7,1/2,210480,1
4,1,21,481,1,1033,1,5,2,2,3,single-choice,spatial-relational,2|3,7,2/3,210481,2
4,1,21,482,1,892,1,13,6,6,7,single-choice,spatial-relational,6|7,7,6/7,210482,6
4,1,21,483,1,794,1,13,6,6,7,single-choice,spatial-relational,6|7,7,6/7,210483,6
4,1,21,484,1,795,1,11,5,5,6,single-choice,spatial-relational,5|6,7,5/6,210484,5
4,1,21,485,0,1252,1,7,3,4,4,single-choice,spatial-relational,3|4,7,3/4,210485,3
4,1,21,486,1,821,1,11,5,5,6,single-choice,spatial-relational,5|6,7,5/6,210486,5
4,1,21,487,0,813,1,7,3,4,4,single-choice,spatial-relational,3|4,7,3/4,210487,3
4,1,21,488,1,1251,1,3,1,1,2,single-choice,spatial-relational,1|2,7,1/2,210488,1
4,1,21,489,1,1052,1,9,4,4,5,single-choice,spatial-relational,4|5,7,4/5,210489,4
4,1,21,490,0,918,1,5,2,3,3,single-choice,spatial-relational,2|3,7,2/3,210490,2
4,1,21,491,0,939,1,3,1,2,2,single-choice,spatial-relational,1|2,7,1/2,210491,1
4,1,21,492,1,1037,1,9,4,4,5,single-choice,spatial-relational,4|5,7,4/5,210492,4
4,1,21,493,0,786,1,11,5,6,6,single-choice,spatial-relational,5|6,7,5/6,210493,5
4,1,21,494,1,825,1,7,3,3,4,single-choice,spatial-relational,3|4,7,3/4,210494,3
4,1,21,495,1,970,1,13,6,6,7,single-choice,spatial-relational,6|7,7,6/7,210495,6
4,1,21,496,0,835,1,3,1,2,2,single-choice,spatial-relational,1|2,7,1/2,210496,1
4,1,21,497,0,874,1,7,3,4,4,single-choice,spatial-relational,3|4,7,3/4,210497,3
4,1,21,498,1,870,1,13,6,6,7,single-choice,spatial-relational,6|7,7,6/7,210498,6
4,1,21,499,1,1277,1,5,2,2,3,single-choice,spatial-relational,2|3,7,2/3,210499,2
4,1,21,500,1,764,1,5,2,2,3,single-choice,spatial-relational,2|3,7,2/3,210500,2
4,1,21,501,1,961,1,9,4,4,5,single-choice,spatial-relational,4|5,7,4/5,210501,4
4,1,21,502,0,831,1,9,4,5,5,single-choice,spatial-relational,4|5,7,4/5,210502,4
4,1,21,503,0,852,1,11,5,6,6,single-choice,spatial-relational,5|6,7,5/6,210503,5
4,1,21,504,1,19,1,3,1,1,2,single-choice,spatial-relational,1|2,7,1/2,210504,1
4,1,21,505,0,1134,1,3,1,2,2,single-choice,spatial-relational,1|2,7,1/2,210505,1
4,1,21,506,0,997,1,11,5,6,6,single-choice,spatial-relational,5|6,7,5/6,210506,5
4,1,21,507,1,1265,1,13,6,6,7,single-choice,spatial-relational,6|7,7,6/7,210507,6
4,1,21,508,1,971,1,13,6,6,7,single-choice,spatial-relational,6|7,7,6/7,210508,6
4,1,21,509,1,929,1,5,2,2,3,single-choice,spatial-relational,2|3,7,2/3,210509,2
4,1,21,510,0,786,1,9,4,5,5,single-choice,spatial-relational,4|5,7,4/5,210510,4
4,1,21,511,1,878,1,11,5,5,6,single-choice,spatial-relational,5|6,7,5/6,210511,5
4,1,21,512,1,916,1,9,4,4,5,single-choice,spatial-relational,4|5,7,4/5,210512,4
4,1,21,513,0,1858,1,7,3,4,4,single-choice,spatial-relational,3|4,7,3/4,210513,3
4,1,21,514,1,954,1,7,3,3,4,single-choice,spatial-relational,3|4,7,3/4,210514,3
4,1,21,515,0,738,1,3,1,2,2,single-choice,spatial-relational,1|2,7,1/2,210515,1
4,1,21,516,1,878,1,5,2,2,3,single-choice,spatial-relational,2|3,7,2/3,210516,2
4,1,21,517,1,908,1,13,6,6,7,single-choice,spatial-relational,6|7,7,6/7,210517,6
4,1,21,518,1,763,1,13,6,6,7,single-choice,spatial-relational,6|7,7,6/7,210518,6
4,1,21,519,1,948,1,9,4,4,5,single-choice,spatial-relational,4|5,7,4/5,210519,4
4,1,21,520,0,1857,1,11,5,6,6,single-choice,spatial-relational,5|6,7,5/6,210520,5
4,1,21,521,1,1195,1,9,4,4,5,single-choice,spatial-relational,4|5,7,4/5,210521,4
4,1,21,522,1,844,1,5,2,2,3,single-choice,spatial-relational,2|3,7,2/3,210522,2
4,1,21,523,1,813,1,3,1,1,2,single-choice,spatial-relational,1|2,7,1/2,210523,1
4,1,21,524,1,869,1,5,2,2,3,single-choice,spatial-relational,2|3,7,2/3,210524,2
4,1,21,525,0,635,1,7,3,4,4,single-choice,spatial-relational,3|4,7,3/4,210525,3
4,1,21,526,1,839,1,7,3,3,4,single-choice,spatial-relational,3|4,7,3/4,210526,3
4,1,21,527,0,820,1,3,1,2,2,single-choice,spatial-relational,1|2,7,1/2,210527,1
4,1,21,528,1,1312,1,11,5,5,6,single-choice,spatial-relational,5|6,7,5/6,210528,5
4,1,21,529,1,1277,1,7,3,3,4,single-choice,spatial-relational,3|4,7,3/4,210529,3
4,1,21,530,0,687,1,5,2,3,3,single-choice,spatial-relational,2|3,7,2/3,210530,2
4,1,21,531,0,923,1,9,4,5,5,single-choice,spatial-relational,4|5,7,4/5,210531,4
4,1,21,532,0,817,1,3,1,2,2,single-choice,spatial-relational,1|2,7,1/2,210532,1
4,1,21,533,1,847,1,13,6,6,7,single-choice,spatial-relational,6|7,7,6/7,210533,6
4,1,21,534,0,1198,1,7,3,4,4,single-choice,spatial-relational,3|4,7,3/4,210534,3
4,1,21,535,1,1394,1,11,5,5,6,single-choice,spatial-relational,5|6,7,5/6,210535,5
4,1,21,536,1,1114,1,9,4,4,5,single-choice,spatial-relational,4|5,7,4/5,210536,4
4,1,21,537,1,969,1,3,1,1,2,single-choice,spatial-relational,1|2,7,1/2,210537,1
4,1,21,538,0,726,1,11,5,6,6,single-choice,spatial-relational,5|6,7,5/6,210538,5
4,1,21,539,1,1042,1,5,2,2,3,single-choice,spatial-relational,2|3,7,2/3,210539,2
4,1,21,540,1,942,1,13,6,6,7,single-choice,spatial-relational,6|7,7,6/7,210540,6
4,1,21,541,1,702,1,5,2,2,3,single-choice,spatial-relational,2|3,7,2/3,210541,2
4,1,21,542,1,906,1,9,4,4,5,single-choice,spatial-relational,4|5,7,4/5,210542,4
4,1,21,543,1,996,1,13,6,6,7,single-choice,spatial-relational,6|7,7,6/7,210543,6
4,1,21,544,0,949,1,5,2,3,3,single-choice,spatial-relational,2|3,7,2/3,210544,2
4,1,21,545,1,822,1,13,6,6,7,single-choice,spatial-relational,6|7,7,6/7,210545,6
4,1,21,546,0,856,1,9,4,5,5,single-choice,spatial-relational,4|5,7,4/5,210546,4
4,1,21,547,0,1434,1,11,5,6,6,single-choice,spatial-relational,5|6,7,5/6,210547,5
4,1,21,548,1,883,1,7,3,3,4,single-choice,spatial-relational,3|4,7,3/4,210548,3
4,1,21,549,0,719,1,3,1,2,2,single-choice,spatial-relational,1|2,7,1/2,210549,1
4,1,21,550,0,1349,1,11,5,6,6,single-choice,spatial-relational,5|6,7,5/6,210550,5
4,1,21,551,1,1419,1,3,1,1,2,single-choice,spatial-relational,1|2,7,1/2,210551,1
4,1,21,552,0,950,1,7,3,4,4,single-choice,spatial-relational,3|4,7,3/4,210552,3
4,1,21,553,0,882,1,9,4,5,5,single-choice,spatial-relational,4|5,7,4/5,210553,4
4,1,21,554,1,1042,1,13,6,6,7,single-choice,spatial-relational,6|7,7,6/7,210554,6
4,1,21,555,1,756,1,5,2,2,3,single-choice,spatial-relational,2|3,7,2/3,210555,2
4,1,21,556,1,895,1,13,6,6,7,single-choice,spatial-relational,6|7,7,6/7,210556,6
4,1,21,557,1,944,1,3,1,1,2,single-choice,spatial-relational,1|2,7,1/2,210557,1
4,1,21,558,0,1237,1,11,5,6,6,single-choice,spatial-relational,5|6,7,5/6,210558,5
4,1,21,559,1,1159,1,9,4,4,5,single-choice,spatial-relational,4|5,7,4/5,210559,4
4,1,21,560,1,843,1,7,3,3,4,single-choice,spatial-relational,3|4,7,3/4,210560,3
4,1,21,561,0,650,1,3,1,2,2,single-choice,spatial-relational,1|2,7,1/2,210561,1
4,1,21,562,1,868,1,7,3,3,4,single-choice,spatial-relational,3|4,7,3/4,210562,3
4,1,21,563,0,1525,1,5,2,3,3,single-choice,spatial-relational,2|3,7,2/3,210563,2
4,1,21,564,0,1067,1,11,5,6,6,single-choice,spatial-relational,5|6,7,5/6,210564,5
4,1,21,565,1,1080,1,7,3,3,4,single-choice,spatial-relational,3|4,7,3/4,210565,3
4,1,21,566,0,835,1,5,2,3,3,single-choice,spatial-relational,2|3,7,2/3,210566,2
4,1,21,567,1,954,1,11,5,5,6,single-choice,spatial-relational,5|6,7,5/6,210567,5
4,1,21,568,1,873,1,11,5,5,6,single-choice,spatial-relational,5|6,7,5/6,210568,5
4,1,21,569,0,802,1,13,6,7,7,single-choice,spatial-relational,6|7,7,6/7,210569,6
4,1,21,570,1,1065,1,3,1,1,2,single-choice,spatial-relational,1|2,7,1/2,210570,1
4,1,21,571,1,1159,1,9,4,4,5,single-choice,spatial-relational,4|5,7,4/5,210571,4
4,1,21,572,1,780,1,9,4,4,5,single-choice,spatial-relational,4|5,7,4/5,210572,4
4,1,21,573,0,913,1,7,3,4,4,single-choice,spatial-relational,3|4,7,3/4,210573,3
4,1,21,574,1,1138,1,3,1,1,2,single-choice,spatial-relational,1|2,7,1/2,210574,1
4,1,21,575,1,859,1,13,6,6,7,single-choice,spatial-relational,6|7,7,6/7,210575,6
4,1,21,576,1,747,1,5,2,2,3,single-choice,spatial-relational,2|3,7,2/3,210576,2
4,1,21,577,0,903,1,9,4,5,5,single-choice,spatial-relational,4|5,7,4/5,210577,4
4,1,21,578,1,1108,1,9,4,4,5,single-choice,spatial-relational,4|5,7,4/5,210578,4
4,1,21,579,1,671,1,7,3,3,4,single-choice,spatial-relational,3|4,7,3/4,210579,3
4,1,21,580,1,887,1,13,6,6,7,single-choice,spatial-relational,6|7,7,6/7,210580,6
4,1,21,581,0,963,1,11,5,6,6,single-choice,spatial-relational,5|6,7,5/6,210581,5
4,1,21,582,1,1083,1,13,6,6,7,single-choice,spatial-relational,6|7,7,6/7,210582,6
4,1,21,583,1,1056,1,5,2,2,3,single-choice,spatial-relational,2|3,7,2/3,210583,2
4,1,21,584,0,1130,1,11,5,6,6,single-choice,spatial-relational,5|6,7,5/6,210584,5
4,1,21,585,1,1236,1,3,1,1,2,single-choice,spatial-relational,1|2,7,1/2,210585,1
4,1,21,586,1,851,1,5,2,2,3,single-choice,spatial-relational,2|3,7,2/3,210586,2
4,1,21,587,0,725,1,3,1,2,2,single-choice,spatial-relational,1|2,7,1/2,210587,1
4,1,21,588,1,1190,1,7,3,3,4,single-choice,spatial-relational,3|4,7,3/4,210588,3
4,1,21,589,0,745,1,7,3,4,4,single-choice,spatial-relational,3|4,7,3/4,210589,3
4,1,21,590,0,1002,1,3,1,2,2,single-choice,spatial-relational,1|2,7,1/2,210590,1
4,1,21,591,0,867,1,9,4,5,5,single-choice,spatial-relational,4|5,7,4/5,210591,4
4,1,21,592,1,1250,1,13,6,6,7,single-choice,spatial-relational,6|7,7,6/7,210592,6
4,1,21,593,1,837,1,13,6,6,7,single-choice,spatial-relational,6|7,7,6/7,210593,6
4,1,21,594,0,815,1,11,5,6,6,single-choice,spatial-relational,5|6,7,5/6,210594,5
4,1,21,595,1,1216,1,7,3,3,4,single-choice,spatial-relational,3|4,7,3/4,210595,3
4,1,21,596,0,942,1,11,5,6,6,single-choice,spatial-relational,5|6,7,5/6,210596,5
4,1,21,597,1,916,1,9,4,4,5,single-choice,spatial-relational,4|5,7,4/5,210597,4
4,1,21,598,1,647,1,5,2,2,3,single-choice,spatial-relational,2|3,7,2/3,210598,2
4,1,21,599,0,629,1,3,1,2,2,single-choice,spatial-relational,1|2,7,1/2,210599,1
4,1,21,600,1,1016,1,5,2,2,3,single-choice,spatial-relational,2|3,7,2/3,210600,2
5,1,21,1,1,901,1,9,4,4,5,single-choice,spatial-relational,4|5,7,4/5,210001,4
5,1,21,2,1,641,1,7,3,3,4,single-choice,spatial-relational,3|4,7,3/4,210002,3
5,1,21,3,0,16,1,3,1,2,2,single-choice,spatial-relational,1|2,7,1/2,210003,1
5,1,21,4,1,588,1,9,4,4,5,single-choice,spatial-relational,4|5,7,4/5,210004,4
5,1,21,5,1,71,1,13,6,6,7,single-choice,spatial-relational,6|7,7,6/7,210005,6
5,1,21,6,1,11,1,3,1,1,2,single-choice,spatial-relational,1|2,7,1/2,210006,1
5,1,21,7,1,23,1,5,2,2,3,single-choice,spatial-relational,2|3,7,2/3,210007,2
5,1,21,8,0,24,1,11,5,6,6,single-choice,spatial-relational,5|6,7,5/6,210008,5
5,1,21,9,0,474,1,7,3,4,4,single-choice,spatial-relational,3|4,7,3/4,210009,3
5,1,21,10,0,767,1,11,5,6,6,single-choice,spatial-relational,5|6,7,5/6,210010,5
5,1,21,11,0,527,1,5,2,3,3,single-choice,spatial-relational,2|3,7,2/3,210011,2
5,1,21,12,1,864,1,13,6,6,7,single-choice,spatial-relational,6|7,7,6/7,210012,6
5,1,21,13,1,15,1,5,2,2,3,single-choice,spatial-relational,2|3,7,2/3,210013,2
5,1,21,14,0,15,1,11,5,6,6,single-choice,spatial-relational,5|6,7,5/6,210014,5
5,1,21,15,0,528,1,9,4,5,5,single-choice,spatial-relational,4|5,7,4/5,210015,4
5,1,21,16,1,4,1,3,1,1,2,single-choice,spatial-relational,1|2,7,1/2,210016,1
5,1,21,17,0,20,1,5,2,3,3,single-choice,spatial-relational,2|3,7,2/3,210017,2
5,1,21,18,1,565,1,9,4,4,5,single-choice,spatial-relational,4|5,7,4/5,210018,4
5,1,21,19,0,549,1,7,3,4,4,single-choice,spatial-relational,3|4,7,3/4,210019,3
5,1,21,20,0,891,1,7,3,4,4,single-choice,spatial-relational,3|4,7,3/4,210020,3
5,1,21,21,1,5,1,11,5,5,6,single-choice,spatial-relational,5|6,7,5/6,210021,5
5,1,21,22,0,604,1,13,6,7,7,single-choice,spatial-relational,6|7,7,6/7,210022,6
5,1,21,23,0,768,1,3,1,2,2,single-choice,spatial-relational,1|2,7,1/2,210023,1
5,1,21,24,1,4,1,13,6,6,7,single-choice,spatial-relational,6|7,7,6/7,210024,6
5,1,21,25,1,587,1,5,2,2,3,single-choice,spatial-relational,2|3,7,2/3,210025,2
5,1,21,26,1,674,1,13,6,6,7,single-choice,spatial-relational,6|7,7,6/7,210026,6
5,1,21,27,0,792,1,11,5,6,6,single-choice,spatial-relational,5|6,7,5/6,210027,5
5,1,21,28,0,755,1,3,1,2,2,single-choice,spatial-relational,1|2,7,1/2,210028,1
5,1,21,29,1,11,1,3,1,1,2,single-choice,spatial-relational,1|2,7,1/2,210029,1
5,1,21,30,0,6,1,13,6,7,7,single-choice,spatial-relational,6|7,7,6/7,210030,6
5,1,21,31,0,721,1,7,3,4,4,single-choice,spatial-relational,3|4,7,3/4,210031,3
5,1,21,32,0,931,1,7,3,4,4,single-choice,spatial-relational,3|4,7,3/4,210032,3
5,1,21,33,0,694,1,11,5,6,6,single-choice,spatial-relational,5|6,7,5/6,210033,5
5,1,21,34,0,830,1,5,2,3,3,single-choice,spatial-relational,2|3,7,2/3,210034,2
5,1,21,35,0,734,1,9,4,5,5,single-choice,spatial-relational,4|5,7,4/5,210035,4
5,1,21,36,1,918,1,9,4,4,5,single-choice,spatial-relational,4|5,7,4/5,210036,4
5,1,21,37,1,704,1,13,6,6,7,single-choice,spatial-relational,6|7,7,6/7,210037,6
5,1,21,38,1,1176,1,11,5,5,6,single-choice,spatial-relational,5|6,7,5/6,210038,5
5,1,21,39,1,748,1,9,4,4,5,single-choice,spatial-relational,4|5,7,4/5,210039,4
5,1,21,40,1,730,1,13,6,6,7,single-choice,spatial-relational,6|7,7,6/7,210040,6
5,1,21,41,0,715,1,3,1,2,2,single-choice,spatial-relational,1|2,7,1/2,210041,1
5,1,21,42,0,627,1,7,3,4,4,single-choice,spatial-relational,3|4,7,3/4,210042,3
5,1,21,43,0,740,1,11,5,6,6,single-choice,spatial-relational,5|6,7,5/6,210043,5
5,1,21,44,1,1018,1,9,4,4,5,single-choice,spatial-relational,4|5,7,4/5,210044,4
5,1,21,45,1,1311,1,7,3,3,4,single-choice,spatial-relational,3|4,7,3/4,210045,3
5,1,21,46,0,931,1,5,2,3,3,single-choice,spatial-relational,2|3,7,2/3,210046,2
5,1,21,47,1,1116,1,5,2,2,3,single-choice,spatial-relational,2|3,7,2/3,210047,2
5,1,21,48,1,952,1,3,1,1,2,single-choice,spatial-relational,1|2,7,1/2,210048,1
5,1,21,49,1,723,1,7,3,3,4,single-choice,spatial-relational,3|4,7,3/4,210049,3
5,1,21,50,0,721,1,5,2,3,3,single-choice,spatial-relational,2|3,7,2/3,210050,2
5,1,21,51,1,903,1,11,5,5,6,single-choice,spatial-relational,5|6,7,5/6,210051,5
5,1,21,52,1,732,1,11,5,5,6,single-choice,spatial-relational,5|6,7,5/6,210052,5
5,1,21,53,0,828,1,7,3,4,4,single-choice,spatial-relational,3|4,7,3/4,210053,3
5,1,21,54,0,930,1,3,1,2,2,single-choice,spatial-relational,1|2,7,1/2,210054,1
5,1,21,55,1,1028,1,9,4,4,5,single-choice,spatial-relational,4|5,7,4/5,210055,4
5,1,21,56,1,757,1,13,6,6,7,single-choice,spatial-relational,6|7,7,6/7,210056,6
5,1,21,57,0,1222,1,9,4,5,5,single-choice,spatial-relational,4|5,7,4/5,210057,4
5,1,21,58,0,794,1,5,2,3,3,single-choice,spatial-relational,2|3,7,2/3,210058,2
5,1,21,59,0,787,1,3,1,2,2,single-choice,spatial-relational,1|2,7,1/2,210059,1
5,1,21,60,1,921,1,13,6,6,7,single-choice,spatial-relational,6|7,7,6/7,210060,6
5,1,21,61,0,1178,1,7,3,4,4,single-choice,spatial-relational,3|4,7,3/4,210061,3
5,1,21,62,0,931,1,7,3,4,4,single-choice,spatial-relational,3|4,7,3/4,210062,3
5,1,21,63,1,1174,1,13,6,6,7,single-choice,spatial-relational,6|7,7,6/7,210063,6
5,1,21,64,0,740,1,3,1,2,2,single-choice,spatial-relational,1|2,7,1/2,210064,1
5,1,21,65,0,1358,1,5,2,3,3,single-choice,spatial-relational,2|3,7,2/3,210065,2
5,1,21,66,1,877,1,3,1,1,2,single-choice,spatial-relational,1|2,7,1/2,210066,1
5,1,21,67,1,814,1,5,2,2,3,single-choice,spatial-relational,2|3,7,2/3,210067,2
5,1,21,68,1,719,1,13,6,6,7,single-choice,spatial-relational,6|7,7,6/7,210068,6
5,1,21,69,1,1106,1,11,5,5,6,single-choice,spatial-relational,5|6,7,5/6,210069,5
5,1,21,70,0,1297,1,11,5,6,6,single-choice,spatial-relational,5|6,7,5/6,210070,5
5,1,21,71,1,1049,1,9,4,4,5,single-choice,spatial-relational,4|5,7,4/5,210071,4
5,1,21,72,1,947,1,9,4,4,5,single-choice,spatial-relational,4|5,7,4/5,210072,4
5,1,21,73,1,923,1,7,3,3,4,single-choice,spatial-relational,3|4,7,3/4,210073,3
5,1,21,74,1,693,1,11,5,5,6,single-choice,spatial-relational,5|6,7,5/6,210074,5
5,1,21,75,0,795,1,5,2,3,3,single-choice,spatial-relational,2|3,7,2/3,210075,2
5,1,21,76,1,814,1,11,5,5,6,single-choice,spatial-relational,5|6,7,5/6,210076,5
5,1,21,77,1,855,1,9,4,4,5,single-choice,spatial-relational,4|5,7,4/5,210077,4
5,1,21,78,0,792,1,3,1,2,2,single-choice,spatial-relational,1|2,7,1/2,210078,1
5,1,21,79,1,1386,1,9,4,4,5,single-choice,spatial-relational,4|5,7,4/5,210079,4
5,1,21,80,1,899,1,13,6,6,7,single-choice,spatial-relational,6|7,7,6/7,210080,6
5,1,21,81,1,961,1,7,3,3,4,single-choice,spatial-relational,3|4,7,3/4,210081,3
5,1,21,82,0,1281,1,5,2,3,3,single-choice,spatial-relational,2|3,7,2/3,210082,2
5,1,21,83,0,1241,1,13,6,7,7,single-choice,spatial-relational,6|7,7,6/7,210083,6
5,1,21,84,0,811,1,3,1,2,2,single-choice,spatial-relational,1|2,7,1/2,210084,1
5,1,21,85,1,1230,1,9,4,4,5,single-choice,spatial-relational,4|5,7,4/5,210085,4
5,1,21,86,0,978,1,5,2,3,3,single-choice,spatial-relational,2|3,7,2/3,210086,2
5,1,21,87,0,876,1,13,6,7,7,single-choice,spatial-relational,6|7,7,6/7,210087,6
5,1,21,88,1,1255,1,7,3,3,4,single-choice,spatial-relational,3|4,7,3/4,210088,3
5,1,21,89,0,740,1,3,1,2,2,single-choice,spatial-relational,1|2,7,1/2,210089,1
5,1,21,90,0,1129,1,11,5,6,6,single-choice,spatial-relational,5|6,7,5/6,210090,5
5,1,21,91,0,835,1,5,2,3,3,single-choice,spatial-relational,2|3,7,2/3,210091,2
5,1,21,92,1,23,1,11,5,5,6,single-choice,spatial-relational,5|6,7,5/6,210092,5
5,1,21,93,0,904,1,9,4,5,5,single-choice,spatial-relational,4|5,7,4/5,210093,4
5,1,21,94,1,949,1,7,3,3,4,single-choice,spatial-relational,3|4,7,3/4,210094,3
5,1,21,95,1,954,1,3,1,1,2,single-choice,spatial-relational,1|2,7,1/2,210095,1
5,1,21,96,1,633,1,13,6,6,7,single-choice,spatial-relational,6|7,7,6/7,210096,6
5,1,21,97,0,806,1,3,1,2,2,single-choice,spatial-relational,1|2,7,1/2,210097,1
5,1,21,98,1,873,1,7,3,3,4,single-choice,spatial-relational,3|4,7,3/4,210098,3
5,1,21,99,0,871,1,3,1,2,2,single-choice,spatial-relational,1|2,7,1/2,210099,1
5,1,21,100,1,1360,1,7,3,3,4,single-choice,spatial-relational,3|4,7,3/4,210100,3
5,1,21,101,1,907,1,13,6,6,7,single-choice,spatial-relational,6|7,7,6/7,210101,6
5,1,21,102,1,793,1,9,4,4,5,single-choice,spatial-relational,4|5,7,4/5,210102,4
5,1,21,103,0,933,1,9,4,5,5,single-choice,spatial-relational,4|5,7,4/5,210103,4
5,1,21,104,1,1083,1,11,5,5,6,single-choice,spatial-relational,5|6,7,5/6,210104,5
5,1,21,105,1,987,1,13,6,6,7,single-choice,spatial-relational,6|7,7,6/7,210105,6
5,1,21,106,1,1095,1,5,2,2,3,single-choice,spatial-relational,2|3,7,2/3,210106,2
5,1,21,107,0,717,1,5,2,3,3,single-choice,spatial-relational,2|3,7,2/3,210107,2
5,1,21,108,0,1234,1,11,5,6,6,single-choice,spatial-relational,5|6,7,5/6,210108,5
5,1,21,109,1,973,1,9,4,4,5,single-choice,spatial-relational,4|5,7,4/5,210109,4
5,1,21,110,0,896,1,11,5,6,6,single-choice,spatial-relational,5|6,7,5/6,210110,5
5,1,21,111,1,1017,1,11,5,5,6,single-choice,spatial-relational,5|6,7,5/6,210111,5
5,1,21,112,1,1436,1,7,3,3,4,single-choice,spatial-relational,3|4,7,3/4,210112,3
5,1,21,113,0,641,1,13,6,7,7,single-choice,spatial-relational,6|7,7,6/7,210113,6
5,1,21,114,1,1004,1,13,6,6,7,single-choice,spatial-relational,6|7,7,6/7,210114,6
5,1,21,115,1,803,1,9,4,4,5,single-choice,spatial-relational,4|5,7,4/5,210115,4
5,1,21,116,1,765,1,3,1,1,2,single-choice,spatial-relational,1|2,7,1/2,210116,1
5,1,21,117,1,966,1,5,2,2,3,single-choice,spatial-relational,2|3,7,2/3,210117,2
5,1,21,118,0,773,1,5,2,3,3,single-choice,spatial-relational,2|3,7,2/3,210118,2
5,1,21,119,1,932,1,3,1,1,2,single-choice,spatial-relational,1|2,7,1/2,210119,1
5,1,21,120,0,830,1,7,3,4,4,single-choice,spatial-relational,3|4,7,3/4,210120,3
5,1,21,121,0,1073,1,11,5,6,6,single-choice,spatial-relational,5|6,7,5/6,210121,5
5,1,21,122,1,1125,1,9,4,4,5,single-choice,spatial-relational,4|5,7,4/5,210122,4
5,1,21,123,1,924,1,13,6,6,7,single-choice,spatial-relational,6|7,7,6/7,210123,6
5,1,21,124,0,817,1,5,2,3,3,single-choice,spatial-relational,2|3,7,2/3,210124,2
5,1,21,125,1,938,1,3,1,1,2,single-choice,spatial-relational,1|2,7,1/2,210125,1
5,1,21,126,0,1079,1,11,5,6,6,single-choice,spatial-relational,5|6,7,5/6,210126,5
5,1,21,127,1,874,1,7,3,3,4,single-choice,spatial-relational,3|4,7,3/4,210127,3
5,1,21,128,1,887,1,9,4,4,5,single-choice,spatial-relational,4|5,7,4/5,210128,4
5,1,21,129,1,1024,1,7,3,3,4,single-choice,spatial-relational,3|4,7,3/4,210129,3
5,1,21,130,1,751,1,3,1,1,2,single-choice,spatial-relational,1|2,7,1/2,210130,1
5,1,21,131,0,606,1,13,6,7,7,single-choice,spatial-relational,6|7,7,6/7,210131,6
5,1,21,132,0,784,1,5,2,3,3,single-choice,spatial-relational,2|3,7,2/3,210132,2
5,1,21,133,1,853,1,5,2,2,3,single-choice,spatial-relational,2|3,7,2/3,210133,2
5,1,21,134,0,722,1,3,1,2,2,single-choice,spatial-relational,1|2,7,1/2,210134,1
5,1,21,135,1,1149,1,3,1,1,2,single-choice,spatial-relational,1|2,7,1/2,210135,1
5,1,21,136,1,960,1,13,6,6,7,single-choice,spatial-relational,6|7,7,6/7,210136,6
5,1,21,137,1,1073,1,7,3,3,4,single-choice,spatial-relational,3|4,7,3/4,210137,3
5,1,21,138,0,1012,1,11,5,6,6,single-choice,spatial-relational,5|6,7,5/6,210138,5
5,1,21,139,1,989,1,7,3,3,4,single-choice,spatial-relational,3|4,7,3/4,210139,3
5,1,21,140,0,716,1,9,4,5,5,single-choice,spatial-relational,4|5,7,4/5,210140,4
5,1,21,141,0,1188,1,11,5,6,6,single-choice,spatial-relational,5|6,7,5/6,210141,5
5,1,21,142,0,1167,1,5,2,3,3,single-choice,spatial-relational,2|3,7,2/3,210142,2
5,1,21,143,0,1138,1,9,4,5,5,single-choice,spatial-relational,4|5,7,4/5,210143,4
5,1,21,144,1,1280,1,13,6,6,7,single-choice,spatial-relational,6|7,7,6/7,210144,6
5,1,21,145,1,743,1,3,1,1,2,single-choice,spatial-relational,1|2,7,1/2,210145,1
5,1,21,146,1,804,1,13,6,6,7,single-choice,spatial-relational,6|7,7,6/7,210146,6
5,1,21,147,0,766,1,7,3,4,4,single-choice,spatial-relational,3|4,7,3/4,210147,3
5,1,21,148,1,1574,1,9,4,4,5,single-choice,spatial-relational,4|5,7,4/5,210148,4
5,1,21,149,1,887,1,11,5,5,6,single-choice,spatial-relational,5|6,7,5/6,210149,5
5,1,21,150,0,762,1,3,1,2,2,single-choice,spatial-relational,1|2,7,1/2,210150,1
5,1,21,151,1,1329,1,9,4,4,5,single-choice,spatial-relational,4|5,7,4/5,210151,4
5,1,21,152,0,842,1,5,2,3,3,single-choice,spatial-relational,2|3,7,2/3,210152,2
5,1,21,153,1,1049,1,13,6,6,7,single-choice,spatial-relational,6|7,7,6/7,210153,6
5,1,21,154,1,1019,1,5,2,2,3,single-choice,spatial-relational,2|3,7,2/3,210154,2
5,1,21,155,1,984,1,11,5,5,6,single-choice,spatial-relational,5|6,7,5/6,210155,5
5,1,21,156,0,867,1,7,3,4,4,single-choice,spatial-relational,3|4,7,3/4,210156,3
5,1,21,157,1,879,1,7,3,3,4,single-choice,spatial-relational,3|4,7,3/4,210157,3
5,1,21,158,1,1125,1,11,5,5,6,single-choice,spatial-relational,5|6,7,5/6,210158,5
5,1,21,159,1,953,1,5,2,2,3,single-choice,spatial-relational,2|3,7,2/3,210159,2
5,1,21,160,0,834,1,9,4,5,5,single-choice,spatial-relational,4|5,7,4/5,210160,4
5,1,21,161,1,929,1,3,1,1,2,single-choice,spatial-relational,1|2,7,1/2,210161,1
5,1,21,162,1,769,1,5,2,2,3,single-choice,spatial-relational,2|3,7,2/3,210162,2
5,1,21,163,0,1252,1,11,5,6,6,single-choice,spatial-relational,5|6,7,5/6,210163,5
5,1,21,164,1,974,1,9,4,4,5,single-choice,spatial-relational,4|5,7,4/5,210164,4
5,1,21,165,1,1062,1,13,6,6,7,single-choice,spatial-relational,6|7,7,6/7,210165,6
5,1,21,166,1,780,1,13,6,6,7,single-choice,spatial-relational,6|7,7,6/7,210166,6
5,1,21,167,0,891,1,3,1,2,2,single-choice,spatial-relational,1|2,7,1/2,210167,1
5,1,21,168,1,855,1,7,3,3,4,single-choice,spatial-relational,3|4,7,3/4,210168,3
5,1,21,169,1,1221,1,7,3,3,4,single-choice,spatial-relational,3|4,7,3/4,210169,3
5,1,21,170,1,1035,1,5,2,2,3,single-choice,spatial-relational,2|3,7,2/3,210170,2
5,1,21,171,0,979,1,11,5,6,6,single-choice,spatial-relational,5|6,7,5/6,210171,5
5,1,21,172,1,937,1,9,4,4,5,single-choice,spatial-relational,4|5,7,4/5,210172,4
5,1,21,173,1,910,1,13,6,6,7,single-choice,spatial-relational,6|7,7,6/7,210173,6
5,1,21,174,1,778,1,3,1,1,2,single-choice,spatial-relational,1|2,7,1/2,210174,1
5,1,21,175,0,714,1,9,4,5,5,single-choice,spatial-relational,4|5,7,4/5,210175,4
5,1,21,176,1,1004,1,11,5,5,6,single-choice,spatial-relational,5|6,7,5/6,210176,5
5,1,21,177,0,818,1,3,1,2,2,single-choice,spatial-relational,1|2,7,1/2,210177,1
5,1,21,178,1,1094,1,7,3,3,4,single-choice,spatial-relational,3|4,7,3/4,210178,3
5,1,21,179,1,743,1,13,6,6,7,single-choice,spatial-relational,6|7,7,6/7,210179,6
5,1,21,180,0,1608,1,5,2,3,3,single-choice,spatial-relational,2|3,7,2/3,210180,2
5,1,21,181,0,838,1,3,1,2,2,single-choice,spatial-relational,1|2,7,1/2,210181,1
5,1,21,182,1,922,1,5,2,2,3,single-choice,spatial-relational,2|3,7,2/3,210182,2
5,1,21,183,0,877,1,11,5,6,6,single-choice,spatial-relational,5|6,7,5/6,210183,5
5,1,21,184,1,1005,1,9,4,4,5,single-choice,spatial-relational,4|5,7,4/5,210184,4
5,1,21,185,1,904,1,3,1,1,2,single-choice,spatial-relational,1|2,7,1/2,210185,1
5,1,21,186,1,840,1,13,6,6,7,single-choice,spatial-relational,6|7,7,6/7,210186,6
5,1,21,187,0,1231,1,7,3,4,4,single-choice,spatial-relational,3|4,7,3/4,210187,3
5,1,21,188,1,1178,1,7,3,3,4,single-choice,spatial-relational,3|4,7,3/4,210188,3
5,1,21,189,1,955,1,13,6,6,7,single-choice,spatial-relational,6|7,7,6/7,210189,6
5,1,21,190,0,789,1,11,5,6,6,single-choice,spatial-relational,5|6,7,5/6,210190,5
5,1,21,191,0,1518,1,5,2,3,3,single-choice,spatial-relational,2|3,7,2/3,210191,2
5,1,21,192,1,1549,1,9,4,4,5,single-choice,spatial-relational,4|5,7,4/5,210192,4
5,1,21,193,1,806,1,9,4,4,5,single-choice,spatial-relational,4|5,7,4/5,210193,4
5,1,21,194,0,1283,1,7,3,4,4,single-choice,spatial-relational,3|4,7,3/4,210194,3
5,1,21,195,1,1397,1,5,2,2,3,single-choice,spatial-relational,2|3,7,2/3,210195,2
5,1,21,196,0,699,1,13,6,7,7,single-choice,spatial-relational,6|7,7,6/7,210196,6
5,1,21,197,1,1696,1,7,3,3,4,single-choice,spatial-relational,3|4,7,3/4,210197,3
5,1,21,198,1,948,1,3,1,1,2,single-choice,spatial-relational,1|2,7,1/2,210198,1
5,1,21,199,1,907,1,5,2,2,3,single-choice,spatial-relational,2|3,7,2/3,210199,2
5,1,21,200,0,978,1,11,5,6,6,single-choice,spatial-relational,5|6,7,5/6,210200,5
5,1,21,201,0,1433,1,9,4,5,5,single-choice,spatial-relational,4|5,7,4/5,210201,4
5,1,21,202,0,1048,1,11,5,6,6,single-choice,spatial-relational,5|6,7,5/6,210202,5
5,1,21,203,1,1112,1,13,6,6,7,single-choice,spatial-relational,6|7,7,6/7,210203,6
5,1,21,204,0,728,1,3,1,2,2,single-choice,spatial-relational,1|2,7,1/2,210204,1
5,1,21,205,1,978,1,3,1,1,2,single-choice,spatial-relational,1|2,7,1/2,210205,1
5,1,21,206,1,601,1,13,6,6,7,single-choice,spatial-relational,6|7,7,6/7,210206,6
5,1,21,207,0,833,1,9,4,5,5,single-choice,spatial-relational,4|5,7,4/5,210207,4
5,1,21,208,1,1090,1,5,2,2,3,single-choice,spatial-relational,2|3,7,2/3,210208,2
5,1,21,209,1,878,1,13,6,6,7,single-choice,spatial-relational,6|7,7,6/7,210209,6
5,1,21,210,0,1227,1,11,5,6,6,single-choice,spatial-relational,5|6,7,5/6,210210,5
5,1,21,211,1,1117,1,11,5,5,6,single-choice,spatial-relational,5|6,7,5/6,210211,5
5,1,21,212,1,1424,1,7,3,3,4,single-choice,spatial-relational,3|4,7,3/4,210212,3
5,1,21,213,1,880,1,9,4,4,5,single-choice,spatial-relational,4|5,7,4/5,210213,4
5,1,21,214,1,728,1,7,3,3,4,single-choice,spatial-relational,3|4,7,3/4,210214,3
5,1,21,215,1,908,1,5,2,2,3,single-choice,spatial-relational,2|3,7,2/3,210215,2
5,1,21,216,0,718,1,3,1,2,2,single-choice,spatial-relational,1|2,7,1/2,210216,1
5,1,21,217,0,1387,1,9,4,5,5,single-choice,spatial-relational,4|5,7,4/5,210217,4
5,1,21,218,0,879,1,13,6,7,7,single-choice,spatial-relational,6|7,7,6/7,210218,6
5,1,21,219,1,907,1,11,5,5,6,single-choice,spatial-relational,5|6,7,5/6,210219,5
5,1,21,220,1,1010,1,7,3,3,4,single-choice,spatial-relational,3|4,7,3/4,210220,3
5,1,21,221,0,704,1,3,1,2,2,single-choice,spatial-relational,1|2,7,1/2,210221,1
5,1,21,222,1,1008,1,9,4,4,5,single-choice,spatial-relational,4|5,7,4/5,210222,4
5,1,21,223,0,867,1,5,2,3,3,single-choice,spatial-relational,2|3,7,2/3,210223,2
5,1,21,224,1,1593,1,5,2,2,3,single-choice,spatial-relational,2|3,7,2/3,210224,2
5,1,21,225,1,1045,1,11,5,5,6,single-choice,spatial-relational,5|6,7,5/6,210225,5
5,1,21,226,0,1770,1,7,3,4,4,single-choice,spatial-relational,3|4,7,3/4,210226,3
5,1,21,227,1,954,1,3,1,1,2,single-choice,spatial-relational,1|2,7,1/2,210227,1
5,1,21,228,1,799,1,13,6,6,7,single-choice,spatial-relational,6|7,7,6/7,210228,6
5,1,21,229,0,1000,1,7,3,4,4,single-choice,spatial-relational,3|4,7,3/4,210229,3
5,1,21,230,1,853,1,5,2,2,3,single-choice,spatial-relational,2|3,7,2/3,210230,2
5,1,21,231,1,779,1,3,1,1,2,single-choice,spatial-relational,1|2,7,1/2,210231,1
5,1,21,232,0,921,1,11,5,6,6,single-choice,spatial-relational,5|6,7,5/6,210232,5
5,1,21,233,1,1191,1,11,5,5,6,single-choice,spatial-relational,5|6,7,5/6,210233,5
5,1,21,234,1,874,1,13,6,6,7,single-choice,spatial-relational,6|7,7,6/7,210234,6
5,1,21,235,0,1238,1,7,3,4,4,single-choice,spatial-relational,3|4,7,3/4,210235,3
5,1,21,236,1,1179,1,9,4,4,5,single-choice,spatial-relational,4|5,7,4/5,210236,4
5,1,21,237,0,854,1,9,4,5,5,single-choice,spatial-relational,4|5,7,4/5,210237,4
5,1,21,238,0,859,1,5,2,3,3,single-choice,spatial-relational,2|3,7,2/3,210238,2
5,1,21,239,1,880,1,3,1,1,2,single-choice,spatial-relational,1|2,7,1/2,210239,1
5,1,21,240,1,928,1,13,6,6,7,single-choice,spatial-relational,6|7,7,6/7,210240,6
5,1,21,241,0,1115,1,9,4,5,5,single-choice,spatial-relational,4|5,7,4/5,210241,4
5,1,21,242,1,1000,1,11,5,5,6,single-choice,spatial-relational,5|6,7,5/6,210242,5
5,1,21,243,0,1603,1,13,6,7,7,single-choice,spatial-relational,6|7,7,6/7,210243,6
5,1,21,244,1,1292,1,5,2,2,3,single-choice,spatial-relational,2|3,7,2/3,210244,2
5,1,21,245,0,1116,1,3,1,2,2,single-choice,spatial-relational,1|2,7,1/2,210245,1
5,1,21,246,1,955,1,13,6,6,7,single-choice,spatial-relational,6|7,7,6/7,210246,6
5,1,21,247,1,925,1,9,4,4,5,single-choice,spatial-relational,4|5,7,4/5,210247,4
5,1,21,248,0,865,1,5,2,3,3,single-choice,spatial-relational,2|3,7,2/3,210248,2
5,1,21,249,0,137,1,7,3,4,4,single-choice,spatial-relational,3|4,7,3/4,210249,3
5,1,21,250,0,1096,1,11,5,6,6,single-choice,spatial-relational,5|6,7,5/6,210250,5
5,1,21,251,1,1003,1,7,3,3,4,single-choice,spatial-relational,3|4,7,3/4,210251,3
5,1,21,252,0,1201,1,3,1,2,2,single-choice,spatial-relational,1|2,7,1/2,210252,1
5,1,21,253,1,1014,1,5,2,2,3,single-choice,spatial-relational,2|3,7,2/3,210253,2
5,1,21,254,0,687,1,9,4,5,5,single-choice,spatial-relational,4|5,7,4/5,210254,4
5,1,21,255,1,982,1,13,6,6,7,single-choice,spatial-relational,6|7,7,6/7,210255,6
5,1,21,256,1,920,1,5,2,2,3,single-choice,spatial-relational,2|3,7,2/3,210256,2
5,1,21,257,1,1009,1,11,5,5,6,single-choice,spatial-relational,5|6,7,5/6,210257,5
5,1,21,258,0,921,1,3,1,2,2,single-choice,spatial-relational,1|2,7,1/2,210258,1
5,1,21,259,1,817,1,3,1,1,2,single-choice,spatial-relational,1|2,7,1/2,210259,1
5,1,21,260,1,886,1,7,3,3,4,single-choice,spatial-relational,3|4,7,3/4,210260,3
5,1,21,261,1,1008,1,9,4,4,5,single-choice,spatial-relational,4|5,7,4/5,210261,4
5,1,21,262,1,933,1,13,6,6,7,single-choice,spatial-relational,6|7,7,6/7,210262,6
5,1,21,263,1,992,1,7,3,3,4,single-choice,spatial-relational,3|4,7,3/4,210263,3
5,1,21,264,1,721,1,11,5,5,6,single-choice,spatial-relational,5|6,7,5/6,210264,5
5,1,21,265,1,844,1,13,6,6,7,single-choice,spatial-relational,6|7,7,6/7,210265,6
5,1,21,266,0,985,1,7,3,4,4,single-choice,spatial-relational,3|4,7,3/4,210266,3
5,1,21,267,1,1326,1,11,5,5,6,single-choice,spatial-relational,5|6,7,5/6,210267,5
5,1,21,268,1,1027,1,5,2,2,3,single-choice,spatial-relational,2|3,7,2/3,210268,2
5,1,21,269,1,806,1,9,4,4,5,single-choice,spatial-relational,4|5,7,4/5,210269,4
5,1,21,270,1,1098,1,11,5,5,6,single-choice,spatial-relational,5|6,7,5/6,210270,5
5,1,21,271,0,914,1,3,1,2,2,single-choice,spatial-relational,1|2,7,1/2,210271,1
5,1,21,272,1,978,1,7,3,3,4,single-choice,spatial-relational,3|4,7,3/4,210272,3
5,1,21,273,1,894,1,5,2,2,3,single-choice,spatial-relational,2|3,7,2/3,210273,2
5,1,21,274,0,890,1,9,4,5,5,single-choice,spatial-relational,4|5,7,4/5,210274,4
5,1,21,275,1,915,1,3,1,1,2,single-choice,spatial-relational,1|2,7,1/2,210275,1
5,1,21,276,1,826,1,13,6,6,7,single-choice,spatial-relational,6|7,7,6/7,210276,6
5,1,21,277,0,785,1,11,5,6,6,single-choice,spatial-relational,5|6,7,5/6,210277,5
5,1,21,278,1,967,1,3,1,1,2,single-choice,spatial-relational,1|2,7,1/2,210278,1
5,1,21,279,1,865,1,13,6,6,7,single-choice,spatial-relational,6|7,7,6/7,210279,6
5,1,21,280,0,855,1,9,4,5,5,single-choice,spatial-relational,4|5,7,4/5,210280,4
5,1,21,281,1,851,1,7,3,3,4,single-choice,spatial-relational,3|4,7,3/4,210281,3
5,1,21,282,1,1318,1,7,3,3,4,single-choice,spatial-relational,3|4,7,3/4,210282,3
5,1,21,283,1,778,1,13,6,6,7,single-choice,spatial-relational,6|7,7,6/7,210283,6
5,1,21,284,1,1143,1,5,2,2,3,single-choice,spatial-relational,2|3,7,2/3,210284,2
5,1,21,285,0,675,1,3,1,2,2,single-choice,spatial-relational,1|2,7,1/2,210285,1
5,1,21,286,0,788,1,5,2,3,3,single-choice,spatial-relational,2|3,7,2/3,210286,2
5,1,21,287,0,1134,1,11,5,6,6,single-choice,spatial-relational,5|6,7,5/6,210287,5
5,1,21,288,1,1005,1,9,4,4,5,single-choice,spatial-relational,4|5,7,4/5,210288,4
5,1,21,289,1,1377,1,9,4,4,5,single-choice,spatial-relational,4|5,7,4/5,210289,4
5,1,21,290,0,1342,1,3,1,2,2,single-choice,spatial-relational,1|2,7,1/2,210290,1
5,1,21,291,1,1145,1,13,6,6,7,single-choice,spatial-relational,6|7,7,6/7,210291,6
5,1,21,292,1,1334,1,7,3,3,4,single-choice,spatial-relational,3|4,7,3/4,210292,3
5,1,21,293,1,1212,1,7,3,3,4,single-choice,spatial-relational,3|4,7,3/4,210293,3
5,1,21,294,0,749,1,9,4,5,5,single-choice,spatial-relational,4|5,7,4/5,210294,4
5,1,21,295,0,1094,1,11,5,6,6,single-choice,spatial-relational,5|6,7,5/6,210295,5
5,1,21,296,0,1059,1,5,2,3,3,single-choice,spatial-relational,2|3,7,2/3,210296,2
5,1,21,297,1,1024,1,3,1,1,2,single-choice,spatial-relational,1|2,7,1/2,210297,1
5,1,21,298,1,889,1,13,6,6,7,single-choice,spatial-relational,6|7,7,6/7,210298,6
5,1,21,299,0,1222,1,11,5,6,6,single-choice,spatial-relational,5|6,7,5/6,210299,5
5,1,21,300,0,1850,1,5,2,3,3,single-choice,spatial-relational,2|3,7,2/3,210300,2
5,1,21,301,1,1042,1,13,6,6,7,single-choice,spatial-relational,6|7,7,6/7,210301,6
5,1,21,302,0,954,1,11,5,6,6,single-choice,spatial-relational,5|6,7,5/6,210302,5
5,1,21,303,1,1159,1,5,2,2,3,single-choice,spatial-relational,2|3,7,2/3,210303,2
5,1,21,304,1,1130,1,7,3,3,4,single-choice,spatial-relational,3|4,7,3/4,210304,3
5,1,21,305,0,1163,1,5,2,3,3,single-choice,spatial-relational,2|3,7,2/3,210305,2
5,1,21,306,1,1136,1,13,6,6,7,single-choice,spatial-relational,6|7,7,6/7,210306,6
5,1,21,307,1,931,1,7,3,3,4,single-choice,spatial-relational,3|4,7,3/4,210307,3
5,1,21,308,1,931,1,9,4,4,5,single-choice,spatial-relational,4|5,7,4/5,210308,4
5,1,21,309,1,891,1,11,5,5,6,single-choice,spatial-relational,5|6,7,5/6,210309,5
5,1,21,310,0,820,1,9,4,5,5,single-choice,spatial-relational,4|5,7,4/5,210310,4
5,1,21,311,1,1174,1,3,1,1,2,single-choice,spatial-relational,1|2,7,1/2,210311,1
5,1,21,312,1,931,1,3,1,1,2,single-choice,spatial-relational,1|2,7,1/2,210312,1
5,1,21,313,0,860,1,7,3,4,4,single-choice,spatial-relational,3|4,7,3/4,210313,3
5,1,21,314,1,1252,1,9,4,4,5,single-choice,spatial-relational,4|5,7,4/5,210314,4
5,1,21,315,0,1063,1,11,5,6,6,single-choice,spatial-relational,5|6,7,5/6,210315,5
5,1,21,316,1,1154,1,7,3,3,4,single-choice,spatial-relational,3|4,7,3/4,210316,3
5,1,21,317,0,836,1,3,1,2,2,single-choice,spatial-relational,1|2,7,1/2,210317,1
5,1,21,318,1,928,1,3,1,1,2,single-choice,spatial-relational,1|2,7,1/2,210318,1
5,1,21,319,1,1435,1,9,4,4,5,single-choice,spatial-relational,4|5,7,4/5,210319,4
5,1,21,320,1,859,1,5,2,2,3,single-choice,spatial-relational,2|3,7,2/3,210320,2
5,1,21,321,1,853,1,13,6,6,7,single-choice,spatial-relational,6|7,7,6/7,210321,6
5,1,21,322,1,1435,1,13,6,6,7,single-choice,spatial-relational,6|7,7,6/7,210322,6
5,1,21,323,0,1272,1,5,2,3,3,single-choice,spatial-relational,2|3,7,2/3,210323,2
5,1,21,324,1,1197,1,11,5,5,6,single-choice,spatial-relational,5|6,7,5/6,210324,5
5,1,21,325,0,1263,1,3,1,2,2,single-choice,spatial-relational,1|2,7,1/2,210325,1
5,1,21,326,0,1262,1,5,2,3,3,single-choice,spatial-relational,2|3,7,2/3,210326,2
5,1,21,327,1,1071,1,13,6,6,7,single-choice,spatial-relational,6|7,7,6/7,210327,6
5,1,21,328,1,1121,1,5,2,2,3,single-choice,spatial-relational,2|3,7,2/3,210328,2
5,1,21,329,0,1593,1,7,3,4,4,single-choice,spatial-relational,3|4,7,3/4,210329,3
5,1,21,330,0,1154,1,11,5,6,6,single-choice,spatial-relational,5|6,7,5/6,210330,5
5,1,21,331,0,851,1,9,4,5,5,single-choice,spatial-relational,4|5,7,4/5,210331,4
5,1,21,332,1,1139,1,7,3,3,4,single-choice,spatial-relational,3|4,7,3/4,210332,3
5,1,21,333,1,946,1,9,4,4,5,single-choice,spatial-relational,4|5,7,4/5,210333,4
5,1,21,334,0,761,1,11,5,6,6,single-choice,spatial-relational,5|6,7,5/6,210334,5
5,1,21,335,1,894,1,3,1,1,2,single-choice,spatial-relational,1|2,7,1/2,210335,1
5,1,21,336,1,1299,1,13,6,6,7,single-choice,spatial-relational,6|7,7,6/7,210336,6
5,1,21,337,1,1218,1,13,6,6,7,single-choice,spatial-relational,6|7,7,6/7,210337,6
5,1,21,338,1,1173,1,7,3,3,4,single-choice,spatial-relational,3|4,7,3/4,210338,3
5,1,21,339,1,1016,1,5,2,2,3,single-choice,spatial-relational,2|3,7,2/3,210339,2
5,1,21,340,0,1266,1,11,5,6,6,single-choice,spatial-relational,5|6,7,5/6,210340,5
5,1,21,341,1,1063,1,3,1,1,2,single-choice,spatial-relational,1|2,7,1/2,210341,1
5,1,21,342,1,1446,1,11,5,5,6,single-choice,spatial-relational,5|6,7,5/6,210342,5
5,1,21,343,1,1168,1,9,4,4,5,single-choice,spatial-relational,4|5,7,4/5,210343,4
5,1,21,344,0,927,1,3,1,2,2,single-choice,spatial-relational,1|2,7,1/2,210344,1
5,1,21,345,0,1707,1,9,4,5,5,single-choice,spatial-relational,4|5,7,4/5,210345,4
5,1,21,346,0,853,1,5,2,3,3,single-choice,spatial-relational,2|3,7,2/3,210346,2
5,1,21,347,1,989,1,13,6,6,7,single-choice,spatial-relational,6|7,7,6/7,210347,6
5,1,21,348,0,1147,1,7,3,4,4,single-choice,spatial-relational,3|4,7,3/4,210348,3
5,1,21,349,0,981,1,9,4,5,5,single-choice,spatial-relational,4|5,7,4/5,210349,4
5,1,21,350,1,868,1,7,3,3,4,single-choice,spatial-relational,3|4,7,3/4,210350,3
5,1,21,351,1,903,1,11,5,5,6,single-choice,spatial-relational,5|6,7,5/6,210351,5
5,1,21,352,0,1104,1,11,5,6,6,single-choice,spatial-relational,5|6,7,5/6,210352,5
5,1,21,353,1,1299,1,3,1,1,2,single-choice,spatial-relational,1|2,7,1/2,210353,1
5,1,21,354,1,1342,1,5,2,2,3,single-choice,spatial-relational,2|3,7,2/3,210354,2
5,1,21,355,1,832,1,13,6,6,7,single-choice,spatial-relational,6|7,7,6/7,210355,6
5,1,21,356,1,1344,1,7,3,3,4,single-choice,spatial-relational,3|4,7,3/4,210356,3
5,1,21,357,0,688,1,13,6,7,7,single-choice,spatial-relational,6|7,7,6/7,210357,6
5,1,21,358,0,1047,1,5,2,3,3,single-choice,spatial-relational,2|3,7,2/3,210358,2
5,1,21,359,1,966,1,9,4,4,5,single-choice,spatial-relational,4|5,7,4/5,210359,4
5,1,21,360,1,925,1,3,1,1,2,single-choice,spatial-relational,1|2,7,1/2,210360,1
5,1,21,361,0,906,1,11,5,6,6,single-choice,spatial-relational,5|6,7,5/6,210361,5
5,1,21,362,1,869,1,13,6,6,7,single-choice,spatial-relational,6|7,7,6/7,210362,6
5,1,21,363,1,1338,1,13,6,6,7,single-choice,spatial-relational,6|7,7,6/7,210363,6
5,1,21,364,0,852,1,11,5,6,6,single-choice,spatial-relational,5|6,7,5/6,210364,5
5,1,21,365,0,919,1,9,4,5,5,single-choice,spatial-relational,4|5,7,4/5,210365,4
5,1,21,366,1,984,1,7,3,3,4,single-choice,spatial-relational,3|4,7,3/4,210366,3
5,1,21,367,1,972,1,9,4,4,5,single-choice,spatial-relational,4|5,7,4/5,210367,4
5,1,21,368,1,1070,1,5,2,2,3,single-choice,spatial-relational,2|3,7,2/3,210368,2
5,1,21,369,0,988,1,3,1,2,2,single-choice,spatial-relational,1|2,7,1/2,210369,1
5,1,21,370,1,1083,1,7,3,3,4,single-choice,spatial-relational,3|4,7,3/4,210370,3
5,1,21,371,0,883,1,3,1,2,2,single-choice,spatial-relational,1|2,7,1/2,210371,1
5,1,21,372,0,972,1,5,2,3,3,single-choice,spatial-relational,2|3,7,2/3,210372,2
5,1,21,373,0,1140,1,11,5,6,6,single-choice,spatial-relational,5|6,7,5/6,210373,5
5,1,21,374,1,917,1,3,1,1,2,single-choice,spatial-relational,1|2,7,1/2,210374,1
5,1,21,375,1,1080,1,9,4,4,5,single-choice,spatial-relational,4|5,7,4/5,210375,4
5,1,21,376,0,1007,1,11,5,6,6,single-choice,spatial-relational,5|6,7,5/6,210376,5
5,1,21,377,1,1024,1,5,2,2,3,single-choice,spatial-relational,2|3,7,2/3,210377,2
5,1,21,378,1,1029,1,13,6,6,7,single-choice,spatial-relational,6|7,7,6/7,210378,6
5,1,21,379,0,1329,1,7,3,4,4,single-choice,spatial-relational,3|4,7,3/4,210379,3
5,1,21,380,0,1578,1,5,2,3,3,single-choice,spatial-relational,2|3,7,2/3,210380,2
5,1,21,381,1,1060,1,3,1,1,2,single-choice,spatial-relational,1|2,7,1/2,210381,1
5,1,21,382,0,1204,1,9,4,5,5,single-choice,spatial-relational,4|5,7,4/5,210382,4
5,1,21,383,1,1016,1,7,3,3,4,single-choice,spatial-relational,3|4,7,3/4,210383,3
5,1,21,384,0,657,1,13,6,7,7,single-choice,spatial-relational,6|7,7,6/7,210384,6
5,1,21,385,1,1012,1,13,6,6,7,single-choice,spatial-relational,6|7,7,6/7,210385,6
5,1,21,386,1,1128,1,5,2,2,3,single-choice,spatial-relational,2|3,7,2/3,210386,2
5,1,21,387,1,869,1,11,5,5,6,single-choice,spatial-relational,5|6,7,5/6,210387,5
5,1,21,388,0,861,1,9,4,5,5,single-choice,spatial-relational,4|5,7,4/5,210388,4
5,1,21,389,1,1169,1,3,1,1,2,single-choice,spatial-relational,1|2,7,1/2,210389,1
5,1,21,390,1,775,1,13,6,6,7,single-choice,spatial-relational,6|7,7,6/7,210390,6
5,1,21,391,0,813,1,3,1,2,2,single-choice,spatial-relational,1|2,7,1/2,210391,1
5,1,21,392,1,1160,1,11,5,5,6,single-choice,spatial-relational,5|6,7,5/6,210392,5
5,1,21,393,1,1278,1,7,3,3,4,single-choice,spatial-relational,3|4,7,3/4,210393,3
5,1,21,394,1,884,1,7,3,3,4,single-choice,spatial-relational,3|4,7,3/4,210394,3
5,1,21,395,1,1678,1,9,4,4,5,single-choice,spatial-relational,4|5,7,4/5,210395,4
5,1,21,396,0,661,1,5,2,3,3,single-choice,spatial-relational,2|3,7,2/3,210396,2
5,1,21,397,0,1241,1,11,5,6,6,single-choice,spatial-relational,5|6,7,5/6,210397,5
5,1,21,398,1,1018,1,9,4,4,5,single-choice,spatial-relational,4|5,7,4/5,210398,4
5,1,21,399,1,939,1,13,6,6,7,single-choice,spatial-relational,6|7,7,6/7,210399,6
5,1,21,400,1,1127,1,7,3,3,4,single-choice,spatial-relational,3|4,7,3/4,210400,3
5,1,21,401,1,922,1,5,2,2,3,single-choice,spatial-relational,2|3,7,2/3,210401,2
5,1,21,402,0,739,1,11,5,6,6,single-choice,spatial-relational,5|6,7,5/6,210402,5
5,1,21,403,1,1044,1,5,2,2,3,single-choice,spatial-relational,2|3,7,2/3,210403,2
5,1,21,404,1,888,1,13,6,6,7,single-choice,spatial-relational,6|7,7,6/7,210404,6
5,1,21,405,1,932,1,7,3,3,4,single-choice,spatial-relational,3|4,7,3/4,210405,3
5,1,21,406,0,776,1,3,1,2,2,single-choice,spatial-relational,1|2,7,1/2,210406,1
5,1,21,407,1,1243,1,9,4,4,5,single-choice,spatial-relational,4|5,7,4/5,210407,4
5,1,21,408,1,994,1,3,1,1,2,single-choice,spatial-relational,1|2,7,1/2,210408,1
5,1,21,409,0,1120,1,9,4,5,5,single-choice,spatial-relational,4|5,7,4/5,210409,4
5,1,21,410,0,1450,1,11,5,6,6,single-choice,spatial-relational,5|6,7,5/6,210410,5
5,1,21,411,1,992,1,7,3,3,4,single-choice,spatial-relational,3|4,7,3/4,210411,3
5,1,21,412,1,1118,1,5,2,2,3,single-choice,spatial-relational,2|3,7,2/3,210412,2
5,1,21,413,0,1152,1,5,2,3,3,single-choice,spatial-relational,2|3,7,2/3,210413,2
5,1,21,414,1,1159,1,11,5,5,6,single-choice,spatial-relational,5|6,7,5/6,210414,5
5,1,21,415,1,1007,1,13,6,6,7,single-choice,spatial-relational,6|7,7,6/7,210415,6
5,1,21,416,0,959,1,3,1,2,2,single-choice,spatial-relational,1|2,7,1/2,210416,1
5,1,21,417,1,67,1,3,1,1,2,single-choice,spatial-relational,1|2,7,1/2,210417,1
5,1,21,418,1,792,1,7,3,3,4,single-choice,spatial-relational,3|4,7,3/4,210418,3
5,1,21,419,1,940,1,13,6,6,7,single-choice,spatial-relational,6|7,7,6/7,210419,6
5,1,21,420,0,918,1,9,4,5,5,single-choice,spatial-relational,4|5,7,4/5,210420,4
5,1,21,421,0,1239,1,11,5,6,6,single-choice,spatial-relational,5|6,7,5/6,210421,5
5,1,21,422,0,975,1,9,4,5,5,single-choice,spatial-relational,4|5,7,4/5,210422,4
5,1,21,423,1,992,1,7,3,3,4,single-choice,spatial-relational,3|4,7,3/4,210423,3
5,1,21,424,1,811,1,5,2,2,3,single-choice,spatial-relational,2|3,7,2/3,210424,2
5,1,21,425,0,970,1,3,1,2,2,single-choice,spatial-relational,1|2,7,1/2,210425,1
5,1,21,426,0,1024,1,5,2,3,3,single-choice,spatial-relational,2|3,7,2/3,210426,2
5,1,21,427,1,948,1,11,5,5,6,single-choice,spatial-relational,5|6,7,5/6,210427,5
5,1,21,428,1,994,1,9,4,4,5,single-choice,spatial-relational,4|5,7,4/5,210428,4
5,1,21,429,1,1427,1,7,3,3,4,single-choice,spatial-relational,3|4,7,3/4,210429,3
5,1,21,430,1,807,1,13,6,6,7,single-choice,spatial-relational,6|7,7,6/7,210430,6
5,1,21,431,1,846,1,13,6,6,7,single-choice,spatial-relational,6|7,7,6/7,210431,6
5,1,21,432,0,816,1,3,1,2,2,single-choice,spatial-relational,1|2,7,1/2,210432,1
5,1,21,433,1,937,1,7,3,3,4,single-choice,spatial-relational,3|4,7,3/4,210433,3
5,1,21,434,0,989,1,3,1,2,2,single-choice,spatial-relational,1|2,7,1/2,210434,1
5,1,21,435,1,1178,1,13,6,6,7,single-choice,spatial-relational,6|7,7,6/7,210435,6
5,1,21,436,0,1195,1,11,5,6,6,single-choice,spatial-relational,5|6,7,5/6,210436,5
5,1,21,437,1,924,1,9,4,4,5,single-choice,spatial-relational,4|5,7,4/5,210437,4
5,1,21,438,1,1162,1,7,3,3,4,single-choice,spatial-relational,3|4,7,3/4,210438,3
5,1,21,439,1,1061,1,3,1,1,2,single-choice,spatial-relational,1|2,7,1/2,210439,1
5,1,21,440,1,1213,1,9,4,4,5,single-choice,spatial-relational,4|5,7,4/5,210440,4
5,1,21,441,0,757,1,5,2,3,3,single-choice,spatial-relational,2|3,7,2/3,210441,2
5,1,21,442,1,1618,1,5,2,2,3,single-choice,spatial-relational,2|3,7,2/3,210442,2
5,1,21,443,1,863,1,13,6,6,7,single-choice,spatial-relational,6|7,7,6/7,210443,6
5,1,21,444,0,992,1,11,5,6,6,single-choice,spatial-relational,5|6,7,5/6,210444,5
5,1,21,445,0,1238,1,9,4,5,5,single-choice,spatial-relational,4|5,7,4/5,210445,4
5,1,21,446,1,1069,1,3,1,1,2,single-choice,spatial-relational,1|2,7,1/2,210446,1
5,1,21,447,0,1080,1,11,5,6,6,single-choice,spatial-relational,5|6,7,5/6,210447,5
5,1,21,448,1,883,1,7,3,3,4,single-choice,spatial-relational,3|4,7,3/4,210448,3
5,1,21,449,0,786,1,3,1,2,2,single-choice,spatial-relational,1|2,7,1/2,210449,1
5,1,21,450,1,1185,1,11,5,5,6,single-choice,spatial-relational,5|6,7,5/6,210450,5
5,1,21,451,1,1627,1,7,3,3,4,single-choice,spatial-relational,3|4,7,3/4,210451,3
5,1,21,452,1,877,1,13,6,6,7,single-choice,spatial-relational,6|7,7,6/7,210452,6
5,1,21,453,0,885,1,5,2,3,3,single-choice,spatial-relational,2|3,7,2/3,210453,2
5,1,21,454,1,906,1,5,2,2,3,single-choice,spatial-relational,2|3,7,2/3,210454,2
5,1,21,455,1,726,1,9,4,4,5,single-choice,spatial-relational,4|5,7,4/5,210455,4
5,1,21,456,1,672,1,13,6,6,7,single-choice,spatial-relational,6|7,7,6/7,210456,6
5,1,21,457,1,1348,1,3,1,1,2,single-choice,spatial-relational,1|2,7,1/2,210457,1
5,1,21,458,0,735,1,11,5,6,6,single-choice,spatial-relational,5|6,7,5/6,210458,5
5,1,21,459,1,1924,1,9,4,4,5,single-choice,spatial-relational,4|5,7,4/5,210459,4
5,1,21,460,0,1220,1,9,4,5,5,single-choice,spatial-relational,4|5,7,4/5,210460,4
5,1,21,461,1,1143,1,7,3,3,4,single-choice,spatial-relational,3|4,7,3/4,210461,3
5,1,21,462,1,933,1,3,1,1,2,single-choice,spatial-relational,1|2,7,1/2,210462,1
5,1,21,463,1,814,1,13,6,6,7,single-choice,spatial-relational,6|7,7,6/7,210463,6
5,1,21,464,0,1452,1,5,2,3,3,single-choice,spatial-relational,2|3,7,2/3,210464,2
5,1,21,465,1,844,1,7,3,3,4,single-choice,spatial-relational,3|4,7,3/4,210465,3
5,1,21,466,0,1135,1,5,2,3,3,single-choice,spatial-relational,2|3,7,2/3,210466,2
5,1,21,467,1,1134,1,13,6,6,7,single-choice,spatial-relational,6|7,7,6/7,210467,6
5,1,21,468,1,1259,1,11,5,5,6,single-choice,spatial-relational,5|6,7,5/6,210468,5
5,1,21,469,1,1368,1,5,2,2,3,single-choice,spatial-relational,2|3,7,2/3,210469,2
5,1,21,470,1,1016,1,11,5,5,6,single-choice,spatial-relational,5|6,7,5/6,210470,5
5,1,21,471,0,1152,1,7,3,4,4,single-choice,spatial-relational,3|4,7,3/4,210471,3
5,1,21,472,1,1693,1,13,6,6,7,single-choice,spatial-relational,6|7,7,6/7,210472,6
5,1,21,473,1,1318,1,7,3,3,4,single-choice,spatial-relational,3|4,7,3/4,210473,3
5,1,21,474,1,2040,1,9,4,4,5,single-choice,spatial-relational,4|5,7,4/5,210474,4
5,1,21,475,1,1179,1,9,4,4,5,single-choice,spatial-relational,4|5,7,4/5,210475,4
5,1,21,476,0,927,1,3,1,2,2,single-choice,spatial-relational,1|2,7,1/2,210476,1
5,1,21,477,1,1047,1,3,1,1,2,single-choice,spatial-relational,1|2,7,1/2,210477,1
5,1,21,478,1,979,1,13,6,6,7,single-choice,spatial-relational,6|7,7,6/7,210478,6
5,1,21,479,0,1384,1,11,5,6,6,single-choice,spatial-relational,5|6,7,5/6,210479,5
5,1,21,480,1,910,1,5,2,2,3,single-choice,spatial-relational,2|3,7,2/3,210480,2
5,1,21,481,1,1060,1,13,6,6,7,single-choice,spatial-relational,6|7,7,6/7,210481,6
5,1,21,482,0,922,1,11,5,6,6,single-choice,spatial-relational,5|6,7,5/6,210482,5
5,1,21,483,1,908,1,3,1,1,2,single-choice,spatial-relational,1|2,7,1/2,210483,1
5,1,21,484,0,1693,1,9,4,5,5,single-choice,spatial-relational,4|5,7,4/5,210484,4
5,1,21,485,1,1153,1,3,1,1,2,single-choice,spatial-relational,1|2,7,1/2,210485,1
5,1,21,486,1,1390,1,5,2,2,3,single-choice,spatial-relational,2|3,7,2/3,210486,2
5,1,21,487,1,1150,1,9,4,4,5,single-choice,spatial-relational,4|5,7,4/5,210487,4
5,1,21,488,1,1005,1,7,3,3,4,single-choice,spatial-relational,3|4,7,3/4,210488,3
5,1,21,489,1,700,1,13,6,6,7,single-choice,spatial-relational,6|7,7,6/7,210489,6
5,1,21,490,0,934,1,7,3,4,4,single-choice,spatial-relational,3|4,7,3/4,210490,3
5,1,21,491,1,1043,1,11,5,5,6,single-choice,spatial-relational,5|6,7,5/6,210491,5
5,1,21,492,1,1255,1,5,2,2,3,single-choice,spatial-relational,2|3,7,2/3,210492,2
5,1,21,493,1,1018,1,13,6,6,7,single-choice,spatial-relational,6|7,7,6/7,210493,6
5,1,21,494,0,1490,1,3,1,2,2,single-choice,spatial-relational,1|2,7,1/2,210494,1
5,1,21,495,0,913,1,5,2,3,3,single-choice,spatial-relational,2|3,7,2/3,210495,2
5,1,21,496,1,1044,1,13,6,6,7,single-choice,spatial-relational,6|7,7,6/7,210496,6
5,1,21,497,0,1159,1,7,3,4,4,single-choice,spatial-relational,3|4,7,3/4,210497,3
5,1,21,498,0,70,1,3,1,2,2,single-choice,spatial-relational,1|2,7,1/2,210498,1
5,1,21,499,0,914,1,9,4,5,5,single-choice,spatial-relational,4|5,7,4/5,210499,4
5,1,21,500,1,903,1,7,3,3,4,single-choice,spatial-relational,3|4,7,3/4,210500,3
5,1,21,501,1,1178,1,9,4,4,5,single-choice,spatial-relational,4|5,7,4/5,210501,4
5,1,21,502,0,1033,1,11,5,6,6,single-choice,spatial-relational,5|6,7,5/6,210502,5
5,1,21,503,0,1365,1,5,2,3,3,single-choice,spatial-relational,2|3,7,2/3,210503,2
5,1,21,504,0,957,1,11,5,6,6,single-choice,spatial-relational,5|6,7,5/6,210504,5
5,1,21,505,0,928,1,5,2,3,3,single-choice,spatial-relational,2|3,7,2/3,210505,2
5,1,21,506,1,1175,1,9,4,4,5,single-choice,spatial-relational,4|5,7,4/5,210506,4
5,1,21,507,1,1202,1,11,5,5,6,single-choice,spatial-relational,5|6,7,5/6,210507,5
5,1,21,508,0,883,1,3,1,2,2,single-choice,spatial-relational,1|2,7,1/2,210508,1
5,1,21,509,1,1116,1,9,4,4,5,single-choice,spatial-relational,4|5,7,4/5,210509,4
5,1,21,510,1,1008,1,13,6,6,7,single-choice,spatial-relational,6|7,7,6/7,210510,6
5,1,21,511,1,1085,1,7,3,3,4,single-choice,spatial-relational,3|4,7,3/4,210511,3
5,1,21,512,1,837,1,7,3,3,4,single-choice,spatial-relational,3|4,7,3/4,210512,3
5,1,21,513,1,939,1,5,2,2,3,single-choice,spatial-relational,2|3,7,2/3,210513,2
5,1,21,514,1,1276,1,3,1,1,2,single-choice,spatial-relational,1|2,7,1/2,210514,1
5,1,21,515,0,1554,1,11,5,6,6,single-choice,spatial-relational,5|6,7,5/6,210515,5
5,1,21,516,0,1440,1,13,6,7,7,single-choice,spatial-relational,6|7,7,6/7,210516,6
5,1,21,517,0,1130,1,9,4,5,5,single-choice,spatial-relational,4|5,7,4/5,210517,4
5,1,21,518,0,1058,1,11,5,6,6,single-choice,spatial-relational,5|6,7,5/6,210518,5
5,1,21,519,0,1265,1,7,3,4,4,single-choice,spatial-relational,3|4,7,3/4,210519,3
5,1,21,520,1,1106,1,9,4,4,5,single-choice,spatial-relational,4|5,7,4/5,210520,4
5,1,21,521,1,1166,1,13,6,6,7,single-choice,spatial-relational,6|7,7,6/7,210521,6
5,1,21,522,1,1109,1,13,6,6,7,single-choice,spatial-relational,6|7,7,6/7,210522,6
5,1,21,523,0,944,1,3,1,2,2,single-choice,spatial-relational,1|2,7,1/2,210523,1
5,1,21,524,1,1106,1,11,5,5,6,single-choice,spatial-relational,5|6,7,5/6,210524,5
5,1,21,525,1,1594,1,7,3,3,4,single-choice,spatial-relational,3|4,7,3/4,210525,3
5,1,21,526,1,901,1,5,2,2,3,single-choice,spatial-relational,2|3,7,2/3,210526,2
5,1,21,527,0,1240,1,3,1,2,2,single-choice,spatial-relational,1|2,7,1/2,210527,1
5,1,21,528,0,92,1,5,2,3,3,single-choice,spatial-relational,2|3,7,2/3,210528,2
5,1,21,529,0,890,1,3,1,2,2,single-choice,spatial-relational,1|2,7,1/2,210529,1
5,1,21,530,0,555,1,5,2,3,3,single-choice,spatial-relational,2|3,7,2/3,210530,2
5,1,21,531,1,1330,1,13,6,6,7,single-choice,spatial-relational,6|7,7,6/7,210531,6
5,1,21,532,1,916,1,9,4,4,5,single-choice,spatial-relational,4|5,7,4/5,210532,4
5,1,21,533,0,1025,1,11,5,6,6,single-choice,spatial-relational,5|6,7,5/6,210533,5
5,1,21,534,1,1082,1,3,1,1,2,single-choice,spatial-relational,1|2,7,1/2,210534,1
5,1,21,535,1,976,1,9,4,4,5,single-choice,spatial-relational,4|5,7,4/5,210535,4
5,1,21,536,1,812,1,5,2,2,3,single-choice,spatial-relational,2|3,7,2/3,210536,2
5,1,21,537,1,802,1,11,5,5,6,single-choice,spatial-relational,5|6,7,5/6,210537,5
5,1,21,538,0,794,1,7,3,4,4,single-choice,spatial-relational,3|4,7,3/4,210538,3
5,1,21,539,1,1427,1,7,3,3,4,single-choice,spatial-relational,3|4,7,3/4,210539,3
5,1,21,540,1,1149,1,13,6,6,7,single-choice,spatial-relational,6|7,7,6/7,210540,6
5,1,21,541,1,962,1,13,6,6,7,single-choice,spatial-relational,6|7,7,6/7,210541,6
5,1,21,542,1,1049,1,3,1,1,2,single-choice,spatial-relational,1|2,7,1/2,210542,1
5,1,21,543,0,9,1,5,2,3,3,single-choice,spatial-relational,2|3,7,2/3,210543,2
5,1,21,544,1,971,1,13,6,6,7,single-choice,spatial-relational,6|7,7,6/7,210544,6
5,1,21,545,1,936,1,5,2,2,3,single-choice,spatial-relational,2|3,7,2/3,210545,2
5,1,21,546,1,1562,1,9,4,4,5,single-choice,spatial-relational,4|5,7,4/5,210546,4
5,1,21,547,0,764,1,3,1,2,2,single-choice,spatial-relational,1|2,7,1/2,210547,1
5,1,21,548,1,1051,1,9,4,4,5,single-choice,spatial-relational,4|5,7,4/5,210548,4
5,1,21,549,1,723,1,11,5,5,6,single-choice,spatial-relational,5|6,7,5/6,210549,5
5,1,21,550,1,1342,1,7,3,3,4,single-choice,spatial-relational,3|4,7,3/4,210550,3
5,1,21,551,0,799,1,11,5,6,6,single-choice,spatial-relational,5|6,7,5/6,210551,5
5,1,21,552,1,1191,1,7,3,3,4,single-choice,spatial-relational,3|4,7,3/4,210552,3
5,1,21,553,0,1717,1,11,5,6,6,single-choice,spatial-relational,5|6,7,5/6,210553,5
5,1,21,554,1,1053,1,13,6,6,7,single-choice,spatial-relational,6|7,7,6/7,210554,6
5,1,21,555,0,1499,1,7,3,4,4,single-choice,spatial-relational,3|4,7,3/4,210555,3
5,1,21,556,1,1035,1,3,1,1,2,single-choice,spatial-relational,1|2,7,1/2,210556,1
5,1,21,557,0,853,1,5,2,3,3,single-choice,spatial-relational,2|3,7,2/3,210557,2
5,1,21,558,1,865,1,7,3,3,4,single-choice,spatial-relational,3|4,7,3/4,210558,3
5,1,21,559,0,867,1,11,5,6,6,single-choice,spatial-relational,5|6,7,5/6,210559,5
5,1,21,560,0,1149,1,13,6,7,7,single-choice,spatial-relational,6|7,7,6/7,210560,6
5,1,21,561,0,1697,1,3,1,2,2,single-choice,spatial-relational,1|2,7,1/2,210561,1
5,1,21,562,1,1258,1,9,4,4,5,single-choice,spatial-relational,4|5,7,4/5,210562,4
5,1,21,563,1,865,1,9,4,4,5,single-choice,spatial-relational,4|5,7,4/5,210563,4
5,1,21,564,0,1150,1,5,2,3,3,single-choice,spatial-relational,2|3,7,2/3,210564,2
5,1,21,565,1,879,1,7,3,3,4,single-choice,spatial-relational,3|4,7,3/4,210565,3
5,1,21,566,1,913,1,5,2,2,3,single-choice,spatial-relational,2|3,7,2/3,210566,2
5,1,21,567,1,737,1,5,2,2,3,single-choice,spatial-relational,2|3,7,2/3,210567,2
5,1,21,568,1,987,1,9,4,4,5,single-choice,spatial-relational,4|5,7,4/5,210568,4
5,1,21,569,0,984,1,11,5,6,6,single-choice,spatial-relational,5|6,7,5/6,210569,5
5,1,21,570,1,888,1,3,1,1,2,single-choice,spatial-relational,1|2,7,1/2,210570,1
5,1,21,571,1,1062,1,3,1,1,2,single-choice,spatial-relational,1|2,7,1/2,210571,1
5,1,21,572,1,563,1,13,6,6,7,single-choice,spatial-relational,6|7,7,6/7,210572,6
5,1,21,573,1,1423,1,9,4,4,5,single-choice,spatial-relational,4|5,7,4/5,210573,4
5,1,21,574,1,871,1,13,6,6,7,single-choice,spatial-relational,6|7,7,6/7,210574,6
5,1,21,575,0,857,1,11,5,6,6,single-choice,spatial-relational,5|6,7,5/6,210575,5
5,1,21,576,1,1360,1,7,3,3,4,single-choice,spatial-relational,3|4,7,3/4,210576,3
5,1,21,577,1,1093,1,13,6,6,7,single-choice,spatial-relational,6|7,7,6/7,210577,6
5,1,21,578,0,1848,1,13,6,7,7,single-choice,spatial-relational,6|7,7,6/7,210578,6
5,1,21,579,1,834,1,3,1,1,2,single-choice,spatial-relational,1|2,7,1/2,210579,1
5,1,21,580,0,1049,1,11,5,6,6,single-choice,spatial-relational,5|6,7,5/6,210580,5
5,1,21,581,1,1112,1,3,1,1,2,single-choice,spatial-relational,1|2,7,1/2,210581,1
5,1,21,582,1,888,1,7,3,3,4,single-choice,spatial-relational,3|4,7,3/4,210582,3
5,1,21,583,1,790,1,5,2,2,3,single-choice,spatial-relational,2|3,7,2/3,210583,2
5,1,21,584,1,1046,1,7,3,3,4,single-choice,spatial-relational,3|4,7,3/4,210584,3
5,1,21,585,0,793,1,9,4,5,5,single-choice,spatial-relational,4|5,7,4/5,210585,4
5,1,21,586,0,1535,1,5,2,3,3,single-choice,spatial-relational,2|3,7,2/3,210586,2
5,1,21,587,1,1485,1,9,4,4,5,single-choice,spatial-relational,4|5,7,4/5,210587,4
5,1,21,588,1,1665,1,11,5,5,6,single-choice,spatial-relational,5|6,7,5/6,210588,5
5,1,21,589,1,1135,1,5,2,2,3,single-choice,spatial-relational,2|3,7,2/3,210589,2
5,1,21,590,1,759,1,7,3,3,4,single-choice,spatial-relational,3|4,7,3/4,210590,3
5,1,21,591,0,803,1,9,4,5,5,single-choice,spatial-relational,4|5,7,4/5,210591,4
5,1,21,592,1,1496,1,13,6,6,7,single-choice,spatial-relational,6|7,7,6/7,210592,6
5,1,21,593,1,967,1,3,1,1,2,single-choice,spatial-relational,1|2,7,1/2,210593,1
5,1,21,594,0,1370,1,11,5,6,6,single-choice,spatial-relational,5|6,7,5/6,210594,5
5,1,21,595,1,1119,1,5,2,2,3,single-choice,spatial-relational,2|3,7,2/3,210595,2
5,1,21,596,1,995,1,13,6,6,7,single-choice,spatial-relational,6|7,7,6/7,210596,6
5,1,21,597,1,1088,1,7,3,3,4,single-choice,spatial-relational,3|4,7,3/4,210597,3
5,1,21,598,1,1152,1,11,5,5,6,single-choice,spatial-relational,5|6,7,5/6,210598,5
5,1,21,599,1,840,1,3,1,1,2,single-choice,spatial-relational,1|2,7,1/2,210599,1
5,1,21,600,1,693,1,9,4,4,5,single-choice,spatial-relational,4|5,7,4/5,210600,4
6,1,21,1,0,24,1,13,6,7,7,single-choice,spatial-relational,6|7,7,6/7,210001,6
6,1,21,2,1,643,1,11,5,5,6,single-choice,spatial-relational,5|6,7,5/6,210002,5
6,1,21,3,1,599,1,13,6,6,7,single-choice,spatial-relational,6|7,7,6/7,210003,6
6,1,21,4,1,803,1,3,1,1,2,single-choice,spatial-relational,1|2,7,1/2,210004,1
6,1,21,5,0,594,1,3,1,2,2,single-choice,spatial-relational,1|2,7,1/2,210005,1
6,1,21,6,0,804,1,7,3,4,4,single-choice,spatial-relational,3|4,7,3/4,210006,3
6,1,21,7,0,745,1,5,2,3,3,single-choice,spatial-relational,2|3,7,2/3,210007,2
6,1,21,8,1,544,1,9,4,4,5,single-choice,spatial-relational,4|5,7,4/5,210008,4
6,1,21,9,1,483,1,9,4,4,5,single-choice,spatial-relational,4|5,7,4/5,210009,4
6,1,21,10,0,427,1,7,3,4,4,single-choice,spatial-relational,3|4,7,3/4,210010,3
6,1,21,11,0,547,1,5,2,3,3,single-choice,spatial-relational,2|3,7,2/3,210011,2
6,1,21,12,0,546,1,11,5,6,6,single-choice,spatial-relational,5|6,7,5/6,210012,5
6,1,21,13,0,800,1,3,1,2,2,single-choice,spatial-relational,1|2,7,1/2,210013,1
6,1,21,14,0,772,1,5,2,3,3,single-choice,spatial-relational,2|3,7,2/3,210014,2
6,1,21,15,0,653,1,3,1,2,2,single-choice,spatial-relational,1|2,7,1/2,210015,1
6,1,21,16,0,539,1,7,3,4,4,single-choice,spatial-relational,3|4,7,3/4,210016,3
6,1,21,17,0,665,1,11,5,6,6,single-choice,spatial-relational,5|6,7,5/6,210017,5
6,1,21,18,1,596,1,9,4,4,5,single-choice,spatial-relational,4|5,7,4/5,210018,4
6,1,21,19,1,853,1,9,4,4,5,single-choice,spatial-relational,4|5,7,4/5,210019,4
6,1,21,20,1,760,1,13,6,6,7,single-choice,spatial-relational,6|7,7,6/7,210020,6
6,1,21,21,1,817,1,13,6,6,7,single-choice,spatial-relational,6|7,7,6/7,210021,6
6,1,21,22,0,730,1,5,2,3,3,single-choice,spatial-relational,2|3,7,2/3,210022,2
6,1,21,23,1,1002,1,11,5,5,6,single-choice,spatial-relational,5|6,7,5/6,210023,5
6,1,21,24,0,798,1,7,3,4,4,single-choice,spatial-relational,3|4,7,3/4,210024,3
6,1,21,25,1,689,1,13,6,6,7,single-choice,spatial-relational,6|7,7,6/7,210025,6
6,1,21,26,0,816,1,7,3,4,4,single-choice,spatial-relational,3|4,7,3/4,210026,3
6,1,21,27,0,750,1,5,2,3,3,single-choice,spatial-relational,2|3,7,2/3,210027,2
6,1,21,28,0,557,1,11,5,6,6,single-choice,spatial-relational,5|6,7,5/6,210028,5
6,1,21,29,0,536,1,7,3,4,4,single-choice,spatial-relational,3|4,7,3/4,210029,3
6,1,21,30,1,600,1,13,6,6,7,single-choice,spatial-relational,6|7,7,6/7,210030,6
6,1,21,31,1,865,1,3,1,1,2,single-choice,spatial-relational,1|2,7,1/2,210031,1
6,1,21,32,0,640,1,11,5,6,6,single-choice,spatial-relational,5|6,7,5/6,210032,5
6,1,21,33,1,940,1,5,2,2,3,single-choice,spatial-relational,2|3,7,2/3,210033,2
6,1,21,34,1,608,1,9,4,4,5,single-choice,spatial-relational,4|5,7,4/5,210034,4
6,1,21,35,1,889,1,9,4,4,5,single-choice,spatial-relational,4|5,7,4/5,210035,4
6,1,21,36,0,694,1,3,1,2,2,single-choice,spatial-relational,1|2,7,1/2,210036,1
6,1,21,37,1,705,1,13,6,6,7,single-choice,spatial-relational,6|7,7,6/7,210037,6
6,1,21,38,1,759,1,3,1,1,2,single-choice,spatial-relational,1|2,7,1/2,210038,1
6,1,21,39,0,592,1,3,1,2,2,single-choice,spatial-relational,1|2,7,1/2,210039,1
6,1,21,40,1,531,1,9,4,4,5,single-choice,spatial-relational,4|5,7,4/5,210040,4
6,1,21,41,1,747,1,9,4,4,5,single-choice,spatial-relational,4|5,7,4/5,210041,4
6,1,21,42,0,591,1,7,3,4,4,single-choice,spatial-relational,3|4,7,3/4,210042,3
6,1,21,43,1,590,1,13,6,6,7,single-choice,spatial-relational,6|7,7,6/7,210043,6
6,1,21,44,0,801,1,5,2,3,3,single-choice,spatial-relational,2|3,7,2/3,210044,2
6,1,21,45,0,494,1,11,5,6,6,single-choice,spatial-relational,5|6,7,5/6,210045,5
6,1,21,46,0,596,1,11,5,6,6,single-choice,spatial-relational,5|6,7,5/6,210046,5
6,1,21,47,0,519,1,7,3,4,4,single-choice,spatial-relational,3|4,7,3/4,210047,3
6,1,21,48,0,728,1,5,2,3,3,single-choice,spatial-relational,2|3,7,2/3,210048,2
6,1,21,49,1,725,1,7,3,3,4,single-choice,spatial-relational,3|4,7,3/4,210049,3
6,1,21,50,1,613,1,13,6,6,7,single-choice,spatial-relational,6|7,7,6/7,210050,6
6,1,21,51,1,819,1,13,6,6,7,single-choice,spatial-relational,6|7,7,6/7,210051,6
6,1,21,52,1,784,1,9,4,4,5,single-choice,spatial-relational,4|5,7,4/5,210052,4
6,1,21,53,0,705,1,11,5,6,6,single-choice,spatial-relational,5|6,7,5/6,210053,5
6,1,21,54,1,861,1,7,3,3,4,single-choice,spatial-relational,3|4,7,3/4,210054,3
6,1,21,55,0,776,1,3,1,2,2,single-choice,spatial-relational,1|2,7,1/2,210055,1
6,1,21,56,0,722,1,5,2,3,3,single-choice,spatial-relational,2|3,7,2/3,210056,2
6,1,21,57,0,806,1,5,2,3,3,single-choice,spatial-relational,2|3,7,2/3,210057,2
6,1,21,58,1,960,1,9,4,4,5,single-choice,spatial-relational,4|5,7,4/5,210058,4
6,1,21,59,1,792,1,3,1,1,2,single-choice,spatial-relational,1|2,7,1/2,210059,1
6,1,21,60,0,662,1,11,5,6,6,single-choice,spatial-relational,5|6,7,5/6,210060,5
6,1,21,61,1,877,1,3,1,1,2,single-choice,spatial-relational,1|2,7,1/2,210061,1
6,1,21,62,0,499,1,5,2,3,3,single-choice,spatial-relational,2|3,7,2/3,210062,2
6,1,21,63,0,591,1,7,3,4,4,single-choice,spatial-relational,3|4,7,3/4,210063,3
6,1,21,64,1,783,1,5,2,2,3,single-choice,spatial-relational,2|3,7,2/3,210064,2
6,1,21,65,0,583,1,13,6,7,7,single-choice,spatial-relational,6|7,7,6/7,210065,6
6,1,21,66,1,789,1,7,3,3,4,single-choice,spatial-relational,3|4,7,3/4,210066,3
6,1,21,67,0,831,1,11,5,6,6,single-choice,spatial-relational,5|6,7,5/6,210067,5
6,1,21,68,1,1195,1,11,5,5,6,single-choice,spatial-relational,5|6,7,5/6,210068,5
6,1,21,69,1,873,1,13,6,6,7,single-choice,spatial-relational,6|7,7,6/7,210069,6
6,1,21,70,1,838,1,9,4,4,5,single-choice,spatial-relational,4|5,7,4/5,210070,4
6,1,21,71,1,1164,1,9,4,4,5,single-choice,spatial-relational,4|5,7,4/5,210071,4
6,1,21,72,0,773,1,3,1,2,2,single-choice,spatial-relational,1|2,7,1/2,210072,1
6,1,21,73,0,674,1,3,1,2,2,single-choice,spatial-relational,1|2,7,1/2,210073,1
6,1,21,74,1,847,1,3,1,1,2,single-choice,spatial-relational,1|2,7,1/2,210074,1
6,1,21,75,0,535,1,5,2,3,3,single-choice,spatial-relational,2|3,7,2/3,210075,2
6,1,21,76,0,841,1,11,5,6,6,single-choice,spatial-relational,5|6,7,5/6,210076,5
6,1,21,77,1,544,1,9,4,4,5,single-choice,spatial-relational,4|5,7,4/5,210077,4
6,1,21,78,0,911,1,11,5,6,6,single-choice,spatial-relational,5|6,7,5/6,210078,5
6,1,21,79,1,976,1,9,4,4,5,single-choice,spatial-relational,4|5,7,4/5,210079,4
6,1,21,80,1,1217,1,7,3,3,4,single-choice,spatial-relational,3|4,7,3/4,210080,3
6,1,21,81,1,718,1,5,2,2,3,single-choice,spatial-relational,2|3,7,2/3,210081,2
6,1,21,82,1,711,1,13,6,6,7,single-choice,spatial-relational,6|7,7,6/7,210082,6
6,1,21,83,1,1008,1,13,6,6,7,single-choice,spatial-relational,6|7,7,6/7,210083,6
6,1,21,84,0,1347,1,7,3,4,4,single-choice,spatial-relational,3|4,7,3/4,210084,3
6,1,21,85,0,976,1,5,2,3,3,single-choice,spatial-relational,2|3,7,2/3,210085,2
6,1,21,86,1,862,1,9,4,4,5,single-choice,spatial-relational,4|5,7,4/5,210086,4
6,1,21,87,1,887,1,3,1,1,2,single-choice,spatial-relational,1|2,7,1/2,210087,1
6,1,21,88,0,734,1,7,3,4,4,single-choice,spatial-relational,3|4,7,3/4,210088,3
6,1,21,89,0,691,1,11,5,6,6,single-choice,spatial-relational,5|6,7,5/6,210089,5
6,1,21,90,1,731,1,13,6,6,7,single-choice,spatial-relational,6|7,7,6/7,210090,6
6,1,21,91,0,736,1,3,1,2,2,single-choice,spatial-relational,1|2,7,1/2,210091,1
6,1,21,92,0,834,1,9,4,5,5,single-choice,spatial-relational,4|5,7,4/5,210092,4
6,1,21,93,0,831,1,7,3,4,4,single-choice,spatial-relational,3|4,7,3/4,210093,3
6,1,21,94,0,1146,1,11,5,6,6,single-choice,spatial-relational,5|6,7,5/6,210094,5
6,1,21,95,1,1407,1,5,2,2,3,single-choice,spatial-relational,2|3,7,2/3,210095,2
6,1,21,96,1,744,1,13,6,6,7,single-choice,spatial-relational,6|7,7,6/7,210096,6
6,1,21,97,1,1091,1,3,1,1,2,single-choice,spatial-relational,1|2,7,1/2,210097,1
6,1,21,98,1,779,1,13,6,6,7,single-choice,spatial-relational,6|7,7,6/7,210098,6
6,1,21,99,1,802,1,9,4,4,5,single-choice,spatial-relational,4|5,7,4/5,210099,4
6,1,21,100,0,902,1,3,1,2,2,single-choice,spatial-relational,1|2,7,1/2,210100,1
6,1,21,101,1,669,1,13,6,6,7,single-choice,spatial-relational,6|7,7,6/7,210101,6
6,1,21,102,0,768,1,11,5,6,6,single-choice,spatial-relational,5|6,7,5/6,210102,5
6,1,21,103,1,792,1,7,3,3,4,single-choice,spatial-relational,3|4,7,3/4,210103,3
6,1,21,104,1,797,1,9,4,4,5,single-choice,spatial-relational,4|5,7,4/5,210104,4
6,1,21,105,1,836,1,5,2,2,3,single-choice,spatial-relational,2|3,7,2/3,210105,2
6,1,21,106,1,853,1,5,2,2,3,single-choice,spatial-relational,2|3,7,2/3,210106,2
6,1,21,107,0,587,1,7,3,4,4,single-choice,spatial-relational,3|4,7,3/4,210107,3
6,1,21,108,1,798,1,11,5,5,6,single-choice,spatial-relational,5|6,7,5/6,210108,5
6,1,21,109,1,939,1,9,4,4,5,single-choice,spatial-relational,4|5,7,4/5,210109,4
6,1,21,110,1,783,1,5,2,2,3,single-choice,spatial-relational,2|3,7,2/3,210110,2
6,1,21,111,0,736,1,3,1,2,2,single-choice,spatial-relational,1|2,7,1/2,210111,1
6,1,21,112,1,521,1,9,4,4,5,single-choice,spatial-relational,4|5,7,4/5,210112,4
6,1,21,113,0,785,1,11,5,6,6,single-choice,spatial-relational,5|6,7,5/6,210113,5
6,1,21,114,0,503,1,11,5,6,6,single-choice,spatial-relational,5|6,7,5/6,210114,5
6,1,21,115,1,689,1,13,6,6,7,single-choice,spatial-relational,6|7,7,6/7,210115,6
6,1,21,116,1,765,1,13,6,6,7,single-choice,spatial-relational,6|7,7,6/7,210116,6
6,1,21,117,0,648,1,7,3,4,4,single-choice,spatial-relational,3|4,7,3/4,210117,3
6,1,21,118,1,911,1,3,1,1,2,single-choice,spatial-relational,1|2,7,1/2,210118,1
6,1,21,119,0,533,1,7,3,4,4,single-choice,spatial-relational,3|4,7,3/4,210119,3
6,1,21,120,0,513,1,5,2,3,3,single-choice,spatial-relational,2|3,7,2/3,210120,2
6,1,21,121,0,559,1,11,5,6,6,single-choice,spatial-relational,5|6,7,5/6,210121,5
6,1,21,122,1,811,1,13,6,6,7,single-choice,spatial-relational,6|7,7,6/7,210122,6
6,1,21,123,0,709,1,11,5,6,6,single-choice,spatial-relational,5|6,7,5/6,210123,5
6,1,21,124,1,743,1,13,6,6,7,single-choice,spatial-relational,6|7,7,6/7,210124,6
6,1,21,125,0,835,1,5,2,3,3,single-choice,spatial-relational,2|3,7,2/3,210125,2
6,1,21,126,1,721,1,7,3,3,4,single-choice,spatial-relational,3|4,7,3/4,210126,3
6,1,21,127,0,826,1,3,1,2,2,single-choice,spatial-relational,1|2,7,1/2,210127,1
6,1,21,128,0,756,1,3,1,2,2,single-choice,spatial-relational,1|2,7,1/2,210128,1
6,1,21,129,0,468,1,7,3,4,4,single-choice,spatial-relational,3|4,7,3/4,210129,3
6,1,21,130,1,740,1,9,4,4,5,single-choice,spatial-relational,4|5,7,4/5,210130,4
6,1,21,131,0,838,1,5,2,3,3,single-choice,spatial-relational,2|3,7,2/3,210131,2
6,1,21,132,0,628,1,9,4,5,5,single-choice,spatial-relational,4|5,7,4/5,210132,4
6,1,21,133,1,715,1,3,1,1,2,single-choice,spatial-relational,1|2,7,1/2,210133,1
6,1,21,134,0,686,1,11,5,6,6,single-choice,spatial-relational,5|6,7,5/6,210134,5
6,1,21,135,1,826,1,13,6,6,7,single-choice,spatial-relational,6|7,7,6/7,210135,6
6,1,21,136,1,1291,1,9,4,4,5,single-choice,spatial-relational,4|5,7,4/5,210136,4
6,1,21,137,1,807,1,5,2,2,3,single-choice,spatial-relational,2|3,7,2/3,210137,2
6,1,21,138,1,766,1,7,3,3,4,single-choice,spatial-relational,3|4,7,3/4,210138,3
6,1,21,139,1,941,1,7,3,3,4,single-choice,spatial-relational,3|4,7,3/4,210139,3
6,1,21,140,1,675,1,3,1,1,2,single-choice,spatial-relational,1|2,7,1/2,210140,1
6,1,21,141,1,1015,1,5,2,2,3,single-choice,spatial-relational,2|3,7,2/3,210141,2
6,1,21,142,0,597,1,11,5,6,6,single-choice,spatial-relational,5|6,7,5/6,210142,5
6,1,21,143,1,927,1,13,6,6,7,single-choice,spatial-relational,6|7,7,6/7,210143,6
6,1,21,144,1,713,1,9,4,4,5,single-choice,spatial-relational,4|5,7,4/5,210144,4
6,1,21,145,0,729,1,3,1,2,2,single-choice,spatial-relational,1|2,7,1/2,210145,1
6,1,21,146,0,781,1,9,4,5,5,single-choice,spatial-relational,4|5,7,4/5,210146,4
6,1,21,147,0,873,1,5,2,3,3,single-choice,spatial-relational,2|3,7,2/3,210147,2
6,1,21,148,1,684,1,9,4,4,5,single-choice,spatial-relational,4|5,7,4/5,210148,4
6,1,21,149,0,846,1,7,3,4,4,single-choice,spatial-relational,3|4,7,3/4,210149,3
6,1,21,150,0,792,1,11,5,6,6,single-choice,spatial-relational,5|6,7,5/6,210150,5
6,1,21,151,0,784,1,5,2,3,3,single-choice,spatial-relational,2|3,7,2/3,210151,2
6,1,21,152,1,754,1,13,6,6,7,single-choice,spatial-relational,6|7,7,6/7,210152,6
6,1,21,153,0,818,1,11,5,6,6,single-choice,spatial-relational,5|6,7,5/6,210153,5
6,1,21,154,1,743,1,7,3,3,4,single-choice,spatial-relational,3|4,7,3/4,210154,3
6,1,21,155,1,994,1,13,6,6,7,single-choice,spatial-relational,6|7,7,6/7,210155,6
6,1,21,156,1,882,1,3,1,1,2,single-choice,spatial-relational,1|2,7,1/2,210156,1
6,1,21,157,1,733,1,3,1,1,2,single-choice,spatial-relational,1|2,7,1/2,210157,1
6,1,21,158,0,672,1,11,5,6,6,single-choice,spatial-relational,5|6,7,5/6,210158,5
6,1,21,159,1,700,1,5,2,2,3,single-choice,spatial-relational,2|3,7,2/3,210159,2
6,1,21,160,0,605,1,11,5,6,6,single-choice,spatial-relational,5|6,7,5/6,210160,5
6,1,21,161,1,904,1,9,4,4,5,single-choice,spatial-relational,4|5,7,4/5,210161,4
6,1,21,162,1,949,1,9,4,4,5,single-choice,spatial-relational,4|5,7,4/5,210162,4
6,1,21,163,0,754,1,5,2,3,3,single-choice,spatial-relational,2|3,7,2/3,210163,2
6,1,21,164,1,823,1,7,3,3,4,single-choice,spatial-relational,3|4,7,3/4,210164,3
6,1,21,165,0,823,1,3,1,2,2,single-choice,spatial-relational,1|2,7,1/2,210165,1
6,1,21,166,1,810,1,7,3,3,4,single-choice,spatial-relational,3|4,7,3/4,210166,3
6,1,21,167,1,1364,1,13,6,6,7,single-choice,spatial-relational,6|7,7,6/7,210167,6
6,1,21,168,1,848,1,13,6,6,7,single-choice,spatial-relational,6|7,7,6/7,210168,6
6,1,21,169,1,1397,1,7,3,3,4,single-choice,spatial-relational,3|4,7,3/4,210169,3
6,1,21,170,1,721,1,7,3,3,4,single-choice,spatial-relational,3|4,7,3/4,210170,3
6,1,21,171,1,944,1,13,6,6,7,single-choice,spatial-relational,6|7,7,6/7,210171,6
6,1,21,172,1,775,1,13,6,6,7,single-choice,spatial-relational,6|7,7,6/7,210172,6
6,1,21,173,1,806,1,9,4,4,5,single-choice,spatial-relational,4|5,7,4/5,210173,4
6,1,21,174,0,724,1,11,5,6,6,single-choice,spatial-relational,5|6,7,5/6,210174,5
6,1,21,175,0,919,1,3,1,2,2,single-choice,spatial-relational,1|2,7,1/2,210175,1
6,1,21,176,0,1000,1,11,5,6,6,single-choice,spatial-relational,5|6,7,5/6,210176,5
6,1,21,177,1,1098,1,9,4,4,5,single-choice,spatial-relational,4|5,7,4/5,210177,4
6,1,21,178,1,890,1,5,2,2,3,single-choice,spatial-relational,2|3,7,2/3,210178,2
6,1,21,179,0,675,1,3,1,2,2,single-choice,spatial-relational,1|2,7,1/2,210179,1
6,1,21,180,1,857,1,5,2,2,3,single-choice,spatial-relational,2|3,7,2/3,210180,2
6,1,21,181,1,836,1,9,4,4,5,single-choice,spatial-relational,4|5,7,4/5,210181,4
6,1,21,182,1,943,1,7,3,3,4,single-choice,spatial-relational,3|4,7,3/4,210182,3
6,1,21,183,1,706,1,5,2,2,3,single-choice,spatial-relational,2|3,7,2/3,210183,2
6,1,21,184,0,1031,1,11,5,6,6,single-choice,spatial-relational,5|6,7,5/6,210184,5
6,1,21,185,1,907,1,11,5,5,6,single-choice,spatial-relational,5|6,7,5/6,210185,5
6,1,21,186,1,777,1,9,4,4,5,single-choice,spatial-relational,4|5,7,4/5,210186,4
6,1,21,187,1,860,1,3,1,1,2,single-choice,spatial-relational,1|2,7,1/2,210187,1
6,1,21,188,0,551,1,13,6,7,7,single-choice,spatial-relational,6|7,7,6/7,210188,6
6,1,21,189,1,938,1,5,2,2,3,single-choice,spatial-relational,2|3,7,2/3,210189,2
6,1,21,190,1,813,1,13,6,6,7,single-choice,spatial-relational,6|7,7,6/7,210190,6
6,1,21,191,0,702,1,3,1,2,2,single-choice,spatial-relational,1|2,7,1/2,210191,1
6,1,21,192,1,711,1,7,3,3,4,single-choice,spatial-relational,3|4,7,3/4,210192,3
6,1,21,193,1,735,1,9,4,4,5,single-choice,spatial-relational,4|5,7,4/5,210193,4
6,1,21,194,0,794,1,3,1,2,2,single-choice,spatial-relational,1|2,7,1/2,210194,1
6,1,21,195,1,857,1,5,2,2,3,single-choice,spatial-relational,2|3,7,2/3,210195,2
6,1,21,196,0,783,1,5,2,3,3,single-choice,spatial-relational,2|3,7,2/3,210196,2
6,1,21,197,1,1119,1,13,6,6,7,single-choice,spatial-relational,6|7,7,6/7,210197,6
6,1,21,198,0,1191,1,9,4,5,5,single-choice,spatial-relational,4|5,7,4/5,210198,4
6,1,21,199,1,1436,1,13,6,6,7,single-choice,spatial-relational,6|7,7,6/7,210199,6
6,1,21,200,1,869,1,3,1,1,2,single-choice,spatial-relational,1|2,7,1/2,210200,1
6,1,21,201,0,606,1,7,3,4,4,single-choice,spatial-relational,3|4,7,3/4,210201,3
6,1,21,202,1,972,1,11,5,5,6,single-choice,spatial-relational,5|6,7,5/6,210202,5
6,1,21,203,1,1448,1,7,3,3,4,single-choice,spatial-relational,3|4,7,3/4,210203,3
6,1,21,204,1,748,1,11,5,5,6,single-choice,spatial-relational,5|6,7,5/6,210204,5
6,1,21,205,1,801,1,3,1,1,2,single-choice,spatial-relational,1|2,7,1/2,210205,1
6,1,21,206,1,1090,1,13,6,6,7,single-choice,spatial-relational,6|7,7,6/7,210206,6
6,1,21,207,0,1776,1,7,3,4,4,single-choice,spatial-relational,3|4,7,3/4,210207,3
6,1,21,208,1,1207,1,11,5,5,6,single-choice,spatial-relational,5|6,7,5/6,210208,5
6,1,21,209,1,1442,1,13,6,6,7,single-choice,spatial-relational,6|7,7,6/7,210209,6
6,1,21,210,0,1856,1,3,1,2,2,single-choice,spatial-relational,1|2,7,1/2,210210,1
6,1,21,211,0,641,1,5,2,3,3,single-choice,spatial-relational,2|3,7,2/3,210211,2
6,1,21,212,1,1308,1,9,4,4,5,single-choice,spatial-relational,4|5,7,4/5,210212,4
6,1,21,213,1,1223,1,5,2,2,3,single-choice,spatial-relational,2|3,7,2/3,210213,2
6,1,21,214,0,735,1,11,5,6,6,single-choice,spatial-relational,5|6,7,5/6,210214,5
6,1,21,215,0,1222,1,7,3,4,4,single-choice,spatial-relational,3|4,7,3/4,210215,3
6,1,21,216,0,745,1,9,4,5,5,single-choice,spatial-relational,4|5,7,4/5,210216,4
6,1,21,217,0,849,1,9,4,5,5,single-choice,spatial-relational,4|5,7,4/5,210217,4
6,1,21,218,1,720,1,3,1,1,2,single-choice,spatial-relational,1|2,7,1/2,210218,1
6,1,21,219,0,1012,1,11,5,6,6,single-choice,spatial-relational,5|6,7,5/6,210219,5
6,1,21,220,1,690,1,5,2,2,3,single-choice,spatial-relational,2|3,7,2/3,210220,2
6,1,21,221,1,829,1,7,3,3,4,single-choice,spatial-relational,3|4,7,3/4,210221,3
6,1,21,222,1,873,1,7,3,3,4,single-choice,spatial-relational,3|4,7,3/4,210222,3
6,1,21,223,1,911,1,13,6,6,7,single-choice,spatial-relational,6|7,7,6/7,210223,6
6,1,21,224,1,1053,1,5,2,2,3,single-choice,spatial-relational,2|3,7,2/3,210224,2
6,1,21,225,0,752,1,3,1,2,2,single-choice,spatial-relational,1|2,7,1/2,210225,1
6,1,21,226,1,978,1,11,5,5,6,single-choice,spatial-relational,5|6,7,5/6,210226,5
6,1,21,227,1,824,1,9,4,4,5,single-choice,spatial-relational,4|5,7,4/5,210227,4
6,1,21,228,1,920,1,13,6,6,7,single-choice,spatial-relational,6|7,7,6/7,210228,6
6,1,21,229,0,794,1,7,3,4,4,single-choice,spatial-relational,3|4,7,3/4,210229,3
6,1,21,230,1,1235,1,11,5,5,6,single-choice,spatial-relational,5|6,7,5/6,210230,5
6,1,21,231,1,1340,1,7,3,3,4,single-choice,spatial-relational,3|4,7,3/4,210231,3
6,1,21,232,1,967,1,13,6,6,7,single-choice,spatial-relational,6|7,7,6/7,210232,6
6,1,21,233,1,1217,1,5,2,2,3,single-choice,spatial-relational,2|3,7,2/3,210233,2
6,1,21,234,1,903,1,3,1,1,2,single-choice,spatial-relational,1|2,7,1/2,210234,1
6,1,21,235,1,1096,1,13,6,6,7,single-choice,spatial-relational,6|7,7,6/7,210235,6
6,1,21,236,1,1560,1,5,2,2,3,single-choice,spatial-relational,2|3,7,2/3,210236,2
6,1,21,237,0,744,1,11,5,6,6,single-choice,spatial-relational,5|6,7,5/6,210237,5
6,1,21,238,0,887,1,9,4,5,5,single-choice,spatial-relational,4|5,7,4/5,210238,4
6,1,21,239,1,1298,1,9,4,4,5,single-choice,spatial-relational,4|5,7,4/5,210239,4
6,1,21,240,0,802,1,3,1,2,2,single-choice,spatial-relational,1|2,7,1/2,210240,1
6,1,21,241,1,1090,1,11,5,5,6,single-choice,spatial-relational,5|6,7,5/6,210241,5
6,1,21,242,1,1798,1,5,2,2,3,single-choice,spatial-relational,2|3,7,2/3,210242,2
6,1,21,243,1,995,1,7,3,3,4,single-choice,spatial-relational,3|4,7,3/4,210243,3
6,1,21,244,1,881,1,13,6,6,7,single-choice,spatial-relational,6|7,7,6/7,210244,6
6,1,21,245,1,1014,1,9,4,4,5,single-choice,spatial-relational,4|5,7,4/5,210245,4
6,1,21,246,1,897,1,13,6,6,7,single-choice,spatial-relational,6|7,7,6/7,210246,6
6,1,21,247,1,971,1,3,1,1,2,single-choice,spatial-relational,1|2,7,1/2,210247,1
6,1,21,248,1,974,1,11,5,5,6,single-choice,spatial-relational,5|6,7,5/6,210248,5
6,1,21,249,0,742,1,7,3,4,4,single-choice,spatial-relational,3|4,7,3/4,210249,3
6,1,21,250,1,844,1,3,1,1,2,single-choice,spatial-relational,1|2,7,1/2,210250,1
6,1,21,251,1,913,1,9,4,4,5,single-choice,spatial-relational,4|5,7,4/5,210251,4
6,1,21,252,0,906,1,5,2,3,3,single-choice,spatial-relational,2|3,7,2/3,210252,2
6,1,21,253,1,1002,1,7,3,3,4,single-choice,spatial-relational,3|4,7,3/4,210253,3
6,1,21,254,1,757,1,5,2,2,3,single-choice,spatial-relational,2|3,7,2/3,210254,2
6,1,21,255,0,1351,1,11,5,6,6,single-choice,spatial-relational,5|6,7,5/6,210255,5
6,1,21,256,0,724,1,5,2,3,3,single-choice,spatial-relational,2|3,7,2/3,210256,2
6,1,21,257,1,945,1,3,1,1,2,single-choice,spatial-relational,1|2,7,1/2,210257,1
6,1,21,258,1,894,1,7,3,3,4,single-choice,spatial-relational,3|4,7,3/4,210258,3
6,1,21,259,1,904,1,9,4,4,5,single-choice,spatial-relational,4|5,7,4/5,210259,4
6,1,21,260,1,1677,1,13,6,6,7,single-choice,spatial-relational,6|7,7,6/7,210260,6
6,1,21,261,0,871,1,13,6,7,7,single-choice,spatial-relational,6|7,7,6/7,210261,6
6,1,21,262,1,787,1,3,1,1,2,single-choice,spatial-relational,1|2,7,1/2,210262,1
6,1,21,263,0,803,1,11,5,6,6,single-choice,spatial-relational,5|6,7,5/6,210263,5
6,1,21,264,1,837,1,9,4,4,5,single-choice,spatial-relational,4|5,7,4/5,210264,4
6,1,21,265,1,900,1,13,6,6,7,single-choice,spatial-relational,6|7,7,6/7,210265,6
6,1,21,266,1,1844,1,13,6,6,7,single-choice,spatial-relational,6|7,7,6/7,210266,6
6,1,21,267,1,1224,1,9,4,4,5,single-choice,spatial-relational,4|5,7,4/5,210267,4
6,1,21,268,1,1073,1,7,3,3,4,single-choice,spatial-relational,3|4,7,3/4,210268,3
6,1,21,269,1,745,1,7,3,3,4,single-choice,spatial-relational,3|4,7,3/4,210269,3
6,1,21,270,1,924,1,5,2,2,3,single-choice,spatial-relational,2|3,7,2/3,210270,2
6,1,21,271,1,868,1,11,5,5,6,single-choice,spatial-relational,5|6,7,5/6,210271,5
6,1,21,272,1,662,1,11,5,5,6,single-choice,spatial-relational,5|6,7,5/6,210272,5
6,1,21,273,1,900,1,5,2,2,3,single-choice,spatial-relational,2|3,7,2/3,210273,2
6,1,21,274,1,834,1,3,1,1,2,single-choice,spatial-relational,1|2,7,1/2,210274,1
6,1,21,275,0,636,1,3,1,2,2,single-choice,spatial-relational,1|2,7,1/2,210275,1
6,1,21,276,1,1001,1,9,4,4,5,single-choice,spatial-relational,4|5,7,4/5,210276,4
6,1,21,277,1,768,1,9,4,4,5,single-choice,spatial-relational,4|5,7,4/5,210277,4
6,1,21,278,1,955,1,3,1,1,2,single-choice,spatial-relational,1|2,7,1/2,210278,1
6,1,21,279,1,780,1,7,3,3,4,single-choice,spatial-relational,3|4,7,3/4,210279,3
6,1,21,280,1,1165,1,5,2,2,3,single-choice,spatial-relational,2|3,7,2/3,210280,2
6,1,21,281,1,865,1,13,6,6,7,single-choice,spatial-relational,6|7,7,6/7,210281,6
6,1,21,282,0,901,1,11,5,6,6,single-choice,spatial-relational,5|6,7,5/6,210282,5
6,1,21,283,0,1198,1,7,3,4,4,single-choice,spatial-relational,3|4,7,3/4,210283,3
6,1,21,284,0,1194,1,11,5,6,6,single-choice,spatial-relational,5|6,7,5/6,210284,5
6,1,21,285,0,1148,1,5,2,3,3,single-choice,spatial-relational,2|3,7,2/3,210285,2
6,1,21,286,1,1186,1,9,4,4,5,single-choice,spatial-relational,4|5,7,4/5,210286,4
6,1,21,287,1,845,1,3,1,1,2,single-choice,spatial-relational,1|2,7,1/2,210287,1
6,1,21,288,1,717,1,13,6,6,7,single-choice,spatial-relational,6|7,7,6/7,210288,6
6,1,21,289,1,965,1,13,6,6,7,single-choice,spatial-relational,6|7,7,6/7,210289,6
6,1,21,290,0,1152,1,13,6,7,7,single-choice,spatial-relational,6|7,7,6/7,210290,6
6,1,21,291,1,1466,1,9,4,4,5,single-choice,spatial-relational,4|5,7,4/5,210291,4
6,1,21,292,1,893,1,5,2,2,3,single-choice,spatial-relational,2|3,7,2/3,210292,2
6,1,21,293,0,848,1,7,3,4,4,single-choice,spatial-relational,3|4,7,3/4,210293,3
6,1,21,294,0,803,1,9,4,5,5,single-choice,spatial-relational,4|5,7,4/5,210294,4
6,1,21,295,1,793,1,5,2,2,3,single-choice,spatial-relational,2|3,7,2/3,210295,2
6,1,21,296,0,954,1,11,5,6,6,single-choice,spatial-relational,5|6,7,5/6,210296,5
6,1,21,297,0,1139,1,11,5,6,6,single-choice,spatial-relational,5|6,7,5/6,210297,5
6,1,21,298,1,760,1,3,1,1,2,single-choice,spatial-relational,1|2,7,1/2,210298,1
6,1,21,299,1,1136,1,7,3,3,4,single-choice,spatial-relational,3|4,7,3/4,210299,3
6,1,21,300,0,903,1,3,1,2,2,single-choice,spatial-relational,1|2,7,1/2,210300,1
6,1,21,301,0,1056,1,7,3,4,4,single-choice,spatial-relational,3|4,7,3/4,210301,3
6,1,21,302,1,795,1,5,2,2,3,single-choice,spatial-relational,2|3,7,2/3,210302,2
6,1,21,303,0,802,1,11,5,6,6,single-choice,spatial-relational,5|6,7,5/6,210303,5
6,1,21,304,1,808,1,7,3,3,4,single-choice,spatial-relational,3|4,7,3/4,210304,3
6,1,21,305,1,1053,1,9,4,4,5,single-choice,spatial-relational,4|5,7,4/5,210305,4
6,1,21,306,0,1285,1,11,5,6,6,single-choice,spatial-relational,5|6,7,5/6,210306,5
6,1,21,307,1,943,1,3,1,1,2,single-choice,spatial-relational,1|2,7,1/2,210307,1
6,1,21,308,1,1283,1,5,2,2,3,single-choice,spatial-relational,2|3,7,2/3,210308,2
6,1,21,309,1,805,1,3,1,1,2,single-choice,spatial-relational,1|2,7,1/2,210309,1
6,1,21,310,1,900,1,13,6,6,7,single-choice,spatial-relational,6|7,7,6/7,210310,6
6,1,21,311,1,818,1,13,6,6,7,single-choice,spatial-relational,6|7,7,6/7,210311,6
6,1,21,312,1,1106,1,9,4,4,5,single-choice,spatial-relational,4|5,7,4/5,210312,4
6,1,21,313,0,1224,1,5,2,3,3,single-choice,spatial-relational,2|3,7,2/3,210313,2
6,1,21,314,1,1014,1,13,6,6,7,single-choice,spatial-relational,6|7,7,6/7,210314,6
6,1,21,315,1,1164,1,11,5,5,6,single-choice,spatial-relational,5|6,7,5/6,210315,5
6,1,21,316,1,1047,1,7,3,3,4,single-choice,spatial-relational,3|4,7,3/4,210316,3
6,1,21,317,1,953,1,5,2,2,3,single-choice,spatial-relational,2|3,7,2/3,210317,2
6,1,21,318,1,898,1,3,1,1,2,single-choice,spatial-relational,1|2,7,1/2,210318,1
6,1,21,319,0,1376,1,3,1,2,2,single-choice,spatial-relational,1|2,7,1/2,210319,1
6,1,21,320,1,782,1,7,3,3,4,single-choice,spatial-relational,3|4,7,3/4,210320,3
6,1,21,321,1,870,1,9,4,4,5,single-choice,spatial-relational,4|5,7,4/5,210321,4
6,1,21,322,0,1150,1,9,4,5,5,single-choice,spatial-relational,4|5,7,4/5,210322,4
6,1,21,323,1,1199,1,13,6,6,7,single-choice,spatial-relational,6|7,7,6/7,210323,6
6,1,21,324,0,901,1,11,5,6,6,single-choice,spatial-relational,5|6,7,5/6,210324,5
6,1,21,325,1,738,1,7,3,3,4,single-choice,spatial-relational,3|4,7,3/4,210325,3
6,1,21,326,1,1438,1,11,5,5,6,single-choice,spatial-relational,5|6,7,5/6,210326,5
6,1,21,327,0,1087,1,9,4,5,5,single-choice,spatial-relational,4|5,7,4/5,210327,4
6,1,21,328,1,784,1,3,1,1,2,single-choice,spatial-relational,1|2,7,1/2,210328,1
6,1,21,329,1,880,1,9,4,4,5,single-choice,spatial-relational,4|5,7,4/5,210329,4
6,1,21,330,0,881,1,13,6,7,7,single-choice,spatial-relational,6|7,7,6/7,210330,6
6,1,21,331,1,963,1,13,6,6,7,single-choice,spatial-relational,6|7,7,6/7,210331,6
6,1,21,332,1,1349,1,11,5,5,6,single-choice,spatial-relational,5|6,7,5/6,210332,5
6,1,21,333,0,875,1,3,1,2,2,single-choice,spatial-relational,1|2,7,1/2,210333,1
6,1,21,334,1,935,1,5,2,2,3,single-choice,spatial-relational,2|3,7,2/3,210334,2
6,1,21,335,1,965,1,7,3,3,4,single-choice,spatial-relational,3|4,7,3/4,210335,3
6,1,21,336,0,709,1,5,2,3,3,single-choice,spatial-relational,2|3,7,2/3,210336,2
6,1,21,337,1,861,1,3,1,1,2,single-choice,spatial-relational,1|2,7,1/2,210337,1
6,1,21,338,1,1068,1,7,3,3,4,single-choice,spatial-relational,3|4,7,3/4,210338,3
6,1,21,339,1,954,1,3,1,1,2,single-choice,spatial-relational,1|2,7,1/2,210339,1
6,1,21,340,1,1074,1,13,6,6,7,single-choice,spatial-relational,6|7,7,6/7,210340,6
6,1,21,341,1,1459,1,9,4,4,5,single-choice,spatial-relational,4|5,7,4/5,210341,4
6,1,21,342,0,834,1,11,5,6,6,single-choice,spatial-relational,5|6,7,5/6,210342,5
6,1,21,343,0,705,1,5,2,3,3,single-choice,spatial-relational,2|3,7,2/3,210343,2
6,1,21,344,1,866,1,11,5,5,6,single-choice,spatial-relational,5|6,7,5/6,210344,5
6,1,21,345,1,1027,1,9,4,4,5,single-choice,spatial-relational,4|5,7,4/5,210345,4
6,1,21,346,1,1213,1,5,2,2,3,single-choice,spatial-relational,2|3,7,2/3,210346,2
6,1,21,347,1,1054,1,7,3,3,4,single-choice,spatial-relational,3|4,7,3/4,210347,3
6,1,21,348,1,969,1,13,6,6,7,single-choice,spatial-relational,6|7,7,6/7,210348,6
6,1,21,349,1,1009,1,5,2,2,3,single-choice,spatial-relational,2|3,7,2/3,210349,2
6,1,21,350,1,630,1,7,3,3,4,single-choice,spatial-relational,3|4,7,3/4,210350,3
6,1,21,351,1,1323,1,13,6,6,7,single-choice,spatial-relational,6|7,7,6/7,210351,6
6,1,21,352,0,1514,1,5,2,3,3,single-choice,spatial-relational,2|3,7,2/3,210352,2
6,1,21,353,1,870,1,11,5,5,6,single-choice,spatial-relational,5|6,7,5/6,210353,5
6,1,21,354,1,1517,1,11,5,5,6,single-choice,spatial-relational,5|6,7,5/6,210354,5
6,1,21,355,1,913,1,9,4,4,5,single-choice,spatial-relational,4|5,7,4/5,210355,4
6,1,21,356,1,915,1,13,6,6,7,single-choice,spatial-relational,6|7,7,6/7,210356,6
6,1,21,357,1,1466,1,9,4,4,5,single-choice,spatial-relational,4|5,7,4/5,210357,4
6,1,21,358,0,702,1,3,1,2,2,single-choice,spatial-relational,1|2,7,1/2,210358,1
6,1,21,359,1,1233,1,7,3,3,4,single-choice,spatial-relational,3|4,7,3/4,210359,3
6,1,21,360,0,742,1,3,1,2,2,single-choice,spatial-relational,1|2,7,1/2,210360,1
6,1,21,361,0,799,1,3,1,2,2,single-choice,spatial-relational,1|2,7,1/2,210361,1
6,1,21,362,1,899,1,13,6,6,7,single-choice,spatial-relational,6|7,7,6/7,210362,6
6,1,21,363,1,1065,1,5,2,2,3,single-choice,spatial-relational,2|3,7,2/3,210363,2
6,1,21,364,1,1130,1,5,2,2,3,single-choice,spatial-relational,2|3,7,2/3,210364,2
6,1,21,365,1,1010,1,3,1,1,2,single-choice,spatial-relational,1|2,7,1/2,210365,1
6,1,21,366,0,656,1,7,3,4,4,single-choice,spatial-relational,3|4,7,3/4,210366,3
6,1,21,367,0,1197,1,7,3,4,4,single-choice,spatial-relational,3|4,7,3/4,210367,3
6,1,21,368,1,822,1,13,6,6,7,single-choice,spatial-relational,6|7,7,6/7,210368,6
6,1,21,369,1,1598,1,11,5,5,6,single-choice,spatial-relational,5|6,7,5/6,210369,5
6,1,21,370,1,859,1,9,4,4,5,single-choice,spatial-relational,4|5,7,4/5,210370,4
6,1,21,371,0,916,1,11,5,6,6,single-choice,spatial-relational,5|6,7,5/6,210371,5
6,1,21,372,1,1104,1,9,4,4,5,single-choice,spatial-relational,4|5,7,4/5,210372,4
6,1,21,373,1,1603,1,11,5,5,6,single-choice,spatial-relational,5|6,7,5/6,210373,5
6,1,21,374,1,1400,1,11,5,5,6,single-choice,spatial-relational,5|6,7,5/6,210374,5
6,1,21,375,0,1377,1,7,3,4,4,single-choice,spatial-relational,3|4,7,3/4,210375,3
6,1,21,376,1,1032,1,9,4,4,5,single-choice,spatial-relational,4|5,7,4/5,210376,4
6,1,21,377,0,867,1,3,1,2,2,single-choice,spatial-relational,1|2,7,1/2,210377,1
6,1,21,378,1,974,1,13,6,6,7,single-choice,spatial-relational,6|7,7,6/7,210378,6
6,1,21,379,0,904,1,5,2,3,3,single-choice,spatial-relational,2|3,7,2/3,210379,2
6,1,21,380,1,909,1,3,1,1,2,single-choice,spatial-relational,1|2,7,1/2,210380,1
6,1,21,381,1,690,1,13,6,6,7,single-choice,spatial-relational,6|7,7,6/7,210381,6
6,1,21,382,0,1018,1,5,2,3,3,single-choice,spatial-relational,2|3,7,2/3,210382,2
6,1,21,383,1,2272,1,9,4,4,5,single-choice,spatial-relational,4|5,7,4/5,210383,4
6,1,21,384,0,834,1,7,3,4,4,single-choice,spatial-relational,3|4,7,3/4,210384,3
6,1,21,385,1,1266,1,13,6,6,7,single-choice,spatial-relational,6|7,7,6/7,210385,6
6,1,21,386,0,909,1,11,5,6,6,single-choice,spatial-relational,5|6,7,5/6,210386,5
6,1,21,387,1,787,1,5,2,2,3,single-choice,spatial-relational,2|3,7,2/3,210387,2
6,1,21,388,0,948,1,11,5,6,6,single-choice,spatial-relational,5|6,7,5/6,210388,5
6,1,21,389,0,952,1,9,4,5,5,single-choice,spatial-relational,4|5,7,4/5,210389,4
6,1,21,390,1,820,1,13,6,6,7,single-choice,spatial-relational,6|7,7,6/7,210390,6
6,1,21,391,0,845,1,3,1,2,2,single-choice,spatial-relational,1|2,7,1/2,210391,1
6,1,21,392,1,1219,1,9,4,4,5,single-choice,spatial-relational,4|5,7,4/5,210392,4
6,1,21,393,1,1008,1,7,3,3,4,single-choice,spatial-relational,3|4,7,3/4,210393,3
6,1,21,394,0,892,1,3,1,2,2,single-choice,spatial-relational,1|2,7,1/2,210394,1
6,1,21,395,1,882,1,7,3,3,4,single-choice,spatial-relational,3|4,7,3/4,210395,3
6,1,21,396,1,910,1,5,2,2,3,single-choice,spatial-relational,2|3,7,2/3,210396,2
6,1,21,397,1,1581,1,11,5,5,6,single-choice,spatial-relational,5|6,7,5/6,210397,5
6,1,21,398,0,739,1,3,1,2,2,single-choice,spatial-relational,1|2,7,1/2,210398,1
6,1,21,399,0,800,1,9,4,5,5,single-choice,spatial-relational,4|5,7,4/5,210399,4
6,1,21,400,1,834,1,5,2,2,3,single-choice,spatial-relational,2|3,7,2/3,210400,2
6,1,21,401,1,1468,1,13,6,6,7,single-choice,spatial-relational,6|7,7,6/7,210401,6
6,1,21,402,0,835,1,7,3,4,4,single-choice,spatial-relational,3|4,7,3/4,210402,3
6,1,21,403,0,1421,1,9,4,5,5,single-choice,spatial-relational,4|5,7,4/5,210403,4
6,1,21,404,1,968,1,5,2,2,3,single-choice,spatial-relational,2|3,7,2/3,210404,2
6,1,21,405,1,1208,1,7,3,3,4,single-choice,spatial-relational,3|4,7,3/4,210405,3
6,1,21,406,0,734,1,3,1,2,2,single-choice,spatial-relational,1|2,7,1/2,210406,1
6,1,21,407,1,839,1,13,6,6,7,single-choice,spatial-relational,6|7,7,6/7,210407,6
6,1,21,408,1,1457,1,11,5,5,6,single-choice,spatial-relational,5|6,7,5/6,210408,5
6,1,21,409,1,806,1,13,6,6,7,single-choice,spatial-relational,6|7,7,6/7,210409,6
6,1,21,410,1,1285,1,7,3,3,4,single-choice,spatial-relational,3|4,7,3/4,210410,3
6,1,21,411,0,844,1,3,1,2,2,single-choice,spatial-relational,1|2,7,1/2,210411,1
6,1,21,412,1,1229,1,11,5,5,6,single-choice,spatial-relational,5|6,7,5/6,210412,5
6,1,21,413,1,1199,1,5,2,2,3,single-choice,spatial-relational,2|3,7,2/3,210413,2
6,1,21,414,0,713,1,9,4,5,5,single-choice,spatial-relational,4|5,7,4/5,210414,4
6,1,21,415,1,985,1,9,4,4,5,single-choice,spatial-relational,4|5,7,4/5,210415,4
6,1,21,416,0,842,1,11,5,6,6,single-choice,spatial-relational,5|6,7,5/6,210416,5
6,1,21,417,1,890,1,13,6,6,7,single-choice,spatial-relational,6|7,7,6/7,210417,6
6,1,21,418,1,1418,1,7,3,3,4,single-choice,spatial-relational,3|4,7,3/4,210418,3
6,1,21,419,0,961,1,5,2,3,3,single-choice,spatial-relational,2|3,7,2/3,210419,2
6,1,21,420,1,949,1,3,1,1,2,single-choice,spatial-relational,1|2,7,1/2,210420,1
6,1,21,421,1,992,1,5,2,2,3,single-choice,spatial-relational,2|3,7,2/3,210421,2
6,1,21,422,1,801,1,9,4,4,5,single-choice,spatial-relational,4|5,7,4/5,210422,4
6,1,21,423,1,1457,1,7,3,3,4,single-choice,spatial-relational,3|4,7,3/4,210423,3
6,1,21,424,0,824,1,11,5,6,6,single-choice,spatial-relational,5|6,7,5/6,210424,5
6,1,21,425,1,725,1,3,1,1,2,single-choice,spatial-relational,1|2,7,1/2,210425,1
6,1,21,426,1,1217,1,13,6,6,7,single-choice,spatial-relational,6|7,7,6/7,210426,6
6,1,21,427,1,1553,1,9,4,4,5,single-choice,spatial-relational,4|5,7,4/5,210427,4
6,1,21,428,1,1302,1,7,3,3,4,single-choice,spatial-relational,3|4,7,3/4,210428,3
6,1,21,429,0,939,1,11,5,6,6,single-choice,spatial-relational,5|6,7,5/6,210429,5
6,1,21,430,1,915,1,13,6,6,7,single-choice,spatial-relational,6|7,7,6/7,210430,6
6,1,21,431,0,798,1,3,1,2,2,single-choice,spatial-relational,1|2,7,1/2,210431,1
6,1,21,432,1,799,1,5,2,2,3,single-choice,spatial-relational,2|3,7,2/3,210432,2
6,1,21,433,0,779,1,9,4,5,5,single-choice,spatial-relational,4|5,7,4/5,210433,4
6,1,21,434,1,782,1,7,3,3,4,single-choice,spatial-relational,3|4,7,3/4,210434,3
6,1,21,435,1,924,1,13,6,6,7,single-choice,spatial-relational,6|7,7,6/7,210435,6
6,1,21,436,0,746,1,3,1,2,2,single-choice,spatial-relational,1|2,7,1/2,210436,1
6,1,21,437,0,1158,1,11,5,6,6,single-choice,spatial-relational,5|6,7,5/6,210437,5
6,1,21,438,1,798,1,5,2,2,3,single-choice,spatial-relational,2|3,7,2/3,210438,2
6,1,21,439,0,1212,1,9,4,5,5,single-choice,spatial-relational,4|5,7,4/5,210439,4
6,1,21,440,0,1249,1,5,2,3,3,single-choice,spatial-relational,2|3,7,2/3,210440,2
6,1,21,441,0,1224,1,11,5,6,6,single-choice,spatial-relational,5|6,7,5/6,210441,5
6,1,21,442,1,752,1,7,3,3,4,single-choice,spatial-relational,3|4,7,3/4,210442,3
6,1,21,443,1,1093,1,13,6,6,7,single-choice,spatial-relational,6|7,7,6/7,210443,6
6,1,21,444,1,1106,1,3,1,1,2,single-choice,spatial-relational,1|2,7,1/2,210444,1
6,1,21,445,1,783,1,3,1,1,2,single-choice,spatial-relational,1|2,7,1/2,210445,1
6,1,21,446,1,1015,1,11,5,5,6,single-choice,spatial-relational,5|6,7,5/6,210446,5
6,1,21,447,1,1257,1,13,6,6,7,single-choice,spatial-relational,6|7,7,6/7,210447,6
6,1,21,448,1,1084,1,9,4,4,5,single-choice,spatial-relational,4|5,7,4/5,210448,4
6,1,21,449,0,953,1,11,5,6,6,single-choice,spatial-relational,5|6,7,5/6,210449,5
6,1,21,450,1,922,1,3,1,1,2,single-choice,spatial-relational,1|2,7,1/2,210450,1
6,1,21,451,1,782,1,7,3,3,4,single-choice,spatial-relational,3|4,7,3/4,210451,3
6,1,21,452,1,1013,1,7,3,3,4,single-choice,spatial-relational,3|4,7,3/4,210452,3
6,1,21,453,1,1146,1,5,2,2,3,single-choice,spatial-relational,2|3,7,2/3,210453,2
6,1,21,454,1,1040,1,5,2,2,3,single-choice,spatial-relational,2|3,7,2/3,210454,2
6,1,21,455,1,870,1,9,4,4,5,single-choice,spatial-relational,4|5,7,4/5,210455,4
6,1,21,456,1,1108,1,13,6,6,7,single-choice,spatial-relational,6|7,7,6/7,210456,6
6,1,21,457,0,764,1,3,1,2,2,single-choice,spatial-relational,1|2,7,1/2,210457,1
6,1,21,458,1,1105,1,9,4,4,5,single-choice,spatial-relational,4|5,7,4/5,210458,4
6,1,21,459,1,1184,1,7,3,3,4,single-choice,spatial-relational,3|4,7,3/4,210459,3
6,1,21,460,1,703,1,7,3,3,4,single-choice,spatial-relational,3|4,7,3/4,210460,3
6,1,21,461,1,1459,1,5,2,2,3,single-choice,spatial-relational,2|3,7,2/3,210461,2
6,1,21,462,1,1177,1,13,6,6,7,single-choice,spatial-relational,6|7,7,6/7,210462,6
6,1,21,463,0,902,1,9,4,5,5,single-choice,spatial-relational,4|5,7,4/5,210463,4
6,1,21,464,1,1128,1,13,6,6,7,single-choice,spatial-relational,6|7,7,6/7,210464,6
6,1,21,465,1,1223,1,5,2,2,3,single-choice,spatial-relational,2|3,7,2/3,210465,2
6,1,21,466,1,983,1,3,1,1,2,single-choice,spatial-relational,1|2,7,1/2,210466,1
6,1,21,467,0,1540,1,11,5,6,6,single-choice,spatial-relational,5|6,7,5/6,210467,5
6,1,21,468,1,1262,1,11,5,5,6,single-choice,spatial-relational,5|6,7,5/6,210468,5
6,1,21,469,1,992,1,9,4,4,5,single-choice,spatial-relational,4|5,7,4/5,210469,4
6,1,21,470,0,874,1,5,2,3,3,single-choice,spatial-relational,2|3,7,2/3,210470,2
6,1,21,471,1,916,1,13,6,6,7,single-choice,spatial-relational,6|7,7,6/7,210471,6
6,1,21,472,1,1207,1,9,4,4,5,single-choice,spatial-relational,4|5,7,4/5,210472,4
6,1,21,473,1,1254,1,7,3,3,4,single-choice,spatial-relational,3|4,7,3/4,210473,3
6,1,21,474,1,703,1,13,6,6,7,single-choice,spatial-relational,6|7,7,6/7,210474,6
6,1,21,475,0,903,1,3,1,2,2,single-choice,spatial-relational,1|2,7,1/2,210475,1
6,1,21,476,0,869,1,11,5,6,6,single-choice,spatial-relational,5|6,7,5/6,210476,5
6,1,21,477,1,859,1,11,5,5,6,single-choice,spatial-relational,5|6,7,5/6,210477,5
6,1,21,478,1,1510,1,3,1,1,2,single-choice,spatial-relational,1|2,7,1/2,210478,1
6,1,21,479,1,781,1,5,2,2,3,single-choice,spatial-relational,2|3,7,2/3,210479,2
6,1,21,480,1,884,1,7,3,3,4,single-choice,spatial-relational,3|4,7,3/4,210480,3
6,1,21,481,1,1008,1,13,6,6,7,single-choice,spatial-relational,6|7,7,6/7,210481,6
6,1,21,482,0,727,1,11,5,6,6,single-choice,spatial-relational,5|6,7,5/6,210482,5
6,1,21,483,1,909,1,3,1,1,2,single-choice,spatial-relational,1|2,7,1/2,210483,1
6,1,21,484,1,742,1,7,3,3,4,single-choice,spatial-relational,3|4,7,3/4,210484,3
6,1,21,485,1,945,1,9,4,4,5,single-choice,spatial-relational,4|5,7,4/5,210485,4
6,1,21,486,0,951,1,5,2,3,3,single-choice,spatial-relational,2|3,7,2/3,210486,2
6,1,21,487,1,832,1,7,3,3,4,single-choice,spatial-relational,3|4,7,3/4,210487,3
6,1,21,488,0,938,1,5,2,3,3,single-choice,spatial-relational,2|3,7,2/3,210488,2
6,1,21,489,0,589,1,3,1,2,2,single-choice,spatial-relational,1|2,7,1/2,210489,1
6,1,21,490,0,1035,1,11,5,6,6,single-choice,spatial-relational,5|6,7,5/6,210490,5
6,1,21,491,1,902,1,13,6,6,7,single-choice,spatial-relational,6|7,7,6/7,210491,6
6,1,21,492,1,754,1,9,4,4,5,single-choice,spatial-relational,4|5,7,4/5,210492,4
6,1,21,493,0,660,1,3,1,2,2,single-choice,spatial-relational,1|2,7,1/2,210493,1
6,1,21,494,0,755,1,3,1,2,2,single-choice,spatial-relational,1|2,7,1/2,210494,1
6,1,21,495,1,548,1,13,6,6,7,single-choice,spatial-relational,6|7,7,6/7,210495,6
6,1,21,496,1,735,1,9,4,4,5,single-choice,spatial-relational,4|5,7,4/5,210496,4
6,1,21,497,0,1123,1,5,2,3,3,single-choice,spatial-relational,2|3,7,2/3,210497,2
6,1,21,498,1,817,1,9,4,4,5,single-choice,spatial-relational,4|5,7,4/5,210498,4
6,1,21,499,1,1022,1,5,2,2,3,single-choice,spatial-relational,2|3,7,2/3,210499,2
6,1,21,500,1,897,1,13,6,6,7,single-choice,spatial-relational,6|7,7,6/7,210500,6
6,1,21,501,1,1076,1,11,5,5,6,single-choice,spatial-relational,5|6,7,5/6,210501,5
6,1,21,502,0,1380,1,7,3,4,4,single-choice,spatial-relational,3|4,7,3/4,210502,3
6,1,21,503,1,986,1,11,5,5,6,single-choice,spatial-relational,5|6,7,5/6,210503,5
6,1,21,504,1,1040,1,7,3,3,4,single-choice,spatial-relational,3|4,7,3/4,210504,3
6,1,21,505,1,884,1,3,1,1,2,single-choice,spatial-relational,1|2,7,1/2,210505,1
6,1,21,506,1,929,1,9,4,4,5,single-choice,spatial-relational,4|5,7,4/5,210506,4
6,1,21,507,0,936,1,9,4,5,5,single-choice,spatial-relational,4|5,7,4/5,210507,4
6,1,21,508,1,745,1,5,2,2,3,single-choice,spatial-relational,2|3,7,2/3,210508,2
6,1,21,509,0,679,1,11,5,6,6,single-choice,spatial-relational,5|6,7,5/6,210509,5
6,1,21,510,1,111,1,13,6,6,7,single-choice,spatial-relational,6|7,7,6/7,210510,6
6,1,21,511,0,1041,1,5,2,3,3,single-choice,spatial-relational,2|3,7,2/3,210511,2
6,1,21,512,1,829,1,3,1,1,2,single-choice,spatial-relational,1|2,7,1/2,210512,1
6,1,21,513,0,1084,1,11,5,6,6,single-choice,spatial-relational,5|6,7,5/6,210513,5
6,1,21,514,1,942,1,13,6,6,7,single-choice,spatial-relational,6|7,7,6/7,210514,6
6,1,21,515,1,1101,1,7,3,3,4,single-choice,spatial-relational,3|4,7,3/4,210515,3
6,1,21,516,1,1070,1,7,3,3,4,single-choice,spatial-relational,3|4,7,3/4,210516,3
6,1,21,517,1,1364,1,13,6,6,7,single-choice,spatial-relational,6|7,7,6/7,210517,6
6,1,21,518,0,884,1,5,2,3,3,single-choice,spatial-relational,2|3,7,2/3,210518,2
6,1,21,519,1,1040,1,9,4,4,5,single-choice,spatial-relational,4|5,7,4/5,210519,4
6,1,21,520,0,1004,1,5,2,3,3,single-choice,spatial-relational,2|3,7,2/3,210520,2
6,1,21,521,0,995,1,11,5,6,6,single-choice,spatial-relational,5|6,7,5/6,210521,5
6,1,21,522,1,949,1,7,3,3,4,single-choice,spatial-relational,3|4,7,3/4,210522,3
6,1,21,523,1,837,1,9,4,4,5,single-choice,spatial-relational,4|5,7,4/5,210523,4
6,1,21,524,0,757,1,3,1,2,2,single-choice,spatial-relational,1|2,7,1/2,210524,1
6,1,21,525,1,1125,1,7,3,3,4,single-choice,spatial-relational,3|4,7,3/4,210525,3
6,1,21,526,0,708,1,11,5,6,6,single-choice,spatial-relational,5|6,7,5/6,210526,5
6,1,21,527,0,767,1,3,1,2,2,single-choice,spatial-relational,1|2,7,1/2,210527,1
6,1,21,528,1,938,1,13,6,6,7,single-choice,spatial-relational,6|7,7,6/7,210528,6
6,1,21,529,1,1326,1,7,3,3,4,single-choice,spatial-relational,3|4,7,3/4,210529,3
6,1,21,530,1,753,1,7,3,3,4,single-choice,spatial-relational,3|4,7,3/4,210530,3
6,1,21,531,0,816,1,13,6,7,7,single-choice,spatial-relational,6|7,7,6/7,210531,6
6,1,21,532,1,902,1,5,2,2,3,single-choice,spatial-relational,2|3,7,2/3,210532,2
6,1,21,533,0,779,1,9,4,5,5,single-choice,spatial-relational,4|5,7,4/5,210533,4
6,1,21,534,0,905,1,11,5,6,6,single-choice,spatial-relational,5|6,7,5/6,210534,5
6,1,21,535,1,1138,1,11,5,5,6,single-choice,spatial-relational,5|6,7,5/6,210535,5
6,1,21,536,1,922,1,5,2,2,3,single-choice,spatial-relational,2|3,7,2/3,210536,2
6,1,21,537,1,1021,1,3,1,1,2,single-choice,spatial-relational,1|2,7,1/2,210537,1
6,1,21,538,1,811,1,3,1,1,2,single-choice,spatial-relational,1|2,7,1/2,210538,1
6,1,21,539,1,986,1,9,4,4,5,single-choice,spatial-relational,4|5,7,4/5,210539,4
6,1,21,540,1,1287,1,13,6,6,7,single-choice,spatial-relational,6|7,7,6/7,210540,6
6,1,21,541,1,793,1,9,4,4,5,single-choice,spatial-relational,4|5,7,4/5,210541,4
6,1,21,542,1,1092,1,7,3,3,4,single-choice,spatial-relational,3|4,7,3/4,210542,3
6,1,21,543,1,1031,1,13,6,6,7,single-choice,spatial-relational,6|7,7,6/7,210543,6
6,1,21,544,1,1091,1,3,1,1,2,single-choice,spatial-relational,1|2,7,1/2,210544,1
6,1,21,545,0,1025,1,5,2,3,3,single-choice,spatial-relational,2|3,7,2/3,210545,2
6,1,21,546,0,724,1,3,1,2,2,single-choice,spatial-relational,1|2,7,1/2,210546,1
6,1,21,547,0,1166,1,11,5,6,6,single-choice,spatial-relational,5|6,7,5/6,210547,5
6,1,21,548,1,949,1,7,3,3,4,single-choice,spatial-relational,3|4,7,3/4,210548,3
6,1,21,549,0,799,1,5,2,3,3,single-choice,spatial-relational,2|3,7,2/3,210549,2
6,1,21,550,1,934,1,13,6,6,7,single-choice,spatial-relational,6|7,7,6/7,210550,6
6,1,21,551,0,1487,1,11,5,6,6,single-choice,spatial-relational,5|6,7,5/6,210551,5
6,1,21,552,1,1065,1,9,4,4,5,single-choice,spatial-relational,4|5,7,4/5,210552,4
6,1,21,553,1,1287,1,7,3,3,4,single-choice,spatial-relational,3|4,7,3/4,210553,3
6,1,21,554,0,917,1,9,4,5,5,single-choice,spatial-relational,4|5,7,4/5,210554,4
6,1,21,555,1,876,1,3,1,1,2,single-choice,spatial-relational,1|2,7,1/2,210555,1
6,1,21,556,0,807,1,3,1,2,2,single-choice,spatial-relational,1|2,7,1/2,210556,1
6,1,21,557,0,1154,1,9,4,5,5,single-choice,spatial-relational,4|5,7,4/5,210557,4
6,1,21,558,1,1116,1,5,2,2,3,single-choice,spatial-relational,2|3,7,2/3,210558,2
6,1,21,559,1,797,1,7,3,3,4,single-choice,spatial-relational,3|4,7,3/4,210559,3
6,1,21,560,1,970,1,11,5,5,6,single-choice,spatial-relational,5|6,7,5/6,210560,5
6,1,21,561,1,1515,1,13,6,6,7,single-choice,spatial-relational,6|7,7,6/7,210561,6
6,1,21,562,1,1886,1,13,6,6,7,single-choice,spatial-relational,6|7,7,6/7,210562,6
6,1,21,563,0,862,1,5,2,3,3,single-choice,spatial-relational,2|3,7,2/3,210563,2
6,1,21,564,1,954,1,11,5,5,6,single-choice,spatial-relational,5|6,7,5/6,210564,5
6,1,21,565,0,884,1,9,4,5,5,single-choice,spatial-relational,4|5,7,4/5,210565,4
6,1,21,566,1,792,1,3,1,1,2,single-choice,spatial-relational,1|2,7,1/2,210566,1
6,1,21,567,0,1379,1,11,5,6,6,single-choice,spatial-relational,5|6,7,5/6,210567,5
6,1,21,568,1,846,1,7,3,3,4,single-choice,spatial-relational,3|4,7,3/4,210568,3
6,1,21,569,1,921,1,11,5,5,6,single-choice,spatial-relational,5|6,7,5/6,210569,5
6,1,21,570,0,1118,1,7,3,4,4,single-choice,spatial-relational,3|4,7,3/4,210570,3
6,1,21,571,0,734,1,9,4,5,5,single-choice,spatial-relational,4|5,7,4/5,210571,4
6,1,21,572,1,980,1,5,2,2,3,single-choice,spatial-relational,2|3,7,2/3,210572,2
6,1,21,573,1,824,1,3,1,1,2,single-choice,spatial-relational,1|2,7,1/2,210573,1
6,1,21,574,1,1095,1,13,6,6,7,single-choice,spatial-relational,6|7,7,6/7,210574,6
6,1,21,575,1,1205,1,5,2,2,3,single-choice,spatial-relational,2|3,7,2/3,210575,2
6,1,21,576,1,1038,1,13,6,6,7,single-choice,spatial-relational,6|7,7,6/7,210576,6
6,1,21,577,0,974,1,11,5,6,6,single-choice,spatial-relational,5|6,7,5/6,210577,5
6,1,21,578,1,751,1,3,1,1,2,single-choice,spatial-relational,1|2,7,1/2,210578,1
6,1,21,579,1,770,1,3,1,1,2,single-choice,spatial-relational,1|2,7,1/2,210579,1
6,1,21,580,1,1291,1,13,6,6,7,single-choice,spatial-relational,6|7,7,6/7,210580,6
6,1,21,581,1,1099,1,5,2,2,3,single-choice,spatial-relational,2|3,7,2/3,210581,2
6,1,21,582,1,937,1,7,3,3,4,single-choice,spatial-relational,3|4,7,3/4,210582,3
6,1,21,583,1,791,1,9,4,4,5,single-choice,spatial-relational,4|5,7,4/5,210583,4
6,1,21,584,1,953,1,7,3,3,4,single-choice,spatial-relational,3|4,7,3/4,210584,3
6,1,21,585,1,934,1,9,4,4,5,single-choice,spatial-relational,4|5,7,4/5,210585,4
6,1,21,586,1,804,1,13,6,6,7,single-choice,spatial-relational,6|7,7,6/7,210586,6
6,1,21,587,1,859,1,5,2,2,3,single-choice,spatial-relational,2|3,7,2/3,210587,2
6,1,21,588,1,998,1,11,5,5,6,single-choice,spatial-relational,5|6,7,5/6,210588,5
6,1,21,589,1,928,1,3,1,1,2,single-choice,spatial-relational,1|2,7,1/2,210589,1
6,1,21,590,1,939,1,11,5,5,6,single-choice,spatial-relational,5|6,7,5/6,210590,5
6,1,21,591,0,747,1,9,4,5,5,single-choice,spatial-relational,4|5,7,4/5,210591,4
6,1,21,592,1,775,1,3,1,1,2,single-choice,spatial-relational,1|2,7,1/2,210592,1
6,1,21,593,0,955,1,11,5,6,6,single-choice,spatial-relational,5|6,7,5/6,210593,5
6,1,21,594,1,1180,1,13,6,6,7,single-choice,spatial-relational,6|7,7,6/7,210594,6
6,1,21,595,0,1418,1,5,2,3,3,single-choice,spatial-relational,2|3,7,2/3,210595,2
6,1,21,596,1,757,1,7,3,3,4,single-choice,spatial-relational,3|4,7,3/4,210596,3
6,1,21,597,1,1182,1,13,6,6,7,single-choice,spatial-relational,6|7,7,6/7,210597,6
6,1,21,598,1,1481,1,7,3,3,4,single-choice,spatial-relational,3|4,7,3/4,210598,3
6,1,21,599,0,1269,1,9,4,5,5,single-choice,spatial-relational,4|5,7,4/5,210599,4
6,1,21,600,0,1011,1,5,2,3,3,single-choice,spatial-relational,2|3,7,2/3,210600,2
7,1,21,1,0,8,1,13,6,7,7,single-choice,spatial-relational,6|7,7,6/7,210001,6
7,1,21,2,1,859,1,11,5,5,6,single-choice,spatial-relational,5|6,7,5/6,210002,5
7,1,21,3,1,719,1,13,6,6,7,single-choice,spatial-relational,6|7,7,6/7,210003,6
7,1,21,4,1,868,1,5,2,2,3,single-choice,spatial-relational,2|3,7,2/3,210004,2
7,1,21,5,0,636,1,3,1,2,2,single-choice,spatial-relational,1|2,7,1/2,210005,1
7,1,21,6,1,832,1,11,5,5,6,single-choice,spatial-relational,5|6,7,5/6,210006,5
7,1,21,7,1,946,1,7,3,3,4,single-choice,spatial-relational,3|4,7,3/4,210007,3
7,1,21,8,0,1158,1,7,3,4,4,single-choice,spatial-relational,3|4,7,3/4,210008,3
7,1,21,9,1,780,1,5,2,2,3,single-choice,spatial-relational,2|3,7,2/3,210009,2
7,1,21,10,1,1206,1,9,4,4,5,single-choice,spatial-relational,4|5,7,4/5,210010,4
7,1,21,11,1,890,1,9,4,4,5,single-choice,spatial-relational,4|5,7,4/5,210011,4
7,1,21,12,1,1060,1,3,1,1,2,single-choice,spatial-relational,1|2,7,1/2,210012,1
7,1,21,13,1,984,1,13,6,6,7,single-choice,spatial-relational,6|7,7,6/7,210013,6
7,1,21,14,1,900,1,5,2,2,3,single-choice,spatial-relational,2|3,7,2/3,210014,2
7,1,21,15,1,806,1,13,6,6,7,single-choice,spatial-relational,6|7,7,6/7,210015,6
7,1,21,16,1,1767,1,5,2,2,3,single-choice,spatial-relational,2|3,7,2/3,210016,2
7,1,21,17,1,1219,1,9,4,4,5,single-choice,spatial-relational,4|5,7,4/5,210017,4
7,1,21,18,0,1753,1,9,4,5,5,single-choice,spatial-relational,4|5,7,4/5,210018,4
7,1,21,19,1,824,1,7,3,3,4,single-choice,spatial-relational,3|4,7,3/4,210019,3
7,1,21,20,1,1090,1,11,5,5,6,single-choice,spatial-relational,5|6,7,5/6,210020,5
7,1,21,21,1,941,1,3,1,1,2,single-choice,spatial-relational,1|2,7,1/2,210021,1
7,1,21,22,1,784,1,11,5,5,6,single-choice,spatial-relational,5|6,7,5/6,210022,5
7,1,21,23,0,918,1,3,1,2,2,single-choice,spatial-relational,1|2,7,1/2,210023,1
7,1,21,24,0,650,1,7,3,4,4,single-choice,spatial-relational,3|4,7,3/4,210024,3
7,1,21,25,1,611,1,5,2,2,3,single-choice,spatial-relational,2|3,7,2/3,210025,2
7,1,21,26,1,912,1,11,5,5,6,single-choice,spatial-relational,5|6,7,5/6,210026,5
7,1,21,27,0,1031,1,5,2,3,3,single-choice,spatial-relational,2|3,7,2/3,210027,2
7,1,21,28,1,699,1,13,6,6,7,single-choice,spatial-relational,6|7,7,6/7,210028,6
7,1,21,29,1,2157,1,7,3,3,4,single-choice,spatial-relational,3|4,7,3/4,210029,3
7,1,21,30,1,576,1,13,6,6,7,single-choice,spatial-relational,6|7,7,6/7,210030,6
7,1,21,31,0,709,1,7,3,4,4,single-choice,spatial-relational,3|4,7,3/4,210031,3
7,1,21,32,1,776,1,3,1,1,2,single-choice,spatial-relational,1|2,7,1/2,210032,1
7,1,21,33,0,1070,1,3,1,2,2,single-choice,spatial-relational,1|2,7,1/2,210033,1
7,1,21,34,1,1514,1,9,4,4,5,single-choice,spatial-relational,4|5,7,4/5,210034,4
7,1,21,35,0,34,1,11,5,6,6,single-choice,spatial-relational,5|6,7,5/6,210035,5
7,1,21,36,1,2,1,9,4,4,5,single-choice,spatial-relational,4|5,7,4/5,210036,4
7,1,21,37,1,2876,1,9,4,4,5,single-choice,spatial-relational,4|5,7,4/5,210037,4
7,1,21,38,0,1328,1,7,3,4,4,single-choice,spatial-relational,3|4,7,3/4,210038,3
7,1,21,39,1,569,1,13,6,6,7,single-choice,spatial-relational,6|7,7,6/7,210039,6
7,1,21,40,0,1610,1,5,2,3,3,single-choice,spatial-relational,2|3,7,2/3,210040,2
7,1,21,41,1,1064,1,3,1,1,2,single-choice,spatial-relational,1|2,7,1/2,210041,1
7,1,21,42,1,797,1,7,3,3,4,single-choice,spatial-relational,3|4,7,3/4,210042,3
7,1,21,43,1,1574,1,11,5,5,6,single-choice,spatial-relational,5|6,7,5/6,210043,5
7,1,21,44,1,918,1,5,2,2,3,single-choice,spatial-relational,2|3,7,2/3,210044,2
7,1,21,45,1,1454,1,11,5,5,6,single-choice,spatial-relational,5|6,7,5/6,210045,5
7,1,21,46,1,1017,1,3,1,1,2,single-choice,spatial-relational,1|2,7,1/2,210046,1
7,1,21,47,1,949,1,13,6,6,7,single-choice,spatial-relational,6|7,7,6/7,210047,6
7,1,21,48,1,1982,1,9,4,4,5,single-choice,spatial-relational,4|5,7,4/5,210048,4
7,1,21,49,1,5117,1,3,1,1,2,single-choice,spatial-relational,1|2,7,1/2,210049,1
7,1,21,50,0,1508,1,11,5,6,6,single-choice,spatial-relational,5|6,7,5/6,210050,5
7,1,21,51,1,975,1,9,4,4,5,single-choice,spatial-relational,4|5,7,4/5,210051,4
7,1,21,52,1,960,1,5,2,2,3,single-choice,spatial-relational,2|3,7,2/3,210052,2
7,1,21,53,1,1141,1,11,5,5,6,single-choice,spatial-relational,5|6,7,5/6,210053,5
7,1,21,54,1,1246,1,5,2,2,3,single-choice,spatial-relational,2|3,7,2/3,210054,2
7,1,21,55,1,2011,1,9,4,4,5,single-choice,spatial-relational,4|5,7,4/5,210055,4
7,1,21,56,1,1938,1,7,3,3,4,single-choice,spatial-relational,3|4,7,3/4,210056,3
7,1,21,57,1,1238,1,3,1,1,2,single-choice,spatial-relational,1|2,7,1/2,210057,1
7,1,21,58,1,1077,1,13,6,6,7,single-choice,spatial-relational,6|7,7,6/7,210058,6
7,1,21,59,1,1292,1,7,3,3,4,single-choice,spatial-relational,3|4,7,3/4,210059,3
7,1,21,60,1,620,1,13,6,6,7,single-choice,spatial-relational,6|7,7,6/7,210060,6
7,1,21,61,1,957,1,13,6,6,7,single-choice,spatial-relational,6|7,7,6/7,210061,6
7,1,21,62,1,1175,1,3,1,1,2,single-choice,spatial-relational,1|2,7,1/2,210062,1
7,1,21,63,1,1405,1,9,4,4,5,single-choice,spatial-relational,4|5,7,4/5,210063,4
7,1,21,64,1,752,1,5,2,2,3,single-choice,spatial-relational,2|3,7,2/3,210064,2
7,1,21,65,1,1775,1,7,3,3,4,single-choice,spatial-relational,3|4,7,3/4,210065,3
7,1,21,66,1,1123,1,7,3,3,4,single-choice,spatial-relational,3|4,7,3/4,210066,3
7,1,21,67,1,1356,1,11,5,5,6,single-choice,spatial-relational,5|6,7,5/6,210067,5
7,1,21,68,1,1328,1,3,1,1,2,single-choice,spatial-relational,1|2,7,1/2,210068,1
7,1,21,69,0,876,1,9,4,5,5,single-choice,spatial-relational,4|5,7,4/5,210069,4
7,1,21,70,0,1399,1,5,2,3,3,single-choice,spatial-relational,2|3,7,2/3,210070,2
7,1,21,71,1,976,1,13,6,6,7,single-choice,spatial-relational,6|7,7,6/7,210071,6
7,1,21,72,1,1373,1,11,5,5,6,single-choice,spatial-relational,5|6,7,5/6,210072,5
7,1,21,73,1,714,1,5,2,2,3,single-choice,spatial-relational,2|3,7,2/3,210073,2
7,1,21,74,1,1410,1,5,2,2,3,single-choice,spatial-relational,2|3,7,2/3,210074,2
7,1,21,75,1,2225,1,11,5,5,6,single-choice,spatial-relational,5|6,7,5/6,210075,5
7,1,21,76,0,928,1,3,1,2,2,single-choice,spatial-relational,1|2,7,1/2,210076,1
7,1,21,77,1,1067,1,11,5,5,6,single-choice,spatial-relational,5|6,7,5/6,210077,5
7,1,21,78,1,1874,1,9,4,4,5,single-choice,spatial-relational,4|5,7,4/5,210078,4
7,1,21,79,1,942,1,9,4,4,5,single-choice,spatial-relational,4|5,7,4/5,210079,4
7,1,21,80,0,1943,1,3,1,2,2,single-choice,spatial-relational,1|2,7,1/2,210080,1
7,1,21,81,1,970,1,7,3,3,4,single-choice,spatial-relational,3|4,7,3/4,210081,3
7,1,21,82,1,646,1,13,6,6,7,single-choice,spatial-relational,6|7,7,6/7,210082,6
7,1,21,83,1,1383,1,7,3,3,4,single-choice,spatial-relational,3|4,7,3/4,210083,3
7,1,21,84,1,1043,1,13,6,6,7,single-choice,spatial-relational,6|7,7,6/7,210084,6
7,1,21,85,0,1557,1,9,4,5,5,single-choice,spatial-relational,4|5,7,4/5,210085,4
7,1,21,86,0,22,1,13,6,7,7,single-choice,spatial-relational,6|7,7,6/7,210086,6
7,1,21,87,1,774,1,5,2,2,3,single-choice,spatial-relational,2|3,7,2/3,210087,2
7,1,21,88,1,1019,1,7,3,3,4,single-choice,spatial-relational,3|4,7,3/4,210088,3
7,1,21,89,1,1345,1,3,1,1,2,single-choice,spatial-relational,1|2,7,1/2,210089,1
7,1,21,90,1,697,1,13,6,6,7,single-choice,spatial-relational,6|7,7,6/7,210090,6
7,1,21,91,1,2651,1,3,1,1,2,single-choice,spatial-relational,1|2,7,1/2,210091,1
7,1,21,92,0,929,1,11,5,6,6,single-choice,spatial-relational,5|6,7,5/6,210092,5
7,1,21,93,0,599,1,5,2,3,3,single-choice,spatial-relational,2|3,7,2/3,210093,2
7,1,21,94,0,713,1,7,3,4,4,single-choice,spatial-relational,3|4,7,3/4,210094,3
7,1,21,95,1,5841,1,9,4,4,5,single-choice,spatial-relational,4|5,7,4/5,210095,4
7,1,21,96,1,909,1,11,5,5,6,single-choice,spatial-relational,5|6,7,5/6,210096,5
7,1,21,97,1,930,1,13,6,6,7,single-choice,spatial-relational,6|7,7,6/7,210097,6
7,1,21,98,1,863,1,3,1,1,2,single-choice,spatial-relational,1|2,7,1/2,210098,1
7,1,21,99,1,688,1,13,6,6,7,single-choice,spatial-relational,6|7,7,6/7,210099,6
7,1,21,100,1,1417,1,3,1,1,2,single-choice,spatial-relational,1|2,7,1/2,210100,1
7,1,21,101,1,1009,1,5,2,2,3,single-choice,spatial-relational,2|3,7,2/3,210101,2
7,1,21,102,0,766,1,11,5,6,6,single-choice,spatial-relational,5|6,7,5/6,210102,5
7,1,21,103,1,743,1,9,4,4,5,single-choice,spatial-relational,4|5,7,4/5,210103,4
7,1,21,104,1,1209,1,9,4,4,5,single-choice,spatial-relational,4|5,7,4/5,210104,4
7,1,21,105,1,1095,1,7,3,3,4,single-choice,spatial-relational,3|4,7,3/4,210105,3
7,1,21,106,0,1114,1,11,5,6,6,single-choice,spatial-relational,5|6,7,5/6,210106,5
7,1,21,107,1,971,1,7,3,3,4,single-choice,spatial-relational,3|4,7,3/4,210107,3
7,1,21,108,1,1136,1,5,2,2,3,single-choice,spatial-relational,2|3,7,2/3,210108,2
7,1,21,109,1,746,1,13,6,6,7,single-choice,spatial-relational,6|7,7,6/7,210109,6
7,1,21,110,1,1533,1,11,5,5,6,single-choice,spatial-relational,5|6,7,5/6,210110,5
7,1,21,111,1,1680,1,7,3,3,4,single-choice,spatial-relational,3|4,7,3/4,210111,3
7,1,21,112,1,939,1,3,1,1,2,single-choice,spatial-relational,1|2,7,1/2,210112,1
7,1,21,113,1,970,1,11,5,5,6,single-choice,spatial-relational,5|6,7,5/6,210113,5
7,1,21,114,1,1490,1,5,2,2,3,single-choice,spatial-relational,2|3,7,2/3,210114,2
7,1,21,115,1,1317,1,7,3,3,4,single-choice,spatial-relational,3|4,7,3/4,210115,3
7,1,21,116,1,1093,1,13,6,6,7,single-choice,spatial-relational,6|7,7,6/7,210116,6
7,1,21,117,1,1583,1,9,4,4,5,single-choice,spatial-relational,4|5,7,4/5,210117,4
7,1,21,118,0,1677,1,9,4,5,5,single-choice,spatial-relational,4|5,7,4/5,210118,4
7,1,21,119,1,860,1,5,2,2,3,single-choice,spatial-relational,2|3,7,2/3,210119,2
7,1,21,120,1,899,1,3,1,1,2,single-choice,spatial-relational,1|2,7,1/2,210120,1
7,1,21,121,1,751,1,13,6,6,7,single-choice,spatial-relational,6|7,7,6/7,210121,6
7,1,21,122,1,677,1,5,2,2,3,single-choice,spatial-relational,2|3,7,2/3,210122,2
7,1,21,123,1,929,1,13,6,6,7,single-choice,spatial-relational,6|7,7,6/7,210123,6
7,1,21,124,1,1759,1,11,5,5,6,single-choice,spatial-relational,5|6,7,5/6,210124,5
7,1,21,125,1,975,1,9,4,4,5,single-choice,spatial-relational,4|5,7,4/5,210125,4
7,1,21,126,0,635,1,5,2,3,3,single-choice,spatial-relational,2|3,7,2/3,210126,2
7,1,21,127,1,737,1,3,1,1,2,single-choice,spatial-relational,1|2,7,1/2,210127,1
7,1,21,128,1,1145,1,9,4,4,5,single-choice,spatial-relational,4|5,7,4/5,210128,4
7,1,21,129,1,812,1,7,3,3,4,single-choice,spatial-relational,3|4,7,3/4,210129,3
7,1,21,130,1,1294,1,7,3,3,4,single-choice,spatial-relational,3|4,7,3/4,210130,3
7,1,21,131,1,510,1,11,5,5,6,single-choice,spatial-relational,5|6,7,5/6,210131,5
7,1,21,132,1,1292,1,3,1,1,2,single-choice,spatial-relational,1|2,7,1/2,210132,1
7,1,21,133,1,1436,1,5,2,2,3,single-choice,spatial-relational,2|3,7,2/3,210133,2
7,1,21,134,0,2119,1,7,3,4,4,single-choice,spatial-relational,3|4,7,3/4,210134,3
7,1,21,135,1,926,1,11,5,5,6,single-choice,spatial-relational,5|6,7,5/6,210135,5
7,1,21,136,1,792,1,13,6,6,7,single-choice,spatial-relational,6|7,7,6/7,210136,6
7,1,21,137,0,1569,1,9,4,5,5,single-choice,spatial-relational,4|5,7,4/5,210137,4
7,1,21,138,1,810,1,7,3,3,4,single-choice,spatial-relational,3|4,7,3/4,210138,3
7,1,21,139,1,1548,1,9,4,4,5,single-choice,spatial-relational,4|5,7,4/5,210139,4
7,1,21,140,1,708,1,5,2,2,3,single-choice,spatial-relational,2|3,7,2/3,210140,2
7,1,21,141,1,1107,1,3,1,1,2,single-choice,spatial-relational,1|2,7,1/2,210141,1
7,1,21,142,1,785,1,13,6,6,7,single-choice,spatial-relational,6|7,7,6/7,210142,6
7,1,21,143,1,1249,1,11,5,5,6,single-choice,spatial-relational,5|6,7,5/6,210143,5
7,1,21,144,1,1204,1,3,1,1,2,single-choice,spatial-relational,1|2,7,1/2,210144,1
7,1,21,145,1,1696,1,5,2,2,3,single-choice,spatial-relational,2|3,7,2/3,210145,2
7,1,21,146,1,1544,1,3,1,1,2,single-choice,spatial-relational,1|2,7,1/2,210146,1
7,1,21,147,1,895,1,7,3,3,4,single-choice,spatial-relational,3|4,7,3/4,210147,3
7,1,21,148,1,2497,1,7,3,3,4,single-choice,spatial-relational,3|4,7,3/4,210148,3
7,1,21,149,1,987,1,11,5,5,6,single-choice,spatial-relational,5|6,7,5/6,210149,5
7,1,21,150,1,3189,1,9,4,4,5,single-choice,spatial-relational,4|5,7,4/5,210150,4
7,1,21,151,0,799,1,11,5,6,6,single-choice,spatial-relational,5|6,7,5/6,210151,5
7,1,21,152,0,826,1,3,1,2,2,single-choice,spatial-relational,1|2,7,1/2,210152,1
7,1,21,153,1,824,1,13,6,6,7,single-choice,spatial-relational,6|7,7,6/7,210153,6
7,1,21,154,1,955,1,13,6,6,7,single-choice,spatial-relational,6|7,7,6/7,210154,6
7,1,21,155,1,1368,1,5,2,2,3,single-choice,spatial-relational,2|3,7,2/3,210155,2
7,1,21,156,1,1449,1,9,4,4,5,single-choice,spatial-relational,4|5,7,4/5,210156,4
7,1,21,157,1,608,1,13,6,6,7,single-choice,spatial-relational,6|7,7,6/7,210157,6
7,1,21,158,1,1697,1,9,4,4,5,single-choice,spatial-relational,4|5,7,4/5,210158,4
7,1,21,159,1,1743,1,11,5,5,6,single-choice,spatial-relational,5|6,7,5/6,210159,5
7,1,21,160,1,1140,1,7,3,3,4,single-choice,spatial-relational,3|4,7,3/4,210160,3
7,1,21,161,1,654,1,5,2,2,3,single-choice,spatial-relational,2|3,7,2/3,210161,2
7,1,21,162,1,1260,1,3,1,1,2,single-choice,spatial-relational,1|2,7,1/2,210162,1
7,1,21,163,1,924,1,3,1,1,2,single-choice,spatial-relational,1|2,7,1/2,210163,1
7,1,21,164,1,695,1,9,4,4,5,single-choice,spatial-relational,4|5,7,4/5,210164,4
7,1,21,165,1,1521,1,5,2,2,3,single-choice,spatial-relational,2|3,7,2/3,210165,2
7,1,21,166,1,900,1,13,6,6,7,single-choice,spatial-relational,6|7,7,6/7,210166,6
7,1,21,167,1,1001,1,7,3,3,4,single-choice,spatial-relational,3|4,7,3/4,210167,3
7,1,21,168,0,1228,1,11,5,6,6,single-choice,spatial-relational,5|6,7,5/6,210168,5
7,1,21,169,1,786,1,3,1,1,2,single-choice,spatial-relational,1|2,7,1/2,210169,1
7,1,21,170,1,837,1,13,6,6,7,single-choice,spatial-relational,6|7,7,6/7,210170,6
7,1,21,171,0,762,1,3,1,2,2,single-choice,spatial-relational,1|2,7,1/2,210171,1
7,1,21,172,1,852,1,7,3,3,4,single-choice,spatial-relational,3|4,7,3/4,210172,3
7,1,21,173,1,1154,1,5,2,2,3,single-choice,spatial-relational,2|3,7,2/3,210173,2
7,1,21,174,1,626,1,13,6,6,7,single-choice,spatial-relational,6|7,7,6/7,210174,6
7,1,21,175,1,1162,1,9,4,4,5,single-choice,spatial-relational,4|5,7,4/5,210175,4
7,1,21,176,1,872,1,5,2,2,3,single-choice,spatial-relational,2|3,7,2/3,210176,2
7,1,21,177,1,1369,1,9,4,4,5,single-choice,spatial-relational,4|5,7,4/5,210177,4
7,1,21,178,1,1224,1,7,3,3,4,single-choice,spatial-relational,3|4,7,3/4,210178,3
7,1,21,179,1,1565,1,11,5,5,6,single-choice,spatial-relational,5|6,7,5/6,210179,5
7,1,21,180,1,1229,1,11,5,5,6,single-choice,spatial-relational,5|6,7,5/6,210180,5
7,1,21,181,1,2292,1,7,3,3,4,single-choice,spatial-relational,3|4,7,3/4,210181,3
7,1,21,182,1,958,1,13,6,6,7,single-choice,spatial-relational,6|7,7,6/7,210182,6
7,1,21,183,1,772,1,5,2,2,3,single-choice,spatial-relational,2|3,7,2/3,210183,2
7,1,21,184,1,1186,1,9,4,4,5,single-choice,spatial-relational,4|5,7,4/5,210184,4
7,1,21,185,1,1213,1,11,5,5,6,single-choice,spatial-relational,5|6,7,5/6,210185,5
7,1,21,186,1,1322,1,3,1,1,2,single-choice,spatial-relational,1|2,7,1/2,210186,1
7,1,21,187,0,890,1,5,2,3,3,single-choice,spatial-relational,2|3,7,2/3,210187,2
7,1,21,188,1,571,1,13,6,6,7,single-choice,spatial-relational,6|7,7,6/7,210188,6
7,1,21,189,0,1651,1,9,4,5,5,single-choice,spatial-relational,4|5,7,4/5,210189,4
7,1,21,190,1,939,1,7,3,3,4,single-choice,spatial-relational,3|4,7,3/4,210190,3
7,1,21,191,0,1031,1,11,5,6,6,single-choice,spatial-relational,5|6,7,5/6,210191,5
7,1,21,192,1,1028,1,3,1,1,2,single-choice,spatial-relational,1|2,7,1/2,210192,1
7,1,21,193,1,1136,1,11,5,5,6,single-choice,spatial-relational,5|6,7,5/6,210193,5
7,1,21,194,1,1316,1,9,4,4,5,single-choice,spatial-relational,4|5,7,4/5,210194,4
7,1,21,195,1,1202,1,7,3,3,4,single-choice,spatial-relational,3|4,7,3/4,210195,3
7,1,21,196,0,721,1,3,1,2,2,single-choice,spatial-relational,1|2,7,1/2,210196,1
7,1,21,197,1,817,1,3,1,1,2,single-choice,spatial-relational,1|2,7,1/2,210197,1
7,1,21,198,1,1218,1,7,3,3,4,single-choice,spatial-relational,3|4,7,3/4,210198,3
7,1,21,199,1,1395,1,5,2,2,3,single-choice,spatial-relational,2|3,7,2/3,210199,2
7,1,21,200,1,872,1,11,5,5,6,single-choice,spatial-relational,5|6,7,5/6,210200,5
7,1,21,201,1,915,1,9,4,4,5,single-choice,spatial-relational,4|5,7,4/5,210201,4
7,1,21,202,1,1022,1,13,6,6,7,single-choice,spatial-relational,6|7,7,6/7,210202,6
7,1,21,203,1,902,1,5,2,2,3,single-choice,spatial-relational,2|3,7,2/3,210203,2
7,1,21,204,1,861,1,13,6,6,7,single-choice,spatial-relational,6|7,7,6/7,210204,6
7,1,21,205,1,1174,1,11,5,5,6,single-choice,spatial-relational,5|6,7,5/6,210205,5
7,1,21,206,1,1670,1,3,1,1,2,single-choice,spatial-relational,1|2,7,1/2,210206,1
7,1,21,207,1,751,1,5,2,2,3,single-choice,spatial-relational,2|3,7,2/3,210207,2
7,1,21,208,1,778,1,13,6,6,7,single-choice,spatial-relational,6|7,7,6/7,210208,6
7,1,21,209,1,1355,1,5,2,2,3,single-choice,spatial-relational,2|3,7,2/3,210209,2
7,1,21,210,1,1563,1,7,3,3,4,single-choice,spatial-relational,3|4,7,3/4,210210,3
7,1,21,211,1,1129,1,3,1,1,2,single-choice,spatial-relational,1|2,7,1/2,210211,1
7,1,21,212,1,819,1,11,5,5,6,single-choice,spatial-relational,5|6,7,5/6,210212,5
7,1,21,213,0,310,1,7,3,4,4,single-choice,spatial-relational,3|4,7,3/4,210213,3
7,1,21,214,1,956,1,9,4,4,5,single-choice,spatial-relational,4|5,7,4/5,210214,4
7,1,21,215,1,1025,1,13,6,6,7,single-choice,spatial-relational,6|7,7,6/7,210215,6
7,1,21,216,1,1115,1,9,4,4,5,single-choice,spatial-relational,4|5,7,4/5,210216,4
7,1,21,217,1,1304,1,9,4,4,5,single-choice,spatial-relational,4|5,7,4/5,210217,4
7,1,21,218,1,1248,1,7,3,3,4,single-choice,spatial-relational,3|4,7,3/4,210218,3
7,1,21,219,1,1002,1,13,6,6,7,single-choice,spatial-relational,6|7,7,6/7,210219,6
7,1,21,220,1,1825,1,5,2,2,3,single-choice,spatial-relational,2|3,7,2/3,210220,2
7,1,21,221,1,961,1,7,3,3,4,single-choice,spatial-relational,3|4,7,3/4,210221,3
7,1,21,222,1,1363,1,3,1,1,2,single-choice,spatial-relational,1|2,7,1/2,210222,1
7,1,21,223,1,984,1,3,1,1,2,single-choice,spatial-relational,1|2,7,1/2,210223,1
7,1,21,224,1,485,1,13,6,6,7,single-choice,spatial-relational,6|7,7,6/7,210224,6
7,1,21,225,1,1175,1,5,2,2,3,single-choice,spatial-relational,2|3,7,2/3,210225,2
7,1,21,226,1,1153,1,11,5,5,6,single-choice,spatial-relational,5|6,7,5/6,210226,5
7,1,21,227,1,912,1,11,5,5,6,single-choice,spatial-relational,5|6,7,5/6,210227,5
7,1,21,228,1,1044,1,9,4,4,5,single-choice,spatial-relational,4|5,7,4/5,210228,4
7,1,21,229,1,1327,1,9,4,4,5,single-choice,spatial-relational,4|5,7,4/5,210229,4
7,1,21,230,1,976,1,11,5,5,6,single-choice,spatial-relational,5|6,7,5/6,210230,5
7,1,21,231,1,824,1,13,6,6,7,single-choice,spatial-relational,6|7,7,6/7,210231,6
7,1,21,232,1,1290,1,5,2,2,3,single-choice,spatial-relational,2|3,7,2/3,210232,2
7,1,21,233,1,1085,1,7,3,3,4,single-choice,spatial-relational,3|4,7,3/4,210233,3
7,1,21,234,1,1198,1,11,5,5,6,single-choice,spatial-relational,5|6,7,5/6,210234,5
7,1,21,235,1,623,1,5,2,2,3,single-choice,spatial-relational,2|3,7,2/3,210235,2
7,1,21,236,1,950,1,13,6,6,7,single-choice,spatial-relational,6|7,7,6/7,210236,6
7,1,21,237,1,686,1,3,1,1,2,single-choice,spatial-relational,1|2,7,1/2,210237,1
7,1,21,238,1,3288,1,9,4,4,5,single-choice,spatial-relational,4|5,7,4/5,210238,4
7,1,21,239,1,910,1,7,3,3,4,single-choice,spatial-relational,3|4,7,3/4,210239,3
7,1,21,240,1,1691,1,3,1,1,2,single-choice,spatial-relational,1|2,7,1/2,210240,1
7,1,21,241,1,944,1,11,5,5,6,single-choice,spatial-relational,5|6,7,5/6,210241,5
7,1,21,242,1,669,1,13,6,6,7,single-choice,spatial-relational,6|7,7,6/7,210242,6
7,1,21,243,1,1105,1,9,4,4,5,single-choice,spatial-relational,4|5,7,4/5,210243,4
7,1,21,244,1,854,1,5,2,2,3,single-choice,spatial-relational,2|3,7,2/3,210244,2
7,1,21,245,1,1094,1,13,6,6,7,single-choice,spatial-relational,6|7,7,6/7,210245,6
7,1,21,246,1,1776,1,9,4,4,5,single-choice,spatial-relational,4|5,7,4/5,210246,4
7,1,21,247,1,1470,1,5,2,2,3,single-choice,spatial-relational,2|3,7,2/3,210247,2
7,1,21,248,1,1661,1,3,1,1,2,single-choice,spatial-relational,1|2,7,1/2,210248,1
7,1,21,249,1,990,1,7,3,3,4,single-choice,spatial-relational,3|4,7,3/4,210249,3
7,1,21,250,1,1929,1,11,5,5,6,single-choice,spatial-relational,5|6,7,5/6,210250,5
7,1,21,251,0,702,1,3,1,2,2,single-choice,spatial-relational,1|2,7,1/2,210251,1
7,1,21,252,1,877,1,7,3,3,4,single-choice,spatial-relational,3|4,7,3/4,210252,3
7,1,21,253,1,1331,1,3,1,1,2,single-choice,spatial-relational,1|2,7,1/2,210253,1
7,1,21,254,1,1125,1,3,1,1,2,single-choice,spatial-relational,1|2,7,1/2,210254,1
7,1,21,255,1,1389,1,11,5,5,6,single-choice,spatial-relational,5|6,7,5/6,210255,5
7,1,21,256,1,1119,1,13,6,6,7,single-choice,spatial-relational,6|7,7,6/7,210256,6
7,1,21,257,1,1321,1,9,4,4,5,single-choice,spatial-relational,4|5,7,4/5,210257,4
7,1,21,258,1,892,1,11,5,5,6,single-choice,spatial-relational,5|6,7,5/6,210258,5
7,1,21,259,1,1806,1,5,2,2,3,single-choice,spatial-relational,2|3,7,2/3,210259,2
7,1,21,260,1,1660,1,9,4,4,5,single-choice,spatial-relational,4|5,7,4/5,210260,4
7,1,21,261,0,3044,1,7,3,4,4,single-choice,spatial-relational,3|4,7,3/4,210261,3
7,1,21,262,0,1105,1,7,3,4,4,single-choice,spatial-relational,3|4,7,3/4,210262,3
7,1,21,263,1,799,1,13,6,6,7,single-choice,spatial-relational,6|7,7,6/7,210263,6
7,1,21,264,1,1014,1,5,2,2,3,single-choice,spatial-relational,2|3,7,2/3,210264,2
7,1,21,265,1,1302,1,9,4,4,5,single-choice,spatial-relational,4|5,7,4/5,210265,4
7,1,21,266,1,17,1,13,6,6,7,single-choice,spatial-relational,6|7,7,6/7,210266,6
7,1,21,267,1,1794,1,7,3,3,4,single-choice,spatial-relational,3|4,7,3/4,210267,3
7,1,21,268,0,1008,1,11,5,6,6,single-choice,spatial-relational,5|6,7,5/6,210268,5
7,1,21,269,0,1472,1,5,2,3,3,single-choice,spatial-relational,2|3,7,2/3,210269,2
7,1,21,270,1,877,1,13,6,6,7,single-choice,spatial-relational,6|7,7,6/7,210270,6
7,1,21,271,0,1007,1,9,4,5,5,single-choice,spatial-relational,4|5,7,4/5,210271,4
7,1,21,272,1,1101,1,3,1,1,2,single-choice,spatial-relational,1|2,7,1/2,210272,1
7,1,21,273,1,805,1,5,2,2,3,single-choice,spatial-relational,2|3,7,2/3,210273,2
7,1,21,274,1,1006,1,11,5,5,6,single-choice,spatial-relational,5|6,7,5/6,210274,5
7,1,21,275,1,1933,1,7,3,3,4,single-choice,spatial-relational,3|4,7,3/4,210275,3
7,1,21,276,1,1495,1,3,1,1,2,single-choice,spatial-relational,1|2,7,1/2,210276,1
7,1,21,277,1,719,1,13,6,6,7,single-choice,spatial-relational,6|7,7,6/7,210277,6
7,1,21,278,1,937,1,3,1,1,2,single-choice,spatial-relational,1|2,7,1/2,210278,1
7,1,21,279,1,1854,1,11,5,5,6,single-choice,spatial-relational,5|6,7,5/6,210279,5
7,1,21,280,0,2069,1,7,3,4,4,single-choice,spatial-relational,3|4,7,3/4,210280,3
7,1,21,281,1,888,1,13,6,6,7,single-choice,spatial-relational,6|7,7,6/7,210281,6
7,1,21,282,1,943,1,5,2,2,3,single-choice,spatial-relational,2|3,7,2/3,210282,2
7,1,21,283,1,1156,1,3,1,1,2,single-choice,spatial-relational,1|2,7,1/2,210283,1
7,1,21,284,1,999,1,9,4,4,5,single-choice,spatial-relational,4|5,7,4/5,210284,4
7,1,21,285,1,1500,1,5,2,2,3,single-choice,spatial-relational,2|3,7,2/3,210285,2
7,1,21,286,1,880,1,11,5,5,6,single-choice,spatial-relational,5|6,7,5/6,210286,5
7,1,21,287,1,1408,1,7,3,3,4,single-choice,spatial-relational,3|4,7,3/4,210287,3
7,1,21,288,0,896,1,9,4,5,5,single-choice,spatial-relational,4|5,7,4/5,210288,4
7,1,21,289,1,1027,1,9,4,4,5,single-choice,spatial-relational,4|5,7,4/5,210289,4
7,1,21,290,1,907,1,5,2,2,3,single-choice,spatial-relational,2|3,7,2/3,210290,2
7,1,21,291,1,649,1,13,6,6,7,single-choice,spatial-relational,6|7,7,6/7,210291,6
7,1,21,292,1,2361,1,7,3,3,4,single-choice,spatial-relational,3|4,7,3/4,210292,3
7,1,21,293,1,1817,1,11,5,5,6,single-choice,spatial-relational,5|6,7,5/6,210293,5
7,1,21,294,1,911,1,5,2,2,3,single-choice,spatial-relational,2|3,7,2/3,210294,2
7,1,21,295,1,1328,1,7,3,3,4,single-choice,spatial-relational,3|4,7,3/4,210295,3
7,1,21,296,1,865,1,13,6,6,7,single-choice,spatial-relational,6|7,7,6/7,210296,6
7,1,21,297,1,900,1,3,1,1,2,single-choice,spatial-relational,1|2,7,1/2,210297,1
7,1,21,298,1,1913,1,11,5,5,6,single-choice,spatial-relational,5|6,7,5/6,210298,5
7,1,21,299,0,613,1,3,1,2,2,single-choice,spatial-relational,1|2,7,1/2,210299,1
7,1,21,300,1,859,1,9,4,4,5,single-choice,spatial-relational,4|5,7,4/5,210300,4
7,1,21,301,1,1199,1,3,1,1,2,single-choice,spatial-relational,1|2,7,1/2,210301,1
7,1,21,302,1,737,1,13,6,6,7,single-choice,spatial-relational,6|7,7,6/7,210302,6
7,1,21,303,1,781,1,5,2,2,3,single-choice,spatial-relational,2|3,7,2/3,210303,2
7,1,21,304,1,1352,1,11,5,5,6,single-choice,spatial-relational,5|6,7,5/6,210304,5
7,1,21,305,0,1159,1,7,3,4,4,single-choice,spatial-relational,3|4,7,3/4,210305,3
7,1,21,306,0,41,1,5,2,3,3,single-choice,spatial-relational,2|3,7,2/3,210306,2
7,1,21,307,0,997,1,9,4,5,5,single-choice,spatial-relational,4|5,7,4/5,210307,4
7,1,21,308,1,62,1,11,5,5,6,single-choice,spatial-relational,5|6,7,5/6,210308,5
7,1,21,309,1,860,1,13,6,6,7,single-choice,spatial-relational,6|7,7,6/7,210309,6
7,1,21,310,1,1620,1,3,1,1,2,single-choice,spatial-relational,1|2,7,1/2,210310,1
7,1,21,311,1,1441,1,9,4,4,5,single-choice,spatial-relational,4|5,7,4/5,210311,4
7,1,21,312,1,2052,1,7,3,3,4,single-choice,spatial-relational,3|4,7,3/4,210312,3
7,1,21,313,1,1175,1,11,5,5,6,single-choice,spatial-relational,5|6,7,5/6,210313,5
7,1,21,314,1,672,1,13,6,6,7,single-choice,spatial-relational,6|7,7,6/7,210314,6
7,1,21,315,1,2281,1,9,4,4,5,single-choice,spatial-relational,4|5,7,4/5,210315,4
7,1,21,316,1,1629,1,7,3,3,4,single-choice,spatial-relational,3|4,7,3/4,210316,3
7,1,21,317,1,813,1,13,6,6,7,single-choice,spatial-relational,6|7,7,6/7,210317,6
7,1,21,318,0,698,1,3,1,2,2,single-choice,spatial-relational,1|2,7,1/2,210318,1
7,1,21,319,1,1075,1,5,2,2,3,single-choice,spatial-relational,2|3,7,2/3,210319,2
7,1,21,320,1,1354,1,5,2,2,3,single-choice,spatial-relational,2|3,7,2/3,210320,2
7,1,21,321,0,1087,1,11,5,6,6,single-choice,spatial-relational,5|6,7,5/6,210321,5
7,1,21,322,1,906,1,3,1,1,2,single-choice,spatial-relational,1|2,7,1/2,210322,1
7,1,21,323,0,942,1,9,4,5,5,single-choice,spatial-relational,4|5,7,4/5,210323,4
7,1,21,324,1,948,1,7,3,3,4,single-choice,spatial-relational,3|4,7,3/4,210324,3
7,1,21,325,1,1873,1,11,5,5,6,single-choice,spatial-relational,5|6,7,5/6,210325,5
7,1,21,326,1,1086,1,11,5,5,6,single-choice,spatial-relational,5|6,7,5/6,210326,5
7,1,21,327,1,1054,1,13,6,6,7,single-choice,spatial-relational,6|7,7,6/7,210327,6
7,1,21,328,1,1284,1,3,1,1,2,single-choice,spatial-relational,1|2,7,1/2,210328,1
7,1,21,329,1,1168,1,3,1,1,2,single-choice,spatial-relational,1|2,7,1/2,210329,1
7,1,21,330,1,703,1,5,2,2,3,single-choice,spatial-relational,2|3,7,2/3,210330,2
7,1,21,331,0,1149,1,7,3,4,4,single-choice,spatial-relational,3|4,7,3/4,210331,3
7,1,21,332,1,1040,1,7,3,3,4,single-choice,spatial-relational,3|4,7,3/4,210332,3
7,1,21,333,1,830,1,5,2,2,3,single-choice,spatial-relational,2|3,7,2/3,210333,2
7,1,21,334,1,1404,1,9,4,4,5,single-choice,spatial-relational,4|5,7,4/5,210334,4
7,1,21,335,1,2457,1,9,4,4,5,single-choice,spatial-relational,4|5,7,4/5,210335,4
7,1,21,336,1,801,1,13,6,6,7,single-choice,spatial-relational,6|7,7,6/7,210336,6
7,1,21,337,1,742,1,13,6,6,7,single-choice,spatial-relational,6|7,7,6/7,210337,6
7,1,21,338,1,1342,1,7,3,3,4,single-choice,spatial-relational,3|4,7,3/4,210338,3
7,1,21,339,0,1072,1,3,1,2,2,single-choice,spatial-relational,1|2,7,1/2,210339,1
7,1,21,340,1,833,1,7,3,3,4,single-choice,spatial-relational,3|4,7,3/4,210340,3
7,1,21,341,1,1059,1,11,5,5,6,single-choice,spatial-relational,5|6,7,5/6,210341,5
7,1,21,342,1,5,1,11,5,5,6,single-choice,spatial-relational,5|6,7,5/6,210342,5
7,1,21,343,1,1116,1,9,4,4,5,single-choice,spatial-relational,4|5,7,4/5,210343,4
7,1,21,344,1,1689,1,13,6,6,7,single-choice,spatial-relational,6|7,7,6/7,210344,6
7,1,21,345,1,1474,1,5,2,2,3,single-choice,spatial-relational,2|3,7,2/3,210345,2
7,1,21,346,1,1427,1,3,1,1,2,single-choice,spatial-relational,1|2,7,1/2,210346,1
7,1,21,347,1,859,1,5,2,2,3,single-choice,spatial-relational,2|3,7,2/3,210347,2
7,1,21,348,1,849,1,9,4,4,5,single-choice,spatial-relational,4|5,7,4/5,210348,4
7,1,21,349,1,1411,1,5,2,2,3,single-choice,spatial-relational,2|3,7,2/3,210349,2
7,1,21,350,1,1859,1,9,4,4,5,single-choice,spatial-relational,4|5,7,4/5,210350,4
7,1,21,351,1,1018,1,7,3,3,4,single-choice,spatial-relational,3|4,7,3/4,210351,3
7,1,21,352,1,1407,1,5,2,2,3,single-choice,spatial-relational,2|3,7,2/3,210352,2
7,1,21,353,1,1003,1,11,5,5,6,single-choice,spatial-relational,5|6,7,5/6,210353,5
7,1,21,354,1,930,1,3,1,1,2,single-choice,spatial-relational,1|2,7,1/2,210354,1
7,1,21,355,0,61,1,11,5,6,6,single-choice,spatial-relational,5|6,7,5/6,210355,5
7,1,21,356,1,991,1,13,6,6,7,single-choice,spatial-relational,6|7,7,6/7,210356,6
7,1,21,357,0,788,1,7,3,4,4,single-choice,spatial-relational,3|4,7,3/4,210357,3
7,1,21,358,1,1007,1,3,1,1,2,single-choice,spatial-relational,1|2,7,1/2,210358,1
7,1,21,359,1,1000,1,9,4,4,5,single-choice,spatial-relational,4|5,7,4/5,210359,4
7,1,21,360,1,827,1,13,6,6,7,single-choice,spatial-relational,6|7,7,6/7,210360,6
7,1,21,361,1,680,1,13,6,6,7,single-choice,spatial-relational,6|7,7,6/7,210361,6
7,1,21,362,1,795,1,5,2,2,3,single-choice,spatial-relational,2|3,7,2/3,210362,2
7,1,21,363,1,1516,1,11,5,5,6,single-choice,spatial-relational,5|6,7,5/6,210363,5
7,1,21,364,1,1202,1,7,3,3,4,single-choice,spatial-relational,3|4,7,3/4,210364,3
7,1,21,365,1,1653,1,9,4,4,5,single-choice,spatial-relational,4|5,7,4/5,210365,4
7,1,21,366,0,1025,1,11,5,6,6,single-choice,spatial-relational,5|6,7,5/6,210366,5
7,1,21,367,1,662,1,13,6,6,7,single-choice,spatial-relational,6|7,7,6/7,210367,6
7,1,21,368,1,1308,1,3,1,1,2,single-choice,spatial-relational,1|2,7,1/2,210368,1
7,1,21,369,1,1063,1,7,3,3,4,single-choice,spatial-relational,3|4,7,3/4,210369,3
7,1,21,370,1,1004,1,5,2,2,3,single-choice,spatial-relational,2|3,7,2/3,210370,2
7,1,21,371,0,1113,1,9,4,5,5,single-choice,spatial-relational,4|5,7,4/5,210371,4
7,1,21,372,1,883,1,3,1,1,2,single-choice,spatial-relational,1|2,7,1/2,210372,1
7,1,21,373,0,1038,1,5,2,3,3,single-choice,spatial-relational,2|3,7,2/3,210373,2
7,1,21,374,1,869,1,5,2,2,3,single-choice,spatial-relational,2|3,7,2/3,210374,2
7,1,21,375,1,971,1,9,4,4,5,single-choice,spatial-relational,4|5,7,4/5,210375,4
7,1,21,376,1,949,1,13,6,6,7,single-choice,spatial-relational,6|7,7,6/7,210376,6
7,1,21,377,1,1054,1,9,4,4,5,single-choice,spatial-relational,4|5,7,4/5,210377,4
7,1,21,378,1,42,1,3,1,1,2,single-choice,spatial-relational,1|2,7,1/2,210378,1
7,1,21,379,1,692,1,13,6,6,7,single-choice,spatial-relational,6|7,7,6/7,210379,6
7,1,21,380,1,1030,1,11,5,5,6,single-choice,spatial-relational,5|6,7,5/6,210380,5
7,1,21,381,0,49,1,7,3,4,4,single-choice,spatial-relational,3|4,7,3/4,210381,3
7,1,21,382,0,1244,1,11,5,6,6,single-choice,spatial-relational,5|6,7,5/6,210382,5
7,1,21,383,1,1190,1,7,3,3,4,single-choice,spatial-relational,3|4,7,3/4,210383,3
7,1,21,384,1,1037,1,3,1,1,2,single-choice,spatial-relational,1|2,7,1/2,210384,1
7,1,21,385,1,1316,1,11,5,5,6,single-choice,spatial-relational,5|6,7,5/6,210385,5
7,1,21,386,1,1660,1,9,4,4,5,single-choice,spatial-relational,4|5,7,4/5,210386,4
7,1,21,387,1,1719,1,13,6,6,7,single-choice,spatial-relational,6|7,7,6/7,210387,6
7,1,21,388,1,1714,1,5,2,2,3,single-choice,spatial-relational,2|3,7,2/3,210388,2
7,1,21,389,1,901,1,13,6,6,7,single-choice,spatial-relational,6|7,7,6/7,210389,6
7,1,21,390,1,2231,1,9,4,4,5,single-choice,spatial-relational,4|5,7,4/5,210390,4
7,1,21,391,1,1321,1,7,3,3,4,single-choice,spatial-relational,3|4,7,3/4,210391,3
7,1,21,392,1,1061,1,7,3,3,4,single-choice,spatial-relational,3|4,7,3/4,210392,3
7,1,21,393,0,763,1,3,1,2,2,single-choice,spatial-relational,1|2,7,1/2,210393,1
7,1,21,394,1,1116,1,5,2,2,3,single-choice,spatial-relational,2|3,7,2/3,210394,2
7,1,21,395,1,1548,1,3,1,1,2,single-choice,spatial-relational,1|2,7,1/2,210395,1
7,1,21,396,1,997,1,11,5,5,6,single-choice,spatial-relational,5|6,7,5/6,210396,5
7,1,21,397,1,2173,1,7,3,3,4,single-choice,spatial-relational,3|4,7,3/4,210397,3
7,1,21,398,1,1177,1,5,2,2,3,single-choice,spatial-relational,2|3,7,2/3,210398,2
7,1,21,399,1,1798,1,9,4,4,5,single-choice,spatial-relational,4|5,7,4/5,210399,4
7,1,21,400,0,1154,1,3,1,2,2,single-choice,spatial-relational,1|2,7,1/2,210400,1
7,1,21,401,1,1276,1,13,6,6,7,single-choice,spatial-relational,6|7,7,6/7,210401,6
7,1,21,402,1,2291,1,9,4,4,5,single-choice,spatial-relational,4|5,7,4/5,210402,4
7,1,21,403,1,1090,1,7,3,3,4,single-choice,spatial-relational,3|4,7,3/4,210403,3
7,1,21,404,1,1036,1,11,5,5,6,single-choice,spatial-relational,5|6,7,5/6,210404,5
7,1,21,405,1,1564,1,5,2,2,3,single-choice,spatial-relational,2|3,7,2/3,210405,2
7,1,21,406,1,1549,1,11,5,5,6,single-choice,spatial-relational,5|6,7,5/6,210406,5
7,1,21,407,1,1339,1,3,1,1,2,single-choice,spatial-relational,1|2,7,1/2,210407,1
7,1,21,408,1,1511,1,13,6,6,7,single-choice,spatial-relational,6|7,7,6/7,210408,6
7,1,21,409,0,732,1,5,2,3,3,single-choice,spatial-relational,2|3,7,2/3,210409,2
7,1,21,410,1,576,1,13,6,6,7,single-choice,spatial-relational,6|7,7,6/7,210410,6
7,1,21,411,1,837,1,13,6,6,7,single-choice,spatial-relational,6|7,7,6/7,210411,6
7,1,21,412,1,1280,1,9,4,4,5,single-choice,spatial-relational,4|5,7,4/5,210412,4
7,1,21,413,1,1365,1,7,3,3,4,single-choice,spatial-relational,3|4,7,3/4,210413,3
7,1,21,414,0,1746,1,3,1,2,2,single-choice,spatial-relational,1|2,7,1/2,210414,1
7,1,21,415,1,761,1,9,4,4,5,single-choice,spatial-relational,4|5,7,4/5,210415,4
7,1,21,416,1,1787,1,11,5,5,6,single-choice,spatial-relational,5|6,7,5/6,210416,5
7,1,21,417,0,747,1,3,1,2,2,single-choice,spatial-relational,1|2,7,1/2,210417,1
7,1,21,418,1,946,1,11,5,5,6,single-choice,spatial-relational,5|6,7,5/6,210418,5
7,1,21,419,1,1745,1,7,3,3,4,single-choice,spatial-relational,3|4,7,3/4,210419,3
7,1,21,420,1,2270,1,5,2,2,3,single-choice,spatial-relational,2|3,7,2/3,210420,2
7,1,21,421,1,1227,1,7,3,3,4,single-choice,spatial-relational,3|4,7,3/4,210421,3
7,1,21,422,0,1516,1,9,4,5,5,single-choice,spatial-relational,4|5,7,4/5,210422,4
7,1,21,423,1,1193,1,5,2,2,3,single-choice,spatial-relational,2|3,7,2/3,210423,2
7,1,21,424,1,988,1,11,5,5,6,single-choice,spatial-relational,5|6,7,5/6,210424,5
7,1,21,425,1,2581,1,7,3,3,4,single-choice,spatial-relational,3|4,7,3/4,210425,3
7,1,21,426,1,982,1,3,1,1,2,single-choice,spatial-relational,1|2,7,1/2,210426,1
7,1,21,427,1,1270,1,9,4,4,5,single-choice,spatial-relational,4|5,7,4/5,210427,4
7,1,21,428,0,883,1,11,5,6,6,single-choice,spatial-relational,5|6,7,5/6,210428,5
7,1,21,429,1,1138,1,5,2,2,3,single-choice,spatial-relational,2|3,7,2/3,210429,2
7,1,21,430,1,802,1,13,6,6,7,single-choice,spatial-relational,6|7,7,6/7,210430,6
7,1,21,431,1,1346,1,13,6,6,7,single-choice,spatial-relational,6|7,7,6/7,210431,6
7,1,21,432,1,1346,1,3,1,1,2,single-choice,spatial-relational,1|2,7,1/2,210432,1
7,1,21,433,1,1604,1,3,1,1,2,single-choice,spatial-relational,1|2,7,1/2,210433,1
7,1,21,434,1,930,1,3,1,1,2,single-choice,spatial-relational,1|2,7,1/2,210434,1
7,1,21,435,1,936,1,7,3,3,4,single-choice,spatial-relational,3|4,7,3/4,210435,3
7,1,21,436,1,1374,1,9,4,4,5,single-choice,spatial-relational,4|5,7,4/5,210436,4
7,1,21,437,1,1900,1,11,5,5,6,single-choice,spatial-relational,5|6,7,5/6,210437,5
7,1,21,438,1,1189,1,7,3,3,4,single-choice,spatial-relational,3|4,7,3/4,210438,3
7,1,21,439,1,853,1,5,2,2,3,single-choice,spatial-relational,2|3,7,2/3,210439,2
7,1,21,440,1,1291,1,5,2,2,3,single-choice,spatial-relational,2|3,7,2/3,210440,2
7,1,21,441,1,1396,1,9,4,4,5,single-choice,spatial-relational,4|5,7,4/5,210441,4
7,1,21,442,0,14,1,11,5,6,6,single-choice,spatial-relational,5|6,7,5/6,210442,5
7,1,21,443,1,1275,1,13,6,6,7,single-choice,spatial-relational,6|7,7,6/7,210443,6
7,1,21,444,1,724,1,13,6,6,7,single-choice,spatial-relational,6|7,7,6/7,210444,6
7,1,21,445,0,1479,1,7,3,4,4,single-choice,spatial-relational,3|4,7,3/4,210445,3
7,1,21,446,1,1070,1,11,5,5,6,single-choice,spatial-relational,5|6,7,5/6,210446,5
7,1,21,447,1,2098,1,3,1,1,2,single-choice,spatial-relational,1|2,7,1/2,210447,1
7,1,21,448,1,946,1,3,1,1,2,single-choice,spatial-relational,1|2,7,1/2,210448,1
7,1,21,449,0,1317,1,5,2,3,3,single-choice,spatial-relational,2|3,7,2/3,210449,2
7,1,21,450,1,842,1,11,5,5,6,single-choice,spatial-relational,5|6,7,5/6,210450,5
7,1,21,451,1,740,1,13,6,6,7,single-choice,spatial-relational,6|7,7,6/7,210451,6
7,1,21,452,1,596,1,13,6,6,7,single-choice,spatial-relational,6|7,7,6/7,210452,6
7,1,21,453,1,1384,1,5,2,2,3,single-choice,spatial-relational,2|3,7,2/3,210453,2
7,1,21,454,1,1449,1,9,4,4,5,single-choice,spatial-relational,4|5,7,4/5,210454,4
7,1,21,455,0,2464,1,7,3,4,4,single-choice,spatial-relational,3|4,7,3/4,210455,3
7,1,21,456,1,1236,1,9,4,4,5,single-choice,spatial-relational,4|5,7,4/5,210456,4
7,1,21,457,1,1003,1,13,6,6,7,single-choice,spatial-relational,6|7,7,6/7,210457,6
7,1,21,458,1,1239,1,7,3,3,4,single-choice,spatial-relational,3|4,7,3/4,210458,3
7,1,21,459,1,1154,1,5,2,2,3,single-choice,spatial-relational,2|3,7,2/3,210459,2
7,1,21,460,1,1005,1,3,1,1,2,single-choice,spatial-relational,1|2,7,1/2,210460,1
7,1,21,461,1,905,1,9,4,4,5,single-choice,spatial-relational,4|5,7,4/5,210461,4
7,1,21,462,1,1151,1,11,5,5,6,single-choice,spatial-relational,5|6,7,5/6,210462,5
7,1,21,463,0,31277,1,7,3,4,4,single-choice,spatial-relational,3|4,7,3/4,210463,3
7,1,21,464,0,1201,1,5,2,3,3,single-choice,spatial-relational,2|3,7,2/3,210464,2
7,1,21,465,1,957,1,3,1,1,2,single-choice,spatial-relational,1|2,7,1/2,210465,1
7,1,21,466,1,774,1,11,5,5,6,single-choice,spatial-relational,5|6,7,5/6,210466,5
7,1,21,467,1,1386,1,9,4,4,5,single-choice,spatial-relational,4|5,7,4/5,210467,4
7,1,21,468,1,783,1,13,6,6,7,single-choice,spatial-relational,6|7,7,6/7,210468,6
7,1,21,469,1,1856,1,9,4,4,5,single-choice,spatial-relational,4|5,7,4/5,210469,4
7,1,21,470,1,1096,1,5,2,2,3,single-choice,spatial-relational,2|3,7,2/3,210470,2
7,1,21,471,1,1177,1,11,5,5,6,single-choice,spatial-relational,5|6,7,5/6,210471,5
7,1,21,472,1,1926,1,7,3,3,4,single-choice,spatial-relational,3|4,7,3/4,210472,3
7,1,21,473,1,1205,1,5,2,2,3,single-choice,spatial-relational,2|3,7,2/3,210473,2
7,1,21,474,1,953,1,3,1,1,2,single-choice,spatial-relational,1|2,7,1/2,210474,1
7,1,21,475,1,772,1,13,6,6,7,single-choice,spatial-relational,6|7,7,6/7,210475,6
7,1,21,476,1,776,1,13,6,6,7,single-choice,spatial-relational,6|7,7,6/7,210476,6
7,1,21,477,1,3571,1,9,4,4,5,single-choice,spatial-relational,4|5,7,4/5,210477,4
7,1,21,478,1,867,1,11,5,5,6,single-choice,spatial-relational,5|6,7,5/6,210478,5
7,1,21,479,1,1468,1,3,1,1,2,single-choice,spatial-relational,1|2,7,1/2,210479,1
7,1,21,480,1,1525,1,7,3,3,4,single-choice,spatial-relational,3|4,7,3/4,210480,3
7,1,21,481,0,690,1,3,1,2,2,single-choice,spatial-relational,1|2,7,1/2,210481,1
7,1,21,482,1,827,1,5,2,2,3,single-choice,spatial-relational,2|3,7,2/3,210482,2
7,1,21,483,0,662,1,7,3,4,4,single-choice,spatial-relational,3|4,7,3/4,210483,3
7,1,21,484,0,852,1,9,4,5,5,single-choice,spatial-relational,4|5,7,4/5,210484,4
7,1,21,485,1,891,1,13,6,6,7,single-choice,spatial-relational,6|7,7,6/7,210485,6
7,1,21,486,1,837,1,3,1,1,2,single-choice,spatial-relational,1|2,7,1/2,210486,1
7,1,21,487,1,711,1,13,6,6,7,single-choice,spatial-relational,6|7,7,6/7,210487,6
7,1,21,488,1,1213,1,9,4,4,5,single-choice,spatial-relational,4|5,7,4/5,210488,4
7,1,21,489,1,871,1,11,5,5,6,single-choice,spatial-relational,5|6,7,5/6,210489,5
7,1,21,490,0,6881,1,5,2,3,3,single-choice,spatial-relational,2|3,7,2/3,210490,2
7,1,21,491,1,1129,1,7,3,3,4,single-choice,spatial-relational,3|4,7,3/4,210491,3
7,1,21,492,0,998,1,11,5,6,6,single-choice,spatial-relational,5|6,7,5/6,210492,5
7,1,21,493,1,1322,1,11,5,5,6,single-choice,spatial-relational,5|6,7,5/6,210493,5
7,1,21,494,1,1174,1,3,1,1,2,single-choice,spatial-relational,1|2,7,1/2,210494,1
7,1,21,495,1,770,1,5,2,2,3,single-choice,spatial-relational,2|3,7,2/3,210495,2
7,1,21,496,1,709,1,13,6,6,7,single-choice,spatial-relational,6|7,7,6/7,210496,6
7,1,21,497,0,1254,1,7,3,4,4,single-choice,spatial-relational,3|4,7,3/4,210497,3
7,1,21,498,1,2136,1,11,5,5,6,single-choice,spatial-relational,5|6,7,5/6,210498,5
7,1,21,499,1,968,1,7,3,3,4,single-choice,spatial-relational,3|4,7,3/4,210499,3
7,1,21,500,1,874,1,3,1,1,2,single-choice,spatial-relational,1|2,7,1/2,210500,1
7,1,21,501,1,1193,1,9,4,4,5,single-choice,spatial-relational,4|5,7,4/5,210501,4
7,1,21,502,0,1031,1,5,2,3,3,single-choice,spatial-relational,2|3,7,2/3,210502,2
7,1,21,503,0,6,1,13,6,7,7,single-choice,spatial-relational,6|7,7,6/7,210503,6
7,1,21,504,1,1372,1,9,4,4,5,single-choice,spatial-relational,4|5,7,4/5,210504,4
7,1,21,505,1,881,1,7,3,3,4,single-choice,spatial-relational,3|4,7,3/4,210505,3
7,1,21,506,1,1096,1,11,5,5,6,single-choice,spatial-relational,5|6,7,5/6,210506,5
7,1,21,507,1,1355,1,11,5,5,6,single-choice,spatial-relational,5|6,7,5/6,210507,5
7,1,21,508,0,921,1,3,1,2,2,single-choice,spatial-relational,1|2,7,1/2,210508,1
7,1,21,509,1,1295,1,7,3,3,4,single-choice,spatial-relational,3|4,7,3/4,210509,3
7,1,21,510,1,830,1,9,4,4,5,single-choice,spatial-relational,4|5,7,4/5,210510,4
7,1,21,511,1,723,1,13,6,6,7,single-choice,spatial-relational,6|7,7,6/7,210511,6
7,1,21,512,1,814,1,5,2,2,3,single-choice,spatial-relational,2|3,7,2/3,210512,2
7,1,21,513,1,1109,1,5,2,2,3,single-choice,spatial-relational,2|3,7,2/3,210513,2
7,1,21,514,1,804,1,13,6,6,7,single-choice,spatial-relational,6|7,7,6/7,210514,6
7,1,21,515,1,1423,1,9,4,4,5,single-choice,spatial-relational,4|5,7,4/5,210515,4
7,1,21,516,1,893,1,3,1,1,2,single-choice,spatial-relational,1|2,7,1/2,210516,1
7,1,21,517,1,876,1,7,3,3,4,single-choice,spatial-relational,3|4,7,3/4,210517,3
7,1,21,518,0,2369,1,11,5,6,6,single-choice,spatial-relational,5|6,7,5/6,210518,5
7,1,21,519,1,1048,1,13,6,6,7,single-choice,spatial-relational,6|7,7,6/7,210519,6
7,1,21,520,1,906,1,5,2,2,3,single-choice,spatial-relational,2|3,7,2/3,210520,2
7,1,21,521,1,1304,1,7,3,3,4,single-choice,spatial-relational,3|4,7,3/4,210521,3
7,1,21,522,1,1204,1,3,1,1,2,single-choice,spatial-relational,1|2,7,1/2,210522,1
7,1,21,523,1,734,1,13,6,6,7,single-choice,spatial-relational,6|7,7,6/7,210523,6
7,1,21,524,1,837,1,3,1,1,2,single-choice,spatial-relational,1|2,7,1/2,210524,1
7,1,21,525,1,1013,1,11,5,5,6,single-choice,spatial-relational,5|6,7,5/6,210525,5
7,1,21,526,1,2818,1,5,2,2,3,single-choice,spatial-relational,2|3,7,2/3,210526,2
7,1,21,527,1,902,1,9,4,4,5,single-choice,spatial-relational,4|5,7,4/5,210527,4
7,1,21,528,1,1068,1,9,4,4,5,single-choice,spatial-relational,4|5,7,4/5,210528,4
7,1,21,529,0,804,1,11,5,6,6,single-choice,spatial-relational,5|6,7,5/6,210529,5
7,1,21,530,1,55,1,7,3,3,4,single-choice,spatial-relational,3|4,7,3/4,210530,3
7,1,21,531,1,764,1,9,4,4,5,single-choice,spatial-relational,4|5,7,4/5,210531,4
7,1,21,532,1,1861,1,3,1,1,2,single-choice,spatial-relational,1|2,7,1/2,210532,1
7,1,21,533,0,842,1,5,2,3,3,single-choice,spatial-relational,2|3,7,2/3,210533,2
7,1,21,534,0,49,1,13,6,7,7,single-choice,spatial-relational,6|7,7,6/7,210534,6
7,1,21,535,1,1106,1,3,1,1,2,single-choice,spatial-relational,1|2,7,1/2,210535,1
7,1,21,536,1,776,1,13,6,6,7,single-choice,spatial-relational,6|7,7,6/7,210536,6
7,1,21,537,1,1448,1,9,4,4,5,single-choice,spatial-relational,4|5,7,4/5,210537,4
7,1,21,538,1,847,1,5,2,2,3,single-choice,spatial-relational,2|3,7,2/3,210538,2
7,1,21,539,1,1112,1,7,3,3,4,single-choice,spatial-relational,3|4,7,3/4,210539,3
7,1,21,540,1,1027,1,11,5,5,6,single-choice,spatial-relational,5|6,7,5/6,210540,5
7,1,21,541,1,1281,1,13,6,6,7,single-choice,spatial-relational,6|7,7,6/7,210541,6
7,1,21,542,0,792,1,7,3,4,4,single-choice,spatial-relational,3|4,7,3/4,210542,3
7,1,21,543,1,1032,1,9,4,4,5,single-choice,spatial-relational,4|5,7,4/5,210543,4
7,1,21,544,1,1070,1,3,1,1,2,single-choice,spatial-relational,1|2,7,1/2,210544,1
7,1,21,545,0,1481,1,3,1,2,2,single-choice,spatial-relational,1|2,7,1/2,210545,1
7,1,21,546,1,1715,1,13,6,6,7,single-choice,spatial-relational,6|7,7,6/7,210546,6
7,1,21,547,1,1247,1,7,3,3,4,single-choice,spatial-relational,3|4,7,3/4,210547,3
7,1,21,548,0,795,1,11,5,6,6,single-choice,spatial-relational,5|6,7,5/6,210548,5
7,1,21,549,1,940,1,5,2,2,3,single-choice,spatial-relational,2|3,7,2/3,210549,2
7,1,21,550,1,1013,1,9,4,4,5,single-choice,spatial-relational,4|5,7,4/5,210550,4
7,1,21,551,1,1822,1,5,2,2,3,single-choice,spatial-relational,2|3,7,2/3,210551,2
7,1,21,552,1,1108,1,11,5,5,6,single-choice,spatial-relational,5|6,7,5/6,210552,5
7,1,21,553,0,661,1,3,1,2,2,single-choice,spatial-relational,1|2,7,1/2,210553,1
7,1,21,554,1,688,1,13,6,6,7,single-choice,spatial-relational,6|7,7,6/7,210554,6
7,1,21,555,1,1466,1,7,3,3,4,single-choice,spatial-relational,3|4,7,3/4,210555,3
7,1,21,556,1,1141,1,5,2,2,3,single-choice,spatial-relational,2|3,7,2/3,210556,2
7,1,21,557,1,1094,1,9,4,4,5,single-choice,spatial-relational,4|5,7,4/5,210557,4
7,1,21,558,1,1299,1,7,3,3,4,single-choice,spatial-relational,3|4,7,3/4,210558,3
7,1,21,559,0,1292,1,11,5,6,6,single-choice,spatial-relational,5|6,7,5/6,210559,5
7,1,21,560,1,948,1,13,6,6,7,single-choice,spatial-relational,6|7,7,6/7,210560,6
7,1,21,561,1,1047,1,3,1,1,2,single-choice,spatial-relational,1|2,7,1/2,210561,1
7,1,21,562,1,731,1,11,5,5,6,single-choice,spatial-relational,5|6,7,5/6,210562,5
7,1,21,563,1,1097,1,9,4,4,5,single-choice,spatial-relational,4|5,7,4/5,210563,4
7,1,21,564,1,900,1,5,2,2,3,single-choice,spatial-relational,2|3,7,2/3,210564,2
7,1,21,565,0,1061,1,3,1,2,2,single-choice,spatial-relational,1|2,7,1/2,210565,1
7,1,21,566,1,1147,1,13,6,6,7,single-choice,spatial-relational,6|7,7,6/7,210566,6
7,1,21,567,1,989,1,3,1,1,2,single-choice,spatial-relational,1|2,7,1/2,210567,1
7,1,21,568,1,885,1,7,3,3,4,single-choice,spatial-relational,3|4,7,3/4,210568,3
7,1,21,569,0,628,1,5,2,3,3,single-choice,spatial-relational,2|3,7,2/3,210569,2
7,1,21,570,1,2551,1,9,4,4,5,single-choice,spatial-relational,4|5,7,4/5,210570,4
7,1,21,571,1,1023,1,11,5,5,6,single-choice,spatial-relational,5|6,7,5/6,210571,5
7,1,21,572,1,1548,1,11,5,5,6,single-choice,spatial-relational,5|6,7,5/6,210572,5
7,1,21,573,1,871,1,13,6,6,7,single-choice,spatial-relational,6|7,7,6/7,210573,6
7,1,21,574,1,911,1,9,4,4,5,single-choice,spatial-relational,4|5,7,4/5,210574,4
7,1,21,575,1,1864,1,7,3,3,4,single-choice,spatial-relational,3|4,7,3/4,210575,3
7,1,21,576,1,668,1,5,2,2,3,single-choice,spatial-relational,2|3,7,2/3,210576,2
7,1,21,577,1,1282,1,3,1,1,2,single-choice,spatial-relational,1|2,7,1/2,210577,1
7,1,21,578,1,949,1,11,5,5,6,single-choice,spatial-relational,5|6,7,5/6,210578,5
7,1,21,579,1,1297,1,5,2,2,3,single-choice,spatial-relational,2|3,7,2/3,210579,2
7,1,21,580,1,870,1,9,4,4,5,single-choice,spatial-relational,4|5,7,4/5,210580,4
7,1,21,581,1,1039,1,13,6,6,7,single-choice,spatial-relational,6|7,7,6/7,210581,6
7,1,21,582,1,1239,1,7,3,3,4,single-choice,spatial-relational,3|4,7,3/4,210582,3
7,1,21,583,1,834,1,5,2,2,3,single-choice,spatial-relational,2|3,7,2/3,210583,2
7,1,21,584,1,907,1,3,1,1,2,single-choice,spatial-relational,1|2,7,1/2,210584,1
7,1,21,585,0,584,1,11,5,6,6,single-choice,spatial-relational,5|6,7,5/6,210585,5
7,1,21,586,1,982,1,7,3,3,4,single-choice,spatial-relational,3|4,7,3/4,210586,3
7,1,21,587,1,1091,1,13,6,6,7,single-choice,spatial-relational,6|7,7,6/7,210587,6
7,1,21,588,1,1852,1,9,4,4,5,single-choice,spatial-relational,4|5,7,4/5,210588,4
7,1,21,589,1,1265,1,3,1,1,2,single-choice,spatial-relational,1|2,7,1/2,210589,1
7,1,21,590,1,1268,1,5,2,2,3,single-choice,spatial-relational,2|3,7,2/3,210590,2
7,1,21,591,1,1040,1,9,4,4,5,single-choice,spatial-relational,4|5,7,4/5,210591,4
7,1,21,592,1,1209,1,9,4,4,5,single-choice,spatial-relational,4|5,7,4/5,210592,4
7,1,21,593,0,939,1,11,5,6,6,single-choice,spatial-relational,5|6,7,5/6,210593,5
7,1,21,594,1,819,1,13,6,6,7,single-choice,spatial-relational,6|7,7,6/7,210594,6
7,1,21,595,1,1022,1,7,3,3,4,single-choice,spatial-relational,3|4,7,3/4,210595,3
7,1,21,596,1,812,1,13,6,6,7,single-choice,spatial-relational,6|7,7,6/7,210596,6
7,1,21,597,0,857,1,3,1,2,2,single-choice,spatial-relational,1|2,7,1/2,210597,1
7,1,21,598,1,63,1,5,2,2,3,single-choice,spatial-relational,2|3,7,2/3,210598,2
7,1,21,599,1,1017,1,11,5,5,6,single-choice,spatial-relational,5|6,7,5/6,210599,5
7,1,21,600,0,1300,1,7,3,4,4,single-choice,spatial-relational,3|4,7,3/4,210600,3
1,1,22,1,0,1059,3,7,2,5,5,single-choice,spatial-relational,2|5,7,2/5,220001,2
1,1,22,2,1,635,1,13,6,6,7,single-choice,spatial-relational,6|7,7,6/7,220002,6
1,1,22,3,0,951,1,11,5,6,6,single-choice,spatial-relational,5|6,7,5/6,220003,5
1,1,22,4,0,627,3,11,4,7,7,single-choice,spatial-relational,4|7,7,4/7,220004,4
1,1,22,5,1,1082,1,9,4,4,5,single-choice,spatial-relational,4|5,7,4/5,220005,4
1,1,22,6,1,1153,3,11,4,4,7,single-choice,spatial-relational,4|7,7,4/7,220006,4
1,1,22,7,0,871,5,7,1,6,6,single-choice,spatial-relational,1|6,7,1/6,220007,1
1,1,22,8,1,1117,4,10,3,3,7,single-choice,spatial-relational,3|7,7,3/7,220008,3
1,1,22,9,0,722,5,9,2,7,7,single-choice,spatial-relational,2|7,7,2/7,220009,2
1,1,22,10,0,1019,5,9,2,7,7,single-choice,spatial-relational,2|7,7,2/7,220010,2
1,1,22,11,0,800,3,9,3,6,6,single-choice,spatial-relational,3|6,7,3/6,220011,3
1,1,22,12,0,976,1,7,3,4,4,single-choice,spatial-relational,3|4,7,3/4,220012,3
1,1,22,13,1,1040,2,8,3,3,5,single-choice,spatial-relational,3|5,7,3/5,220013,3
1,1,22,14,0,1022,4,8,2,6,6,single-choice,spatial-relational,2|6,7,2/6,220014,2
1,1,22,15,1,1033,3,5,1,1,4,single-choice,spatial-relational,1|4,7,1/4,220015,1
1,1,22,16,0,728,4,6,1,5,5,single-choice,spatial-relational,1|5,7,1/5,220016,1
1,1,22,17,1,868,2,6,2,2,4,single-choice,spatial-relational,2|4,7,2/4,220017,2
1,1,22,18,1,1061,1,5,2,2,3,single-choice,spatial-relational,2|3,7,2/3,220018,2
1,1,22,19,0,824,6,8,1,7,7,single-choice,spatial-relational,1|7,7,1/7,220019,1
1,1,22,20,0,1067,1,9,4,5,5,single-choice,spatial-relational,4|5,7,4/5,220020,4
1,1,22,21,1,971,1,11,5,5,6,single-choice,spatial-relational,5|6,7,5/6,220021,5
1,1,22,22,1,1129,4,8,2,2,6,single-choice,spatial-relational,2|6,7,2/6,220022,2
1,1,22,23,0,768,1,7,3,4,4,single-choice,spatial-relational,3|4,7,3/4,220023,3
1,1,22,24,1,1211,2,4,1,1,3,single-choice,spatial-relational,1|3,7,1/3,220024,1
1,1,22,25,0,755,4,6,1,5,5,single-choice,spatial-relational,1|5,7,1/5,220025,1
1,1,22,26,1,989,3,7,2,2,5,single-choice,spatial-relational,2|5,7,2/5,220026,2
1,1,22,27,1,1287,2,8,3,3,5,single-choice,spatial-relational,3|5,7,3/5,220027,3
1,1,22,28,1,1001,5,7,1,1,6,single-choice,spatial-relational,1|6,7,1/6,220028,1
1,1,22,29,0,789,6,8,1,7,7,single-choice,spatial-relational,1|7,7,1/7,220029,1
1,1,22,30,1,758,3,9,3,3,6,single-choice,spatial-relational,3|6,7,3/6,220030,3
1,1,22,31,1,748,2,12,5,5,7,single-choice,spatial-relational,5|7,7,5/7,220031,5
1,1,22,32,1,1240,2,4,1,1,3,single-choice,spatial-relational,1|3,7,1/3,220032,1
1,1,22,33,1,775,1,13,6,6,7,single-choice,spatial-relational,6|7,7,6/7,220033,6
1,1,22,34,1,941,1,3,1,1,2,single-choice,spatial-relational,1|2,7,1/2,220034,1
1,1,22,35,0,877,4,10,3,7,7,single-choice,spatial-relational,3|7,7,3/7,220035,3
1,1,22,36,1,927,2,6,2,2,4,single-choice,spatial-relational,2|4,7,2/4,220036,2
1,1,22,37,0,913,2,10,4,6,6,single-choice,spatial-relational,4|6,7,4/6,220037,4
1,1,22,38,1,1066,2,10,4,4,6,single-choice,spatial-relational,4|6,7,4/6,220038,4
1,1,22,39,1,1127,2,12,5,5,7,single-choice,spatial-relational,5|7,7,5/7,220039,5
1,1,22,40,1,889,1,3,1,1,2,single-choice,spatial-relational,1|2,7,1/2,220040,1
1,1,22,41,0,632,1,5,2,3,3,single-choice,spatial-relational,2|3,7,2/3,220041,2
1,1,22,42,1,804,3,5,1,1,4,single-choice,spatial-relational,1|4,7,1/4,220042,1
1,1,22,43,1,786,1,13,6,6,7,single-choice,spatial-relational,6|7,7,6/7,220043,6
1,1,22,44,1,896,1,3,1,1,2,single-choice,spatial-relational,1|2,7,1/2,220044,1
1,1,22,45,1,787,3,5,1,1,4,single-choice,spatial-relational,1|4,7,1/4,220045,1
1,1,22,46,1,1501,3,11,4,4,7,single-choice,spatial-relational,4|7,7,4/7,220046,4
1,1,22,47,1,1854,4,10,3,3,7,single-choice,spatial-relational,3|7,7,3/7,220047,3
1,1,22,48,1,787,2,6,2,2,4,single-choice,spatial-relational,2|4,7,2/4,220048,2
1,1,22,49,1,632,6,8,1,1,7,single-choice,spatial-relational,1|7,7,1/7,220049,1
1,1,22,50,1,749,1,13,6,6,7,single-choice,spatial-relational,6|7,7,6/7,220050,6
1,1,22,51,1,925,1,7,3,3,4,single-choice,spatial-relational,3|4,7,3/4,220051,3
1,1,22,52,0,598,2,12,5,7,7,single-choice,spatial-relational,5|7,7,5/7,220052,5
1,1,22,53,1,937,2,12,5,5,7,single-choice,spatial-relational,5|7,7,5/7,220053,5
1,1,22,54,1,871,5,7,1,1,6,single-choice,spatial-relational,1|6,7,1/6,220054,1
1,1,22,55,1,789,5,9,2,2,7,single-choice,spatial-relational,2|7,7,2/7,220055,2
1,1,22,56,0,766,6,8,1,7,7,single-choice,spatial-relational,1|7,7,1/7,220056,1
1,1,22,57,0,1001,3,11,4,7,7,single-choice,spatial-relational,4|7,7,4/7,220057,4
1,1,22,58,0,844,4,8,2,6,6,single-choice,spatial-relational,2|6,7,2/6,220058,2
1,1,22,59,1,1303,3,9,3,3,6,single-choice,spatial-relational,3|6,7,3/6,220059,3
1,1,22,60,1,1181,5,9,2,2,7,single-choice,spatial-relational,2|7,7,2/7,220060,2
1,1,22,61,1,838,1,5,2,2,3,single-choice,spatial-relational,2|3,7,2/3,220061,2
1,1,22,62,0,613,4,6,1,5,5,single-choice,spatial-relational,1|5,7,1/5,220062,1
1,1,22,63,1,1611,4,10,3,3,7,single-choice,spatial-relational,3|7,7,3/7,220063,3
1,1,22,64,0,910,1,9,4,5,5,single-choice,spatial-relational,4|5,7,4/5,220064,4
1,1,22,65,1,979,1,11,5,5,6,single-choice,spatial-relational,5|6,7,5/6,220065,5
1,1,22,66,0,868,1,7,3,4,4,single-choice,spatial-relational,3|4,7,3/4,220066,3
1,1,22,67,1,1063,5,7,1,1,6,single-choice,spatial-relational,1|6,7,1/6,220067,1
1,1,22,68,1,819,2,8,3,3,5,single-choice,spatial-relational,3|5,7,3/5,220068,3
1,1,22,69,1,1081,3,7,2,2,5,single-choice,spatial-relational,2|5,7,2/5,220069,2
1,1,22,70,0,1156,3,7,2,5,5,single-choice,spatial-relational,2|5,7,2/5,220070,2
1,1,22,71,0,1273,1,11,5,6,6,single-choice,spatial-relational,5|6,7,5/6,220071,5
1,1,22,72,1,874,1,3,1,1,2,single-choice,spatial-relational,1|2,7,1/2,220072,1
1,1,22,73,1,1602,3,9,3,3,6,single-choice,spatial-relational,3|6,7,3/6,220073,3
1,1,22,74,1,969,2,6,2,2,4,single-choice,spatial-relational,2|4,7,2/4,220074,2
1,1,22,75,1,1817,2,8,3,3,5,single-choice,spatial-relational,3|5,7,3/5,220075,3
1,1,22,76,1,904,3,5,1,1,4,single-choice,spatial-relational,1|4,7,1/4,220076,1
1,1,22,77,1,759,4,6,1,1,5,single-choice,spatial-relational,1|5,7,1/5,220077,1
1,1,22,78,1,997,2,4,1,1,3,single-choice,spatial-relational,1|3,7,1/3,220078,1
1,1,22,79,1,731,2,4,1,1,3,single-choice,spatial-relational,1|3,7,1/3,220079,1
1,1,22,80,0,125,1,5,2,3,3,single-choice,spatial-relational,2|3,7,2/3,220080,2
1,1,22,81,0,1361,2,10,4,6,6,single-choice,spatial-relational,4|6,7,4/6,220081,4
1,1,22,82,1,868,4,8,2,2,6,single-choice,spatial-relational,2|6,7,2/6,220082,2
1,1,22,83,1,1012,1,9,4,4,5,single-choice,spatial-relational,4|5,7,4/5,220083,4
1,1,22,84,0,742,2,10,4,6,6,single-choice,spatial-relational,4|6,7,4/6,220084,4
1,1,22,85,1,1257,3,9,3,3,6,single-choice,spatial-relational,3|6,7,3/6,220085,3
1,1,22,86,1,1129,4,6,1,1,5,single-choice,spatial-relational,1|5,7,1/5,220086,1
1,1,22,87,0,955,5,9,2,7,7,single-choice,spatial-relational,2|7,7,2/7,220087,2
1,1,22,88,0,983,2,12,5,7,7,single-choice,spatial-relational,5|7,7,5/7,220088,5
1,1,22,89,1,909,3,7,2,2,5,single-choice,spatial-relational,2|5,7,2/5,220089,2
1,1,22,90,1,901,4,10,3,3,7,single-choice,spatial-relational,3|7,7,3/7,220090,3
1,1,22,91,1,1184,2,4,1,1,3,single-choice,spatial-relational,1|3,7,1/3,220091,1
1,1,22,92,1,686,2,4,1,1,3,single-choice,spatial-relational,1|3,7,1/3,220092,1
1,1,22,93,1,1062,1,7,3,3,4,single-choice,spatial-relational,3|4,7,3/4,220093,3
1,1,22,94,1,832,1,9,4,4,5,single-choice,spatial-relational,4|5,7,4/5,220094,4
1,1,22,95,1,848,1,13,6,6,7,single-choice,spatial-relational,6|7,7,6/7,220095,6
1,1,22,96,1,943,3,11,4,4,7,single-choice,spatial-relational,4|7,7,4/7,220096,4
1,1,22,97,1,1034,6,8,1,1,7,single-choice,spatial-relational,1|7,7,1/7,220097,1
1,1,22,98,0,944,5,7,1,6,6,single-choice,spatial-relational,1|6,7,1/6,220098,1
1,1,22,99,1,1174,5,9,2,2,7,single-choice,spatial-relational,2|7,7,2/7,220099,2
1,1,22,100,1,949,1,5,2,2,3,single-choice,spatial-relational,2|3,7,2/3,220100,2
1,1,22,101,0,798,2,10,4,6,6,single-choice,spatial-relational,4|6,7,4/6,220101,4
1,1,22,102,1,880,1,5,2,2,3,single-choice,spatial-relational,2|3,7,2/3,220102,2
1,1,22,103,1,1090,2,6,2,2,4,single-choice,spatial-relational,2|4,7,2/4,220103,2
1,1,22,104,1,745,2,12,5,5,7,single-choice,spatial-relational,5|7,7,5/7,220104,5
1,1,22,105,1,1256,2,8,3,3,5,single-choice,spatial-relational,3|5,7,3/5,220105,3
1,1,22,106,1,1073,3,5,1,1,4,single-choice,spatial-relational,1|4,7,1/4,220106,1
1,1,22,107,1,751,4,6,1,1,5,single-choice,spatial-relational,1|5,7,1/5,220107,1
1,1,22,108,1,1120,3,9,3,3,6,single-choice,spatial-relational,3|6,7,3/6,220108,3
1,1,22,109,1,884,1,3,1,1,2,single-choice,spatial-relational,1|2,7,1/2,220109,1
1,1,22,110,0,937,4,10,3,7,7,single-choice,spatial-relational,3|7,7,3/7,220110,3
1,1,22,111,1,882,1,13,6,6,7,single-choice,spatial-relational,6|7,7,6/7,220111,6
1,1,22,112,0,801,4,8,2,6,6,single-choice,spatial-relational,2|6,7,2/6,220112,2
1,1,22,113,1,924,2,10,4,4,6,single-choice,spatial-relational,4|6,7,4/6,220113,4
1,1,22,114,1,1018,3,5,1,1,4,single-choice,spatial-relational,1|4,7,1/4,220114,1
1,1,22,115,1,1270,1,7,3,3,4,single-choice,spatial-relational,3|4,7,3/4,220115,3
1,1,22,116,1,1075,4,8,2,2,6,single-choice,spatial-relational,2|6,7,2/6,220116,2
1,1,22,117,0,915,1,11,5,6,6,single-choice,spatial-relational,5|6,7,5/6,220117,5
1,1,22,118,1,913,5,7,1,1,6,single-choice,spatial-relational,1|6,7,1/6,220118,1
1,1,22,119,1,732,1,3,1,1,2,single-choice,spatial-relational,1|2,7,1/2,220119,1
1,1,22,120,0,970,1,9,4,5,5,single-choice,spatial-relational,4|5,7,4/5,220120,4
1,1,22,121,0,2243,1,11,5,6,6,single-choice,spatial-relational,5|6,7,5/6,220121,5
1,1,22,122,0,1056,3,11,4,7,7,single-choice,spatial-relational,4|7,7,4/7,220122,4
1,1,22,123,1,1103,6,8,1,1,7,single-choice,spatial-relational,1|7,7,1/7,220123,1
1,1,22,124,1,110,3,7,2,2,5,single-choice,spatial-relational,2|5,7,2/5,220124,2
1,1,22,125,1,1064,2,8,3,3,5,single-choice,spatial-relational,3|5,7,3/5,220125,3
1,1,22,126,1,1680,2,6,2,2,4,single-choice,spatial-relational,2|4,7,2/4,220126,2
1,1,22,127,1,933,4,6,1,1,5,single-choice,spatial-relational,1|5,7,1/5,220127,1
1,1,22,128,1,920,1,3,1,1,2,single-choice,spatial-relational,1|2,7,1/2,220128,1
1,1,22,129,1,1446,3,9,3,3,6,single-choice,spatial-relational,3|6,7,3/6,220129,3
1,1,22,130,1,900,2,4,1,1,3,single-choice,spatial-relational,1|3,7,1/3,220130,1
1,1,22,131,1,2025,4,8,2,2,6,single-choice,spatial-relational,2|6,7,2/6,220131,2
1,1,22,132,0,668,6,8,1,7,7,single-choice,spatial-relational,1|7,7,1/7,220132,1
1,1,22,133,0,1570,4,10,3,7,7,single-choice,spatial-relational,3|7,7,3/7,220133,3
1,1,22,134,0,1023,1,5,2,3,3,single-choice,spatial-relational,2|3,7,2/3,220134,2
1,1,22,135,1,741,1,3,1,1,2,single-choice,spatial-relational,1|2,7,1/2,220135,1
1,1,22,136,1,843,2,4,1,1,3,single-choice,spatial-relational,1|3,7,1/3,220136,1
1,1,22,137,1,910,1,5,2,2,3,single-choice,spatial-relational,2|3,7,2/3,220137,2
1,1,22,138,1,1197,2,8,3,3,5,single-choice,spatial-relational,3|5,7,3/5,220138,3
1,1,22,139,1,1322,1,11,5,5,6,single-choice,spatial-relational,5|6,7,5/6,220139,5
1,1,22,140,0,1013,2,10,4,6,6,single-choice,spatial-relational,4|6,7,4/6,220140,4
1,1,22,141,0,1376,5,9,2,7,7,single-choice,spatial-relational,2|7,7,2/7,220141,2
1,1,22,142,1,1344,4,10,3,3,7,single-choice,spatial-relational,3|7,7,3/7,220142,3
1,1,22,143,1,832,5,7,1,1,6,single-choice,spatial-relational,1|6,7,1/6,220143,1
1,1,22,144,0,1657,3,9,3,6,6,single-choice,spatial-relational,3|6,7,3/6,220144,3
1,1,22,145,1,1525,2,10,4,4,6,single-choice,spatial-relational,4|6,7,4/6,220145,4
1,1,22,146,1,1248,5,9,2,2,7,single-choice,spatial-relational,2|7,7,2/7,220146,2
1,1,22,147,1,781,3,5,1,1,4,single-choice,spatial-relational,1|4,7,1/4,220147,1
1,1,22,148,1,1670,3,7,2,2,5,single-choice,spatial-relational,2|5,7,2/5,220148,2
1,1,22,149,1,1362,1,7,3,3,4,single-choice,spatial-relational,3|4,7,3/4,220149,3
1,1,22,150,0,814,5,7,1,6,6,single-choice,spatial-relational,1|6,7,1/6,220150,1
1,1,22,151,1,835,1,7,3,3,4,single-choice,spatial-relational,3|4,7,3/4,220151,3
1,1,22,152,1,763,3,11,4,4,7,single-choice,spatial-relational,4|7,7,4/7,220152,4
1,1,22,153,1,869,3,7,2,2,5,single-choice,spatial-relational,2|5,7,2/5,220153,2
1,1,22,154,1,892,1,9,4,4,5,single-choice,spatial-relational,4|5,7,4/5,220154,4
1,1,22,155,1,951,3,5,1,1,4,single-choice,spatial-relational,1|4,7,1/4,220155,1
1,1,22,156,1,822,1,9,4,4,5,single-choice,spatial-relational,4|5,7,4/5,220156,4
1,1,22,157,1,1108,1,11,5,5,6,single-choice,spatial-relational,5|6,7,5/6,220157,5
1,1,22,158,1,1126,2,12,5,5,7,single-choice,spatial-relational,5|7,7,5/7,220158,5
1,1,22,159,1,890,1,13,6,6,7,single-choice,spatial-relational,6|7,7,6/7,220159,6
1,1,22,160,1,809,1,13,6,6,7,single-choice,spatial-relational,6|7,7,6/7,220160,6
1,1,22,161,0,941,2,8,3,5,5,single-choice,spatial-relational,3|5,7,3/5,220161,3
1,1,22,162,1,1098,3,11,4,4,7,single-choice,spatial-relational,4|7,7,4/7,220162,4
1,1,22,163,1,1222,2,6,2,2,4,single-choice,spatial-relational,2|4,7,2/4,220163,2
1,1,22,164,1,979,4,8,2,2,6,single-choice,spatial-relational,2|6,7,2/6,220164,2
1,1,22,165,1,1368,6,8,1,1,7,single-choice,spatial-relational,1|7,7,1/7,220165,1
1,1,22,166,0,891,2,12,5,7,7,single-choice,spatial-relational,5|7,7,5/7,220166,5
1,1,22,167,1,902,4,6,1,1,5,single-choice,spatial-relational,1|5,7,1/5,220167,1
1,1,22,168,1,994,2,6,2,2,4,single-choice,spatial-relational,2|4,7,2/4,220168,2
1,1,22,169,1,1318,3,9,3,3,6,single-choice,spatial-relational,3|6,7,3/6,220169,3
1,1,22,170,1,1153,5,7,1,1,6,single-choice,spatial-relational,1|6,7,1/6,220170,1
1,1,22,171,1,732,3,9,3,3,6,single-choice,spatial-relational,3|6,7,3/6,220171,3
1,1,22,172,1,1120,3,11,4,4,7,single-choice,spatial-relational,4|7,7,4/7,220172,4
1,1,22,173,1,1300,2,6,2,2,4,single-choice,spatial-relational,2|4,7,2/4,220173,2
1,1,22,174,1,1400,1,5,2,2,3,single-choice,spatial-relational,2|3,7,2/3,220174,2
1,1,22,175,0,700,1,11,5,6,6,single-choice,spatial-relational,5|6,7,5/6,220175,5
1,1,22,176,1,1158,3,7,2,2,5,single-choice,spatial-relational,2|5,7,2/5,220176,2
1,1,22,177,0,1742,2,4,1,3,3,single-choice,spatial-relational,1|3,7,1/3,220177,1
1,1,22,178,1,1082,6,8,1,1,7,single-choice,spatial-relational,1|7,7,1/7,220178,1
1,1,22,179,1,972,5,9,2,2,7,single-choice,spatial-relational,2|7,7,2/7,220179,2
1,1,22,180,1,1354,1,13,6,6,7,single-choice,spatial-relational,6|7,7,6/7,220180,6
1,1,22,181,1,903,1,13,6,6,7,single-choice,spatial-relational,6|7,7,6/7,220181,6
1,1,22,182,1,936,2,8,3,3,5,single-choice,spatial-relational,3|5,7,3/5,220182,3
1,1,22,183,1,985,4,6,1,1,5,single-choice,spatial-relational,1|5,7,1/5,220183,1
1,1,22,184,1,882,3,5,1,1,4,single-choice,spatial-relational,1|4,7,1/4,220184,1
1,1,22,185,1,813,3,7,2,2,5,single-choice,spatial-relational,2|5,7,2/5,220185,2
1,1,22,186,0,848,4,10,3,7,7,single-choice,spatial-relational,3|7,7,3/7,220186,3
1,1,22,187,1,948,5,7,1,1,6,single-choice,spatial-relational,1|6,7,1/6,220187,1
1,1,22,188,1,1183,3,5,1,1,4,single-choice,spatial-relational,1|4,7,1/4,220188,1
1,1,22,189,1,1068,4,8,2,2,6,single-choice,spatial-relational,2|6,7,2/6,220189,2
1,1,22,190,0,991,5,9,2,7,7,single-choice,spatial-relational,2|7,7,2/7,220190,2
1,1,22,191,0,1150,2,6,2,4,4,single-choice,spatial-relational,2|4,7,2/4,220191,2
1,1,22,192,1,872,6,8,1,1,7,single-choice,spatial-relational,1|7,7,1/7,220192,1
1,1,22,193,1,921,4,6,1,1,5,single-choice,spatial-relational,1|5,7,1/5,220193,1
1,1,22,194,1,2123,1,7,3,3,4,single-choice,spatial-relational,3|4,7,3/4,220194,3
1,1,22,195,1,1183,1,3,1,1,2,single-choice,spatial-relational,1|2,7,1/2,220195,1
1,1,22,196,1,1240,2,12,5,5,7,single-choice,spatial-relational,5|7,7,5/7,220196,5
1,1,22,197,1,937,2,12,5,5,7,single-choice,spatial-relational,5|7,7,5/7,220197,5
1,1,22,198,0,836,2,10,4,6,6,single-choice,spatial-relational,4|6,7,4/6,220198,4
1,1,22,199,1,1039,1,9,4,4,5,single-choice,spatial-relational,4|5,7,4/5,220199,4
1,1,22,200,0,1398,3,11,4,7,7,single-choice,spatial-relational,4|7,7,4/7,220200,4
1,1,22,201,0,966,2,10,4,6,6,single-choice,spatial-relational,4|6,7,4/6,220201,4
1,1,22,202,1,1623,4,10,3,3,7,single-choice,spatial-relational,3|7,7,3/7,220202,3
1,1,22,203,1,766,1,3,1,1,2,single-choice,spatial-relational,1|2,7,1/2,220203,1
1,1,22,204,1,825,1,7,3,3,4,single-choice,spatial-relational,3|4,7,3/4,220204,3
1,1,22,205,0,791,1,9,4,5,5,single-choice,spatial-relational,4|5,7,4/5,220205,4
1,1,22,206,0,1508,1,11,5,6,6,single-choice,spatial-relational,5|6,7,5/6,220206,5
1,1,22,207,1,1049,4,8,2,2,6,single-choice,spatial-relational,2|6,7,2/6,220207,2
1,1,22,208,1,730,2,4,1,1,3,single-choice,spatial-relational,1|3,7,1/3,220208,1
1,1,22,209,1,1099,1,5,2,2,3,single-choice,spatial-relational,2|3,7,2/3,220209,2
1,1,22,210,0,1056,2,8,3,5,5,single-choice,spatial-relational,3|5,7,3/5,220210,3
1,1,22,211,0,1147,3,9,3,6,6,single-choice,spatial-relational,3|6,7,3/6,220211,3
1,1,22,212,1,847,2,4,1,1,3,single-choice,spatial-relational,1|3,7,1/3,220212,1
1,1,22,213,1,1093,2,8,3,3,5,single-choice,spatial-relational,3|5,7,3/5,220213,3
1,1,22,214,0,924,2,6,2,4,4,single-choice,spatial-relational,2|4,7,2/4,220214,2
1,1,22,215,1,1356,4,6,1,1,5,single-choice,spatial-relational,1|5,7,1/5,220215,1
1,1,22,216,1,727,5,9,2,2,7,single-choice,spatial-relational,2|7,7,2/7,220216,2
1,1,22,217,1,1624,2,12,5,5,7,single-choice,spatial-relational,5|7,7,5/7,220217,5
1,1,22,218,1,849,3,5,1,1,4,single-choice,spatial-relational,1|4,7,1/4,220218,1
1,1,22,219,1,965,2,10,4,4,6,single-choice,spatial-relational,4|6,7,4/6,220219,4
1,1,22,220,0,874,6,8,1,7,7,single-choice,spatial-relational,1|7,7,1/7,220220,1
1,1,22,221,1,1098,2,8,3,3,5,single-choice,spatial-relational,3|5,7,3/5,220221,3
1,1,22,222,1,827,2,12,5,5,7,single-choice,spatial-relational,5|7,7,5/7,220222,5
1,1,22,223,1,979,3,5,1,1,4,single-choice,spatial-relational,1|4,7,1/4,220223,1
1,1,22,224,1,729,1,13,6,6,7,single-choice,spatial-relational,6|7,7,6/7,220224,6
1,1,22,225,0,847,1,11,5,6,6,single-choice,spatial-relational,5|6,7,5/6,220225,5
1,1,22,226,1,1063,1,13,6,6,7,single-choice,spatial-relational,6|7,7,6/7,220226,6
1,1,22,227,1,1243,5,7,1,1,6,single-choice,spatial-relational,1|6,7,1/6,220227,1
1,1,22,228,1,860,2,10,4,4,6,single-choice,spatial-relational,4|6,7,4/6,220228,4
1,1,22,229,1,988,5,7,1,1,6,single-choice,spatial-relational,1|6,7,1/6,220229,1
1,1,22,230,1,817,1,5,2,2,3,single-choice,spatial-relational,2|3,7,2/3,220230,2
1,1,22,231,1,1308,4,10,3,3,7,single-choice,spatial-relational,3|7,7,3/7,220231,3
1,1,22,232,0,956,1,5,2,3,3,single-choice,spatial-relational,2|3,7,2/3,220232,2
1,1,22,233,1,899,1,9,4,4,5,single-choice,spatial-relational,4|5,7,4/5,220233,4
1,1,22,234,0,888,3,7,2,5,5,single-choice,spatial-relational,2|5,7,2/5,220234,2
1,1,22,235,1,1212,4,8,2,2,6,single-choice,spatial-relational,2|6,7,2/6,220235,2
1,1,22,236,1,1004,3,11,4,4,7,single-choice,spatial-relational,4|7,7,4/7,220236,4
1,1,22,237,1,1369,5,9,2,2,7,single-choice,spatial-relational,2|7,7,2/7,220237,2
1,1,22,238,0,978,4,10,3,7,7,single-choice,spatial-relational,3|7,7,3/7,220238,3
1,1,22,239,1,860,1,3,1,1,2,single-choice,spatial-relational,1|2,7,1/2,220239,1
1,1,22,240,1,1130,6,8,1,1,7,single-choice,spatial-relational,1|7,7,1/7,220240,1
1,1,22,241,1,1183,1,7,3,3,4,single-choice,spatial-relational,3|4,7,3/4,220241,3
1,1,22,242,0,1396,2,6,2,4,4,single-choice,spatial-relational,2|4,7,2/4,220242,2
1,1,22,243,1,800,2,4,1,1,3,single-choice,spatial-relational,1|3,7,1/3,220243,1
1,1,22,244,1,9,1,11,5,5,6,single-choice,spatial-relational,5|6,7,5/6,220244,5
1,1,22,245,1,858,1,3,1,1,2,single-choice,spatial-relational,1|2,7,1/2,220245,1
1,1,22,246,1,1239,3,7,2,2,5,single-choice,spatial-relational,2|5,7,2/5,220246,2
1,1,22,247,1,1027,1,9,4,4,5,single-choice,spatial-relational,4|5,7,4/5,220247,4
1,1,22,248,1,809,1,7,3,3,4,single-choice,spatial-relational,3|4,7,3/4,220248,3
1,1,22,249,0,1046,4,8,2,6,6,single-choice,spatial-relational,2|6,7,2/6,220249,2
1,1,22,250,1,1376,3,9,3,3,6,single-choice,spatial-relational,3|6,7,3/6,220250,3
1,1,22,251,1,805,4,6,1,1,5,single-choice,spatial-relational,1|5,7,1/5,220251,1
1,1,22,252,1,1427,3,11,4,4,7,single-choice,spatial-relational,4|7,7,4/7,220252,4
1,1,22,253,1,1377,4,8,2,2,6,single-choice,spatial-relational,2|6,7,2/6,220253,2
1,1,22,254,0,736,2,10,4,6,6,single-choice,spatial-relational,4|6,7,4/6,220254,4
1,1,22,255,1,1105,5,9,2,2,7,single-choice,spatial-relational,2|7,7,2/7,220255,2
1,1,22,256,1,662,1,3,1,1,2,single-choice,spatial-relational,1|2,7,1/2,220256,1
1,1,22,257,1,1088,1,11,5,5,6,single-choice,spatial-relational,5|6,7,5/6,220257,5
1,1,22,258,1,796,3,9,3,3,6,single-choice,spatial-relational,3|6,7,3/6,220258,3
1,1,22,259,0,914,5,9,2,7,7,single-choice,spatial-relational,2|7,7,2/7,220259,2
1,1,22,260,1,946,1,9,4,4,5,single-choice,spatial-relational,4|5,7,4/5,220260,4
1,1,22,261,1,1362,6,8,1,1,7,single-choice,spatial-relational,1|7,7,1/7,220261,1
1,1,22,262,1,838,3,7,2,2,5,single-choice,spatial-relational,2|5,7,2/5,220262,2
1,1,22,263,1,1105,2,12,5,5,7,single-choice,spatial-relational,5|7,7,5/7,220263,5
1,1,22,264,0,854,1,7,3,4,4,single-choice,spatial-relational,3|4,7,3/4,220264,3
1,1,22,265,0,1092,4,10,3,7,7,single-choice,spatial-relational,3|7,7,3/7,220265,3
1,1,22,266,1,889,1,13,6,6,7,single-choice,spatial-relational,6|7,7,6/7,220266,6
1,1,22,267,1,1309,3,9,3,3,6,single-choice,spatial-relational,3|6,7,3/6,220267,3
1,1,22,268,1,795,2,12,5,5,7,single-choice,spatial-relational,5|7,7,5/7,220268,5
1,1,22,269,1,1059,1,3,1,1,2,single-choice,spatial-relational,1|2,7,1/2,220269,1
1,1,22,270,0,1079,2,8,3,5,5,single-choice,spatial-relational,3|5,7,3/5,220270,3
1,1,22,271,1,1125,2,8,3,3,5,single-choice,spatial-relational,3|5,7,3/5,220271,3
1,1,22,272,1,1120,3,11,4,4,7,single-choice,spatial-relational,4|7,7,4/7,220272,4
1,1,22,273,1,1009,4,6,1,1,5,single-choice,spatial-relational,1|5,7,1/5,220273,1
1,1,22,274,1,1380,1,11,5,5,6,single-choice,spatial-relational,5|6,7,5/6,220274,5
1,1,22,275,1,1086,3,5,1,1,4,single-choice,spatial-relational,1|4,7,1/4,220275,1
1,1,22,276,1,1302,4,6,1,1,5,single-choice,spatial-relational,1|5,7,1/5,220276,1
1,1,22,277,0,1095,2,6,2,4,4,single-choice,spatial-relational,2|4,7,2/4,220277,2
1,1,22,278,0,1311,6,8,1,7,7,single-choice,spatial-relational,1|7,7,1/7,220278,1
1,1,22,279,1,828,2,4,1,1,3,single-choice,spatial-relational,1|3,7,1/3,220279,1
1,1,22,280,0,1236,3,11,4,7,7,single-choice,spatial-relational,4|7,7,4/7,220280,4
1,1,22,281,1,1067,2,10,4,4,6,single-choice,spatial-relational,4|6,7,4/6,220281,4
1,1,22,282,0,865,5,7,1,6,6,single-choice,spatial-relational,1|6,7,1/6,220282,1
1,1,22,283,1,1039,2,6,2,2,4,single-choice,spatial-relational,2|4,7,2/4,220283,2
1,1,22,284,1,755,4,8,2,2,6,single-choice,spatial-relational,2|6,7,2/6,220284,2
1,1,22,285,1,1258,1,5,2,2,3,single-choice,spatial-relational,2|3,7,2/3,220285,2
1,1,22,286,1,788,2,4,1,1,3,single-choice,spatial-relational,1|3,7,1/3,220286,1
1,1,22,287,1,1209,1,9,4,4,5,single-choice,spatial-relational,4|5,7,4/5,220287,4
1,1,22,288,1,1089,1,7,3,3,4,single-choice,spatial-relational,3|4,7,3/4,220288,3
1,1,22,289,1,906,1,13,6,6,7,single-choice,spatial-relational,6|7,7,6/7,220289,6
1,1,22,290,1,796,5,7,1,1,6,single-choice,spatial-relational,1|6,7,1/6,220290,1
1,1,22,291,1,713,3,5,1,1,4,single-choice,spatial-relational,1|4,7,1/4,220291,1
1,1,22,292,0,1108,3,7,2,5,5,single-choice,spatial-relational,2|5,7,2/5,220292,2
1,1,22,293,1,1088,4,10,3,3,7,single-choice,spatial-relational,3|7,7,3/7,220293,3
1,1,22,294,1,917,1,5,2,2,3,single-choice,spatial-relational,2|3,7,2/3,220294,2
1,1,22,295,1,1192,5,9,2,2,7,single-choice,spatial-relational,2|7,7,2/7,220295,2
1,1,22,296,1,1103,5,9,2,2,7,single-choice,spatial-relational,2|7,7,2/7,220296,2
1,1,22,297,1,709,1,5,2,2,3,single-choice,spatial-relational,2|3,7,2/3,220297,2
1,1,22,298,1,1122,4,6,1,1,5,single-choice,spatial-relational,1|5,7,1/5,220298,1
1,1,22,299,1,831,1,11,5,5,6,single-choice,spatial-relational,5|6,7,5/6,220299,5
1,1,22,300,0,815,1,9,4,5,5,single-choice,spatial-relational,4|5,7,4/5,220300,4
1,1,22,301,0,1000,1,5,2,3,3,single-choice,spatial-relational,2|3,7,2/3,220301,2
1,1,22,302,1,975,5,7,1,1,6,single-choice,spatial-relational,1|6,7,1/6,220302,1
1,1,22,303,1,1017,3,11,4,4,7,single-choice,spatial-relational,4|7,7,4/7,220303,4
1,1,22,304,1,885,5,7,1,1,6,single-choice,spatial-relational,1|6,7,1/6,220304,1
1,1,22,305,0,1516,6,8,1,7,7,single-choice,spatial-relational,1|7,7,1/7,220305,1
1,1,22,306,1,1109,2,12,5,5,7,single-choice,spatial-relational,5|7,7,5/7,220306,5
1,1,22,307,1,877,1,13,6,6,7,single-choice,spatial-relational,6|7,7,6/7,220307,6
1,1,22,308,1,926,1,3,1,1,2,single-choice,spatial-relational,1|2,7,1/2,220308,1
1,1,22,309,1,1214,2,10,4,4,6,single-choice,spatial-relational,4|6,7,4/6,220309,4
1,1,22,310,1,1102,3,5,1,1,4,single-choice,spatial-relational,1|4,7,1/4,220310,1
1,1,22,311,1,875,3,11,4,4,7,single-choice,spatial-relational,4|7,7,4/7,220311,4
1,1,22,312,1,1280,3,7,2,2,5,single-choice,spatial-relational,2|5,7,2/5,220312,2
1,1,22,313,1,915,6,8,1,1,7,single-choice,spatial-relational,1|7,7,1/7,220313,1
1,1,22,314,1,1028,1,11,5,5,6,single-choice,spatial-relational,5|6,7,5/6,220314,5
1,1,22,315,1,1329,4,10,3,3,7,single-choice,spatial-relational,3|7,7,3/7,220315,3
1,1,22,316,1,862,4,8,2,2,6,single-choice,spatial-relational,2|6,7,2/6,220316,2
1,1,22,317,1,913,3,5,1,1,4,single-choice,spatial-relational,1|4,7,1/4,220317,1
1,1,22,318,1,848,2,4,1,1,3,single-choice,spatial-relational,1|3,7,1/3,220318,1
1,1,22,319,1,1043,3,9,3,3,6,single-choice,spatial-relational,3|6,7,3/6,220319,3
1,1,22,320,1,922,1,7,3,3,4,single-choice,spatial-relational,3|4,7,3/4,220320,3
1,1,22,321,1,1059,4,6,1,1,5,single-choice,spatial-relational,1|5,7,1/5,220321,1
1,1,22,322,1,747,2,8,3,3,5,single-choice,spatial-relational,3|5,7,3/5,220322,3
1,1,22,323,1,659,1,3,1,1,2,single-choice,spatial-relational,1|2,7,1/2,220323,1
1,1,22,324,1,973,2,6,2,2,4,single-choice,spatial-relational,2|4,7,2/4,220324,2
1,1,22,325,1,861,1,13,6,6,7,single-choice,spatial-relational,6|7,7,6/7,220325,6
1,1,22,326,1,829,1,7,3,3,4,single-choice,spatial-relational,3|4,7,3/4,220326,3
1,1,22,327,1,1034,4,10,3,3,7,single-choice,spatial-relational,3|7,7,3/7,220327,3
1,1,22,328,1,743,2,6,2,2,4,single-choice,spatial-relational,2|4,7,2/4,220328,2
1,1,22,329,0,1638,3,9,3,6,6,single-choice,spatial-relational,3|6,7,3/6,220329,3
1,1,22,330,1,1085,2,12,5,5,7,single-choice,spatial-relational,5|7,7,5/7,220330,5
1,1,22,331,0,1256,2,8,3,5,5,single-choice,spatial-relational,3|5,7,3/5,220331,3
1,1,22,332,1,1063,4,8,2,2,6,single-choice,spatial-relational,2|6,7,2/6,220332,2
1,1,22,333,1,1109,2,10,4,4,6,single-choice,spatial-relational,4|6,7,4/6,220333,4
1,1,22,334,1,1080,3,7,2,2,5,single-choice,spatial-relational,2|5,7,2/5,220334,2
1,1,22,335,1,1079,1,9,4,4,5,single-choice,spatial-relational,4|5,7,4/5,220335,4
1,1,22,336,1,1162,2,4,1,1,3,single-choice,spatial-relational,1|3,7,1/3,220336,1
1,1,22,337,1,1020,6,8,1,1,7,single-choice,spatial-relational,1|7,7,1/7,220337,1
1,1,22,338,1,1094,1,7,3,3,4,single-choice,spatial-relational,3|4,7,3/4,220338,3
1,1,22,339,1,1878,2,6,2,2,4,single-choice,spatial-relational,2|4,7,2/4,220339,2
1,1,22,340,1,1525,5,9,2,2,7,single-choice,spatial-relational,2|7,7,2/7,220340,2
1,1,22,341,1,764,5,9,2,2,7,single-choice,spatial-relational,2|7,7,2/7,220341,2
1,1,22,342,1,1109,3,11,4,4,7,single-choice,spatial-relational,4|7,7,4/7,220342,4
1,1,22,343,1,1825,2,10,4,4,6,single-choice,spatial-relational,4|6,7,4/6,220343,4
1,1,22,344,1,960,4,6,1,1,5,single-choice,spatial-relational,1|5,7,1/5,220344,1
1,1,22,345,1,915,2,10,4,4,6,single-choice,spatial-relational,4|6,7,4/6,220345,4
1,1,22,346,1,1162,1,7,3,3,4,single-choice,spatial-relational,3|4,7,3/4,220346,3
1,1,22,347,1,998,3,7,2,2,5,single-choice,spatial-relational,2|5,7,2/5,220347,2
1,1,22,348,1,1014,1,11,5,5,6,single-choice,spatial-relational,5|6,7,5/6,220348,5
1,1,22,349,0,835,1,5,2,3,3,single-choice,spatial-relational,2|3,7,2/3,220349,2
1,1,22,350,1,1025,1,11,5,5,6,single-choice,spatial-relational,5|6,7,5/6,220350,5
1,1,22,351,1,845,3,11,4,4,7,single-choice,spatial-relational,4|7,7,4/7,220351,4
1,1,22,352,1,951,1,13,6,6,7,single-choice,spatial-relational,6|7,7,6/7,220352,6
1,1,22,353,1,818,1,3,1,1,2,single-choice,spatial-relational,1|2,7,1/2,220353,1
1,1,22,354,1,829,4,8,2,2,6,single-choice,spatial-relational,2|6,7,2/6,220354,2
1,1,22,355,1,957,4,6,1,1,5,single-choice,spatial-relational,1|5,7,1/5,220355,1
1,1,22,356,1,1427,2,12,5,5,7,single-choice,spatial-relational,5|7,7,5/7,220356,5
1,1,22,357,0,980,4,10,3,7,7,single-choice,spatial-relational,3|7,7,3/7,220357,3
1,1,22,358,1,1279,3,9,3,3,6,single-choice,spatial-relational,3|6,7,3/6,220358,3
1,1,22,359,1,1000,4,8,2,2,6,single-choice,spatial-relational,2|6,7,2/6,220359,2
1,1,22,360,1,988,2,8,3,3,5,single-choice,spatial-relational,3|5,7,3/5,220360,3
1,1,22,361,0,920,3,9,3,6,6,single-choice,spatial-relational,3|6,7,3/6,220361,3
1,1,22,362,1,943,1,9,4,4,5,single-choice,spatial-relational,4|5,7,4/5,220362,4
1,1,22,363,0,872,3,7,2,5,5,single-choice,spatial-relational,2|5,7,2/5,220363,2
1,1,22,364,0,1205,2,6,2,4,4,single-choice,spatial-relational,2|4,7,2/4,220364,2
1,1,22,365,1,782,3,5,1,1,4,single-choice,spatial-relational,1|4,7,1/4,220365,1
1,1,22,366,1,829,1,13,6,6,7,single-choice,spatial-relational,6|7,7,6/7,220366,6
1,1,22,367,1,1161,5,7,1,1,6,single-choice,spatial-relational,1|6,7,1/6,220367,1
1,1,22,368,1,1134,1,9,4,4,5,single-choice,spatial-relational,4|5,7,4/5,220368,4
1,1,22,369,1,786,1,3,1,1,2,single-choice,spatial-relational,1|2,7,1/2,220369,1
1,1,22,370,1,1281,2,12,5,5,7,single-choice,spatial-relational,5|7,7,5/7,220370,5
1,1,22,371,0,982,6,8,1,7,7,single-choice,spatial-relational,1|7,7,1/7,220371,1
1,1,22,372,1,842,2,4,1,1,3,single-choice,spatial-relational,1|3,7,1/3,220372,1
1,1,22,373,1,145,4,10,3,3,7,single-choice,spatial-relational,3|7,7,3/7,220373,3
1,1,22,374,1,784,5,7,1,1,6,single-choice,spatial-relational,1|6,7,1/6,220374,1
1,1,22,375,0,997,1,5,2,3,3,single-choice,spatial-relational,2|3,7,2/3,220375,2
1,1,22,376,1,916,3,5,1,1,4,single-choice,spatial-relational,1|4,7,1/4,220376,1
1,1,22,377,1,1338,2,4,1,1,3,single-choice,spatial-relational,1|3,7,1/3,220377,1
1,1,22,378,1,905,2,8,3,3,5,single-choice,spatial-relational,3|5,7,3/5,220378,3
1,1,22,379,1,1252,2,8,3,3,5,single-choice,spatial-relational,3|5,7,3/5,220379,3
1,1,22,380,1,862,2,6,2,2,4,single-choice,spatial-relational,2|4,7,2/4,220380,2
1,1,22,381,1,853,2,6,2,2,4,single-choice,spatial-relational,2|4,7,2/4,220381,2
1,1,22,382,1,1636,2,10,4,4,6,single-choice,spatial-relational,4|6,7,4/6,220382,4
1,1,22,383,1,777,1,3,1,1,2,single-choice,spatial-relational,1|2,7,1/2,220383,1
1,1,22,384,1,1254,4,6,1,1,5,single-choice,spatial-relational,1|5,7,1/5,220384,1
1,1,22,385,1,624,1,3,1,1,2,single-choice,spatial-relational,1|2,7,1/2,220385,1
1,1,22,386,1,1002,2,8,3,3,5,single-choice,spatial-relational,3|5,7,3/5,220386,3
1,1,22,387,0,1430,1,11,5,6,6,single-choice,spatial-relational,5|6,7,5/6,220387,5
1,1,22,388,0,1424,1,5,2,3,3,single-choice,spatial-relational,2|3,7,2/3,220388,2
1,1,22,389,0,1130,4,10,3,7,7,single-choice,spatial-relational,3|7,7,3/7,220389,3
1,1,22,390,1,1706,1,11,5,5,6,single-choice,spatial-relational,5|6,7,5/6,220390,5
1,1,22,391,1,1205,4,8,2,2,6,single-choice,spatial-relational,2|6,7,2/6,220391,2
1,1,22,392,1,866,3,11,4,4,7,single-choice,spatial-relational,4|7,7,4/7,220392,4
1,1,22,393,0,835,1,13,6,7,7,single-choice,spatial-relational,6|7,7,6/7,220393,6
1,1,22,394,1,1001,6,8,1,1,7,single-choice,spatial-relational,1|7,7,1/7,220394,1
1,1,22,395,1,834,4,6,1,1,5,single-choice,spatial-relational,1|5,7,1/5,220395,1
1,1,22,396,1,956,5,7,1,1,6,single-choice,spatial-relational,1|6,7,1/6,220396,1
1,1,22,397,1,987,6,8,1,1,7,single-choice,spatial-relational,1|7,7,1/7,220397,1
1,1,22,398,1,700,1,13,6,6,7,single-choice,spatial-relational,6|7,7,6/7,220398,6
1,1,22,399,1,1009,5,9,2,2,7,single-choice,spatial-relational,2|7,7,2/7,220399,2
1,1,22,400,1,1060,2,4,1,1,3,single-choice,spatial-relational,1|3,7,1/3,220400,1
1,1,22,401,1,646,2,4,1,1,3,single-choice,spatial-relational,1|3,7,1/3,220401,1
1,1,22,402,1,914,1,7,3,3,4,single-choice,spatial-relational,3|4,7,3/4,220402,3
1,1,22,403,1,1013,1,9,4,4,5,single-choice,spatial-relational,4|5,7,4/5,220403,4
1,1,22,404,1,939,2,12,5,5,7,single-choice,spatial-relational,5|7,7,5/7,220404,5
1,1,22,405,1,1104,5,7,1,1,6,single-choice,spatial-relational,1|6,7,1/6,220405,1
1,1,22,406,1,1098,3,7,2,2,5,single-choice,spatial-relational,2|5,7,2/5,220406,2
1,1,22,407,1,844,2,10,4,4,6,single-choice,spatial-relational,4|6,7,4/6,220407,4
1,1,22,408,1,1569,3,9,3,3,6,single-choice,spatial-relational,3|6,7,3/6,220408,3
1,1,22,409,1,725,2,12,5,5,7,single-choice,spatial-relational,5|7,7,5/7,220409,5
1,1,22,410,1,952,1,7,3,3,4,single-choice,spatial-relational,3|4,7,3/4,220410,3
1,1,22,411,0,1272,5,9,2,7,7,single-choice,spatial-relational,2|7,7,2/7,220411,2
1,1,22,412,1,896,1,5,2,2,3,single-choice,spatial-relational,2|3,7,2/3,220412,2
1,1,22,413,1,1046,4,10,3,3,7,single-choice,spatial-relational,3|7,7,3/7,220413,3
1,1,22,414,0,1028,3,11,4,7,7,single-choice,spatial-relational,4|7,7,4/7,220414,4
1,1,22,415,0,116,1,9,4,5,5,single-choice,spatial-relational,4|5,7,4/5,220415,4
1,1,22,416,1,1037,3,5,1,1,4,single-choice,spatial-relational,1|4,7,1/4,220416,1
1,1,22,417,1,810,3,7,2,2,5,single-choice,spatial-relational,2|5,7,2/5,220417,2
1,1,22,418,1,952,4,8,2,2,6,single-choice,spatial-relational,2|6,7,2/6,220418,2
1,1,22,419,1,699,3,9,3,3,6,single-choice,spatial-relational,3|6,7,3/6,220419,3
1,1,22,420,1,968,3,5,1,1,4,single-choice,spatial-relational,1|4,7,1/4,220420,1
1,1,22,421,1,891,3,5,1,1,4,single-choice,spatial-relational,1|4,7,1/4,220421,1
1,1,22,422,1,807,5,9,2,2,7,single-choice,spatial-relational,2|7,7,2/7,220422,2
1,1,22,423,1,733,1,3,1,1,2,single-choice,spatial-relational,1|2,7,1/2,220423,1
1,1,22,424,1,801,2,4,1,1,3,single-choice,spatial-relational,1|3,7,1/3,220424,1
1,1,22,425,1,654,2,12,5,5,7,single-choice,spatial-relational,5|7,7,5/7,220425,5
1,1,22,426,1,1370,6,8,1,1,7,single-choice,spatial-relational,1|7,7,1/7,220426,1
1,1,22,427,1,1026,3,9,3,3,6,single-choice,spatial-relational,3|6,7,3/6,220427,3
1,1,22,428,1,718,1,5,2,2,3,single-choice,spatial-relational,2|3,7,2/3,220428,2
1,1,22,429,0,946,3,7,2,5,5,single-choice,spatial-relational,2|5,7,2/5,220429,2
1,1,22,430,1,919,4,8,2,2,6,single-choice,spatial-relational,2|6,7,2/6,220430,2
1,1,22,431,0,1291,1,7,3,4,4,single-choice,spatial-relational,3|4,7,3/4,220431,3
1,1,22,432,1,982,2,6,2,2,4,single-choice,spatial-relational,2|4,7,2/4,220432,2
1,1,22,433,1,887,1,13,6,6,7,single-choice,spatial-relational,6|7,7,6/7,220433,6
1,1,22,434,1,1006,2,10,4,4,6,single-choice,spatial-relational,4|6,7,4/6,220434,4
1,1,22,435,0,900,4,6,1,5,5,single-choice,spatial-relational,1|5,7,1/5,220435,1
1,1,22,436,1,957,2,10,4,4,6,single-choice,spatial-relational,4|6,7,4/6,220436,4
1,1,22,437,1,1302,2,4,1,1,3,single-choice,spatial-relational,1|3,7,1/3,220437,1
1,1,22,438,1,890,3,7,2,2,5,single-choice,spatial-relational,2|5,7,2/5,220438,2
1,1,22,439,1,874,1,9,4,4,5,single-choice,spatial-relational,4|5,7,4/5,220439,4
1,1,22,440,1,1558,1,11,5,5,6,single-choice,spatial-relational,5|6,7,5/6,220440,5
1,1,22,441,1,1693,5,9,2,2,7,single-choice,spatial-relational,2|7,7,2/7,220441,2
1,1,22,442,0,966,3,11,4,7,7,single-choice,spatial-relational,4|7,7,4/7,220442,4
1,1,22,443,1,852,6,8,1,1,7,single-choice,spatial-relational,1|7,7,1/7,220443,1
1,1,22,444,1,1253,1,9,4,4,5,single-choice,spatial-relational,4|5,7,4/5,220444,4
1,1,22,445,0,1116,5,7,1,6,6,single-choice,spatial-relational,1|6,7,1/6,220445,1
1,1,22,446,1,1410,3,11,4,4,7,single-choice,spatial-relational,4|7,7,4/7,220446,4
1,1,22,447,0,1539,4,8,2,6,6,single-choice,spatial-relational,2|6,7,2/6,220447,2
1,1,22,448,0,2006,1,11,5,6,6,single-choice,spatial-relational,5|6,7,5/6,220448,5
1,1,22,449,1,953,4,6,1,1,5,single-choice,spatial-relational,1|5,7,1/5,220449,1
1,1,22,450,1,869,1,3,1,1,2,single-choice,spatial-relational,1|2,7,1/2,220450,1
1,1,22,451,0,1008,1,5,2,3,3,single-choice,spatial-relational,2|3,7,2/3,220451,2
1,1,22,452,0,1320,2,8,3,5,5,single-choice,spatial-relational,3|5,7,3/5,220452,3
1,1,22,453,1,778,3,9,3,3,6,single-choice,spatial-relational,3|6,7,3/6,220453,3
1,1,22,454,1,1395,3,5,1,1,4,single-choice,spatial-relational,1|4,7,1/4,220454,1
1,1,22,455,1,773,5,7,1,1,6,single-choice,spatial-relational,1|6,7,1/6,220455,1
1,1,22,456,1,963,4,10,3,3,7,single-choice,spatial-relational,3|7,7,3/7,220456,3
1,1,22,457,1,1200,2,8,3,3,5,single-choice,spatial-relational,3|5,7,3/5,220457,3
1,1,22,458,1,1150,4,10,3,3,7,single-choice,spatial-relational,3|7,7,3/7,220458,3
1,1,22,459,1,753,2,6,2,2,4,single-choice,spatial-relational,2|4,7,2/4,220459,2
1,1,22,460,1,904,1,13,6,6,7,single-choice,spatial-relational,6|7,7,6/7,220460,6
1,1,22,461,0,1172,2,12,5,7,7,single-choice,spatial-relational,5|7,7,5/7,220461,5
1,1,22,462,1,913,1,7,3,3,4,single-choice,spatial-relational,3|4,7,3/4,220462,3
1,1,22,463,1,1009,3,7,2,2,5,single-choice,spatial-relational,2|5,7,2/5,220463,2
1,1,22,464,0,666,3,9,3,6,6,single-choice,spatial-relational,3|6,7,3/6,220464,3
1,1,22,465,1,1399,2,10,4,4,6,single-choice,spatial-relational,4|6,7,4/6,220465,4
1,1,22,466,1,1468,4,10,3,3,7,single-choice,spatial-relational,3|7,7,3/7,220466,3
1,1,22,467,1,829,1,13,6,6,7,single-choice,spatial-relational,6|7,7,6/7,220467,6
1,1,22,468,1,1030,3,11,4,4,7,single-choice,spatial-relational,4|7,7,4/7,220468,4
1,1,22,469,1,1285,1,9,4,4,5,single-choice,spatial-relational,4|5,7,4/5,220469,4
1,1,22,470,0,1993,1,7,3,4,4,single-choice,spatial-relational,3|4,7,3/4,220470,3
1,1,22,471,0,1180,2,6,2,4,4,single-choice,spatial-relational,2|4,7,2/4,220471,2
1,1,22,472,1,827,2,4,1,1,3,single-choice,spatial-relational,1|3,7,1/3,220472,1
1,1,22,473,1,869,3,5,1,1,4,single-choice,spatial-relational,1|4,7,1/4,220473,1
1,1,22,474,1,1494,1,5,2,2,3,single-choice,spatial-relational,2|3,7,2/3,220474,2
1,1,22,475,1,771,3,11,4,4,7,single-choice,spatial-relational,4|7,7,4/7,220475,4
1,1,22,476,1,950,6,8,1,1,7,single-choice,spatial-relational,1|7,7,1/7,220476,1
1,1,22,477,1,784,2,8,3,3,5,single-choice,spatial-relational,3|5,7,3/5,220477,3
1,1,22,478,1,827,3,5,1,1,4,single-choice,spatial-relational,1|4,7,1/4,220478,1
1,1,22,479,1,1202,1,11,5,5,6,single-choice,spatial-relational,5|6,7,5/6,220479,5
1,1,22,480,0,863,2,4,1,3,3,single-choice,spatial-relational,1|3,7,1/3,220480,1
1,1,22,481,0,1383,5,9,2,7,7,single-choice,spatial-relational,2|7,7,2/7,220481,2
1,1,22,482,1,1063,1,9,4,4,5,single-choice,spatial-relational,4|5,7,4/5,220482,4
1,1,22,483,1,1350,2,8,3,3,5,single-choice,spatial-relational,3|5,7,3/5,220483,3
1,1,22,484,0,1168,1,7,3,4,4,single-choice,spatial-relational,3|4,7,3/4,220484,3
1,1,22,485,1,1558,2,12,5,5,7,single-choice,spatial-relational,5|7,7,5/7,220485,5
1,1,22,486,1,1004,4,6,1,1,5,single-choice,spatial-relational,1|5,7,1/5,220486,1
1,1,22,487,1,1396,1,11,5,5,6,single-choice,spatial-relational,5|6,7,5/6,220487,5
1,1,22,488,1,1458,5,9,2,2,7,single-choice,spatial-relational,2|7,7,2/7,220488,2
1,1,22,489,1,822,6,8,1,1,7,single-choice,spatial-relational,1|7,7,1/7,220489,1
1,1,22,490,1,1237,3,9,3,3,6,single-choice,spatial-relational,3|6,7,3/6,220490,3
1,1,22,491,1,949,4,10,3,3,7,single-choice,spatial-relational,3|7,7,3/7,220491,3
1,1,22,492,1,750,1,13,6,6,7,single-choice,spatial-relational,6|7,7,6/7,220492,6
1,1,22,493,0,910,1,3,1,2,2,single-choice,spatial-relational,1|2,7,1/2,220493,1
1,1,22,494,1,904,3,7,2,2,5,single-choice,spatial-relational,2|5,7,2/5,220494,2
1,1,22,495,1,1194,5,7,1,1,6,single-choice,spatial-relational,1|6,7,1/6,220495,1
1,1,22,496,1,873,4,8,2,2,6,single-choice,spatial-relational,2|6,7,2/6,220496,2
1,1,22,497,1,799,5,7,1,1,6,single-choice,spatial-relational,1|6,7,1/6,220497,1
1,1,22,498,1,877,4,6,1,1,5,single-choice,spatial-relational,1|5,7,1/5,220498,1
1,1,22,499,1,1546,4,8,2,2,6,single-choice,spatial-relational,2|6,7,2/6,220499,2
1,1,22,500,0,596,1,5,2,3,3,single-choice,spatial-relational,2|3,7,2/3,220500,2
1,1,22,501,1,841,1,3,1,1,2,single-choice,spatial-relational,1|2,7,1/2,220501,1
1,1,22,502,1,718,2,12,5,5,7,single-choice,spatial-relational,5|7,7,5/7,220502,5
1,1,22,503,0,966,2,6,2,4,4,single-choice,spatial-relational,2|4,7,2/4,220503,2
1,1,22,504,1,1475,2,10,4,4,6,single-choice,spatial-relational,4|6,7,4/6,220504,4
1,1,22,505,1,1013,1,11,5,5,6,single-choice,spatial-relational,5|6,7,5/6,220505,5
1,1,22,506,1,1272,4,8,2,2,6,single-choice,spatial-relational,2|6,7,2/6,220506,2
1,1,22,507,1,1221,6,8,1,1,7,single-choice,spatial-relational,1|7,7,1/7,220507,1
1,1,22,508,1,782,3,5,1,1,4,single-choice,spatial-relational,1|4,7,1/4,220508,1
1,1,22,509,1,988,2,4,1,1,3,single-choice,spatial-relational,1|3,7,1/3,220509,1
1,1,22,510,1,732,2,4,1,1,3,single-choice,spatial-relational,1|3,7,1/3,220510,1
1,1,22,511,1,1244,5,9,2,2,7,single-choice,spatial-relational,2|7,7,2/7,220511,2
1,1,22,512,1,757,1,5,2,2,3,single-choice,spatial-relational,2|3,7,2/3,220512,2
1,1,22,513,1,669,1,3,1,1,2,single-choice,spatial-relational,1|2,7,1/2,220513,1
1,1,22,514,1,783,1,13,6,6,7,single-choice,spatial-relational,6|7,7,6/7,220514,6
1,1,22,515,1,926,1,7,3,3,4,single-choice,spatial-relational,3|4,7,3/4,220515,3
1,1,22,516,1,1564,3,7,2,2,5,single-choice,spatial-relational,2|5,7,2/5,220516,2
1,1,22,517,1,909,4,8,2,2,6,single-choice,spatial-relational,2|6,7,2/6,220517,2
1,1,22,518,1,1194,5,7,1,1,6,single-choice,spatial-relational,1|6,7,1/6,220518,1
1,1,22,519,0,1579,1,5,2,3,3,single-choice,spatial-relational,2|3,7,2/3,220519,2
1,1,22,520,1,849,4,6,1,1,5,single-choice,spatial-relational,1|5,7,1/5,220520,1
1,1,22,521,0,1007,3,9,3,6,6,single-choice,spatial-relational,3|6,7,3/6,220521,3
1,1,22,522,1,987,3,11,4,4,7,single-choice,spatial-relational,4|7,7,4/7,220522,4
1,1,22,523,1,1031,2,12,5,5,7,single-choice,spatial-relational,5|7,7,5/7,220523,5
1,1,22,524,0,916,5,7,1,6,6,single-choice,spatial-relational,1|6,7,1/6,220524,1
1,1,22,525,1,1750,2,12,5,5,7,single-choice,spatial-relational,5|7,7,5/7,220525,5
1,1,22,526,1,982,4,10,3,3,7,single-choice,spatial-relational,3|7,7,3/7,220526,3
1,1,22,527,1,800,1,11,5,5,6,single-choice,spatial-relational,5|6,7,5/6,220527,5
1,1,22,528,0,1259,5,9,2,7,7,single-choice,spatial-relational,2|7,7,2/7,220528,2
1,1,22,529,1,963,1,3,1,1,2,single-choice,spatial-relational,1|2,7,1/2,220529,1
1,1,22,530,1,1000,6,8,1,1,7,single-choice,spatial-relational,1|7,7,1/7,220530,1
1,1,22,531,1,947,3,5,1,1,4,single-choice,spatial-relational,1|4,7,1/4,220531,1
1,1,22,532,1,862,4,10,3,3,7,single-choice,spatial-relational,3|7,7,3/7,220532,3
1,1,22,533,1,1270,2,10,4,4,6,single-choice,spatial-relational,4|6,7,4/6,220533,4
1,1,22,534,1,1299,2,10,4,4,6,single-choice,spatial-relational,4|6,7,4/6,220534,4
1,1,22,535,1,957,2,6,2,2,4,single-choice,spatial-relational,2|4,7,2/4,220535,2
1,1,22,536,0,1554,1,7,3,4,4,single-choice,spatial-relational,3|4,7,3/4,220536,3
1,1,22,537,0,83,3,7,2,5,5,single-choice,spatial-relational,2|5,7,2/5,220537,2
1,1,22,538,1,855,3,9,3,3,6,single-choice,spatial-relational,3|6,7,3/6,220538,3
1,1,22,539,1,929,4,6,1,1,5,single-choice,spatial-relational,1|5,7,1/5,220539,1
1,1,22,540,1,1171,1,9,4,4,5,single-choice,spatial-relational,4|5,7,4/5,220540,4
1,1,22,541,1,939,1,13,6,6,7,single-choice,spatial-relational,6|7,7,6/7,220541,6
1,1,22,542,1,1339,2,8,3,3,5,single-choice,spatial-relational,3|5,7,3/5,220542,3
1,1,22,543,0,1742,1,9,4,5,5,single-choice,spatial-relational,4|5,7,4/5,220543,4
1,1,22,544,1,1132,2,6,2,2,4,single-choice,spatial-relational,2|4,7,2/4,220544,2
1,1,22,545,0,1358,2,8,3,5,5,single-choice,spatial-relational,3|5,7,3/5,220545,3
1,1,22,546,0,1711,3,11,4,7,7,single-choice,spatial-relational,4|7,7,4/7,220546,4
1,1,22,547,1,947,3,7,2,2,5,single-choice,spatial-relational,2|5,7,2/5,220547,2
1,1,22,548,1,845,3,7,2,2,5,single-choice,spatial-relational,2|5,7,2/5,220548,2
1,1,22,549,1,980,1,11,5,5,6,single-choice,spatial-relational,5|6,7,5/6,220549,5
1,1,22,550,1,1033,3,11,4,4,7,single-choice,spatial-relational,4|7,7,4/7,220550,4
1,1,22,551,1,1437,5,9,2,2,7,single-choice,spatial-relational,2|7,7,2/7,220551,2
1,1,22,552,1,1039,5,7,1,1,6,single-choice,spatial-relational,1|6,7,1/6,220552,1
1,1,22,553,0,1221,3,9,3,6,6,single-choice,spatial-relational,3|6,7,3/6,220553,3
1,1,22,554,1,940,4,6,1,1,5,single-choice,spatial-relational,1|5,7,1/5,220554,1
1,1,22,555,1,794,2,4,1,1,3,single-choice,spatial-relational,1|3,7,1/3,220555,1
1,1,22,556,1,1156,1,9,4,4,5,single-choice,spatial-relational,4|5,7,4/5,220556,4
1,1,22,557,0,871,2,4,1,3,3,single-choice,spatial-relational,1|3,7,1/3,220557,1
1,1,22,558,1,845,1,7,3,3,4,single-choice,spatial-relational,3|4,7,3/4,220558,3
1,1,22,559,1,947,5,7,1,1,6,single-choice,spatial-relational,1|6,7,1/6,220559,1
1,1,22,560,1,890,1,3,1,1,2,single-choice,spatial-relational,1|2,7,1/2,220560,1
1,1,22,561,0,1052,2,8,3,5,5,single-choice,spatial-relational,3|5,7,3/5,220561,3
1,1,22,562,1,979,5,9,2,2,7,single-choice,spatial-relational,2|7,7,2/7,220562,2
1,1,22,563,1,994,4,8,2,2,6,single-choice,spatial-relational,2|6,7,2/6,220563,2
1,1,22,564,0,1038,1,9,4,5,5,single-choice,spatial-relational,4|5,7,4/5,220564,4
1,1,22,565,1,847,1,3,1,1,2,single-choice,spatial-relational,1|2,7,1/2,220565,1
1,1,22,566,1,805,2,6,2,2,4,single-choice,spatial-relational,2|4,7,2/4,220566,2
1,1,22,567,0,1019,1,5,2,3,3,single-choice,spatial-relational,2|3,7,2/3,220567,2
1,1,22,568,0,1228,1,11,5,6,6,single-choice,spatial-relational,5|6,7,5/6,220568,5
1,1,22,569,1,893,1,7,3,3,4,single-choice,spatial-relational,3|4,7,3/4,220569,3
1,1,22,570,1,1015,1,5,2,2,3,single-choice,spatial-relational,2|3,7,2/3,220570,2
1,1,22,571,1,880,3,5,1,1,4,single-choice,spatial-relational,1|4,7,1/4,220571,1
1,1,22,572,1,1368,4,10,3,3,7,single-choice,spatial-relational,3|7,7,3/7,220572,3
1,1,22,573,1,825,3,5,1,1,4,single-choice,spatial-relational,1|4,7,1/4,220573,1
1,1,22,574,1,1342,2,10,4,4,6,single-choice,spatial-relational,4|6,7,4/6,220574,4
1,1,22,575,1,944,2,6,2,2,4,single-choice,spatial-relational,2|4,7,2/4,220575,2
1,1,22,576,0,736,2,8,3,5,5,single-choice,spatial-relational,3|5,7,3/5,220576,3
1,1,22,577,1,1594,1,13,6,6,7,single-choice,spatial-relational,6|7,7,6/7,220577,6
1,1,22,578,0,1012,3,9,3,6,6,single-choice,spatial-relational,3|6,7,3/6,220578,3
1,1,22,579,1,925,4,6,1,1,5,single-choice,spatial-relational,1|5,7,1/5,220579,1
1,1,22,580,1,1229,2,10,4,4,6,single-choice,spatial-relational,4|6,7,4/6,220580,4
1,1,22,581,1,746,2,12,5,5,7,single-choice,spatial-relational,5|7,7,5/7,220581,5
1,1,22,582,1,1393,4,8,2,2,6,single-choice,spatial-relational,2|6,7,2/6,220582,2
1,1,22,583,1,784,2,12,5,5,7,single-choice,spatial-relational,5|7,7,5/7,220583,5
1,1,22,584,1,1193,3,11,4,4,7,single-choice,spatial-relational,4|7,7,4/7,220584,4
1,1,22,585,1,1073,6,8,1,1,7,single-choice,spatial-relational,1|7,7,1/7,220585,1
1,1,22,586,1,745,6,8,1,1,7,single-choice,spatial-relational,1|7,7,1/7,220586,1
1,1,22,587,0,894,4,10,3,7,7,single-choice,spatial-relational,3|7,7,3/7,220587,3
1,1,22,588,1,867,1,13,6,6,7,single-choice,spatial-relational,6|7,7,6/7,220588,6
1,1,22,589,1,995,1,9,4,4,5,single-choice,spatial-relational,4|5,7,4/5,220589,4
1,1,22,590,1,884,4,6,1,1,5,single-choice,spatial-relational,1|5,7,1/5,220590,1
1,1,22,591,0,1359,1,13,6,7,7,single-choice,spatial-relational,6|7,7,6/7,220591,6
1,1,22,592,1,1011,3,7,2,2,5,single-choice,spatial-relational,2|5,7,2/5,220592,2
1,1,22,593,1,881,2,4,1,1,3,single-choice,spatial-relational,1|3,7,1/3,220593,1
1,1,22,594,1,969,3,7,2,2,5,single-choice,spatial-relational,2|5,7,2/5,220594,2
1,1,22,595,1,1020,5,7,1,1,6,single-choice,spatial-relational,1|6,7,1/6,220595,1
1,1,22,596,1,1058,1,11,5,5,6,single-choice,spatial-relational,5|6,7,5/6,220596,5
1,1,22,597,1,999,1,5,2,2,3,single-choice,spatial-relational,2|3,7,2/3,220597,2
1,1,22,598,1,704,3,9,3,3,6,single-choice,spatial-relational,3|6,7,3/6,220598,3
1,1,22,599,1,859,2,10,4,4,6,single-choice,spatial-relational,4|6,7,4/6,220599,4
1,1,22,600,0,846,2,8,3,5,5,single-choice,spatial-relational,3|5,7,3/5,220600,3
2,1,22,1,0,2664,2,8,3,5,5,single-choice,spatial-relational,3|5,7,3/5,220001,3
2,1,22,2,0,783,4,6,1,5,5,single-choice,spatial-relational,1|5,7,1/5,220002,1
2,1,22,3,1,943,3,7,2,2,5,single-choice,spatial-relational,2|5,7,2/5,220003,2
2,1,22,4,1,636,5,9,2,2,7,single-choice,spatial-relational,2|7,7,2/7,220004,2
2,1,22,5,0,486,1,9,4,5,5,single-choice,spatial-relational,4|5,7,4/5,220005,4
2,1,22,6,1,1063,3,5,1,1,4,single-choice,spatial-relational,1|4,7,1/4,220006,1
2,1,22,7,0,1226,1,5,2,3,3,single-choice,spatial-relational,2|3,7,2/3,220007,2
2,1,22,8,0,1026,3,11,4,7,7,single-choice,spatial-relational,4|7,7,4/7,220008,4
2,1,22,9,1,945,1,13,6,6,7,single-choice,spatial-relational,6|7,7,6/7,220009,6
2,1,22,10,0,14,2,12,5,7,7,single-choice,spatial-relational,5|7,7,5/7,220010,5
2,1,22,11,1,422,3,9,3,3,6,single-choice,spatial-relational,3|6,7,3/6,220011,3
2,1,22,12,1,861,2,6,2,2,4,single-choice,spatial-relational,2|4,7,2/4,220012,2
2,1,22,13,0,26,5,7,1,6,6,single-choice,spatial-relational,1|6,7,1/6,220013,1
2,1,22,14,0,1088,2,10,4,6,6,single-choice,spatial-relational,4|6,7,4/6,220014,4
2,1,22,15,1,790,2,6,2,2,4,single-choice,spatial-relational,2|4,7,2/4,220015,2
2,1,22,16,1,961,1,13,6,6,7,single-choice,spatial-relational,6|7,7,6/7,220016,6
2,1,22,17,0,15,3,7,2,5,5,single-choice,spatial-relational,2|5,7,2/5,220017,2
2,1,22,18,1,472,3,5,1,1,4,single-choice,spatial-relational,1|4,7,1/4,220018,1
2,1,22,19,1,951,2,8,3,3,5,single-choice,spatial-relational,3|5,7,3/5,220019,3
2,1,22,20,0,543,4,8,2,6,6,single-choice,spatial-relational,2|6,7,2/6,220020,2
2,1,22,21,1,1067,5,7,1,1,6,single-choice,spatial-relational,1|6,7,1/6,220021,1
2,1,22,22,1,14,4,8,2,2,6,single-choice,spatial-relational,2|6,7,2/6,220022,2
2,1,22,23,1,19,2,4,1,1,3,single-choice,spatial-relational,1|3,7,1/3,220023,1
2,1,22,24,0,15,3,9,3,6,6,single-choice,spatial-relational,3|6,7,3/6,220024,3
2,1,22,25,1,1019,2,10,4,4,6,single-choice,spatial-relational,4|6,7,4/6,220025,4
2,1,22,26,0,5,1,11,5,6,6,single-choice,spatial-relational,5|6,7,5/6,220026,5
2,1,22,27,0,983,6,8,1,7,7,single-choice,spatial-relational,1|7,7,1/7,220027,1
2,1,22,28,1,49,2,12,5,5,7,single-choice,spatial-relational,5|7,7,5/7,220028,5
2,1,22,29,0,1624,1,7,3,4,4,single-choice,spatial-relational,3|4,7,3/4,220029,3
2,1,22,30,1,11,1,9,4,4,5,single-choice,spatial-relational,4|5,7,4/5,220030,4
2,1,22,31,1,923,1,5,2,2,3,single-choice,spatial-relational,2|3,7,2/3,220031,2
2,1,22,32,1,1102,1,11,5,5,6,single-choice,spatial-relational,5|6,7,5/6,220032,5
2,1,22,33,1,1095,1,7,3,3,4,single-choice,spatial-relational,3|4,7,3/4,220033,3
2,1,22,34,0,1110,5,9,2,7,7,single-choice,spatial-relational,2|7,7,2/7,220034,2
2,1,22,35,0,745,4,6,1,5,5,single-choice,spatial-relational,1|5,7,1/5,220035,1
2,1,22,36,1,2,3,11,4,4,7,single-choice,spatial-relational,4|7,7,4/7,220036,4
2,1,22,37,1,797,4,10,3,3,7,single-choice,spatial-relational,3|7,7,3/7,220037,3
2,1,22,38,1,879,4,10,3,3,7,single-choice,spatial-relational,3|7,7,3/7,220038,3
2,1,22,39,1,1009,2,4,1,1,3,single-choice,spatial-relational,1|3,7,1/3,220039,1
2,1,22,40,1,806,1,3,1,1,2,single-choice,spatial-relational,1|2,7,1/2,220040,1
2,1,22,41,0,707,1,3,1,2,2,single-choice,spatial-relational,1|2,7,1/2,220041,1
2,1,22,42,1,6,6,8,1,1,7,single-choice,spatial-relational,1|7,7,1/7,220042,1
2,1,22,43,1,20,5,9,2,2,7,single-choice,spatial-relational,2|7,7,2/7,220043,2
2,1,22,44,0,841,6,8,1,7,7,single-choice,spatial-relational,1|7,7,1/7,220044,1
2,1,22,45,1,894,3,5,1,1,4,single-choice,spatial-relational,1|4,7,1/4,220045,1
2,1,22,46,0,1062,1,9,4,5,5,single-choice,spatial-relational,4|5,7,4/5,220046,4
2,1,22,47,1,1064,1,5,2,2,3,single-choice,spatial-relational,2|3,7,2/3,220047,2
2,1,22,48,1,1378,2,6,2,2,4,single-choice,spatial-relational,2|4,7,2/4,220048,2
2,1,22,49,1,830,4,8,2,2,6,single-choice,spatial-relational,2|6,7,2/6,220049,2
2,1,22,50,0,849,1,11,5,6,6,single-choice,spatial-relational,5|6,7,5/6,220050,5
2,1,22,51,1,1044,3,9,3,3,6,single-choice,spatial-relational,3|6,7,3/6,220051,3
2,1,22,52,1,980,5,7,1,1,6,single-choice,spatial-relational,1|6,7,1/6,220052,1
2,1,22,53,1,957,3,11,4,4,7,single-choice,spatial-relational,4|7,7,4/7,220053,4
2,1,22,54,1,897,1,7,3,3,4,single-choice,spatial-relational,3|4,7,3/4,220054,3
2,1,22,55,0,926,1,3,1,2,2,single-choice,spatial-relational,1|2,7,1/2,220055,1
2,1,22,56,1,900,3,11,4,4,7,single-choice,spatial-relational,4|7,7,4/7,220056,4
2,1,22,57,1,1196,1,9,4,4,5,single-choice,spatial-relational,4|5,7,4/5,220057,4
2,1,22,58,1,1238,5,7,1,1,6,single-choice,spatial-relational,1|6,7,1/6,220058,1
2,1,22,59,1,1003,3,7,2,2,5,single-choice,spatial-relational,2|5,7,2/5,220059,2
2,1,22,60,1,1757,4,10,3,3,7,single-choice,spatial-relational,3|7,7,3/7,220060,3
2,1,22,61,1,947,5,9,2,2,7,single-choice,spatial-relational,2|7,7,2/7,220061,2
2,1,22,62,1,815,2,6,2,2,4,single-choice,spatial-relational,2|4,7,2/4,220062,2
2,1,22,63,1,899,2,10,4,4,6,single-choice,spatial-relational,4|6,7,4/6,220063,4
2,1,22,64,1,771,1,13,6,6,7,single-choice,spatial-relational,6|7,7,6/7,220064,6
2,1,22,65,1,1107,6,8,1,1,7,single-choice,spatial-relational,1|7,7,1/7,220065,1
2,1,22,66,1,795,1,11,5,5,6,single-choice,spatial-relational,5|6,7,5/6,220066,5
2,1,22,67,1,1215,4,10,3,3,7,single-choice,spatial-relational,3|7,7,3/7,220067,3
2,1,22,68,0,791,2,4,1,3,3,single-choice,spatial-relational,1|3,7,1/3,220068,1
2,1,22,69,1,1296,3,9,3,3,6,single-choice,spatial-relational,3|6,7,3/6,220069,3
2,1,22,70,1,1064,1,5,2,2,3,single-choice,spatial-relational,2|3,7,2/3,220070,2
2,1,22,71,0,823,2,8,3,5,5,single-choice,spatial-relational,3|5,7,3/5,220071,3
2,1,22,72,0,16,2,10,4,6,6,single-choice,spatial-relational,4|6,7,4/6,220072,4
2,1,22,73,1,917,2,4,1,1,3,single-choice,spatial-relational,1|3,7,1/3,220073,1
2,1,22,74,1,772,2,12,5,5,7,single-choice,spatial-relational,5|7,7,5/7,220074,5
2,1,22,75,0,863,3,5,1,4,4,single-choice,spatial-relational,1|4,7,1/4,220075,1
2,1,22,76,1,887,1,13,6,6,7,single-choice,spatial-relational,6|7,7,6/7,220076,6
2,1,22,77,0,1050,4,6,1,5,5,single-choice,spatial-relational,1|5,7,1/5,220077,1
2,1,22,78,1,1205,2,8,3,3,5,single-choice,spatial-relational,3|5,7,3/5,220078,3
2,1,22,79,0,746,1,3,1,2,2,single-choice,spatial-relational,1|2,7,1/2,220079,1
2,1,22,80,1,1368,2,12,5,5,7,single-choice,spatial-relational,5|7,7,5/7,220080,5
2,1,22,81,0,959,1,7,3,4,4,single-choice,spatial-relational,3|4,7,3/4,220081,3
2,1,22,82,0,803,4,6,1,5,5,single-choice,spatial-relational,1|5,7,1/5,220082,1
2,1,22,83,1,2030,4,8,2,2,6,single-choice,spatial-relational,2|6,7,2/6,220083,2
2,1,22,84,1,933,3,7,2,2,5,single-choice,spatial-relational,2|5,7,2/5,220084,2
2,1,22,85,1,834,5,7,1,1,6,single-choice,spatial-relational,1|6,7,1/6,220085,1
2,1,22,86,1,778,3,5,1,1,4,single-choice,spatial-relational,1|4,7,1/4,220086,1
2,1,22,87,1,897,4,10,3,3,7,single-choice,spatial-relational,3|7,7,3/7,220087,3
2,1,22,88,1,5283,5,9,2,2,7,single-choice,spatial-relational,2|7,7,2/7,220088,2
2,1,22,89,1,814,2,12,5,5,7,single-choice,spatial-relational,5|7,7,5/7,220089,5
2,1,22,90,0,1060,4,8,2,6,6,single-choice,spatial-relational,2|6,7,2/6,220090,2
2,1,22,91,1,1008,1,7,3,3,4,single-choice,spatial-relational,3|4,7,3/4,220091,3
2,1,22,92,1,954,1,9,4,4,5,single-choice,spatial-relational,4|5,7,4/5,220092,4
2,1,22,93,1,1085,3,5,1,1,4,single-choice,spatial-relational,1|4,7,1/4,220093,1
2,1,22,94,1,691,4,6,1,1,5,single-choice,spatial-relational,1|5,7,1/5,220094,1
2,1,22,95,1,757,1,9,4,4,5,single-choice,spatial-relational,4|5,7,4/5,220095,4
2,1,22,96,0,685,2,4,1,3,3,single-choice,spatial-relational,1|3,7,1/3,220096,1
2,1,22,97,1,790,2,10,4,4,6,single-choice,spatial-relational,4|6,7,4/6,220097,4
2,1,22,98,0,905,2,6,2,4,4,single-choice,spatial-relational,2|4,7,2/4,220098,2
2,1,22,99,1,943,1,13,6,6,7,single-choice,spatial-relational,6|7,7,6/7,220099,6
2,1,22,100,0,1142,3,7,2,5,5,single-choice,spatial-relational,2|5,7,2/5,220100,2
2,1,22,101,1,983,6,8,1,1,7,single-choice,spatial-relational,1|7,7,1/7,220101,1
2,1,22,102,1,969,3,9,3,3,6,single-choice,spatial-relational,3|6,7,3/6,220102,3
2,1,22,103,0,1020,3,7,2,5,5,single-choice,spatial-relational,2|5,7,2/5,220103,2
2,1,22,104,0,1194,1,11,5,6,6,single-choice,spatial-relational,5|6,7,5/6,220104,5
2,1,22,105,1,917,5,7,1,1,6,single-choice,spatial-relational,1|6,7,1/6,220105,1
2,1,22,106,1,994,6,8,1,1,7,single-choice,spatial-relational,1|7,7,1/7,220106,1
2,1,22,107,1,736,1,13,6,6,7,single-choice,spatial-relational,6|7,7,6/7,220107,6
2,1,22,108,1,722,3,11,4,4,7,single-choice,spatial-relational,4|7,7,4/7,220108,4
2,1,22,109,1,1291,2,6,2,2,4,single-choice,spatial-relational,2|4,7,2/4,220109,2
2,1,22,110,1,732,3,11,4,4,7,single-choice,spatial-relational,4|7,7,4/7,220110,4
2,1,22,111,1,850,1,5,2,2,3,single-choice,spatial-relational,2|3,7,2/3,220111,2
2,1,22,112,1,677,1,3,1,1,2,single-choice,spatial-relational,1|2,7,1/2,220112,1
2,1,22,113,1,1816,2,8,3,3,5,single-choice,spatial-relational,3|5,7,3/5,220113,3
2,1,22,114,1,1182,1,5,2,2,3,single-choice,spatial-relational,2|3,7,2/3,220114,2
2,1,22,115,1,903,4,10,3,3,7,single-choice,spatial-relational,3|7,7,3/7,220115,3
2,1,22,116,1,1189,4,6,1,1,5,single-choice,spatial-relational,1|5,7,1/5,220116,1
2,1,22,117,1,871,5,9,2,2,7,single-choice,spatial-relational,2|7,7,2/7,220117,2
2,1,22,118,0,837,3,9,3,6,6,single-choice,spatial-relational,3|6,7,3/6,220118,3
2,1,22,119,0,994,2,10,4,6,6,single-choice,spatial-relational,4|6,7,4/6,220119,4
2,1,22,120,1,786,1,7,3,3,4,single-choice,spatial-relational,3|4,7,3/4,220120,3
2,1,22,121,1,941,2,8,3,3,5,single-choice,spatial-relational,3|5,7,3/5,220121,3
2,1,22,122,0,805,1,3,1,2,2,single-choice,spatial-relational,1|2,7,1/2,220122,1
2,1,22,123,1,885,4,8,2,2,6,single-choice,spatial-relational,2|6,7,2/6,220123,2
2,1,22,124,1,1305,1,11,5,5,6,single-choice,spatial-relational,5|6,7,5/6,220124,5
2,1,22,125,1,1050,2,4,1,1,3,single-choice,spatial-relational,1|3,7,1/3,220125,1
2,1,22,126,1,1119,2,12,5,5,7,single-choice,spatial-relational,5|7,7,5/7,220126,5
2,1,22,127,1,1525,5,9,2,2,7,single-choice,spatial-relational,2|7,7,2/7,220127,2
2,1,22,128,1,803,2,6,2,2,4,single-choice,spatial-relational,2|4,7,2/4,220128,2
2,1,22,129,0,1690,1,7,3,4,4,single-choice,spatial-relational,3|4,7,3/4,220129,3
2,1,22,130,0,956,2,12,5,7,7,single-choice,spatial-relational,5|7,7,5/7,220130,5
2,1,22,131,1,985,3,7,2,2,5,single-choice,spatial-relational,2|5,7,2/5,220131,2
2,1,22,132,1,1245,1,9,4,4,5,single-choice,spatial-relational,4|5,7,4/5,220132,4
2,1,22,133,0,1041,2,10,4,6,6,single-choice,spatial-relational,4|6,7,4/6,220133,4
2,1,22,134,1,792,4,6,1,1,5,single-choice,spatial-relational,1|5,7,1/5,220134,1
2,1,22,135,1,858,6,8,1,1,7,single-choice,spatial-relational,1|7,7,1/7,220135,1
2,1,22,136,1,942,3,5,1,1,4,single-choice,spatial-relational,1|4,7,1/4,220136,1
2,1,22,137,1,898,1,5,2,2,3,single-choice,spatial-relational,2|3,7,2/3,220137,2
2,1,22,138,1,1044,2,10,4,4,6,single-choice,spatial-relational,4|6,7,4/6,220138,4
2,1,22,139,1,932,3,5,1,1,4,single-choice,spatial-relational,1|4,7,1/4,220139,1
2,1,22,140,1,735,1,11,5,5,6,single-choice,spatial-relational,5|6,7,5/6,220140,5
2,1,22,141,0,879,2,8,3,5,5,single-choice,spatial-relational,3|5,7,3/5,220141,3
2,1,22,142,1,1230,1,11,5,5,6,single-choice,spatial-relational,5|6,7,5/6,220142,5
2,1,22,143,1,977,3,7,2,2,5,single-choice,spatial-relational,2|5,7,2/5,220143,2
2,1,22,144,1,981,1,3,1,1,2,single-choice,spatial-relational,1|2,7,1/2,220144,1
2,1,22,145,1,1023,1,5,2,2,3,single-choice,spatial-relational,2|3,7,2/3,220145,2
2,1,22,146,1,1610,2,8,3,3,5,single-choice,spatial-relational,3|5,7,3/5,220146,3
2,1,22,147,0,940,5,7,1,6,6,single-choice,spatial-relational,1|6,7,1/6,220147,1
2,1,22,148,1,799,4,6,1,1,5,single-choice,spatial-relational,1|5,7,1/5,220148,1
2,1,22,149,1,1311,4,10,3,3,7,single-choice,spatial-relational,3|7,7,3/7,220149,3
2,1,22,150,1,1118,3,9,3,3,6,single-choice,spatial-relational,3|6,7,3/6,220150,3
2,1,22,151,0,825,5,7,1,6,6,single-choice,spatial-relational,1|6,7,1/6,220151,1
2,1,22,152,0,1233,1,7,3,4,4,single-choice,spatial-relational,3|4,7,3/4,220152,3
2,1,22,153,1,1275,1,13,6,6,7,single-choice,spatial-relational,6|7,7,6/7,220153,6
2,1,22,154,1,1411,4,8,2,2,6,single-choice,spatial-relational,2|6,7,2/6,220154,2
2,1,22,155,1,846,4,8,2,2,6,single-choice,spatial-relational,2|6,7,2/6,220155,2
2,1,22,156,0,1091,4,10,3,7,7,single-choice,spatial-relational,3|7,7,3/7,220156,3
2,1,22,157,1,952,3,9,3,3,6,single-choice,spatial-relational,3|6,7,3/6,220157,3
2,1,22,158,1,869,6,8,1,1,7,single-choice,spatial-relational,1|7,7,1/7,220158,1
2,1,22,159,1,1446,1,13,6,6,7,single-choice,spatial-relational,6|7,7,6/7,220159,6
2,1,22,160,1,823,1,3,1,1,2,single-choice,spatial-relational,1|2,7,1/2,220160,1
2,1,22,161,0,1129,2,12,5,7,7,single-choice,spatial-relational,5|7,7,5/7,220161,5
2,1,22,162,1,866,3,11,4,4,7,single-choice,spatial-relational,4|7,7,4/7,220162,4
2,1,22,163,1,909,1,9,4,4,5,single-choice,spatial-relational,4|5,7,4/5,220163,4
2,1,22,164,0,923,2,4,1,3,3,single-choice,spatial-relational,1|3,7,1/3,220164,1
2,1,22,165,0,1635,5,9,2,7,7,single-choice,spatial-relational,2|7,7,2/7,220165,2
2,1,22,166,0,1375,3,11,4,7,7,single-choice,spatial-relational,4|7,7,4/7,220166,4
2,1,22,167,1,863,2,6,2,2,4,single-choice,spatial-relational,2|4,7,2/4,220167,2
2,1,22,168,1,899,2,4,1,1,3,single-choice,spatial-relational,1|3,7,1/3,220168,1
2,1,22,169,1,859,2,6,2,2,4,single-choice,spatial-relational,2|4,7,2/4,220169,2
2,1,22,170,1,957,1,11,5,5,6,single-choice,spatial-relational,5|6,7,5/6,220170,5
2,1,22,171,0,1648,1,7,3,4,4,single-choice,spatial-relational,3|4,7,3/4,220171,3
2,1,22,172,0,1272,3,7,2,5,5,single-choice,spatial-relational,2|5,7,2/5,220172,2
2,1,22,173,0,1665,2,12,5,7,7,single-choice,spatial-relational,5|7,7,5/7,220173,5
2,1,22,174,1,1245,4,10,3,3,7,single-choice,spatial-relational,3|7,7,3/7,220174,3
2,1,22,175,1,961,4,6,1,1,5,single-choice,spatial-relational,1|5,7,1/5,220175,1
2,1,22,176,1,870,1,5,2,2,3,single-choice,spatial-relational,2|3,7,2/3,220176,2
2,1,22,177,1,836,1,5,2,2,3,single-choice,spatial-relational,2|3,7,2/3,220177,2
2,1,22,178,1,928,5,7,1,1,6,single-choice,spatial-relational,1|6,7,1/6,220178,1
2,1,22,179,1,1477,2,8,3,3,5,single-choice,spatial-relational,3|5,7,3/5,220179,3
2,1,22,180,1,806,4,6,1,1,5,single-choice,spatial-relational,1|5,7,1/5,220180,1
2,1,22,181,1,931,6,8,1,1,7,single-choice,spatial-relational,1|7,7,1/7,220181,1
2,1,22,182,1,837,2,4,1,1,3,single-choice,spatial-relational,1|3,7,1/3,220182,1
2,1,22,183,1,972,3,9,3,3,6,single-choice,spatial-relational,3|6,7,3/6,220183,3
2,1,22,184,1,1608,5,9,2,2,7,single-choice,spatial-relational,2|7,7,2/7,220184,2
2,1,22,185,0,1257,1,11,5,6,6,single-choice,spatial-relational,5|6,7,5/6,220185,5
2,1,22,186,1,1336,1,9,4,4,5,single-choice,spatial-relational,4|5,7,4/5,220186,4
2,1,22,187,1,1290,1,9,4,4,5,single-choice,spatial-relational,4|5,7,4/5,220187,4
2,1,22,188,1,1371,1,7,3,3,4,single-choice,spatial-relational,3|4,7,3/4,220188,3
2,1,22,189,1,1183,5,7,1,1,6,single-choice,spatial-relational,1|6,7,1/6,220189,1
2,1,22,190,1,666,1,13,6,6,7,single-choice,spatial-relational,6|7,7,6/7,220190,6
2,1,22,191,1,886,3,5,1,1,4,single-choice,spatial-relational,1|4,7,1/4,220191,1
2,1,22,192,1,1371,3,9,3,3,6,single-choice,spatial-relational,3|6,7,3/6,220192,3
2,1,22,193,1,1264,6,8,1,1,7,single-choice,spatial-relational,1|7,7,1/7,220193,1
2,1,22,194,1,893,1,3,1,1,2,single-choice,spatial-relational,1|2,7,1/2,220194,1
2,1,22,195,1,1003,4,8,2,2,6,single-choice,spatial-relational,2|6,7,2/6,220195,2
2,1,22,196,1,1093,2,10,4,4,6,single-choice,spatial-relational,4|6,7,4/6,220196,4
2,1,22,197,0,1314,4,8,2,6,6,single-choice,spatial-relational,2|6,7,2/6,220197,2
2,1,22,198,1,1591,3,11,4,4,7,single-choice,spatial-relational,4|7,7,4/7,220198,4
2,1,22,199,0,1080,3,7,2,5,5,single-choice,spatial-relational,2|5,7,2/5,220199,2
2,1,22,200,1,1363,1,13,6,6,7,single-choice,spatial-relational,6|7,7,6/7,220200,6
2,1,22,201,1,1066,5,9,2,2,7,single-choice,spatial-relational,2|7,7,2/7,220201,2
2,1,22,202,1,1523,4,10,3,3,7,single-choice,spatial-relational,3|7,7,3/7,220202,3
2,1,22,203,1,853,2,4,1,1,3,single-choice,spatial-relational,1|3,7,1/3,220203,1
2,1,22,204,1,838,2,6,2,2,4,single-choice,spatial-relational,2|4,7,2/4,220204,2
2,1,22,205,1,795,3,5,1,1,4,single-choice,spatial-relational,1|4,7,1/4,220205,1
2,1,22,206,0,956,2,10,4,6,6,single-choice,spatial-relational,4|6,7,4/6,220206,4
2,1,22,207,1,721,1,3,1,1,2,single-choice,spatial-relational,1|2,7,1/2,220207,1
2,1,22,208,0,1215,2,12,5,7,7,single-choice,spatial-relational,5|7,7,5/7,220208,5
2,1,22,209,0,80,3,11,4,7,7,single-choice,spatial-relational,4|7,7,4/7,220209,4
2,1,22,210,0,941,2,8,3,5,5,single-choice,spatial-relational,3|5,7,3/5,220210,3
2,1,22,211,1,1052,3,7,2,2,5,single-choice,spatial-relational,2|5,7,2/5,220211,2
2,1,22,212,1,914,1,5,2,2,3,single-choice,spatial-relational,2|3,7,2/3,220212,2
2,1,22,213,1,1242,4,10,3,3,7,single-choice,spatial-relational,3|7,7,3/7,220213,3
2,1,22,214,1,842,1,13,6,6,7,single-choice,spatial-relational,6|7,7,6/7,220214,6
2,1,22,215,1,893,3,5,1,1,4,single-choice,spatial-relational,1|4,7,1/4,220215,1
2,1,22,216,1,1440,4,8,2,2,6,single-choice,spatial-relational,2|6,7,2/6,220216,2
2,1,22,217,1,1163,5,7,1,1,6,single-choice,spatial-relational,1|6,7,1/6,220217,1
2,1,22,218,1,1225,3,9,3,3,6,single-choice,spatial-relational,3|6,7,3/6,220218,3
2,1,22,219,1,988,1,3,1,1,2,single-choice,spatial-relational,1|2,7,1/2,220219,1
2,1,22,220,1,1005,5,7,1,1,6,single-choice,spatial-relational,1|6,7,1/6,220220,1
2,1,22,221,1,1198,4,8,2,2,6,single-choice,spatial-relational,2|6,7,2/6,220221,2
2,1,22,222,1,848,6,8,1,1,7,single-choice,spatial-relational,1|7,7,1/7,220222,1
2,1,22,223,1,95,3,11,4,4,7,single-choice,spatial-relational,4|7,7,4/7,220223,4
2,1,22,224,0,953,1,7,3,4,4,single-choice,spatial-relational,3|4,7,3/4,220224,3
2,1,22,225,1,1091,1,9,4,4,5,single-choice,spatial-relational,4|5,7,4/5,220225,4
2,1,22,226,1,1050,4,10,3,3,7,single-choice,spatial-relational,3|7,7,3/7,220226,3
2,1,22,227,0,791,5,9,2,7,7,single-choice,spatial-relational,2|7,7,2/7,220227,2
2,1,22,228,1,886,2,4,1,1,3,single-choice,spatial-relational,1|3,7,1/3,220228,1
2,1,22,229,1,863,4,6,1,1,5,single-choice,spatial-relational,1|5,7,1/5,220229,1
2,1,22,230,1,807,1,3,1,1,2,single-choice,spatial-relational,1|2,7,1/2,220230,1
2,1,22,231,1,1019,2,10,4,4,6,single-choice,spatial-relational,4|6,7,4/6,220231,4
2,1,22,232,0,965,2,8,3,5,5,single-choice,spatial-relational,3|5,7,3/5,220232,3
2,1,22,233,1,1065,2,6,2,2,4,single-choice,spatial-relational,2|4,7,2/4,220233,2
2,1,22,234,1,1035,1,13,6,6,7,single-choice,spatial-relational,6|7,7,6/7,220234,6
2,1,22,235,1,1026,3,5,1,1,4,single-choice,spatial-relational,1|4,7,1/4,220235,1
2,1,22,236,1,1337,2,10,4,4,6,single-choice,spatial-relational,4|6,7,4/6,220236,4
2,1,22,237,1,1392,2,12,5,5,7,single-choice,spatial-relational,5|7,7,5/7,220237,5
2,1,22,238,1,1405,6,8,1,1,7,single-choice,spatial-relational,1|7,7,1/7,220238,1
2,1,22,239,1,732,3,11,4,4,7,single-choice,spatial-relational,4|7,7,4/7,220239,4
2,1,22,240,1,1087,1,11,5,5,6,single-choice,spatial-relational,5|6,7,5/6,220240,5
2,1,22,241,1,983,2,4,1,1,3,single-choice,spatial-relational,1|3,7,1/3,220241,1
2,1,22,242,0,874,1,9,4,5,5,single-choice,spatial-relational,4|5,7,4/5,220242,4
2,1,22,243,1,1474,3,7,2,2,5,single-choice,spatial-relational,2|5,7,2/5,220243,2
2,1,22,244,1,1355,2,12,5,5,7,single-choice,spatial-relational,5|7,7,5/7,220244,5
2,1,22,245,1,1598,1,11,5,5,6,single-choice,spatial-relational,5|6,7,5/6,220245,5
2,1,22,246,1,1007,2,6,2,2,4,single-choice,spatial-relational,2|4,7,2/4,220246,2
2,1,22,247,1,763,4,6,1,1,5,single-choice,spatial-relational,1|5,7,1/5,220247,1
2,1,22,248,1,916,2,8,3,3,5,single-choice,spatial-relational,3|5,7,3/5,220248,3
2,1,22,249,0,1051,1,5,2,3,3,single-choice,spatial-relational,2|3,7,2/3,220249,2
2,1,22,250,1,904,3,9,3,3,6,single-choice,spatial-relational,3|6,7,3/6,220250,3
2,1,22,251,1,1307,5,9,2,2,7,single-choice,spatial-relational,2|7,7,2/7,220251,2
2,1,22,252,1,1152,1,7,3,3,4,single-choice,spatial-relational,3|4,7,3/4,220252,3
2,1,22,253,1,773,4,10,3,3,7,single-choice,spatial-relational,3|7,7,3/7,220253,3
2,1,22,254,0,1843,3,9,3,6,6,single-choice,spatial-relational,3|6,7,3/6,220254,3
2,1,22,255,1,1338,2,12,5,5,7,single-choice,spatial-relational,5|7,7,5/7,220255,5
2,1,22,256,1,865,2,12,5,5,7,single-choice,spatial-relational,5|7,7,5/7,220256,5
2,1,22,257,1,930,1,5,2,2,3,single-choice,spatial-relational,2|3,7,2/3,220257,2
2,1,22,258,1,1068,3,5,1,1,4,single-choice,spatial-relational,1|4,7,1/4,220258,1
2,1,22,259,1,873,5,9,2,2,7,single-choice,spatial-relational,2|7,7,2/7,220259,2
2,1,22,260,1,1060,3,7,2,2,5,single-choice,spatial-relational,2|5,7,2/5,220260,2
2,1,22,261,1,1473,4,10,3,3,7,single-choice,spatial-relational,3|7,7,3/7,220261,3
2,1,22,262,1,841,2,4,1,1,3,single-choice,spatial-relational,1|3,7,1/3,220262,1
2,1,22,263,1,1310,2,4,1,1,3,single-choice,spatial-relational,1|3,7,1/3,220263,1
2,1,22,264,0,690,4,6,1,5,5,single-choice,spatial-relational,1|5,7,1/5,220264,1
2,1,22,265,1,903,1,7,3,3,4,single-choice,spatial-relational,3|4,7,3/4,220265,3
2,1,22,266,0,907,1,11,5,6,6,single-choice,spatial-relational,5|6,7,5/6,220266,5
2,1,22,267,1,1016,3,11,4,4,7,single-choice,spatial-relational,4|7,7,4/7,220267,4
2,1,22,268,0,1357,2,6,2,4,4,single-choice,spatial-relational,2|4,7,2/4,220268,2
2,1,22,269,1,871,1,5,2,2,3,single-choice,spatial-relational,2|3,7,2/3,220269,2
2,1,22,270,0,1190,2,10,4,6,6,single-choice,spatial-relational,4|6,7,4/6,220270,4
2,1,22,271,1,753,4,6,1,1,5,single-choice,spatial-relational,1|5,7,1/5,220271,1
2,1,22,272,1,858,5,9,2,2,7,single-choice,spatial-relational,2|7,7,2/7,220272,2
2,1,22,273,1,1285,1,11,5,5,6,single-choice,spatial-relational,5|6,7,5/6,220273,5
2,1,22,274,1,780,1,3,1,1,2,single-choice,spatial-relational,1|2,7,1/2,220274,1
2,1,22,275,1,973,3,5,1,1,4,single-choice,spatial-relational,1|4,7,1/4,220275,1
2,1,22,276,1,739,3,9,3,3,6,single-choice,spatial-relational,3|6,7,3/6,220276,3
2,1,22,277,1,719,1,13,6,6,7,single-choice,spatial-relational,6|7,7,6/7,220277,6
2,1,22,278,1,1349,2,10,4,4,6,single-choice,spatial-relational,4|6,7,4/6,220278,4
2,1,22,279,1,1650,2,8,3,3,5,single-choice,spatial-relational,3|5,7,3/5,220279,3
2,1,22,280,1,1552,1,7,3,3,4,single-choice,spatial-relational,3|4,7,3/4,220280,3
2,1,22,281,1,883,6,8,1,1,7,single-choice,spatial-relational,1|7,7,1/7,220281,1
2,1,22,282,1,751,3,11,4,4,7,single-choice,spatial-relational,4|7,7,4/7,220282,4
2,1,22,283,1,1191,4,8,2,2,6,single-choice,spatial-relational,2|6,7,2/6,220283,2
2,1,22,284,0,1321,1,9,4,5,5,single-choice,spatial-relational,4|5,7,4/5,220284,4
2,1,22,285,1,975,4,8,2,2,6,single-choice,spatial-relational,2|6,7,2/6,220285,2
2,1,22,286,1,838,6,8,1,1,7,single-choice,spatial-relational,1|7,7,1/7,220286,1
2,1,22,287,1,659,1,13,6,6,7,single-choice,spatial-relational,6|7,7,6/7,220287,6
2,1,22,288,1,976,5,7,1,1,6,single-choice,spatial-relational,1|6,7,1/6,220288,1
2,1,22,289,1,1008,2,8,3,3,5,single-choice,spatial-relational,3|5,7,3/5,220289,3
2,1,22,290,1,1010,1,3,1,1,2,single-choice,spatial-relational,1|2,7,1/2,220290,1
2,1,22,291,1,935,2,6,2,2,4,single-choice,spatial-relational,2|4,7,2/4,220291,2
2,1,22,292,1,1179,5,7,1,1,6,single-choice,spatial-relational,1|6,7,1/6,220292,1
2,1,22,293,1,943,1,9,4,4,5,single-choice,spatial-relational,4|5,7,4/5,220293,4
2,1,22,294,1,1074,3,7,2,2,5,single-choice,spatial-relational,2|5,7,2/5,220294,2
2,1,22,295,1,853,4,10,3,3,7,single-choice,spatial-relational,3|7,7,3/7,220295,3
2,1,22,296,1,937,3,5,1,1,4,single-choice,spatial-relational,1|4,7,1/4,220296,1
2,1,22,297,1,914,4,6,1,1,5,single-choice,spatial-relational,1|5,7,1/5,220297,1
2,1,22,298,1,823,2,12,5,5,7,single-choice,spatial-relational,5|7,7,5/7,220298,5
2,1,22,299,0,1110,1,9,4,5,5,single-choice,spatial-relational,4|5,7,4/5,220299,4
2,1,22,300,1,941,6,8,1,1,7,single-choice,spatial-relational,1|7,7,1/7,220300,1
2,1,22,301,0,930,4,8,2,6,6,single-choice,spatial-relational,2|6,7,2/6,220301,2
2,1,22,302,1,870,5,7,1,1,6,single-choice,spatial-relational,1|6,7,1/6,220302,1
2,1,22,303,1,1152,4,10,3,3,7,single-choice,spatial-relational,3|7,7,3/7,220303,3
2,1,22,304,1,975,3,5,1,1,4,single-choice,spatial-relational,1|4,7,1/4,220304,1
2,1,22,305,0,1023,2,8,3,5,5,single-choice,spatial-relational,3|5,7,3/5,220305,3
2,1,22,306,1,893,2,4,1,1,3,single-choice,spatial-relational,1|3,7,1/3,220306,1
2,1,22,307,1,802,3,11,4,4,7,single-choice,spatial-relational,4|7,7,4/7,220307,4
2,1,22,308,1,873,3,11,4,4,7,single-choice,spatial-relational,4|7,7,4/7,220308,4
2,1,22,309,0,711,5,7,1,6,6,single-choice,spatial-relational,1|6,7,1/6,220309,1
2,1,22,310,1,728,1,13,6,6,7,single-choice,spatial-relational,6|7,7,6/7,220310,6
2,1,22,311,1,1566,2,6,2,2,4,single-choice,spatial-relational,2|4,7,2/4,220311,2
2,1,22,312,1,853,1,5,2,2,3,single-choice,spatial-relational,2|3,7,2/3,220312,2
2,1,22,313,1,855,4,6,1,1,5,single-choice,spatial-relational,1|5,7,1/5,220313,1
2,1,22,314,1,938,1,11,5,5,6,single-choice,spatial-relational,5|6,7,5/6,220314,5
2,1,22,315,1,906,1,3,1,1,2,single-choice,spatial-relational,1|2,7,1/2,220315,1
2,1,22,316,1,1071,1,7,3,3,4,single-choice,spatial-relational,3|4,7,3/4,220316,3
2,1,22,317,1,1195,1,11,5,5,6,single-choice,spatial-relational,5|6,7,5/6,220317,5
2,1,22,318,1,1179,1,5,2,2,3,single-choice,spatial-relational,2|3,7,2/3,220318,2
2,1,22,319,1,1557,2,12,5,5,7,single-choice,spatial-relational,5|7,7,5/7,220319,5
2,1,22,320,1,745,1,13,6,6,7,single-choice,spatial-relational,6|7,7,6/7,220320,6
2,1,22,321,1,1231,3,7,2,2,5,single-choice,spatial-relational,2|5,7,2/5,220321,2
2,1,22,322,1,1057,3,7,2,2,5,single-choice,spatial-relational,2|5,7,2/5,220322,2
2,1,22,323,1,1425,3,9,3,3,6,single-choice,spatial-relational,3|6,7,3/6,220323,3
2,1,22,324,1,1278,3,9,3,3,6,single-choice,spatial-relational,3|6,7,3/6,220324,3
2,1,22,325,1,1088,2,10,4,4,6,single-choice,spatial-relational,4|6,7,4/6,220325,4
2,1,22,326,1,954,5,9,2,2,7,single-choice,spatial-relational,2|7,7,2/7,220326,2
2,1,22,327,0,1004,2,4,1,3,3,single-choice,spatial-relational,1|3,7,1/3,220327,1
2,1,22,328,1,951,6,8,1,1,7,single-choice,spatial-relational,1|7,7,1/7,220328,1
2,1,22,329,1,1637,2,6,2,2,4,single-choice,spatial-relational,2|4,7,2/4,220329,2
2,1,22,330,1,1172,5,9,2,2,7,single-choice,spatial-relational,2|7,7,2/7,220330,2
2,1,22,331,1,1850,4,8,2,2,6,single-choice,spatial-relational,2|6,7,2/6,220331,2
2,1,22,332,1,758,1,9,4,4,5,single-choice,spatial-relational,4|5,7,4/5,220332,4
2,1,22,333,1,2133,2,10,4,4,6,single-choice,spatial-relational,4|6,7,4/6,220333,4
2,1,22,334,1,1103,2,8,3,3,5,single-choice,spatial-relational,3|5,7,3/5,220334,3
2,1,22,335,1,1621,1,7,3,3,4,single-choice,spatial-relational,3|4,7,3/4,220335,3
2,1,22,336,1,869,1,3,1,1,2,single-choice,spatial-relational,1|2,7,1/2,220336,1
2,1,22,337,1,847,1,11,5,5,6,single-choice,spatial-relational,5|6,7,5/6,220337,5
2,1,22,338,1,711,2,12,5,5,7,single-choice,spatial-relational,5|7,7,5/7,220338,5
2,1,22,339,1,805,4,6,1,1,5,single-choice,spatial-relational,1|5,7,1/5,220339,1
2,1,22,340,1,993,3,7,2,2,5,single-choice,spatial-relational,2|5,7,2/5,220340,2
2,1,22,341,1,683,2,12,5,5,7,single-choice,spatial-relational,5|7,7,5/7,220341,5
2,1,22,342,1,1002,4,10,3,3,7,single-choice,spatial-relational,3|7,7,3/7,220342,3
2,1,22,343,0,913,2,8,3,5,5,single-choice,spatial-relational,3|5,7,3/5,220343,3
2,1,22,344,1,937,1,5,2,2,3,single-choice,spatial-relational,2|3,7,2/3,220344,2
2,1,22,345,1,861,3,5,1,1,4,single-choice,spatial-relational,1|4,7,1/4,220345,1
2,1,22,346,0,1289,2,6,2,4,4,single-choice,spatial-relational,2|4,7,2/4,220346,2
2,1,22,347,1,1472,4,8,2,2,6,single-choice,spatial-relational,2|6,7,2/6,220347,2
2,1,22,348,1,944,3,7,2,2,5,single-choice,spatial-relational,2|5,7,2/5,220348,2
2,1,22,349,1,813,3,11,4,4,7,single-choice,spatial-relational,4|7,7,4/7,220349,4
2,1,22,350,1,920,1,5,2,2,3,single-choice,spatial-relational,2|3,7,2/3,220350,2
2,1,22,351,1,910,4,6,1,1,5,single-choice,spatial-relational,1|5,7,1/5,220351,1
2,1,22,352,0,1146,5,9,2,7,7,single-choice,spatial-relational,2|7,7,2/7,220352,2
2,1,22,353,0,1376,1,9,4,5,5,single-choice,spatial-relational,4|5,7,4/5,220353,4
2,1,22,354,1,697,1,13,6,6,7,single-choice,spatial-relational,6|7,7,6/7,220354,6
2,1,22,355,1,1344,6,8,1,1,7,single-choice,spatial-relational,1|7,7,1/7,220355,1
2,1,22,356,1,885,1,7,3,3,4,single-choice,spatial-relational,3|4,7,3/4,220356,3
2,1,22,357,0,836,2,10,4,6,6,single-choice,spatial-relational,4|6,7,4/6,220357,4
2,1,22,358,1,852,2,4,1,1,3,single-choice,spatial-relational,1|3,7,1/3,220358,1
2,1,22,359,1,806,1,13,6,6,7,single-choice,spatial-relational,6|7,7,6/7,220359,6
2,1,22,360,1,1025,6,8,1,1,7,single-choice,spatial-relational,1|7,7,1/7,220360,1
2,1,22,361,1,958,1,9,4,4,5,single-choice,spatial-relational,4|5,7,4/5,220361,4
2,1,22,362,0,756,5,7,1,6,6,single-choice,spatial-relational,1|6,7,1/6,220362,1
2,1,22,363,1,884,1,7,3,3,4,single-choice,spatial-relational,3|4,7,3/4,220363,3
2,1,22,364,1,850,4,10,3,3,7,single-choice,spatial-relational,3|7,7,3/7,220364,3
2,1,22,365,1,1117,5,9,2,2,7,single-choice,spatial-relational,2|7,7,2/7,220365,2
2,1,22,366,1,1123,5,7,1,1,6,single-choice,spatial-relational,1|6,7,1/6,220366,1
2,1,22,367,1,1123,2,6,2,2,4,single-choice,spatial-relational,2|4,7,2/4,220367,2
2,1,22,368,0,1350,3,9,3,6,6,single-choice,spatial-relational,3|6,7,3/6,220368,3
2,1,22,369,1,1181,2,10,4,4,6,single-choice,spatial-relational,4|6,7,4/6,220369,4
2,1,22,370,1,1007,1,3,1,1,2,single-choice,spatial-relational,1|2,7,1/2,220370,1
2,1,22,371,1,1383,3,9,3,3,6,single-choice,spatial-relational,3|6,7,3/6,220371,3
2,1,22,372,0,984,2,8,3,5,5,single-choice,spatial-relational,3|5,7,3/5,220372,3
2,1,22,373,1,797,3,11,4,4,7,single-choice,spatial-relational,4|7,7,4/7,220373,4
2,1,22,374,1,868,4,8,2,2,6,single-choice,spatial-relational,2|6,7,2/6,220374,2
2,1,22,375,1,879,3,5,1,1,4,single-choice,spatial-relational,1|4,7,1/4,220375,1
2,1,22,376,1,859,1,3,1,1,2,single-choice,spatial-relational,1|2,7,1/2,220376,1
2,1,22,377,1,946,1,11,5,5,6,single-choice,spatial-relational,5|6,7,5/6,220377,5
2,1,22,378,1,1095,2,4,1,1,3,single-choice,spatial-relational,1|3,7,1/3,220378,1
2,1,22,379,1,905,2,4,1,1,3,single-choice,spatial-relational,1|3,7,1/3,220379,1
2,1,22,380,1,913,2,12,5,5,7,single-choice,spatial-relational,5|7,7,5/7,220380,5
2,1,22,381,1,952,2,8,3,3,5,single-choice,spatial-relational,3|5,7,3/5,220381,3
2,1,22,382,1,1465,6,8,1,1,7,single-choice,spatial-relational,1|7,7,1/7,220382,1
2,1,22,383,0,1454,4,6,1,5,5,single-choice,spatial-relational,1|5,7,1/5,220383,1
2,1,22,384,1,838,1,3,1,1,2,single-choice,spatial-relational,1|2,7,1/2,220384,1
2,1,22,385,1,1791,1,5,2,2,3,single-choice,spatial-relational,2|3,7,2/3,220385,2
2,1,22,386,0,971,2,10,4,6,6,single-choice,spatial-relational,4|6,7,4/6,220386,4
2,1,22,387,1,1684,6,8,1,1,7,single-choice,spatial-relational,1|7,7,1/7,220387,1
2,1,22,388,1,1087,1,7,3,3,4,single-choice,spatial-relational,3|4,7,3/4,220388,3
2,1,22,389,1,1311,4,10,3,3,7,single-choice,spatial-relational,3|7,7,3/7,220389,3
2,1,22,390,1,986,3,7,2,2,5,single-choice,spatial-relational,2|5,7,2/5,220390,2
2,1,22,391,0,936,1,9,4,5,5,single-choice,spatial-relational,4|5,7,4/5,220391,4
2,1,22,392,1,898,3,9,3,3,6,single-choice,spatial-relational,3|6,7,3/6,220392,3
2,1,22,393,1,938,4,10,3,3,7,single-choice,spatial-relational,3|7,7,3/7,220393,3
2,1,22,394,1,855,5,9,2,2,7,single-choice,spatial-relational,2|7,7,2/7,220394,2
2,1,22,395,1,862,1,5,2,2,3,single-choice,spatial-relational,2|3,7,2/3,220395,2
2,1,22,396,1,840,4,6,1,1,5,single-choice,spatial-relational,1|5,7,1/5,220396,1
2,1,22,397,1,936,3,5,1,1,4,single-choice,spatial-relational,1|4,7,1/4,220397,1
2,1,22,398,1,993,5,7,1,1,6,single-choice,spatial-relational,1|6,7,1/6,220398,1
2,1,22,399,1,880,3,11,4,4,7,single-choice,spatial-relational,4|7,7,4/7,220399,4
2,1,22,400,0,1436,5,9,2,7,7,single-choice,spatial-relational,2|7,7,2/7,220400,2
2,1,22,401,1,985,3,5,1,1,4,single-choice,spatial-relational,1|4,7,1/4,220401,1
2,1,22,402,1,961,2,8,3,3,5,single-choice,spatial-relational,3|5,7,3/5,220402,3
2,1,22,403,0,1083,2,6,2,4,4,single-choice,spatial-relational,2|4,7,2/4,220403,2
2,1,22,404,1,980,1,9,4,4,5,single-choice,spatial-relational,4|5,7,4/5,220404,4
2,1,22,405,0,1134,3,9,3,6,6,single-choice,spatial-relational,3|6,7,3/6,220405,3
2,1,22,406,1,75,3,11,4,4,7,single-choice,spatial-relational,4|7,7,4/7,220406,4
2,1,22,407,1,912,1,13,6,6,7,single-choice,spatial-relational,6|7,7,6/7,220407,6
2,1,22,408,1,730,1,13,6,6,7,single-choice,spatial-relational,6|7,7,6/7,220408,6
2,1,22,409,1,1833,2,10,4,4,6,single-choice,spatial-relational,4|6,7,4/6,220409,4
2,1,22,410,1,991,3,7,2,2,5,single-choice,spatial-relational,2|5,7,2/5,220410,2
2,1,22,411,1,1389,4,8,2,2,6,single-choice,spatial-relational,2|6,7,2/6,220411,2
2,1,22,412,1,902,2,6,2,2,4,single-choice,spatial-relational,2|4,7,2/4,220412,2
2,1,22,413,1,996,4,8,2,2,6,single-choice,spatial-relational,2|6,7,2/6,220413,2
2,1,22,414,1,871,5,7,1,1,6,single-choice,spatial-relational,1|6,7,1/6,220414,1
2,1,22,415,1,714,1,3,1,1,2,single-choice,spatial-relational,1|2,7,1/2,220415,1
2,1,22,416,1,1285,1,11,5,5,6,single-choice,spatial-relational,5|6,7,5/6,220416,5
2,1,22,417,1,795,2,12,5,5,7,single-choice,spatial-relational,5|7,7,5/7,220417,5
2,1,22,418,1,1082,1,11,5,5,6,single-choice,spatial-relational,5|6,7,5/6,220418,5
2,1,22,419,1,1137,1,7,3,3,4,single-choice,spatial-relational,3|4,7,3/4,220419,3
2,1,22,420,1,987,2,4,1,1,3,single-choice,spatial-relational,1|3,7,1/3,220420,1
2,1,22,421,1,1284,3,11,4,4,7,single-choice,spatial-relational,4|7,7,4/7,220421,4
2,1,22,422,1,899,1,11,5,5,6,single-choice,spatial-relational,5|6,7,5/6,220422,5
2,1,22,423,1,1275,2,10,4,4,6,single-choice,spatial-relational,4|6,7,4/6,220423,4
2,1,22,424,0,850,1,3,1,2,2,single-choice,spatial-relational,1|2,7,1/2,220424,1
2,1,22,425,1,1403,3,9,3,3,6,single-choice,spatial-relational,3|6,7,3/6,220425,3
2,1,22,426,1,950,2,4,1,1,3,single-choice,spatial-relational,1|3,7,1/3,220426,1
2,1,22,427,1,877,1,13,6,6,7,single-choice,spatial-relational,6|7,7,6/7,220427,6
2,1,22,428,1,935,2,4,1,1,3,single-choice,spatial-relational,1|3,7,1/3,220428,1
2,1,22,429,1,1001,1,9,4,4,5,single-choice,spatial-relational,4|5,7,4/5,220429,4
2,1,22,430,1,843,1,5,2,2,3,single-choice,spatial-relational,2|3,7,2/3,220430,2
2,1,22,431,1,877,1,7,3,3,4,single-choice,spatial-relational,3|4,7,3/4,220431,3
2,1,22,432,0,698,3,9,3,6,6,single-choice,spatial-relational,3|6,7,3/6,220432,3
2,1,22,433,1,1331,5,9,2,2,7,single-choice,spatial-relational,2|7,7,2/7,220433,2
2,1,22,434,1,36,3,7,2,2,5,single-choice,spatial-relational,2|5,7,2/5,220434,2
2,1,22,435,1,1231,2,6,2,2,4,single-choice,spatial-relational,2|4,7,2/4,220435,2
2,1,22,436,1,902,2,12,5,5,7,single-choice,spatial-relational,5|7,7,5/7,220436,5
2,1,22,437,1,1206,4,10,3,3,7,single-choice,spatial-relational,3|7,7,3/7,220437,3
2,1,22,438,1,897,4,6,1,1,5,single-choice,spatial-relational,1|5,7,1/5,220438,1
2,1,22,439,1,895,4,8,2,2,6,single-choice,spatial-relational,2|6,7,2/6,220439,2
2,1,22,440,1,1005,5,7,1,1,6,single-choice,spatial-relational,1|6,7,1/6,220440,1
2,1,22,441,0,1141,3,5,1,4,4,single-choice,spatial-relational,1|4,7,1/4,220441,1
2,1,22,442,1,938,1,3,1,1,2,single-choice,spatial-relational,1|2,7,1/2,220442,1
2,1,22,443,1,1345,5,7,1,1,6,single-choice,spatial-relational,1|6,7,1/6,220443,1
2,1,22,444,0,1227,1,7,3,4,4,single-choice,spatial-relational,3|4,7,3/4,220444,3
2,1,22,445,1,956,6,8,1,1,7,single-choice,spatial-relational,1|7,7,1/7,220445,1
2,1,22,446,0,889,2,8,3,5,5,single-choice,spatial-relational,3|5,7,3/5,220446,3
2,1,22,447,1,854,4,10,3,3,7,single-choice,spatial-relational,3|7,7,3/7,220447,3
2,1,22,448,1,1088,2,6,2,2,4,single-choice,spatial-relational,2|4,7,2/4,220448,2
2,1,22,449,1,1042,2,8,3,3,5,single-choice,spatial-relational,3|5,7,3/5,220449,3
2,1,22,450,1,1308,2,10,4,4,6,single-choice,spatial-relational,4|6,7,4/6,220450,4
2,1,22,451,1,993,1,5,2,2,3,single-choice,spatial-relational,2|3,7,2/3,220451,2
2,1,22,452,1,1139,1,9,4,4,5,single-choice,spatial-relational,4|5,7,4/5,220452,4
2,1,22,453,1,1374,5,9,2,2,7,single-choice,spatial-relational,2|7,7,2/7,220453,2
2,1,22,454,1,887,6,8,1,1,7,single-choice,spatial-relational,1|7,7,1/7,220454,1
2,1,22,455,1,785,2,12,5,5,7,single-choice,spatial-relational,5|7,7,5/7,220455,5
2,1,22,456,0,1197,4,6,1,5,5,single-choice,spatial-relational,1|5,7,1/5,220456,1
2,1,22,457,1,991,3,5,1,1,4,single-choice,spatial-relational,1|4,7,1/4,220457,1
2,1,22,458,1,951,1,13,6,6,7,single-choice,spatial-relational,6|7,7,6/7,220458,6
2,1,22,459,1,1137,1,11,5,5,6,single-choice,spatial-relational,5|6,7,5/6,220459,5
2,1,22,460,0,1335,3,7,2,5,5,single-choice,spatial-relational,2|5,7,2/5,220460,2
2,1,22,461,1,771,3,11,4,4,7,single-choice,spatial-relational,4|7,7,4/7,220461,4
2,1,22,462,0,1354,4,8,2,6,6,single-choice,spatial-relational,2|6,7,2/6,220462,2
2,1,22,463,1,851,3,7,2,2,5,single-choice,spatial-relational,2|5,7,2/5,220463,2
2,1,22,464,1,890,5,7,1,1,6,single-choice,spatial-relational,1|6,7,1/6,220464,1
2,1,22,465,1,814,4,6,1,1,5,single-choice,spatial-relational,1|5,7,1/5,220465,1
2,1,22,466,1,931,2,6,2,2,4,single-choice,spatial-relational,2|4,7,2/4,220466,2
2,1,22,467,1,873,2,10,4,4,6,single-choice,spatial-relational,4|6,7,4/6,220467,4
2,1,22,468,0,1013,4,8,2,6,6,single-choice,spatial-relational,2|6,7,2/6,220468,2
2,1,22,469,1,815,2,4,1,1,3,single-choice,spatial-relational,1|3,7,1/3,220469,1
2,1,22,470,1,1128,1,11,5,5,6,single-choice,spatial-relational,5|6,7,5/6,220470,5
2,1,22,471,0,929,2,8,3,5,5,single-choice,spatial-relational,3|5,7,3/5,220471,3
2,1,22,472,0,1143,1,9,4,5,5,single-choice,spatial-relational,4|5,7,4/5,220472,4
2,1,22,473,1,1167,1,7,3,3,4,single-choice,spatial-relational,3|4,7,3/4,220473,3
2,1,22,474,1,1425,6,8,1,1,7,single-choice,spatial-relational,1|7,7,1/7,220474,1
2,1,22,475,1,823,3,11,4,4,7,single-choice,spatial-relational,4|7,7,4/7,220475,4
2,1,22,476,1,1336,5,9,2,2,7,single-choice,spatial-relational,2|7,7,2/7,220476,2
2,1,22,477,1,758,4,10,3,3,7,single-choice,spatial-relational,3|7,7,3/7,220477,3
2,1,22,478,1,775,3,11,4,4,7,single-choice,spatial-relational,4|7,7,4/7,220478,4
2,1,22,479,1,1299,5,9,2,2,7,single-choice,spatial-relational,2|7,7,2/7,220479,2
2,1,22,480,1,847,4,6,1,1,5,single-choice,spatial-relational,1|5,7,1/5,220480,1
2,1,22,481,1,927,1,11,5,5,6,single-choice,spatial-relational,5|6,7,5/6,220481,5
2,1,22,482,1,1294,1,7,3,3,4,single-choice,spatial-relational,3|4,7,3/4,220482,3
2,1,22,483,1,811,4,10,3,3,7,single-choice,spatial-relational,3|7,7,3/7,220483,3
2,1,22,484,1,806,3,5,1,1,4,single-choice,spatial-relational,1|4,7,1/4,220484,1
2,1,22,485,1,761,1,3,1,1,2,single-choice,spatial-relational,1|2,7,1/2,220485,1
2,1,22,486,1,1050,6,8,1,1,7,single-choice,spatial-relational,1|7,7,1/7,220486,1
2,1,22,487,1,1223,3,9,3,3,6,single-choice,spatial-relational,3|6,7,3/6,220487,3
2,1,22,488,1,876,2,12,5,5,7,single-choice,spatial-relational,5|7,7,5/7,220488,5
2,1,22,489,1,813,1,13,6,6,7,single-choice,spatial-relational,6|7,7,6/7,220489,6
2,1,22,490,1,1062,1,5,2,2,3,single-choice,spatial-relational,2|3,7,2/3,220490,2
2,1,22,491,1,1154,4,8,2,2,6,single-choice,spatial-relational,2|6,7,2/6,220491,2
2,1,22,492,1,827,1,13,6,6,7,single-choice,spatial-relational,6|7,7,6/7,220492,6
2,1,22,493,1,1188,5,7,1,1,6,single-choice,spatial-relational,1|6,7,1/6,220493,1
2,1,22,494,1,863,2,4,1,1,3,single-choice,spatial-relational,1|3,7,1/3,220494,1
2,1,22,495,1,1144,1,9,4,4,5,single-choice,spatial-relational,4|5,7,4/5,220495,4
2,1,22,496,1,1502,3,7,2,2,5,single-choice,spatial-relational,2|5,7,2/5,220496,2
2,1,22,497,1,994,3,9,3,3,6,single-choice,spatial-relational,3|6,7,3/6,220497,3
2,1,22,498,1,951,2,10,4,4,6,single-choice,spatial-relational,4|6,7,4/6,220498,4
2,1,22,499,1,994,3,5,1,1,4,single-choice,spatial-relational,1|4,7,1/4,220499,1
2,1,22,500,1,786,1,5,2,2,3,single-choice,spatial-relational,2|3,7,2/3,220500,2
2,1,22,501,1,834,2,12,5,5,7,single-choice,spatial-relational,5|7,7,5/7,220501,5
2,1,22,502,1,1257,2,8,3,3,5,single-choice,spatial-relational,3|5,7,3/5,220502,3
2,1,22,503,1,1261,1,3,1,1,2,single-choice,spatial-relational,1|2,7,1/2,220503,1
2,1,22,504,1,1028,2,6,2,2,4,single-choice,spatial-relational,2|4,7,2/4,220504,2
2,1,22,505,1,1107,1,9,4,4,5,single-choice,spatial-relational,4|5,7,4/5,220505,4
2,1,22,506,1,804,1,13,6,6,7,single-choice,spatial-relational,6|7,7,6/7,220506,6
2,1,22,507,1,1147,2,4,1,1,3,single-choice,spatial-relational,1|3,7,1/3,220507,1
2,1,22,508,1,701,2,12,5,5,7,single-choice,spatial-relational,5|7,7,5/7,220508,5
2,1,22,509,1,869,5,9,2,2,7,single-choice,spatial-relational,2|7,7,2/7,220509,2
2,1,22,510,1,742,4,10,3,3,7,single-choice,spatial-relational,3|7,7,3/7,220510,3
2,1,22,511,1,971,2,4,1,1,3,single-choice,spatial-relational,1|3,7,1/3,220511,1
2,1,22,512,1,1494,1,11,5,5,6,single-choice,spatial-relational,5|6,7,5/6,220512,5
2,1,22,513,1,932,4,10,3,3,7,single-choice,spatial-relational,3|7,7,3/7,220513,3
2,1,22,514,0,821,5,7,1,6,6,single-choice,spatial-relational,1|6,7,1/6,220514,1
2,1,22,515,1,1258,2,6,2,2,4,single-choice,spatial-relational,2|4,7,2/4,220515,2
2,1,22,516,1,785,5,7,1,1,6,single-choice,spatial-relational,1|6,7,1/6,220516,1
2,1,22,517,1,1197,3,5,1,1,4,single-choice,spatial-relational,1|4,7,1/4,220517,1
2,1,22,518,0,705,4,6,1,5,5,single-choice,spatial-relational,1|5,7,1/5,220518,1
2,1,22,519,1,939,2,8,3,3,5,single-choice,spatial-relational,3|5,7,3/5,220519,3
2,1,22,520,0,937,3,9,3,6,6,single-choice,spatial-relational,3|6,7,3/6,220520,3
2,1,22,521,1,809,1,7,3,3,4,single-choice,spatial-relational,3|4,7,3/4,220521,3
2,1,22,522,1,1048,4,8,2,2,6,single-choice,spatial-relational,2|6,7,2/6,220522,2
2,1,22,523,1,847,2,12,5,5,7,single-choice,spatial-relational,5|7,7,5/7,220523,5
2,1,22,524,1,866,3,11,4,4,7,single-choice,spatial-relational,4|7,7,4/7,220524,4
2,1,22,525,1,990,2,6,2,2,4,single-choice,spatial-relational,2|4,7,2/4,220525,2
2,1,22,526,1,1268,5,9,2,2,7,single-choice,spatial-relational,2|7,7,2/7,220526,2
2,1,22,527,1,1556,2,10,4,4,6,single-choice,spatial-relational,4|6,7,4/6,220527,4
2,1,22,528,1,1113,2,8,3,3,5,single-choice,spatial-relational,3|5,7,3/5,220528,3
2,1,22,529,1,780,1,5,2,2,3,single-choice,spatial-relational,2|3,7,2/3,220529,2
2,1,22,530,1,869,3,7,2,2,5,single-choice,spatial-relational,2|5,7,2/5,220530,2
2,1,22,531,1,1024,1,5,2,2,3,single-choice,spatial-relational,2|3,7,2/3,220531,2
2,1,22,532,1,876,4,6,1,1,5,single-choice,spatial-relational,1|5,7,1/5,220532,1
2,1,22,533,1,772,1,3,1,1,2,single-choice,spatial-relational,1|2,7,1/2,220533,1
2,1,22,534,1,885,3,5,1,1,4,single-choice,spatial-relational,1|4,7,1/4,220534,1
2,1,22,535,1,1166,1,7,3,3,4,single-choice,spatial-relational,3|4,7,3/4,220535,3
2,1,22,536,0,991,4,8,2,6,6,single-choice,spatial-relational,2|6,7,2/6,220536,2
2,1,22,537,1,1039,3,11,4,4,7,single-choice,spatial-relational,4|7,7,4/7,220537,4
2,1,22,538,1,881,1,3,1,1,2,single-choice,spatial-relational,1|2,7,1/2,220538,1
2,1,22,539,1,911,1,11,5,5,6,single-choice,spatial-relational,5|6,7,5/6,220539,5
2,1,22,540,1,1283,2,10,4,4,6,single-choice,spatial-relational,4|6,7,4/6,220540,4
2,1,22,541,0,1330,6,8,1,7,7,single-choice,spatial-relational,1|7,7,1/7,220541,1
2,1,22,542,1,1119,3,7,2,2,5,single-choice,spatial-relational,2|5,7,2/5,220542,2
2,1,22,543,1,1353,6,8,1,1,7,single-choice,spatial-relational,1|7,7,1/7,220543,1
2,1,22,544,0,784,3,9,3,6,6,single-choice,spatial-relational,3|6,7,3/6,220544,3
2,1,22,545,1,973,1,13,6,6,7,single-choice,spatial-relational,6|7,7,6/7,220545,6
2,1,22,546,0,1242,1,9,4,5,5,single-choice,spatial-relational,4|5,7,4/5,220546,4
2,1,22,547,1,776,2,4,1,1,3,single-choice,spatial-relational,1|3,7,1/3,220547,1
2,1,22,548,1,1198,3,9,3,3,6,single-choice,spatial-relational,3|6,7,3/6,220548,3
2,1,22,549,1,1226,1,5,2,2,3,single-choice,spatial-relational,2|3,7,2/3,220549,2
2,1,22,550,1,921,1,7,3,3,4,single-choice,spatial-relational,3|4,7,3/4,220550,3
2,1,22,551,1,825,4,6,1,1,5,single-choice,spatial-relational,1|5,7,1/5,220551,1
2,1,22,552,1,860,3,9,3,3,6,single-choice,spatial-relational,3|6,7,3/6,220552,3
2,1,22,553,1,802,2,12,5,5,7,single-choice,spatial-relational,5|7,7,5/7,220553,5
2,1,22,554,1,1009,2,8,3,3,5,single-choice,spatial-relational,3|5,7,3/5,220554,3
2,1,22,555,1,1208,5,7,1,1,6,single-choice,spatial-relational,1|6,7,1/6,220555,1
2,1,22,556,1,801,1,5,2,2,3,single-choice,spatial-relational,2|3,7,2/3,220556,2
2,1,22,557,1,890,3,5,1,1,4,single-choice,spatial-relational,1|4,7,1/4,220557,1
2,1,22,558,0,1153,3,5,1,4,4,single-choice,spatial-relational,1|4,7,1/4,220558,1
2,1,22,559,1,913,1,3,1,1,2,single-choice,spatial-relational,1|2,7,1/2,220559,1
2,1,22,560,1,1272,3,7,2,2,5,single-choice,spatial-relational,2|5,7,2/5,220560,2
2,1,22,561,1,798,5,9,2,2,7,single-choice,spatial-relational,2|7,7,2/7,220561,2
2,1,22,562,1,896,5,7,1,1,6,single-choice,spatial-relational,1|6,7,1/6,220562,1
2,1,22,563,1,990,6,8,1,1,7,single-choice,spatial-relational,1|7,7,1/7,220563,1
2,1,22,564,1,1400,4,8,2,2,6,single-choice,spatial-relational,2|6,7,2/6,220564,2
2,1,22,565,1,907,3,11,4,4,7,single-choice,spatial-relational,4|7,7,4/7,220565,4
2,1,22,566,0,804,2,6,2,4,4,single-choice,spatial-relational,2|4,7,2/4,220566,2
2,1,22,567,1,850,4,10,3,3,7,single-choice,spatial-relational,3|7,7,3/7,220567,3
2,1,22,568,1,1298,3,7,2,2,5,single-choice,spatial-relational,2|5,7,2/5,220568,2
2,1,22,569,1,1891,2,10,4,4,6,single-choice,spatial-relational,4|6,7,4/6,220569,4
2,1,22,570,1,1502,1,11,5,5,6,single-choice,spatial-relational,5|6,7,5/6,220570,5
2,1,22,571,1,1055,2,8,3,3,5,single-choice,spatial-relational,3|5,7,3/5,220571,3
2,1,22,572,1,911,2,6,2,2,4,single-choice,spatial-relational,2|4,7,2/4,220572,2
2,1,22,573,1,895,5,9,2,2,7,single-choice,spatial-relational,2|7,7,2/7,220573,2
2,1,22,574,1,1676,2,10,4,4,6,single-choice,spatial-relational,4|6,7,4/6,220574,4
2,1,22,575,1,1672,1,9,4,4,5,single-choice,spatial-relational,4|5,7,4/5,220575,4
2,1,22,576,0,807,6,8,1,7,7,single-choice,spatial-relational,1|7,7,1/7,220576,1
2,1,22,577,1,1542,1,7,3,3,4,single-choice,spatial-relational,3|4,7,3/4,220577,3
2,1,22,578,1,1051,2,12,5,5,7,single-choice,spatial-relational,5|7,7,5/7,220578,5
2,1,22,579,1,1204,2,4,1,1,3,single-choice,spatial-relational,1|3,7,1/3,220579,1
2,1,22,580,1,1136,1,11,5,5,6,single-choice,spatial-relational,5|6,7,5/6,220580,5
2,1,22,581,1,802,3,11,4,4,7,single-choice,spatial-relational,4|7,7,4/7,220581,4
2,1,22,582,1,1002,4,6,1,1,5,single-choice,spatial-relational,1|5,7,1/5,220582,1
2,1,22,583,1,903,1,13,6,6,7,single-choice,spatial-relational,6|7,7,6/7,220583,6
2,1,22,584,1,896,4,10,3,3,7,single-choice,spatial-relational,3|7,7,3/7,220584,3
2,1,22,585,1,650,1,13,6,6,7,single-choice,spatial-relational,6|7,7,6/7,220585,6
2,1,22,586,0,714,1,3,1,2,2,single-choice,spatial-relational,1|2,7,1/2,220586,1
2,1,22,587,1,1090,1,9,4,4,5,single-choice,spatial-relational,4|5,7,4/5,220587,4
2,1,22,588,1,1086,4,8,2,2,6,single-choice,spatial-relational,2|6,7,2/6,220588,2
2,1,22,589,1,727,2,12,5,5,7,single-choice,spatial-relational,5|7,7,5/7,220589,5
2,1,22,590,1,1085,3,7,2,2,5,single-choice,spatial-relational,2|5,7,2/5,220590,2
2,1,22,591,1,1401,2,8,3,3,5,single-choice,spatial-relational,3|5,7,3/5,220591,3
2,1,22,592,1,994,3,9,3,3,6,single-choice,spatial-relational,3|6,7,3/6,220592,3
2,1,22,593,1,847,2,12,5,5,7,single-choice,spatial-relational,5|7,7,5/7,220593,5
2,1,22,594,0,734,3,7,2,5,5,single-choice,spatial-relational,2|5,7,2/5,220594,2
2,1,22,595,1,937,3,5,1,1,4,single-choice,spatial-relational,1|4,7,1/4,220595,1
2,1,22,596,0,845,6,8,1,7,7,single-choice,spatial-relational,1|7,7,1/7,220596,1
2,1,22,597,0,1273,1,11,5,6,6,single-choice,spatial-relational,5|6,7,5/6,220597,5
2,1,22,598,0,1188,5,7,1,6,6,single-choice,spatial-relational,1|6,7,1/6,220598,1
2,1,22,599,1,1259,6,8,1,1,7,single-choice,spatial-relational,1|7,7,1/7,220599,1
2,1,22,600,1,854,3,5,1,1,4,single-choice,spatial-relational,1|4,7,1/4,220600,1
3,1,22,1,0,965,5,7,1,6,6,single-choice,spatial-relational,1|6,7,1/6,220001,1
3,1,22,2,1,771,2,10,4,4,6,single-choice,spatial-relational,4|6,7,4/6,220002,4
3,1,22,3,1,664,1,3,1,1,2,single-choice,spatial-relational,1|2,7,1/2,220003,1
3,1,22,4,0,537,5,7,1,6,6,single-choice,spatial-relational,1|6,7,1/6,220004,1
3,1,22,5,1,860,1,11,5,5,6,single-choice,spatial-relational,5|6,7,5/6,220005,5
3,1,22,6,0,18,3,9,3,6,6,single-choice,spatial-relational,3|6,7,3/6,220006,3
3,1,22,7,0,639,2,6,2,4,4,single-choice,spatial-relational,2|4,7,2/4,220007,2
3,1,22,8,0,885,2,4,1,3,3,single-choice,spatial-relational,1|3,7,1/3,220008,1
3,1,22,9,1,985,3,9,3,3,6,single-choice,spatial-relational,3|6,7,3/6,220009,3
3,1,22,10,1,647,4,10,3,3,7,single-choice,spatial-relational,3|7,7,3/7,220010,3
3,1,22,11,1,17,1,9,4,4,5,single-choice,spatial-relational,4|5,7,4/5,220011,4
3,1,22,12,0,728,1,5,2,3,3,single-choice,spatial-relational,2|3,7,2/3,220012,2
3,1,22,13,0,657,3,5,1,4,4,single-choice,spatial-relational,1|4,7,1/4,220013,1
3,1,22,14,1,821,2,12,5,5,7,single-choice,spatial-relational,5|7,7,5/7,220014,5
3,1,22,15,0,1096,2,8,3,5,5,single-choice,spatial-relational,3|5,7,3/5,220015,3
3,1,22,16,1,1381,3,7,2,2,5,single-choice,spatial-relational,2|5,7,2/5,220016,2
3,1,22,17,1,1027,2,6,2,2,4,single-choice,spatial-relational,2|4,7,2/4,220017,2
3,1,22,18,1,1985,2,10,4,4,6,single-choice,spatial-relational,4|6,7,4/6,220018,4
3,1,22,19,1,1036,2,12,5,5,7,single-choice,spatial-relational,5|7,7,5/7,220019,5
3,1,22,20,1,1355,4,6,1,1,5,single-choice,spatial-relational,1|5,7,1/5,220020,1
3,1,22,21,1,1698,4,6,1,1,5,single-choice,spatial-relational,1|5,7,1/5,220021,1
3,1,22,22,1,993,6,8,1,1,7,single-choice,spatial-relational,1|7,7,1/7,220022,1
3,1,22,23,0,885,6,8,1,7,7,single-choice,spatial-relational,1|7,7,1/7,220023,1
3,1,22,24,1,1016,3,11,4,4,7,single-choice,spatial-relational,4|7,7,4/7,220024,4
3,1,22,25,1,1135,4,8,2,2,6,single-choice,spatial-relational,2|6,7,2/6,220025,2
3,1,22,26,1,685,4,10,3,3,7,single-choice,spatial-relational,3|7,7,3/7,220026,3
3,1,22,27,1,864,1,13,6,6,7,single-choice,spatial-relational,6|7,7,6/7,220027,6
3,1,22,28,0,1105,1,7,3,4,4,single-choice,spatial-relational,3|4,7,3/4,220028,3
3,1,22,29,1,1329,5,9,2,2,7,single-choice,spatial-relational,2|7,7,2/7,220029,2
3,1,22,30,1,958,3,7,2,2,5,single-choice,spatial-relational,2|5,7,2/5,220030,2
3,1,22,31,1,1043,2,8,3,3,5,single-choice,spatial-relational,3|5,7,3/5,220031,3
3,1,22,32,1,768,1,5,2,2,3,single-choice,spatial-relational,2|3,7,2/3,220032,2
3,1,22,33,0,1299,1,11,5,6,6,single-choice,spatial-relational,5|6,7,5/6,220033,5
3,1,22,34,1,734,3,11,4,4,7,single-choice,spatial-relational,4|7,7,4/7,220034,4
3,1,22,35,0,1227,4,8,2,6,6,single-choice,spatial-relational,2|6,7,2/6,220035,2
3,1,22,36,1,1242,3,5,1,1,4,single-choice,spatial-relational,1|4,7,1/4,220036,1
3,1,22,37,0,1011,1,9,4,5,5,single-choice,spatial-relational,4|5,7,4/5,220037,4
3,1,22,38,1,878,1,13,6,6,7,single-choice,spatial-relational,6|7,7,6/7,220038,6
3,1,22,39,1,955,1,7,3,3,4,single-choice,spatial-relational,3|4,7,3/4,220039,3
3,1,22,40,0,785,2,4,1,3,3,single-choice,spatial-relational,1|3,7,1/3,220040,1
3,1,22,41,1,923,1,3,1,1,2,single-choice,spatial-relational,1|2,7,1/2,220041,1
3,1,22,42,1,756,5,9,2,2,7,single-choice,spatial-relational,2|7,7,2/7,220042,2
3,1,22,43,0,784,6,8,1,7,7,single-choice,spatial-relational,1|7,7,1/7,220043,1
3,1,22,44,0,971,1,11,5,6,6,single-choice,spatial-relational,5|6,7,5/6,220044,5
3,1,22,45,1,1569,4,8,2,2,6,single-choice,spatial-relational,2|6,7,2/6,220045,2
3,1,22,46,1,907,1,3,1,1,2,single-choice,spatial-relational,1|2,7,1/2,220046,1
3,1,22,47,1,918,1,9,4,4,5,single-choice,spatial-relational,4|5,7,4/5,220047,4
3,1,22,48,1,934,1,5,2,2,3,single-choice,spatial-relational,2|3,7,2/3,220048,2
3,1,22,49,1,1185,2,10,4,4,6,single-choice,spatial-relational,4|6,7,4/6,220049,4
3,1,22,50,1,1030,3,5,1,1,4,single-choice,spatial-relational,1|4,7,1/4,220050,1
3,1,22,51,1,773,5,9,2,2,7,single-choice,spatial-relational,2|7,7,2/7,220051,2
3,1,22,52,0,711,5,7,1,6,6,single-choice,spatial-relational,1|6,7,1/6,220052,1
3,1,22,53,1,1316,4,6,1,1,5,single-choice,spatial-relational,1|5,7,1/5,220053,1
3,1,22,54,1,1265,1,9,4,4,5,single-choice,spatial-relational,4|5,7,4/5,220054,4
3,1,22,55,0,1063,2,4,1,3,3,single-choice,spatial-relational,1|3,7,1/3,220055,1
3,1,22,56,1,786,3,7,2,2,5,single-choice,spatial-relational,2|5,7,2/5,220056,2
3,1,22,57,1,1306,3,9,3,3,6,single-choice,spatial-relational,3|6,7,3/6,220057,3
3,1,22,58,1,963,3,11,4,4,7,single-choice,spatial-relational,4|7,7,4/7,220058,4
3,1,22,59,1,960,1,3,1,1,2,single-choice,spatial-relational,1|2,7,1/2,220059,1
3,1,22,60,1,810,1,13,6,6,7,single-choice,spatial-relational,6|7,7,6/7,220060,6
3,1,22,61,1,877,2,12,5,5,7,single-choice,spatial-relational,5|7,7,5/7,220061,5
3,1,22,62,1,1258,3,11,4,4,7,single-choice,spatial-relational,4|7,7,4/7,220062,4
3,1,22,63,0,1001,2,10,4,6,6,single-choice,spatial-relational,4|6,7,4/6,220063,4
3,1,22,64,1,1158,3,9,3,3,6,single-choice,spatial-relational,3|6,7,3/6,220064,3
3,1,22,65,1,1274,6,8,1,1,7,single-choice,spatial-relational,1|7,7,1/7,220065,1
3,1,22,66,1,1825,3,7,2,2,5,single-choice,spatial-relational,2|5,7,2/5,220066,2
3,1,22,67,0,1228,2,6,2,4,4,single-choice,spatial-relational,2|4,7,2/4,220067,2
3,1,22,68,1,1007,4,6,1,1,5,single-choice,spatial-relational,1|5,7,1/5,220068,1
3,1,22,69,0,802,5,7,1,6,6,single-choice,spatial-relational,1|6,7,1/6,220069,1
3,1,22,70,1,1449,4,8,2,2,6,single-choice,spatial-relational,2|6,7,2/6,220070,2
3,1,22,71,1,999,5,9,2,2,7,single-choice,spatial-relational,2|7,7,2/7,220071,2
3,1,22,72,1,1091,1,7,3,3,4,single-choice,spatial-relational,3|4,7,3/4,220072,3
3,1,22,73,1,1829,1,7,3,3,4,single-choice,spatial-relational,3|4,7,3/4,220073,3
3,1,22,74,1,1342,1,5,2,2,3,single-choice,spatial-relational,2|3,7,2/3,220074,2
3,1,22,75,1,1108,2,8,3,3,5,single-choice,spatial-relational,3|5,7,3/5,220075,3
3,1,22,76,1,860,4,10,3,3,7,single-choice,spatial-relational,3|7,7,3/7,220076,3
3,1,22,77,1,1170,2,6,2,2,4,single-choice,spatial-relational,2|4,7,2/4,220077,2
3,1,22,78,0,754,1,11,5,6,6,single-choice,spatial-relational,5|6,7,5/6,220078,5
3,1,22,79,1,784,4,10,3,3,7,single-choice,spatial-relational,3|7,7,3/7,220079,3
3,1,22,80,1,1639,2,8,3,3,5,single-choice,spatial-relational,3|5,7,3/5,220080,3
3,1,22,81,1,645,1,13,6,6,7,single-choice,spatial-relational,6|7,7,6/7,220081,6
3,1,22,82,1,920,2,12,5,5,7,single-choice,spatial-relational,5|7,7,5/7,220082,5
3,1,22,83,1,1074,3,5,1,1,4,single-choice,spatial-relational,1|4,7,1/4,220083,1
3,1,22,84,1,895,2,4,1,1,3,single-choice,spatial-relational,1|3,7,1/3,220084,1
3,1,22,85,1,692,3,11,4,4,7,single-choice,spatial-relational,4|7,7,4/7,220085,4
3,1,22,86,1,658,1,13,6,6,7,single-choice,spatial-relational,6|7,7,6/7,220086,6
3,1,22,87,1,1267,3,9,3,3,6,single-choice,spatial-relational,3|6,7,3/6,220087,3
3,1,22,88,1,1137,3,7,2,2,5,single-choice,spatial-relational,2|5,7,2/5,220088,2
3,1,22,89,1,716,1,3,1,1,2,single-choice,spatial-relational,1|2,7,1/2,220089,1
3,1,22,90,1,961,1,11,5,5,6,single-choice,spatial-relational,5|6,7,5/6,220090,5
3,1,22,91,1,962,5,9,2,2,7,single-choice,spatial-relational,2|7,7,2/7,220091,2
3,1,22,92,1,840,4,6,1,1,5,single-choice,spatial-relational,1|5,7,1/5,220092,1
3,1,22,93,1,986,2,6,2,2,4,single-choice,spatial-relational,2|4,7,2/4,220093,2
3,1,22,94,0,772,5,7,1,6,6,single-choice,spatial-relational,1|6,7,1/6,220094,1
3,1,22,95,1,1919,1,7,3,3,4,single-choice,spatial-relational,3|4,7,3/4,220095,3
3,1,22,96,1,988,1,9,4,4,5,single-choice,spatial-relational,4|5,7,4/5,220096,4
3,1,22,97,0,1351,2,8,3,5,5,single-choice,spatial-relational,3|5,7,3/5,220097,3
3,1,22,98,0,1061,2,8,3,5,5,single-choice,spatial-relational,3|5,7,3/5,220098,3
3,1,22,99,1,1021,4,10,3,3,7,single-choice,spatial-relational,3|7,7,3/7,220099,3
3,1,22,100,1,1086,3,5,1,1,4,single-choice,spatial-relational,1|4,7,1/4,220100,1
3,1,22,101,1,1044,1,7,3,3,4,single-choice,spatial-relational,3|4,7,3/4,220101,3
3,1,22,102,1,679,4,10,3,3,7,single-choice,spatial-relational,3|7,7,3/7,220102,3
3,1,22,103,1,1079,2,4,1,1,3,single-choice,spatial-relational,1|3,7,1/3,220103,1
3,1,22,104,1,986,2,4,1,1,3,single-choice,spatial-relational,1|3,7,1/3,220104,1
3,1,22,105,1,1312,2,10,4,4,6,single-choice,spatial-relational,4|6,7,4/6,220105,4
3,1,22,106,1,752,2,12,5,5,7,single-choice,spatial-relational,5|7,7,5/7,220106,5
3,1,22,107,1,1097,5,9,2,2,7,single-choice,spatial-relational,2|7,7,2/7,220107,2
3,1,22,108,1,884,1,5,2,2,3,single-choice,spatial-relational,2|3,7,2/3,220108,2
3,1,22,109,1,1007,2,6,2,2,4,single-choice,spatial-relational,2|4,7,2/4,220109,2
3,1,22,110,0,1300,1,9,4,5,5,single-choice,spatial-relational,4|5,7,4/5,220110,4
3,1,22,111,1,1208,4,8,2,2,6,single-choice,spatial-relational,2|6,7,2/6,220111,2
3,1,22,112,1,911,1,3,1,1,2,single-choice,spatial-relational,1|2,7,1/2,220112,1
3,1,22,113,1,912,3,7,2,2,5,single-choice,spatial-relational,2|5,7,2/5,220113,2
3,1,22,114,1,858,1,5,2,2,3,single-choice,spatial-relational,2|3,7,2/3,220114,2
3,1,22,115,0,765,4,6,1,5,5,single-choice,spatial-relational,1|5,7,1/5,220115,1
3,1,22,116,1,794,2,12,5,5,7,single-choice,spatial-relational,5|7,7,5/7,220116,5
3,1,22,117,0,1658,6,8,1,7,7,single-choice,spatial-relational,1|7,7,1/7,220117,1
3,1,22,118,1,1391,3,9,3,3,6,single-choice,spatial-relational,3|6,7,3/6,220118,3
3,1,22,119,1,858,3,11,4,4,7,single-choice,spatial-relational,4|7,7,4/7,220119,4
3,1,22,120,1,708,1,13,6,6,7,single-choice,spatial-relational,6|7,7,6/7,220120,6
3,1,22,121,0,1801,2,10,4,6,6,single-choice,spatial-relational,4|6,7,4/6,220121,4
3,1,22,122,1,1155,6,8,1,1,7,single-choice,spatial-relational,1|7,7,1/7,220122,1
3,1,22,123,1,890,3,5,1,1,4,single-choice,spatial-relational,1|4,7,1/4,220123,1
3,1,22,124,1,970,1,11,5,5,6,single-choice,spatial-relational,5|6,7,5/6,220124,5
3,1,22,125,0,654,5,7,1,6,6,single-choice,spatial-relational,1|6,7,1/6,220125,1
3,1,22,126,1,1131,4,8,2,2,6,single-choice,spatial-relational,2|6,7,2/6,220126,2
3,1,22,127,1,1120,3,9,3,3,6,single-choice,spatial-relational,3|6,7,3/6,220127,3
3,1,22,128,1,1054,2,8,3,3,5,single-choice,spatial-relational,3|5,7,3/5,220128,3
3,1,22,129,1,1819,1,11,5,5,6,single-choice,spatial-relational,5|6,7,5/6,220129,5
3,1,22,130,1,917,1,5,2,2,3,single-choice,spatial-relational,2|3,7,2/3,220130,2
3,1,22,131,1,1012,3,11,4,4,7,single-choice,spatial-relational,4|7,7,4/7,220131,4
3,1,22,132,1,937,1,5,2,2,3,single-choice,spatial-relational,2|3,7,2/3,220132,2
3,1,22,133,1,880,5,9,2,2,7,single-choice,spatial-relational,2|7,7,2/7,220133,2
3,1,22,134,1,975,3,9,3,3,6,single-choice,spatial-relational,3|6,7,3/6,220134,3
3,1,22,135,1,1002,2,4,1,1,3,single-choice,spatial-relational,1|3,7,1/3,220135,1
3,1,22,136,1,796,1,13,6,6,7,single-choice,spatial-relational,6|7,7,6/7,220136,6
3,1,22,137,0,1175,2,10,4,6,6,single-choice,spatial-relational,4|6,7,4/6,220137,4
3,1,22,138,0,1448,1,9,4,5,5,single-choice,spatial-relational,4|5,7,4/5,220138,4
3,1,22,139,1,1288,3,7,2,2,5,single-choice,spatial-relational,2|5,7,2/5,220139,2
3,1,22,140,1,735,4,10,3,3,7,single-choice,spatial-relational,3|7,7,3/7,220140,3
3,1,22,141,1,1406,2,6,2,2,4,single-choice,spatial-relational,2|4,7,2/4,220141,2
3,1,22,142,1,1009,3,11,4,4,7,single-choice,spatial-relational,4|7,7,4/7,220142,4
3,1,22,143,1,975,3,5,1,1,4,single-choice,spatial-relational,1|4,7,1/4,220143,1
3,1,22,144,1,955,2,4,1,1,3,single-choice,spatial-relational,1|3,7,1/3,220144,1
3,1,22,145,1,1271,4,8,2,2,6,single-choice,spatial-relational,2|6,7,2/6,220145,2
3,1,22,146,1,944,4,10,3,3,7,single-choice,spatial-relational,3|7,7,3/7,220146,3
3,1,22,147,0,1224,2,12,5,7,7,single-choice,spatial-relational,5|7,7,5/7,220147,5
3,1,22,148,1,1071,2,6,2,2,4,single-choice,spatial-relational,2|4,7,2/4,220148,2
3,1,22,149,1,961,5,7,1,1,6,single-choice,spatial-relational,1|6,7,1/6,220149,1
3,1,22,150,1,1271,6,8,1,1,7,single-choice,spatial-relational,1|7,7,1/7,220150,1
3,1,22,151,1,919,4,8,2,2,6,single-choice,spatial-relational,2|6,7,2/6,220151,2
3,1,22,152,1,1309,2,8,3,3,5,single-choice,spatial-relational,3|5,7,3/5,220152,3
3,1,22,153,1,883,1,13,6,6,7,single-choice,spatial-relational,6|7,7,6/7,220153,6
3,1,22,154,1,1181,3,5,1,1,4,single-choice,spatial-relational,1|4,7,1/4,220154,1
3,1,22,155,1,764,5,9,2,2,7,single-choice,spatial-relational,2|7,7,2/7,220155,2
3,1,22,156,1,936,1,11,5,5,6,single-choice,spatial-relational,5|6,7,5/6,220156,5
3,1,22,157,1,695,2,12,5,5,7,single-choice,spatial-relational,5|7,7,5/7,220157,5
3,1,22,158,1,968,2,10,4,4,6,single-choice,spatial-relational,4|6,7,4/6,220158,4
3,1,22,159,1,865,6,8,1,1,7,single-choice,spatial-relational,1|7,7,1/7,220159,1
3,1,22,160,1,884,3,7,2,2,5,single-choice,spatial-relational,2|5,7,2/5,220160,2
3,1,22,161,1,817,1,3,1,1,2,single-choice,spatial-relational,1|2,7,1/2,220161,1
3,1,22,162,1,1005,1,9,4,4,5,single-choice,spatial-relational,4|5,7,4/5,220162,4
3,1,22,163,0,1077,4,6,1,5,5,single-choice,spatial-relational,1|5,7,1/5,220163,1
3,1,22,164,1,799,1,3,1,1,2,single-choice,spatial-relational,1|2,7,1/2,220164,1
3,1,22,165,1,960,1,7,3,3,4,single-choice,spatial-relational,3|4,7,3/4,220165,3
3,1,22,166,1,868,4,6,1,1,5,single-choice,spatial-relational,1|5,7,1/5,220166,1
3,1,22,167,1,1031,5,7,1,1,6,single-choice,spatial-relational,1|6,7,1/6,220167,1
3,1,22,168,1,862,1,7,3,3,4,single-choice,spatial-relational,3|4,7,3/4,220168,3
3,1,22,169,0,741,1,3,1,2,2,single-choice,spatial-relational,1|2,7,1/2,220169,1
3,1,22,170,1,1092,1,7,3,3,4,single-choice,spatial-relational,3|4,7,3/4,220170,3
3,1,22,171,1,814,3,11,4,4,7,single-choice,spatial-relational,4|7,7,4/7,220171,4
3,1,22,172,1,999,1,5,2,2,3,single-choice,spatial-relational,2|3,7,2/3,220172,2
3,1,22,173,1,715,3,11,4,4,7,single-choice,spatial-relational,4|7,7,4/7,220173,4
3,1,22,174,1,1134,2,8,3,3,5,single-choice,spatial-relational,3|5,7,3/5,220174,3
3,1,22,175,0,1166,2,10,4,6,6,single-choice,spatial-relational,4|6,7,4/6,220175,4
3,1,22,176,1,1002,5,7,1,1,6,single-choice,spatial-relational,1|6,7,1/6,220176,1
3,1,22,177,1,1021,6,8,1,1,7,single-choice,spatial-relational,1|7,7,1/7,220177,1
3,1,22,178,0,979,4,6,1,5,5,single-choice,spatial-relational,1|5,7,1/5,220178,1
3,1,22,179,1,1574,3,9,3,3,6,single-choice,spatial-relational,3|6,7,3/6,220179,3
3,1,22,180,1,1098,5,7,1,1,6,single-choice,spatial-relational,1|6,7,1/6,220180,1
3,1,22,181,1,644,1,13,6,6,7,single-choice,spatial-relational,6|7,7,6/7,220181,6
3,1,22,182,1,949,4,10,3,3,7,single-choice,spatial-relational,3|7,7,3/7,220182,3
3,1,22,183,1,909,4,6,1,1,5,single-choice,spatial-relational,1|5,7,1/5,220183,1
3,1,22,184,1,717,2,4,1,1,3,single-choice,spatial-relational,1|3,7,1/3,220184,1
3,1,22,185,1,893,3,5,1,1,4,single-choice,spatial-relational,1|4,7,1/4,220185,1
3,1,22,186,1,1443,3,9,3,3,6,single-choice,spatial-relational,3|6,7,3/6,220186,3
3,1,22,187,1,1425,4,8,2,2,6,single-choice,spatial-relational,2|6,7,2/6,220187,2
3,1,22,188,1,832,3,7,2,2,5,single-choice,spatial-relational,2|5,7,2/5,220188,2
3,1,22,189,1,926,5,9,2,2,7,single-choice,spatial-relational,2|7,7,2/7,220189,2
3,1,22,190,0,1364,1,3,1,2,2,single-choice,spatial-relational,1|2,7,1/2,220190,1
3,1,22,191,0,1328,2,6,2,4,4,single-choice,spatial-relational,2|4,7,2/4,220191,2
3,1,22,192,0,956,1,5,2,3,3,single-choice,spatial-relational,2|3,7,2/3,220192,2
3,1,22,193,0,1385,2,6,2,4,4,single-choice,spatial-relational,2|4,7,2/4,220193,2
3,1,22,194,1,969,2,12,5,5,7,single-choice,spatial-relational,5|7,7,5/7,220194,5
3,1,22,195,0,962,1,9,4,5,5,single-choice,spatial-relational,4|5,7,4/5,220195,4
3,1,22,196,1,1525,4,8,2,2,6,single-choice,spatial-relational,2|6,7,2/6,220196,2
3,1,22,197,1,910,3,7,2,2,5,single-choice,spatial-relational,2|5,7,2/5,220197,2
3,1,22,198,1,806,1,13,6,6,7,single-choice,spatial-relational,6|7,7,6/7,220198,6
3,1,22,199,1,1453,1,7,3,3,4,single-choice,spatial-relational,3|4,7,3/4,220199,3
3,1,22,200,1,957,1,9,4,4,5,single-choice,spatial-relational,4|5,7,4/5,220200,4
3,1,22,201,1,897,2,4,1,1,3,single-choice,spatial-relational,1|3,7,1/3,220201,1
3,1,22,202,1,792,3,5,1,1,4,single-choice,spatial-relational,1|4,7,1/4,220202,1
3,1,22,203,1,1229,1,11,5,5,6,single-choice,spatial-relational,5|6,7,5/6,220203,5
3,1,22,204,1,1406,5,9,2,2,7,single-choice,spatial-relational,2|7,7,2/7,220204,2
3,1,22,205,0,786,6,8,1,7,7,single-choice,spatial-relational,1|7,7,1/7,220205,1
3,1,22,206,1,1337,2,8,3,3,5,single-choice,spatial-relational,3|5,7,3/5,220206,3
3,1,22,207,1,989,4,10,3,3,7,single-choice,spatial-relational,3|7,7,3/7,220207,3
3,1,22,208,1,967,2,12,5,5,7,single-choice,spatial-relational,5|7,7,5/7,220208,5
3,1,22,209,0,1472,2,10,4,6,6,single-choice,spatial-relational,4|6,7,4/6,220209,4
3,1,22,210,1,1293,1,11,5,5,6,single-choice,spatial-relational,5|6,7,5/6,220210,5
3,1,22,211,1,940,1,3,1,1,2,single-choice,spatial-relational,1|2,7,1/2,220211,1
3,1,22,212,0,14,3,11,4,7,7,single-choice,spatial-relational,4|7,7,4/7,220212,4
3,1,22,213,1,1115,6,8,1,1,7,single-choice,spatial-relational,1|7,7,1/7,220213,1
3,1,22,214,1,1070,3,11,4,4,7,single-choice,spatial-relational,4|7,7,4/7,220214,4
3,1,22,215,1,1068,6,8,1,1,7,single-choice,spatial-relational,1|7,7,1/7,220215,1
3,1,22,216,1,800,3,5,1,1,4,single-choice,spatial-relational,1|4,7,1/4,220216,1
3,1,22,217,0,1236,5,7,1,6,6,single-choice,spatial-relational,1|6,7,1/6,220217,1
3,1,22,218,1,1359,3,7,2,2,5,single-choice,spatial-relational,2|5,7,2/5,220218,2
3,1,22,219,1,1026,2,4,1,1,3,single-choice,spatial-relational,1|3,7,1/3,220219,1
3,1,22,220,1,881,2,12,5,5,7,single-choice,spatial-relational,5|7,7,5/7,220220,5
3,1,22,221,1,1539,4,8,2,2,6,single-choice,spatial-relational,2|6,7,2/6,220221,2
3,1,22,222,1,750,1,13,6,6,7,single-choice,spatial-relational,6|7,7,6/7,220222,6
3,1,22,223,1,674,2,12,5,5,7,single-choice,spatial-relational,5|7,7,5/7,220223,5
3,1,22,224,1,1647,1,9,4,4,5,single-choice,spatial-relational,4|5,7,4/5,220224,4
3,1,22,225,1,899,2,6,2,2,4,single-choice,spatial-relational,2|4,7,2/4,220225,2
3,1,22,226,1,1010,3,9,3,3,6,single-choice,spatial-relational,3|6,7,3/6,220226,3
3,1,22,227,1,758,1,13,6,6,7,single-choice,spatial-relational,6|7,7,6/7,220227,6
3,1,22,228,1,949,1,7,3,3,4,single-choice,spatial-relational,3|4,7,3/4,220228,3
3,1,22,229,1,1133,3,9,3,3,6,single-choice,spatial-relational,3|6,7,3/6,220229,3
3,1,22,230,0,942,1,5,2,3,3,single-choice,spatial-relational,2|3,7,2/3,220230,2
3,1,22,231,1,908,2,8,3,3,5,single-choice,spatial-relational,3|5,7,3/5,220231,3
3,1,22,232,1,1060,2,10,4,4,6,single-choice,spatial-relational,4|6,7,4/6,220232,4
3,1,22,233,1,827,5,9,2,2,7,single-choice,spatial-relational,2|7,7,2/7,220233,2
3,1,22,234,0,30,5,7,1,6,6,single-choice,spatial-relational,1|6,7,1/6,220234,1
3,1,22,235,1,1495,1,7,3,3,4,single-choice,spatial-relational,3|4,7,3/4,220235,3
3,1,22,236,0,832,1,3,1,2,2,single-choice,spatial-relational,1|2,7,1/2,220236,1
3,1,22,237,1,1489,1,11,5,5,6,single-choice,spatial-relational,5|6,7,5/6,220237,5
3,1,22,238,1,1014,3,7,2,2,5,single-choice,spatial-relational,2|5,7,2/5,220238,2
3,1,22,239,1,1044,2,8,3,3,5,single-choice,spatial-relational,3|5,7,3/5,220239,3
3,1,22,240,1,992,2,10,4,4,6,single-choice,spatial-relational,4|6,7,4/6,220240,4
3,1,22,241,1,1106,3,5,1,1,4,single-choice,spatial-relational,1|4,7,1/4,220241,1
3,1,22,242,1,964,4,6,1,1,5,single-choice,spatial-relational,1|5,7,1/5,220242,1
3,1,22,243,1,1445,1,9,4,4,5,single-choice,spatial-relational,4|5,7,4/5,220243,4
3,1,22,244,1,1135,5,9,2,2,7,single-choice,spatial-relational,2|7,7,2/7,220244,2
3,1,22,245,1,1009,4,6,1,1,5,single-choice,spatial-relational,1|5,7,1/5,220245,1
3,1,22,246,1,704,4,10,3,3,7,single-choice,spatial-relational,3|7,7,3/7,220246,3
3,1,22,247,1,939,2,4,1,1,3,single-choice,spatial-relational,1|3,7,1/3,220247,1
3,1,22,248,1,945,4,10,3,3,7,single-choice,spatial-relational,3|7,7,3/7,220248,3
3,1,22,249,1,1266,1,5,2,2,3,single-choice,spatial-relational,2|3,7,2/3,220249,2
3,1,22,250,1,1234,1,11,5,5,6,single-choice,spatial-relational,5|6,7,5/6,220250,5
3,1,22,251,1,1508,2,6,2,2,4,single-choice,spatial-relational,2|4,7,2/4,220251,2
3,1,22,252,1,1215,4,8,2,2,6,single-choice,spatial-relational,2|6,7,2/6,220252,2
3,1,22,253,1,884,3,5,1,1,4,single-choice,spatial-relational,1|4,7,1/4,220253,1
3,1,22,254,1,1120,2,10,4,4,6,single-choice,spatial-relational,4|6,7,4/6,220254,4
3,1,22,255,1,1071,2,4,1,1,3,single-choice,spatial-relational,1|3,7,1/3,220255,1
3,1,22,256,1,1209,4,8,2,2,6,single-choice,spatial-relational,2|6,7,2/6,220256,2
3,1,22,257,1,930,3,5,1,1,4,single-choice,spatial-relational,1|4,7,1/4,220257,1
3,1,22,258,0,765,1,7,3,4,4,single-choice,spatial-relational,3|4,7,3/4,220258,3
3,1,22,259,1,933,4,6,1,1,5,single-choice,spatial-relational,1|5,7,1/5,220259,1
3,1,22,260,1,964,5,7,1,1,6,single-choice,spatial-relational,1|6,7,1/6,220260,1
3,1,22,261,0,938,3,9,3,6,6,single-choice,spatial-relational,3|6,7,3/6,220261,3
3,1,22,262,1,851,2,12,5,5,7,single-choice,spatial-relational,5|7,7,5/7,220262,5
3,1,22,263,1,983,1,9,4,4,5,single-choice,spatial-relational,4|5,7,4/5,220263,4
3,1,22,264,1,1148,5,9,2,2,7,single-choice,spatial-relational,2|7,7,2/7,220264,2
3,1,22,265,1,1556,1,9,4,4,5,single-choice,spatial-relational,4|5,7,4/5,220265,4
3,1,22,266,1,1131,2,8,3,3,5,single-choice,spatial-relational,3|5,7,3/5,220266,3
3,1,22,267,1,831,3,11,4,4,7,single-choice,spatial-relational,4|7,7,4/7,220267,4
3,1,22,268,1,1445,2,8,3,3,5,single-choice,spatial-relational,3|5,7,3/5,220268,3
3,1,22,269,1,1039,6,8,1,1,7,single-choice,spatial-relational,1|7,7,1/7,220269,1
3,1,22,270,0,1023,3,9,3,6,6,single-choice,spatial-relational,3|6,7,3/6,220270,3
3,1,22,271,1,975,4,6,1,1,5,single-choice,spatial-relational,1|5,7,1/5,220271,1
3,1,22,272,1,1343,5,9,2,2,7,single-choice,spatial-relational,2|7,7,2/7,220272,2
3,1,22,273,1,961,2,6,2,2,4,single-choice,spatial-relational,2|4,7,2/4,220273,2
3,1,22,274,1,883,4,10,3,3,7,single-choice,spatial-relational,3|7,7,3/7,220274,3
3,1,22,275,1,752,1,3,1,1,2,single-choice,spatial-relational,1|2,7,1/2,220275,1
3,1,22,276,1,1165,3,7,2,2,5,single-choice,spatial-relational,2|5,7,2/5,220276,2
3,1,22,277,1,720,4,10,3,3,7,single-choice,spatial-relational,3|7,7,3/7,220277,3
3,1,22,278,1,988,3,11,4,4,7,single-choice,spatial-relational,4|7,7,4/7,220278,4
3,1,22,279,0,862,1,11,5,6,6,single-choice,spatial-relational,5|6,7,5/6,220279,5
3,1,22,280,1,1039,4,8,2,2,6,single-choice,spatial-relational,2|6,7,2/6,220280,2
3,1,22,281,1,1114,5,7,1,1,6,single-choice,spatial-relational,1|6,7,1/6,220281,1
3,1,22,282,1,1067,1,3,1,1,2,single-choice,spatial-relational,1|2,7,1/2,220282,1
3,1,22,283,0,768,1,5,2,3,3,single-choice,spatial-relational,2|3,7,2/3,220283,2
3,1,22,284,1,1387,1,11,5,5,6,single-choice,spatial-relational,5|6,7,5/6,220284,5
3,1,22,285,1,1456,2,6,2,2,4,single-choice,spatial-relational,2|4,7,2/4,220285,2
3,1,22,286,1,781,1,13,6,6,7,single-choice,spatial-relational,6|7,7,6/7,220286,6
3,1,22,287,1,1334,1,7,3,3,4,single-choice,spatial-relational,3|4,7,3/4,220287,3
3,1,22,288,1,792,2,12,5,5,7,single-choice,spatial-relational,5|7,7,5/7,220288,5
3,1,22,289,1,1070,3,7,2,2,5,single-choice,spatial-relational,2|5,7,2/5,220289,2
3,1,22,290,1,683,1,13,6,6,7,single-choice,spatial-relational,6|7,7,6/7,220290,6
3,1,22,291,1,1271,1,5,2,2,3,single-choice,spatial-relational,2|3,7,2/3,220291,2
3,1,22,292,0,823,6,8,1,7,7,single-choice,spatial-relational,1|7,7,1/7,220292,1
3,1,22,293,1,922,2,4,1,1,3,single-choice,spatial-relational,1|3,7,1/3,220293,1
3,1,22,294,1,1236,2,10,4,4,6,single-choice,spatial-relational,4|6,7,4/6,220294,4
3,1,22,295,1,996,1,7,3,3,4,single-choice,spatial-relational,3|4,7,3/4,220295,3
3,1,22,296,1,993,1,5,2,2,3,single-choice,spatial-relational,2|3,7,2/3,220296,2
3,1,22,297,1,1387,2,8,3,3,5,single-choice,spatial-relational,3|5,7,3/5,220297,3
3,1,22,298,1,1213,4,8,2,2,6,single-choice,spatial-relational,2|6,7,2/6,220298,2
3,1,22,299,1,900,2,6,2,2,4,single-choice,spatial-relational,2|4,7,2/4,220299,2
3,1,22,300,1,987,1,11,5,5,6,single-choice,spatial-relational,5|6,7,5/6,220300,5
3,1,22,301,1,833,5,9,2,2,7,single-choice,spatial-relational,2|7,7,2/7,220301,2
3,1,22,302,1,1076,4,6,1,1,5,single-choice,spatial-relational,1|5,7,1/5,220302,1
3,1,22,303,1,851,4,6,1,1,5,single-choice,spatial-relational,1|5,7,1/5,220303,1
3,1,22,304,1,1618,2,10,4,4,6,single-choice,spatial-relational,4|6,7,4/6,220304,4
3,1,22,305,1,840,2,12,5,5,7,single-choice,spatial-relational,5|7,7,5/7,220305,5
3,1,22,306,0,738,6,8,1,7,7,single-choice,spatial-relational,1|7,7,1/7,220306,1
3,1,22,307,1,848,3,5,1,1,4,single-choice,spatial-relational,1|4,7,1/4,220307,1
3,1,22,308,1,978,4,8,2,2,6,single-choice,spatial-relational,2|6,7,2/6,220308,2
3,1,22,309,1,841,2,4,1,1,3,single-choice,spatial-relational,1|3,7,1/3,220309,1
3,1,22,310,1,1654,2,8,3,3,5,single-choice,spatial-relational,3|5,7,3/5,220310,3
3,1,22,311,1,1144,1,7,3,3,4,single-choice,spatial-relational,3|4,7,3/4,220311,3
3,1,22,312,0,1894,5,7,1,6,6,single-choice,spatial-relational,1|6,7,1/6,220312,1
3,1,22,313,1,1198,5,9,2,2,7,single-choice,spatial-relational,2|7,7,2/7,220313,2
3,1,22,314,1,1113,1,5,2,2,3,single-choice,spatial-relational,2|3,7,2/3,220314,2
3,1,22,315,1,705,1,13,6,6,7,single-choice,spatial-relational,6|7,7,6/7,220315,6
3,1,22,316,1,1064,2,10,4,4,6,single-choice,spatial-relational,4|6,7,4/6,220316,4
3,1,22,317,1,884,4,10,3,3,7,single-choice,spatial-relational,3|7,7,3/7,220317,3
3,1,22,318,1,928,2,6,2,2,4,single-choice,spatial-relational,2|4,7,2/4,220318,2
3,1,22,319,1,1244,1,9,4,4,5,single-choice,spatial-relational,4|5,7,4/5,220319,4
3,1,22,320,0,1151,3,9,3,6,6,single-choice,spatial-relational,3|6,7,3/6,220320,3
3,1,22,321,1,1172,3,5,1,1,4,single-choice,spatial-relational,1|4,7,1/4,220321,1
3,1,22,322,1,1658,3,9,3,3,6,single-choice,spatial-relational,3|6,7,3/6,220322,3
3,1,22,323,1,719,3,11,4,4,7,single-choice,spatial-relational,4|7,7,4/7,220323,4
3,1,22,324,1,923,3,7,2,2,5,single-choice,spatial-relational,2|5,7,2/5,220324,2
3,1,22,325,1,918,5,7,1,1,6,single-choice,spatial-relational,1|6,7,1/6,220325,1
3,1,22,326,1,660,4,10,3,3,7,single-choice,spatial-relational,3|7,7,3/7,220326,3
3,1,22,327,1,1084,1,3,1,1,2,single-choice,spatial-relational,1|2,7,1/2,220327,1
3,1,22,328,1,933,3,7,2,2,5,single-choice,spatial-relational,2|5,7,2/5,220328,2
3,1,22,329,1,644,1,3,1,1,2,single-choice,spatial-relational,1|2,7,1/2,220329,1
3,1,22,330,1,688,2,12,5,5,7,single-choice,spatial-relational,5|7,7,5/7,220330,5
3,1,22,331,1,849,1,13,6,6,7,single-choice,spatial-relational,6|7,7,6/7,220331,6
3,1,22,332,1,917,3,11,4,4,7,single-choice,spatial-relational,4|7,7,4/7,220332,4
3,1,22,333,1,1160,6,8,1,1,7,single-choice,spatial-relational,1|7,7,1/7,220333,1
3,1,22,334,1,967,1,11,5,5,6,single-choice,spatial-relational,5|6,7,5/6,220334,5
3,1,22,335,1,833,1,9,4,4,5,single-choice,spatial-relational,4|5,7,4/5,220335,4
3,1,22,336,1,1128,2,4,1,1,3,single-choice,spatial-relational,1|3,7,1/3,220336,1
3,1,22,337,1,1399,1,9,4,4,5,single-choice,spatial-relational,4|5,7,4/5,220337,4
3,1,22,338,1,1277,3,7,2,2,5,single-choice,spatial-relational,2|5,7,2/5,220338,2
3,1,22,339,1,719,4,10,3,3,7,single-choice,spatial-relational,3|7,7,3/7,220339,3
3,1,22,340,1,793,4,8,2,2,6,single-choice,spatial-relational,2|6,7,2/6,220340,2
3,1,22,341,1,1044,2,10,4,4,6,single-choice,spatial-relational,4|6,7,4/6,220341,4
3,1,22,342,1,965,1,11,5,5,6,single-choice,spatial-relational,5|6,7,5/6,220342,5
3,1,22,343,1,1219,6,8,1,1,7,single-choice,spatial-relational,1|7,7,1/7,220343,1
3,1,22,344,1,758,3,11,4,4,7,single-choice,spatial-relational,4|7,7,4/7,220344,4
3,1,22,345,1,1063,1,7,3,3,4,single-choice,spatial-relational,3|4,7,3/4,220345,3
3,1,22,346,1,757,4,6,1,1,5,single-choice,spatial-relational,1|5,7,1/5,220346,1
3,1,22,347,1,563,1,13,6,6,7,single-choice,spatial-relational,6|7,7,6/7,220347,6
3,1,22,348,0,915,2,8,3,5,5,single-choice,spatial-relational,3|5,7,3/5,220348,3
3,1,22,349,1,701,2,12,5,5,7,single-choice,spatial-relational,5|7,7,5/7,220349,5
3,1,22,350,1,1231,2,4,1,1,3,single-choice,spatial-relational,1|3,7,1/3,220350,1
3,1,22,351,1,970,3,9,3,3,6,single-choice,spatial-relational,3|6,7,3/6,220351,3
3,1,22,352,1,1141,1,5,2,2,3,single-choice,spatial-relational,2|3,7,2/3,220352,2
3,1,22,353,1,811,3,7,2,2,5,single-choice,spatial-relational,2|5,7,2/5,220353,2
3,1,22,354,1,1195,1,11,5,5,6,single-choice,spatial-relational,5|6,7,5/6,220354,5
3,1,22,355,1,1147,3,9,3,3,6,single-choice,spatial-relational,3|6,7,3/6,220355,3
3,1,22,356,1,853,2,8,3,3,5,single-choice,spatial-relational,3|5,7,3/5,220356,3
3,1,22,357,1,839,5,9,2,2,7,single-choice,spatial-relational,2|7,7,2/7,220357,2
3,1,22,358,1,962,2,4,1,1,3,single-choice,spatial-relational,1|3,7,1/3,220358,1
3,1,22,359,1,1010,5,7,1,1,6,single-choice,spatial-relational,1|6,7,1/6,220359,1
3,1,22,360,1,647,1,3,1,1,2,single-choice,spatial-relational,1|2,7,1/2,220360,1
3,1,22,361,1,755,4,10,3,3,7,single-choice,spatial-relational,3|7,7,3/7,220361,3
3,1,22,362,1,891,3,5,1,1,4,single-choice,spatial-relational,1|4,7,1/4,220362,1
3,1,22,363,1,1093,1,7,3,3,4,single-choice,spatial-relational,3|4,7,3/4,220363,3
3,1,22,364,1,1162,6,8,1,1,7,single-choice,spatial-relational,1|7,7,1/7,220364,1
3,1,22,365,1,693,5,9,2,2,7,single-choice,spatial-relational,2|7,7,2/7,220365,2
3,1,22,366,0,575,5,7,1,6,6,single-choice,spatial-relational,1|6,7,1/6,220366,1
3,1,22,367,0,889,1,3,1,2,2,single-choice,spatial-relational,1|2,7,1/2,220367,1
3,1,22,368,1,990,1,9,4,4,5,single-choice,spatial-relational,4|5,7,4/5,220368,4
3,1,22,369,1,1062,4,8,2,2,6,single-choice,spatial-relational,2|6,7,2/6,220369,2
3,1,22,370,1,1016,2,6,2,2,4,single-choice,spatial-relational,2|4,7,2/4,220370,2
3,1,22,371,1,797,1,13,6,6,7,single-choice,spatial-relational,6|7,7,6/7,220371,6
3,1,22,372,1,862,2,6,2,2,4,single-choice,spatial-relational,2|4,7,2/4,220372,2
3,1,22,373,1,809,1,5,2,2,3,single-choice,spatial-relational,2|3,7,2/3,220373,2
3,1,22,374,0,708,3,5,1,4,4,single-choice,spatial-relational,1|4,7,1/4,220374,1
3,1,22,375,1,1382,2,10,4,4,6,single-choice,spatial-relational,4|6,7,4/6,220375,4
3,1,22,376,0,638,4,6,1,5,5,single-choice,spatial-relational,1|5,7,1/5,220376,1
3,1,22,377,1,711,3,11,4,4,7,single-choice,spatial-relational,4|7,7,4/7,220377,4
3,1,22,378,1,676,2,12,5,5,7,single-choice,spatial-relational,5|7,7,5/7,220378,5
3,1,22,379,1,1044,4,8,2,2,6,single-choice,spatial-relational,2|6,7,2/6,220379,2
3,1,22,380,1,1218,3,9,3,3,6,single-choice,spatial-relational,3|6,7,3/6,220380,3
3,1,22,381,1,1056,2,10,4,4,6,single-choice,spatial-relational,4|6,7,4/6,220381,4
3,1,22,382,1,975,3,7,2,2,5,single-choice,spatial-relational,2|5,7,2/5,220382,2
3,1,22,383,1,1655,1,9,4,4,5,single-choice,spatial-relational,4|5,7,4/5,220383,4
3,1,22,384,1,678,3,11,4,4,7,single-choice,spatial-relational,4|7,7,4/7,220384,4
3,1,22,385,0,839,1,11,5,6,6,single-choice,spatial-relational,5|6,7,5/6,220385,5
3,1,22,386,1,1195,1,7,3,3,4,single-choice,spatial-relational,3|4,7,3/4,220386,3
3,1,22,387,1,773,1,13,6,6,7,single-choice,spatial-relational,6|7,7,6/7,220387,6
3,1,22,388,1,912,2,4,1,1,3,single-choice,spatial-relational,1|3,7,1/3,220388,1
3,1,22,389,1,774,1,3,1,1,2,single-choice,spatial-relational,1|2,7,1/2,220389,1
3,1,22,390,1,616,2,12,5,5,7,single-choice,spatial-relational,5|7,7,5/7,220390,5
3,1,22,391,1,863,1,13,6,6,7,single-choice,spatial-relational,6|7,7,6/7,220391,6
3,1,22,392,1,1213,1,9,4,4,5,single-choice,spatial-relational,4|5,7,4/5,220392,4
3,1,22,393,1,1029,2,6,2,2,4,single-choice,spatial-relational,2|4,7,2/4,220393,2
3,1,22,394,1,866,6,8,1,1,7,single-choice,spatial-relational,1|7,7,1/7,220394,1
3,1,22,395,1,899,5,9,2,2,7,single-choice,spatial-relational,2|7,7,2/7,220395,2
3,1,22,396,1,1038,2,8,3,3,5,single-choice,spatial-relational,3|5,7,3/5,220396,3
3,1,22,397,1,1163,3,9,3,3,6,single-choice,spatial-relational,3|6,7,3/6,220397,3
3,1,22,398,1,760,4,10,3,3,7,single-choice,spatial-relational,3|7,7,3/7,220398,3
3,1,22,399,1,878,2,6,2,2,4,single-choice,spatial-relational,2|4,7,2/4,220399,2
3,1,22,400,1,856,4,8,2,2,6,single-choice,spatial-relational,2|6,7,2/6,220400,2
3,1,22,401,1,867,2,4,1,1,3,single-choice,spatial-relational,1|3,7,1/3,220401,1
3,1,22,402,1,1362,5,7,1,1,6,single-choice,spatial-relational,1|6,7,1/6,220402,1
3,1,22,403,1,1017,1,3,1,1,2,single-choice,spatial-relational,1|2,7,1/2,220403,1
3,1,22,404,0,623,4,6,1,5,5,single-choice,spatial-relational,1|5,7,1/5,220404,1
3,1,22,405,1,917,1,7,3,3,4,single-choice,spatial-relational,3|4,7,3/4,220405,3
3,1,22,406,1,895,4,6,1,1,5,single-choice,spatial-relational,1|5,7,1/5,220406,1
3,1,22,407,1,1094,2,8,3,3,5,single-choice,spatial-relational,3|5,7,3/5,220407,3
3,1,22,408,1,1083,3,7,2,2,5,single-choice,spatial-relational,2|5,7,2/5,220408,2
3,1,22,409,1,773,3,11,4,4,7,single-choice,spatial-relational,4|7,7,4/7,220409,4
3,1,22,410,1,913,4,10,3,3,7,single-choice,spatial-relational,3|7,7,3/7,220410,3
3,1,22,411,0,1128,5,7,1,6,6,single-choice,spatial-relational,1|6,7,1/6,220411,1
3,1,22,412,1,1031,2,12,5,5,7,single-choice,spatial-relational,5|7,7,5/7,220412,5
3,1,22,413,1,1282,2,10,4,4,6,single-choice,spatial-relational,4|6,7,4/6,220413,4
3,1,22,414,1,1047,3,5,1,1,4,single-choice,spatial-relational,1|4,7,1/4,220414,1
3,1,22,415,1,832,1,5,2,2,3,single-choice,spatial-relational,2|3,7,2/3,220415,2
3,1,22,416,0,1691,3,5,1,4,4,single-choice,spatial-relational,1|4,7,1/4,220416,1
3,1,22,417,1,848,1,5,2,2,3,single-choice,spatial-relational,2|3,7,2/3,220417,2
3,1,22,418,1,930,5,9,2,2,7,single-choice,spatial-relational,2|7,7,2/7,220418,2
3,1,22,419,1,930,1,11,5,5,6,single-choice,spatial-relational,5|6,7,5/6,220419,5
3,1,22,420,1,1425,6,8,1,1,7,single-choice,spatial-relational,1|7,7,1/7,220420,1
3,1,22,421,1,1230,1,9,4,4,5,single-choice,spatial-relational,4|5,7,4/5,220421,4
3,1,22,422,1,760,3,11,4,4,7,single-choice,spatial-relational,4|7,7,4/7,220422,4
3,1,22,423,1,749,4,10,3,3,7,single-choice,spatial-relational,3|7,7,3/7,220423,3
3,1,22,424,1,1018,4,8,2,2,6,single-choice,spatial-relational,2|6,7,2/6,220424,2
3,1,22,425,1,957,4,6,1,1,5,single-choice,spatial-relational,1|5,7,1/5,220425,1
3,1,22,426,1,1193,3,9,3,3,6,single-choice,spatial-relational,3|6,7,3/6,220426,3
3,1,22,427,1,1194,2,10,4,4,6,single-choice,spatial-relational,4|6,7,4/6,220427,4
3,1,22,428,0,1234,3,7,2,5,5,single-choice,spatial-relational,2|5,7,2/5,220428,2
3,1,22,429,1,1177,2,6,2,2,4,single-choice,spatial-relational,2|4,7,2/4,220429,2
3,1,22,430,0,983,1,5,2,3,3,single-choice,spatial-relational,2|3,7,2/3,220430,2
3,1,22,431,1,740,1,13,6,6,7,single-choice,spatial-relational,6|7,7,6/7,220431,6
3,1,22,432,1,1529,1,7,3,3,4,single-choice,spatial-relational,3|4,7,3/4,220432,3
3,1,22,433,1,865,5,9,2,2,7,single-choice,spatial-relational,2|7,7,2/7,220433,2
3,1,22,434,1,748,1,3,1,1,2,single-choice,spatial-relational,1|2,7,1/2,220434,1
3,1,22,435,1,800,2,4,1,1,3,single-choice,spatial-relational,1|3,7,1/3,220435,1
3,1,22,436,1,1061,4,8,2,2,6,single-choice,spatial-relational,2|6,7,2/6,220436,2
3,1,22,437,1,1038,2,8,3,3,5,single-choice,spatial-relational,3|5,7,3/5,220437,3
3,1,22,438,1,1012,5,7,1,1,6,single-choice,spatial-relational,1|6,7,1/6,220438,1
3,1,22,439,1,653,2,12,5,5,7,single-choice,spatial-relational,5|7,7,5/7,220439,5
3,1,22,440,1,1072,1,11,5,5,6,single-choice,spatial-relational,5|6,7,5/6,220440,5
3,1,22,441,1,1103,1,7,3,3,4,single-choice,spatial-relational,3|4,7,3/4,220441,3
3,1,22,442,1,906,3,7,2,2,5,single-choice,spatial-relational,2|5,7,2/5,220442,2
3,1,22,443,1,1176,2,12,5,5,7,single-choice,spatial-relational,5|7,7,5/7,220443,5
3,1,22,444,1,1125,5,7,1,1,6,single-choice,spatial-relational,1|6,7,1/6,220444,1
3,1,22,445,1,1176,6,8,1,1,7,single-choice,spatial-relational,1|7,7,1/7,220445,1
3,1,22,446,1,730,3,5,1,1,4,single-choice,spatial-relational,1|4,7,1/4,220446,1
3,1,22,447,1,1054,1,11,5,5,6,single-choice,spatial-relational,5|6,7,5/6,220447,5
3,1,22,448,1,1152,3,5,1,1,4,single-choice,spatial-relational,1|4,7,1/4,220448,1
3,1,22,449,1,874,4,10,3,3,7,single-choice,spatial-relational,3|7,7,3/7,220449,3
3,1,22,450,1,1108,1,5,2,2,3,single-choice,spatial-relational,2|3,7,2/3,220450,2
3,1,22,451,1,941,2,6,2,2,4,single-choice,spatial-relational,2|4,7,2/4,220451,2
3,1,22,452,1,1020,1,9,4,4,5,single-choice,spatial-relational,4|5,7,4/5,220452,4
3,1,22,453,1,1013,2,4,1,1,3,single-choice,spatial-relational,1|3,7,1/3,220453,1
3,1,22,454,1,890,5,9,2,2,7,single-choice,spatial-relational,2|7,7,2/7,220454,2
3,1,22,455,1,1277,3,9,3,3,6,single-choice,spatial-relational,3|6,7,3/6,220455,3
3,1,22,456,1,1079,2,10,4,4,6,single-choice,spatial-relational,4|6,7,4/6,220456,4
3,1,22,457,1,764,4,6,1,1,5,single-choice,spatial-relational,1|5,7,1/5,220457,1
3,1,22,458,1,954,2,8,3,3,5,single-choice,spatial-relational,3|5,7,3/5,220458,3
3,1,22,459,1,1018,3,11,4,4,7,single-choice,spatial-relational,4|7,7,4/7,220459,4
3,1,22,460,1,950,1,3,1,1,2,single-choice,spatial-relational,1|2,7,1/2,220460,1
3,1,22,461,1,906,1,13,6,6,7,single-choice,spatial-relational,6|7,7,6/7,220461,6
3,1,22,462,0,724,6,8,1,7,7,single-choice,spatial-relational,1|7,7,1/7,220462,1
3,1,22,463,1,1038,1,9,4,4,5,single-choice,spatial-relational,4|5,7,4/5,220463,4
3,1,22,464,1,900,2,4,1,1,3,single-choice,spatial-relational,1|3,7,1/3,220464,1
3,1,22,465,1,1229,6,8,1,1,7,single-choice,spatial-relational,1|7,7,1/7,220465,1
3,1,22,466,1,1210,2,10,4,4,6,single-choice,spatial-relational,4|6,7,4/6,220466,4
3,1,22,467,1,1274,2,10,4,4,6,single-choice,spatial-relational,4|6,7,4/6,220467,4
3,1,22,468,1,924,5,9,2,2,7,single-choice,spatial-relational,2|7,7,2/7,220468,2
3,1,22,469,0,1025,3,9,3,6,6,single-choice,spatial-relational,3|6,7,3/6,220469,3
3,1,22,470,1,964,2,6,2,2,4,single-choice,spatial-relational,2|4,7,2/4,220470,2
3,1,22,471,1,918,4,6,1,1,5,single-choice,spatial-relational,1|5,7,1/5,220471,1
3,1,22,472,1,1078,5,7,1,1,6,single-choice,spatial-relational,1|6,7,1/6,220472,1
3,1,22,473,1,730,3,11,4,4,7,single-choice,spatial-relational,4|7,7,4/7,220473,4
3,1,22,474,1,1069,5,9,2,2,7,single-choice,spatial-relational,2|7,7,2/7,220474,2
3,1,22,475,1,754,1,3,1,1,2,single-choice,spatial-relational,1|2,7,1/2,220475,1
3,1,22,476,0,1421,2,4,1,3,3,single-choice,spatial-relational,1|3,7,1/3,220476,1
3,1,22,477,1,1138,3,9,3,3,6,single-choice,spatial-relational,3|6,7,3/6,220477,3
3,1,22,478,1,849,1,13,6,6,7,single-choice,spatial-relational,6|7,7,6/7,220478,6
3,1,22,479,1,831,1,13,6,6,7,single-choice,spatial-relational,6|7,7,6/7,220479,6
3,1,22,480,1,1238,3,7,2,2,5,single-choice,spatial-relational,2|5,7,2/5,220480,2
3,1,22,481,1,852,3,7,2,2,5,single-choice,spatial-relational,2|5,7,2/5,220481,2
3,1,22,482,1,1036,4,6,1,1,5,single-choice,spatial-relational,1|5,7,1/5,220482,1
3,1,22,483,1,794,1,7,3,3,4,single-choice,spatial-relational,3|4,7,3/4,220483,3
3,1,22,484,1,885,1,3,1,1,2,single-choice,spatial-relational,1|2,7,1/2,220484,1
3,1,22,485,1,809,4,10,3,3,7,single-choice,spatial-relational,3|7,7,3/7,220485,3
3,1,22,486,0,923,1,5,2,3,3,single-choice,spatial-relational,2|3,7,2/3,220486,2
3,1,22,487,1,996,2,12,5,5,7,single-choice,spatial-relational,5|7,7,5/7,220487,5
3,1,22,488,1,1050,6,8,1,1,7,single-choice,spatial-relational,1|7,7,1/7,220488,1
3,1,22,489,1,1216,1,7,3,3,4,single-choice,spatial-relational,3|4,7,3/4,220489,3
3,1,22,490,1,1200,1,11,5,5,6,single-choice,spatial-relational,5|6,7,5/6,220490,5
3,1,22,491,1,939,3,11,4,4,7,single-choice,spatial-relational,4|7,7,4/7,220491,4
3,1,22,492,1,1196,4,8,2,2,6,single-choice,spatial-relational,2|6,7,2/6,220492,2
3,1,22,493,1,1060,5,7,1,1,6,single-choice,spatial-relational,1|6,7,1/6,220493,1
3,1,22,494,1,1094,4,8,2,2,6,single-choice,spatial-relational,2|6,7,2/6,220494,2
3,1,22,495,1,937,4,10,3,3,7,single-choice,spatial-relational,3|7,7,3/7,220495,3
3,1,22,496,1,793,2,6,2,2,4,single-choice,spatial-relational,2|4,7,2/4,220496,2
3,1,22,497,1,777,3,5,1,1,4,single-choice,spatial-relational,1|4,7,1/4,220497,1
3,1,22,498,0,1567,1,9,4,5,5,single-choice,spatial-relational,4|5,7,4/5,220498,4
3,1,22,499,1,1078,3,5,1,1,4,single-choice,spatial-relational,1|4,7,1/4,220499,1
3,1,22,500,1,628,2,12,5,5,7,single-choice,spatial-relational,5|7,7,5/7,220500,5
3,1,22,501,1,1576,2,8,3,3,5,single-choice,spatial-relational,3|5,7,3/5,220501,3
3,1,22,502,1,985,1,11,5,5,6,single-choice,spatial-relational,5|6,7,5/6,220502,5
3,1,22,503,1,960,1,5,2,2,3,single-choice,spatial-relational,2|3,7,2/3,220503,2
3,1,22,504,1,972,2,8,3,3,5,single-choice,spatial-relational,3|5,7,3/5,220504,3
3,1,22,505,1,1113,1,5,2,2,3,single-choice,spatial-relational,2|3,7,2/3,220505,2
3,1,22,506,1,1034,2,10,4,4,6,single-choice,spatial-relational,4|6,7,4/6,220506,4
3,1,22,507,0,1111,1,9,4,5,5,single-choice,spatial-relational,4|5,7,4/5,220507,4
3,1,22,508,1,855,1,7,3,3,4,single-choice,spatial-relational,3|4,7,3/4,220508,3
3,1,22,509,1,1022,3,7,2,2,5,single-choice,spatial-relational,2|5,7,2/5,220509,2
3,1,22,510,1,903,4,10,3,3,7,single-choice,spatial-relational,3|7,7,3/7,220510,3
3,1,22,511,1,924,5,9,2,2,7,single-choice,spatial-relational,2|7,7,2/7,220511,2
3,1,22,512,1,1790,1,7,3,3,4,single-choice,spatial-relational,3|4,7,3/4,220512,3
3,1,22,513,1,827,2,6,2,2,4,single-choice,spatial-relational,2|4,7,2/4,220513,2
3,1,22,514,1,1145,4,6,1,1,5,single-choice,spatial-relational,1|5,7,1/5,220514,1
3,1,22,515,1,1008,3,9,3,3,6,single-choice,spatial-relational,3|6,7,3/6,220515,3
3,1,22,516,1,905,4,6,1,1,5,single-choice,spatial-relational,1|5,7,1/5,220516,1
3,1,22,517,1,1176,6,8,1,1,7,single-choice,spatial-relational,1|7,7,1/7,220517,1
3,1,22,518,1,663,2,12,5,5,7,single-choice,spatial-relational,5|7,7,5/7,220518,5
3,1,22,519,1,1125,1,9,4,4,5,single-choice,spatial-relational,4|5,7,4/5,220519,4
3,1,22,520,1,1097,5,9,2,2,7,single-choice,spatial-relational,2|7,7,2/7,220520,2
3,1,22,521,1,825,1,11,5,5,6,single-choice,spatial-relational,5|6,7,5/6,220521,5
3,1,22,522,1,1223,2,8,3,3,5,single-choice,spatial-relational,3|5,7,3/5,220522,3
3,1,22,523,1,909,5,7,1,1,6,single-choice,spatial-relational,1|6,7,1/6,220523,1
3,1,22,524,1,1174,5,7,1,1,6,single-choice,spatial-relational,1|6,7,1/6,220524,1
3,1,22,525,0,707,3,5,1,4,4,single-choice,spatial-relational,1|4,7,1/4,220525,1
3,1,22,526,1,855,1,3,1,1,2,single-choice,spatial-relational,1|2,7,1/2,220526,1
3,1,22,527,1,802,2,4,1,1,3,single-choice,spatial-relational,1|3,7,1/3,220527,1
3,1,22,528,1,915,3,11,4,4,7,single-choice,spatial-relational,4|7,7,4/7,220528,4
3,1,22,529,1,1109,6,8,1,1,7,single-choice,spatial-relational,1|7,7,1/7,220529,1
3,1,22,530,1,843,1,5,2,2,3,single-choice,spatial-relational,2|3,7,2/3,220530,2
3,1,22,531,1,806,3,7,2,2,5,single-choice,spatial-relational,2|5,7,2/5,220531,2
3,1,22,532,1,1519,2,10,4,4,6,single-choice,spatial-relational,4|6,7,4/6,220532,4
3,1,22,533,1,854,4,10,3,3,7,single-choice,spatial-relational,3|7,7,3/7,220533,3
3,1,22,534,1,1138,1,11,5,5,6,single-choice,spatial-relational,5|6,7,5/6,220534,5
3,1,22,535,1,872,3,5,1,1,4,single-choice,spatial-relational,1|4,7,1/4,220535,1
3,1,22,536,0,770,2,4,1,3,3,single-choice,spatial-relational,1|3,7,1/3,220536,1
3,1,22,537,1,990,4,8,2,2,6,single-choice,spatial-relational,2|6,7,2/6,220537,2
3,1,22,538,1,707,1,13,6,6,7,single-choice,spatial-relational,6|7,7,6/7,220538,6
3,1,22,539,1,1080,2,8,3,3,5,single-choice,spatial-relational,3|5,7,3/5,220539,3
3,1,22,540,1,1279,3,9,3,3,6,single-choice,spatial-relational,3|6,7,3/6,220540,3
3,1,22,541,0,991,1,3,1,2,2,single-choice,spatial-relational,1|2,7,1/2,220541,1
3,1,22,542,1,773,2,12,5,5,7,single-choice,spatial-relational,5|7,7,5/7,220542,5
3,1,22,543,1,707,3,11,4,4,7,single-choice,spatial-relational,4|7,7,4/7,220543,4
3,1,22,544,1,1062,4,8,2,2,6,single-choice,spatial-relational,2|6,7,2/6,220544,2
3,1,22,545,1,909,2,6,2,2,4,single-choice,spatial-relational,2|4,7,2/4,220545,2
3,1,22,546,1,652,1,13,6,6,7,single-choice,spatial-relational,6|7,7,6/7,220546,6
3,1,22,547,0,1189,1,9,4,5,5,single-choice,spatial-relational,4|5,7,4/5,220547,4
3,1,22,548,1,1856,4,8,2,2,6,single-choice,spatial-relational,2|6,7,2/6,220548,2
3,1,22,549,1,647,3,11,4,4,7,single-choice,spatial-relational,4|7,7,4/7,220549,4
3,1,22,550,1,1032,2,8,3,3,5,single-choice,spatial-relational,3|5,7,3/5,220550,3
3,1,22,551,0,1220,2,8,3,5,5,single-choice,spatial-relational,3|5,7,3/5,220551,3
3,1,22,552,1,1030,2,10,4,4,6,single-choice,spatial-relational,4|6,7,4/6,220552,4
3,1,22,553,1,954,3,5,1,1,4,single-choice,spatial-relational,1|4,7,1/4,220553,1
3,1,22,554,1,1259,1,11,5,5,6,single-choice,spatial-relational,5|6,7,5/6,220554,5
3,1,22,555,0,863,1,3,1,2,2,single-choice,spatial-relational,1|2,7,1/2,220555,1
3,1,22,556,1,874,1,11,5,5,6,single-choice,spatial-relational,5|6,7,5/6,220556,5
3,1,22,557,1,1054,4,10,3,3,7,single-choice,spatial-relational,3|7,7,3/7,220557,3
3,1,22,558,1,1021,2,4,1,1,3,single-choice,spatial-relational,1|3,7,1/3,220558,1
3,1,22,559,1,825,1,13,6,6,7,single-choice,spatial-relational,6|7,7,6/7,220559,6
3,1,22,560,1,1104,2,4,1,1,3,single-choice,spatial-relational,1|3,7,1/3,220560,1
3,1,22,561,0,1493,5,9,2,7,7,single-choice,spatial-relational,2|7,7,2/7,220561,2
3,1,22,562,1,972,4,6,1,1,5,single-choice,spatial-relational,1|5,7,1/5,220562,1
3,1,22,563,1,1091,1,5,2,2,3,single-choice,spatial-relational,2|3,7,2/3,220563,2
3,1,22,564,1,844,1,3,1,1,2,single-choice,spatial-relational,1|2,7,1/2,220564,1
3,1,22,565,1,603,1,13,6,6,7,single-choice,spatial-relational,6|7,7,6/7,220565,6
3,1,22,566,1,1311,5,7,1,1,6,single-choice,spatial-relational,1|6,7,1/6,220566,1
3,1,22,567,1,688,2,12,5,5,7,single-choice,spatial-relational,5|7,7,5/7,220567,5
3,1,22,568,1,619,2,12,5,5,7,single-choice,spatial-relational,5|7,7,5/7,220568,5
3,1,22,569,1,1175,1,7,3,3,4,single-choice,spatial-relational,3|4,7,3/4,220569,3
3,1,22,570,1,1068,4,8,2,2,6,single-choice,spatial-relational,2|6,7,2/6,220570,2
3,1,22,571,1,1112,6,8,1,1,7,single-choice,spatial-relational,1|7,7,1/7,220571,1
3,1,22,572,1,801,5,7,1,1,6,single-choice,spatial-relational,1|6,7,1/6,220572,1
3,1,22,573,1,737,4,10,3,3,7,single-choice,spatial-relational,3|7,7,3/7,220573,3
3,1,22,574,1,760,3,5,1,1,4,single-choice,spatial-relational,1|4,7,1/4,220574,1
3,1,22,575,1,878,3,7,2,2,5,single-choice,spatial-relational,2|5,7,2/5,220575,2
3,1,22,576,1,1082,1,7,3,3,4,single-choice,spatial-relational,3|4,7,3/4,220576,3
3,1,22,577,0,918,1,5,2,3,3,single-choice,spatial-relational,2|3,7,2/3,220577,2
3,1,22,578,1,904,2,10,4,4,6,single-choice,spatial-relational,4|6,7,4/6,220578,4
3,1,22,579,1,1413,1,9,4,4,5,single-choice,spatial-relational,4|5,7,4/5,220579,4
3,1,22,580,1,1269,3,9,3,3,6,single-choice,spatial-relational,3|6,7,3/6,220580,3
3,1,22,581,0,1048,6,8,1,7,7,single-choice,spatial-relational,1|7,7,1/7,220581,1
3,1,22,582,1,1134,3,7,2,2,5,single-choice,spatial-relational,2|5,7,2/5,220582,2
3,1,22,583,1,1202,3,9,3,3,6,single-choice,spatial-relational,3|6,7,3/6,220583,3
3,1,22,584,1,803,2,6,2,2,4,single-choice,spatial-relational,2|4,7,2/4,220584,2
3,1,22,585,1,912,2,6,2,2,4,single-choice,spatial-relational,2|4,7,2/4,220585,2
3,1,22,586,1,1135,4,6,1,1,5,single-choice,spatial-relational,1|5,7,1/5,220586,1
3,1,22,587,1,777,5,9,2,2,7,single-choice,spatial-relational,2|7,7,2/7,220587,2
3,1,22,588,1,655,3,11,4,4,7,single-choice,spatial-relational,4|7,7,4/7,220588,4
3,1,22,589,1,1358,2,10,4,4,6,single-choice,spatial-relational,4|6,7,4/6,220589,4
3,1,22,590,1,738,1,13,6,6,7,single-choice,spatial-relational,6|7,7,6/7,220590,6
3,1,22,591,0,1576,2,8,3,5,5,single-choice,spatial-relational,3|5,7,3/5,220591,3
3,1,22,592,1,809,2,6,2,2,4,single-choice,spatial-relational,2|4,7,2/4,220592,2
3,1,22,593,1,1213,4,8,2,2,6,single-choice,spatial-relational,2|6,7,2/6,220593,2
3,1,22,594,1,955,2,6,2,2,4,single-choice,spatial-relational,2|4,7,2/4,220594,2
3,1,22,595,1,1332,3,9,3,3,6,single-choice,spatial-relational,3|6,7,3/6,220595,3
3,1,22,596,1,1771,1,11,5,5,6,single-choice,spatial-relational,5|6,7,5/6,220596,5
3,1,22,597,1,886,2,12,5,5,7,single-choice,spatial-relational,5|7,7,5/7,220597,5
3,1,22,598,1,914,1,5,2,2,3,single-choice,spatial-relational,2|3,7,2/3,220598,2
3,1,22,599,1,1183,1,11,5,5,6,single-choice,spatial-relational,5|6,7,5/6,220599,5
3,1,22,600,1,793,1,5,2,2,3,single-choice,spatial-relational,2|3,7,2/3,220600,2
1,1,23,1,0,5730,1,5,2,3,3,single-choice,spatial-relational,2|3,7,2/3,230001,2
1,1,23,2,1,680,1,13,6,6,7,single-choice,spatial-relational,6|7,7,6/7,230002,6
1,1,23,3,1,459,1,11,5,5,6,single-choice,spatial-relational,5|6,7,5/6,230003,5
1,1,23,4,0,641,1,7,3,4,4,single-choice,spatial-relational,3|4,7,3/4,230004,3
1,1,23,5,1,504,1,13,6,6,7,single-choice,spatial-relational,6|7,7,6/7,230005,6
1,1,23,6,1,583,1,3,1,1,2,single-choice,spatial-relational,1|2,7,1/2,230006,1
1,1,23,7,0,673,1,9,4,5,5,single-choice,spatial-relational,4|5,7,4/5,230007,4
1,1,23,8,0,4,1,3,1,2,2,single-choice,spatial-relational,1|2,7,1/2,230008,1
1,1,23,9,1,759,1,5,2,2,3,single-choice,spatial-relational,2|3,7,2/3,230009,2
1,1,23,10,0,687,1,7,3,4,4,single-choice,spatial-relational,3|4,7,3/4,230010,3
1,1,23,11,0,693,1,11,5,6,6,single-choice,spatial-relational,5|6,7,5/6,230011,5
1,1,23,12,1,833,1,9,4,4,5,single-choice,spatial-relational,4|5,7,4/5,230012,4
1,1,23,13,0,733,1,3,1,2,2,single-choice,spatial-relational,1|2,7,1/2,230013,1
1,1,23,14,0,862,1,7,3,4,4,single-choice,spatial-relational,3|4,7,3/4,230014,3
1,1,23,15,1,1013,1,5,2,2,3,single-choice,spatial-relational,2|3,7,2/3,230015,2
1,1,23,16,1,590,1,13,6,6,7,single-choice,spatial-relational,6|7,7,6/7,230016,6
1,1,23,17,1,707,1,9,4,4,5,single-choice,spatial-relational,4|5,7,4/5,230017,4
1,1,23,18,0,892,1,11,5,6,6,single-choice,spatial-relational,5|6,7,5/6,230018,5
1,1,23,19,0,6,1,7,3,4,4,single-choice,spatial-relational,3|4,7,3/4,230019,3
1,1,23,20,1,799,1,3,1,1,2,single-choice,spatial-relational,1|2,7,1/2,230020,1
1,1,23,21,0,720,1,5,2,3,3,single-choice,spatial-relational,2|3,7,2/3,230021,2
1,1,23,22,0,1041,1,9,4,5,5,single-choice,spatial-relational,4|5,7,4/5,230022,4
1,1,23,23,1,710,1,13,6,6,7,single-choice,spatial-relational,6|7,7,6/7,230023,6
1,1,23,24,0,789,1,11,5,6,6,single-choice,spatial-relational,5|6,7,5/6,230024,5
1,1,23,25,0,849,1,11,5,6,6,single-choice,spatial-relational,5|6,7,5/6,230025,5
1,1,23,26,1,882,1,5,2,2,3,single-choice,spatial-relational,2|3,7,2/3,230026,2
1,1,23,27,1,765,1,9,4,4,5,single-choice,spatial-relational,4|5,7,4/5,230027,4
1,1,23,28,0,863,1,7,3,4,4,single-choice,spatial-relational,3|4,7,3/4,230028,3
1,1,23,29,0,830,1,5,2,3,3,single-choice,spatial-relational,2|3,7,2/3,230029,2
1,1,23,30,0,709,1,11,5,6,6,single-choice,spatial-relational,5|6,7,5/6,230030,5
1,1,23,31,1,864,1,9,4,4,5,single-choice,spatial-relational,4|5,7,4/5,230031,4
1,1,23,32,1,864,1,3,1,1,2,single-choice,spatial-relational,1|2,7,1/2,230032,1
1,1,23,33,1,617,1,13,6,6,7,single-choice,spatial-relational,6|7,7,6/7,230033,6
1,1,23,34,0,704,1,7,3,4,4,single-choice,spatial-relational,3|4,7,3/4,230034,3
1,1,23,35,1,812,1,13,6,6,7,single-choice,spatial-relational,6|7,7,6/7,230035,6
1,1,23,36,0,756,1,3,1,2,2,single-choice,spatial-relational,1|2,7,1/2,230036,1
1,1,23,37,0,751,1,11,5,6,6,single-choice,spatial-relational,5|6,7,5/6,230037,5
1,1,23,38,0,734,1,3,1,2,2,single-choice,spatial-relational,1|2,7,1/2,230038,1
1,1,23,39,0,904,1,5,2,3,3,single-choice,spatial-relational,2|3,7,2/3,230039,2
1,1,23,40,1,560,1,13,6,6,7,single-choice,spatial-relational,6|7,7,6/7,230040,6
1,1,23,41,0,729,1,7,3,4,4,single-choice,spatial-relational,3|4,7,3/4,230041,3
1,1,23,42,1,678,1,5,2,2,3,single-choice,spatial-relational,2|3,7,2/3,230042,2
1,1,23,43,0,670,1,7,3,4,4,single-choice,spatial-relational,3|4,7,3/4,230043,3
1,1,23,44,1,717,1,13,6,6,7,single-choice,spatial-relational,6|7,7,6/7,230044,6
1,1,23,45,0,1333,1,9,4,5,5,single-choice,spatial-relational,4|5,7,4/5,230045,4
1,1,23,46,0,846,1,11,5,6,6,single-choice,spatial-relational,5|6,7,5/6,230046,5
1,1,23,47,0,785,1,9,4,5,5,single-choice,spatial-relational,4|5,7,4/5,230047,4
1,1,23,48,1,620,1,3,1,1,2,single-choice,spatial-relational,1|2,7,1/2,230048,1
1,1,23,49,1,757,1,13,6,6,7,single-choice,spatial-relational,6|7,7,6/7,230049,6
1,1,23,50,0,1063,1,7,3,4,4,single-choice,spatial-relational,3|4,7,3/4,230050,3
1,1,23,51,1,4,1,9,4,4,5,single-choice,spatial-relational,4|5,7,4/5,230051,4
1,1,23,52,0,582,1,7,3,4,4,single-choice,spatial-relational,3|4,7,3/4,230052,3
1,1,23,53,1,773,1,9,4,4,5,single-choice,spatial-relational,4|5,7,4/5,230053,4
1,1,23,54,0,1717,1,11,5,6,6,single-choice,spatial-relational,5|6,7,5/6,230054,5
1,1,23,55,1,669,1,13,6,6,7,single-choice,spatial-relational,6|7,7,6/7,230055,6
1,1,23,56,0,1814,1,3,1,2,2,single-choice,spatial-relational,1|2,7,1/2,230056,1
1,1,23,57,1,1006,1,3,1,1,2,single-choice,spatial-relational,1|2,7,1/2,230057,1
1,1,23,58,0,609,1,5,2,3,3,single-choice,spatial-relational,2|3,7,2/3,230058,2
1,1,23,59,0,739,1,11,5,6,6,single-choice,spatial-relational,5|6,7,5/6,230059,5
1,1,23,60,1,529,1,5,2,2,3,single-choice,spatial-relational,2|3,7,2/3,230060,2
1,1,23,61,0,697,1,7,3,4,4,single-choice,spatial-relational,3|4,7,3/4,230061,3
1,1,23,62,0,944,1,7,3,4,4,single-choice,spatial-relational,3|4,7,3/4,230062,3
1,1,23,63,0,948,1,5,2,3,3,single-choice,spatial-relational,2|3,7,2/3,230063,2
1,1,23,64,1,563,1,13,6,6,7,single-choice,spatial-relational,6|7,7,6/7,230064,6
1,1,23,65,1,1039,1,5,2,2,3,single-choice,spatial-relational,2|3,7,2/3,230065,2
1,1,23,66,0,837,1,11,5,6,6,single-choice,spatial-relational,5|6,7,5/6,230066,5
1,1,23,67,0,716,1,11,5,6,6,single-choice,spatial-relational,5|6,7,5/6,230067,5
1,1,23,68,1,1040,1,9,4,4,5,single-choice,spatial-relational,4|5,7,4/5,230068,4
1,1,23,69,0,1040,1,9,4,5,5,single-choice,spatial-relational,4|5,7,4/5,230069,4
1,1,23,70,1,821,1,13,6,6,7,single-choice,spatial-relational,6|7,7,6/7,230070,6
1,1,23,71,0,1497,1,3,1,2,2,single-choice,spatial-relational,1|2,7,1/2,230071,1
1,1,23,72,1,706,1,3,1,1,2,single-choice,spatial-relational,1|2,7,1/2,230072,1
1,1,23,73,0,756,1,5,2,3,3,single-choice,spatial-relational,2|3,7,2/3,230073,2
1,1,23,74,1,819,1,3,1,1,2,single-choice,spatial-relational,1|2,7,1/2,230074,1
1,1,23,75,1,1093,1,13,6,6,7,single-choice,spatial-relational,6|7,7,6/7,230075,6
1,1,23,76,1,1475,1,13,6,6,7,single-choice,spatial-relational,6|7,7,6/7,230076,6
1,1,23,77,0,807,1,11,5,6,6,single-choice,spatial-relational,5|6,7,5/6,230077,5
1,1,23,78,1,909,1,5,2,2,3,single-choice,spatial-relational,2|3,7,2/3,230078,2
1,1,23,79,0,680,1,7,3,4,4,single-choice,spatial-relational,3|4,7,3/4,230079,3
1,1,23,80,0,1010,1,7,3,4,4,single-choice,spatial-relational,3|4,7,3/4,230080,3
1,1,23,81,1,891,1,9,4,4,5,single-choice,spatial-relational,4|5,7,4/5,230081,4
1,1,23,82,1,909,1,9,4,4,5,single-choice,spatial-relational,4|5,7,4/5,230082,4
1,1,23,83,0,1211,1,11,5,6,6,single-choice,spatial-relational,5|6,7,5/6,230083,5
1,1,23,84,0,1160,1,3,1,2,2,single-choice,spatial-relational,1|2,7,1/2,230084,1
1,1,23,85,1,930,1,9,4,4,5,single-choice,spatial-relational,4|5,7,4/5,230085,4
1,1,23,86,0,1184,1,11,5,6,6,single-choice,spatial-relational,5|6,7,5/6,230086,5
1,1,23,87,1,1040,1,13,6,6,7,single-choice,spatial-relational,6|7,7,6/7,230087,6
1,1,23,88,0,851,1,3,1,2,2,single-choice,spatial-relational,1|2,7,1/2,230088,1
1,1,23,89,1,1045,1,5,2,2,3,single-choice,spatial-relational,2|3,7,2/3,230089,2
1,1,23,90,1,820,1,5,2,2,3,single-choice,spatial-relational,2|3,7,2/3,230090,2
1,1,23,91,1,936,1,13,6,6,7,single-choice,spatial-relational,6|7,7,6/7,230091,6
1,1,23,92,0,749,1,7,3,4,4,single-choice,spatial-relational,3|4,7,3/4,230092,3
1,1,23,93,0,657,1,11,5,6,6,single-choice,spatial-relational,5|6,7,5/6,230093,5
1,1,23,94,1,742,1,9,4,4,5,single-choice,spatial-relational,4|5,7,4/5,230094,4
1,1,23,95,0,759,1,7,3,4,4,single-choice,spatial-relational,3|4,7,3/4,230095,3
1,1,23,96,1,855,1,3,1,1,2,single-choice,spatial-relational,1|2,7,1/2,230096,1
1,1,23,97,0,761,1,7,3,4,4,single-choice,spatial-relational,3|4,7,3/4,230097,3
1,1,23,98,0,760,1,3,1,2,2,single-choice,spatial-relational,1|2,7,1/2,230098,1
1,1,23,99,1,591,1,9,4,4,5,single-choice,spatial-relational,4|5,7,4/5,230099,4
1,1,23,100,1,860,1,13,6,6,7,single-choice,spatial-relational,6|7,7,6/7,230100,6
1,1,23,101,1,1074,1,5,2,2,3,single-choice,spatial-relational,2|3,7,2/3,230101,2
1,1,23,102,1,880,1,3,1,1,2,single-choice,spatial-relational,1|2,7,1/2,230102,1
1,1,23,103,0,1358,1,9,4,5,5,single-choice,spatial-relational,4|5,7,4/5,230103,4
1,1,23,104,0,556,1,11,5,6,6,single-choice,spatial-relational,5|6,7,5/6,230104,5
1,1,23,105,0,140,1,11,5,6,6,single-choice,spatial-relational,5|6,7,5/6,230105,5
1,1,23,106,0,737,1,7,3,4,4,single-choice,spatial-relational,3|4,7,3/4,230106,3
1,1,23,107,1,1039,1,13,6,6,7,single-choice,spatial-relational,6|7,7,6/7,230107,6
1,1,23,108,1,841,1,5,2,2,3,single-choice,spatial-relational,2|3,7,2/3,230108,2
1,1,23,109,0,936,1,11,5,6,6,single-choice,spatial-relational,5|6,7,5/6,230109,5
1,1,23,110,0,1185,1,3,1,2,2,single-choice,spatial-relational,1|2,7,1/2,230110,1
1,1,23,111,1,888,1,9,4,4,5,single-choice,spatial-relational,4|5,7,4/5,230111,4
1,1,23,112,0,1026,1,11,5,6,6,single-choice,spatial-relational,5|6,7,5/6,230112,5
1,1,23,113,1,1126,1,5,2,2,3,single-choice,spatial-relational,2|3,7,2/3,230113,2
1,1,23,114,1,649,1,9,4,4,5,single-choice,spatial-relational,4|5,7,4/5,230114,4
1,1,23,115,0,871,1,7,3,4,4,single-choice,spatial-relational,3|4,7,3/4,230115,3
1,1,23,116,0,624,1,7,3,4,4,single-choice,spatial-relational,3|4,7,3/4,230116,3
1,1,23,117,0,681,1,5,2,3,3,single-choice,spatial-relational,2|3,7,2/3,230117,2
1,1,23,118,1,610,1,13,6,6,7,single-choice,spatial-relational,6|7,7,6/7,230118,6
1,1,23,119,0,1147,1,3,1,2,2,single-choice,spatial-relational,1|2,7,1/2,230119,1
1,1,23,120,1,829,1,13,6,6,7,single-choice,spatial-relational,6|7,7,6/7,230120,6
1,1,23,121,1,774,1,13,6,6,7,single-choice,spatial-relational,6|7,7,6/7,230121,6
1,1,23,122,1,741,1,9,4,4,5,single-choice,spatial-relational,4|5,7,4/5,230122,4
1,1,23,123,1,694,1,5,2,2,3,single-choice,spatial-relational,2|3,7,2/3,230123,2
1,1,23,124,0,877,1,3,1,2,2,single-choice,spatial-relational,1|2,7,1/2,230124,1
1,1,23,125,1,781,1,13,6,6,7,single-choice,spatial-relational,6|7,7,6/7,230125,6
1,1,23,126,0,601,1,11,5,6,6,single-choice,spatial-relational,5|6,7,5/6,230126,5
1,1,23,127,0,538,1,11,5,6,6,single-choice,spatial-relational,5|6,7,5/6,230127,5
1,1,23,128,1,836,1,5,2,2,3,single-choice,spatial-relational,2|3,7,2/3,230128,2
1,1,23,129,0,579,1,7,3,4,4,single-choice,spatial-relational,3|4,7,3/4,230129,3
1,1,23,130,0,1028,1,3,1,2,2,single-choice,spatial-relational,1|2,7,1/2,230130,1
1,1,23,131,0,491,1,7,3,4,4,single-choice,spatial-relational,3|4,7,3/4,230131,3
1,1,23,132,1,998,1,9,4,4,5,single-choice,spatial-relational,4|5,7,4/5,230132,4
1,1,23,133,0,683,1,7,3,4,4,single-choice,spatial-relational,3|4,7,3/4,230133,3
1,1,23,134,0,588,1,3,1,2,2,single-choice,spatial-relational,1|2,7,1/2,230134,1
1,1,23,135,1,496,1,5,2,2,3,single-choice,spatial-relational,2|3,7,2/3,230135,2
1,1,23,136,1,761,1,9,4,4,5,single-choice,spatial-relational,4|5,7,4/5,230136,4
1,1,23,137,1,771,1,9,4,4,5,single-choice,spatial-relational,4|5,7,4/5,230137,4
1,1,23,138,0,727,1,11,5,6,6,single-choice,spatial-relational,5|6,7,5/6,230138,5
1,1,23,139,0,1016,1,3,1,2,2,single-choice,spatial-relational,1|2,7,1/2,230139,1
1,1,23,140,1,849,1,5,2,2,3,single-choice,spatial-relational,2|3,7,2/3,230140,2
1,1,23,141,0,1030,1,13,6,7,7,single-choice,spatial-relational,6|7,7,6/7,230141,6
1,1,23,142,0,884,1,7,3,4,4,single-choice,spatial-relational,3|4,7,3/4,230142,3
1,1,23,143,0,778,1,11,5,6,6,single-choice,spatial-relational,5|6,7,5/6,230143,5
1,1,23,144,1,488,1,13,6,6,7,single-choice,spatial-relational,6|7,7,6/7,230144,6
1,1,23,145,0,677,1,3,1,2,2,single-choice,spatial-relational,1|2,7,1/2,230145,1
1,1,23,146,1,829,1,13,6,6,7,single-choice,spatial-relational,6|7,7,6/7,230146,6
1,1,23,147,1,937,1,13,6,6,7,single-choice,spatial-relational,6|7,7,6/7,230147,6
1,1,23,148,0,1008,1,3,1,2,2,single-choice,spatial-relational,1|2,7,1/2,230148,1
1,1,23,149,1,813,1,5,2,2,3,single-choice,spatial-relational,2|3,7,2/3,230149,2
1,1,23,150,1,801,1,5,2,2,3,single-choice,spatial-relational,2|3,7,2/3,230150,2
1,1,23,151,1,1095,1,9,4,4,5,single-choice,spatial-relational,4|5,7,4/5,230151,4
1,1,23,152,0,1165,1,9,4,5,5,single-choice,spatial-relational,4|5,7,4/5,230152,4
1,1,23,153,0,832,1,11,5,6,6,single-choice,spatial-relational,5|6,7,5/6,230153,5
1,1,23,154,0,958,1,7,3,4,4,single-choice,spatial-relational,3|4,7,3/4,230154,3
1,1,23,155,0,761,1,7,3,4,4,single-choice,spatial-relational,3|4,7,3/4,230155,3
1,1,23,156,0,651,1,11,5,6,6,single-choice,spatial-relational,5|6,7,5/6,230156,5
1,1,23,157,1,602,1,9,4,4,5,single-choice,spatial-relational,4|5,7,4/5,230157,4
1,1,23,158,0,652,1,11,5,6,6,single-choice,spatial-relational,5|6,7,5/6,230158,5
1,1,23,159,0,530,1,13,6,7,7,single-choice,spatial-relational,6|7,7,6/7,230159,6
1,1,23,160,1,636,1,5,2,2,3,single-choice,spatial-relational,2|3,7,2/3,230160,2
1,1,23,161,0,846,1,11,5,6,6,single-choice,spatial-relational,5|6,7,5/6,230161,5
1,1,23,162,0,976,1,3,1,2,2,single-choice,spatial-relational,1|2,7,1/2,230162,1
1,1,23,163,1,710,1,5,2,2,3,single-choice,spatial-relational,2|3,7,2/3,230163,2
1,1,23,164,0,685,1,7,3,4,4,single-choice,spatial-relational,3|4,7,3/4,230164,3
1,1,23,165,0,3,1,9,4,5,5,single-choice,spatial-relational,4|5,7,4/5,230165,4
1,1,23,166,0,824,1,3,1,2,2,single-choice,spatial-relational,1|2,7,1/2,230166,1
1,1,23,167,0,43,1,7,3,4,4,single-choice,spatial-relational,3|4,7,3/4,230167,3
1,1,23,168,1,678,1,13,6,6,7,single-choice,spatial-relational,6|7,7,6/7,230168,6
1,1,23,169,1,788,1,5,2,2,3,single-choice,spatial-relational,2|3,7,2/3,230169,2
1,1,23,170,1,660,1,5,2,2,3,single-choice,spatial-relational,2|3,7,2/3,230170,2
1,1,23,171,0,693,1,7,3,4,4,single-choice,spatial-relational,3|4,7,3/4,230171,3
1,1,23,172,0,825,1,3,1,2,2,single-choice,spatial-relational,1|2,7,1/2,230172,1
1,1,23,173,0,911,1,9,4,5,5,single-choice,spatial-relational,4|5,7,4/5,230173,4
1,1,23,174,1,704,1,3,1,1,2,single-choice,spatial-relational,1|2,7,1/2,230174,1
1,1,23,175,0,819,1,11,5,6,6,single-choice,spatial-relational,5|6,7,5/6,230175,5
1,1,23,176,1,612,1,13,6,6,7,single-choice,spatial-relational,6|7,7,6/7,230176,6
1,1,23,177,1,1125,1,9,4,4,5,single-choice,spatial-relational,4|5,7,4/5,230177,4
1,1,23,178,1,1367,1,11,5,5,6,single-choice,spatial-relational,5|6,7,5/6,230178,5
1,1,23,179,1,835,1,13,6,6,7,single-choice,spatial-relational,6|7,7,6/7,230179,6
1,1,23,180,0,752,1,7,3,4,4,single-choice,spatial-relational,3|4,7,3/4,230180,3
1,1,23,181,0,949,1,11,5,6,6,single-choice,spatial-relational,5|6,7,5/6,230181,5
1,1,23,182,0,817,1,7,3,4,4,single-choice,spatial-relational,3|4,7,3/4,230182,3
1,1,23,183,1,798,1,13,6,6,7,single-choice,spatial-relational,6|7,7,6/7,230183,6
1,1,23,184,1,734,1,5,2,2,3,single-choice,spatial-relational,2|3,7,2/3,230184,2
1,1,23,185,0,757,1,11,5,6,6,single-choice,spatial-relational,5|6,7,5/6,230185,5
1,1,23,186,1,903,1,3,1,1,2,single-choice,spatial-relational,1|2,7,1/2,230186,1
1,1,23,187,0,671,1,7,3,4,4,single-choice,spatial-relational,3|4,7,3/4,230187,3
1,1,23,188,1,635,1,9,4,4,5,single-choice,spatial-relational,4|5,7,4/5,230188,4
1,1,23,189,1,805,1,5,2,2,3,single-choice,spatial-relational,2|3,7,2/3,230189,2
1,1,23,190,0,684,1,3,1,2,2,single-choice,spatial-relational,1|2,7,1/2,230190,1
1,1,23,191,1,16,1,13,6,6,7,single-choice,spatial-relational,6|7,7,6/7,230191,6
1,1,23,192,0,1254,1,9,4,5,5,single-choice,spatial-relational,4|5,7,4/5,230192,4
1,1,23,193,0,817,1,7,3,4,4,single-choice,spatial-relational,3|4,7,3/4,230193,3
1,1,23,194,1,704,1,5,2,2,3,single-choice,spatial-relational,2|3,7,2/3,230194,2
1,1,23,195,0,635,1,7,3,4,4,single-choice,spatial-relational,3|4,7,3/4,230195,3
1,1,23,196,1,12,1,11,5,5,6,single-choice,spatial-relational,5|6,7,5/6,230196,5
1,1,23,197,0,1023,1,9,4,5,5,single-choice,spatial-relational,4|5,7,4/5,230197,4
1,1,23,198,1,81,1,5,2,2,3,single-choice,spatial-relational,2|3,7,2/3,230198,2
1,1,23,199,0,564,1,3,1,2,2,single-choice,spatial-relational,1|2,7,1/2,230199,1
1,1,23,200,1,764,1,13,6,6,7,single-choice,spatial-relational,6|7,7,6/7,230200,6
1,1,23,201,0,910,1,11,5,6,6,single-choice,spatial-relational,5|6,7,5/6,230201,5
1,1,23,202,0,155,1,9,4,5,5,single-choice,spatial-relational,4|5,7,4/5,230202,4
1,1,23,203,1,826,1,13,6,6,7,single-choice,spatial-relational,6|7,7,6/7,230203,6
1,1,23,204,1,1052,1,3,1,1,2,single-choice,spatial-relational,1|2,7,1/2,230204,1
1,1,23,205,0,810,1,9,4,5,5,single-choice,spatial-relational,4|5,7,4/5,230205,4
1,1,23,206,0,835,1,11,5,6,6,single-choice,spatial-relational,5|6,7,5/6,230206,5
1,1,23,207,0,734,1,7,3,4,4,single-choice,spatial-relational,3|4,7,3/4,230207,3
1,1,23,208,1,1394,1,13,6,6,7,single-choice,spatial-relational,6|7,7,6/7,230208,6
1,1,23,209,1,1045,1,5,2,2,3,single-choice,spatial-relational,2|3,7,2/3,230209,2
1,1,23,210,1,820,1,9,4,4,5,single-choice,spatial-relational,4|5,7,4/5,230210,4
1,1,23,211,1,1835,1,13,6,6,7,single-choice,spatial-relational,6|7,7,6/7,230211,6
1,1,23,212,1,720,1,5,2,2,3,single-choice,spatial-relational,2|3,7,2/3,230212,2
1,1,23,213,0,681,1,7,3,4,4,single-choice,spatial-relational,3|4,7,3/4,230213,3
1,1,23,214,1,862,1,3,1,1,2,single-choice,spatial-relational,1|2,7,1/2,230214,1
1,1,23,215,0,686,1,11,5,6,6,single-choice,spatial-relational,5|6,7,5/6,230215,5
1,1,23,216,0,714,1,3,1,2,2,single-choice,spatial-relational,1|2,7,1/2,230216,1
1,1,23,217,1,782,1,5,2,2,3,single-choice,spatial-relational,2|3,7,2/3,230217,2
1,1,23,218,1,1182,1,13,6,6,7,single-choice,spatial-relational,6|7,7,6/7,230218,6
1,1,23,219,1,938,1,7,3,3,4,single-choice,spatial-relational,3|4,7,3/4,230219,3
1,1,23,220,1,913,1,3,1,1,2,single-choice,spatial-relational,1|2,7,1/2,230220,1
1,1,23,221,0,732,1,11,5,6,6,single-choice,spatial-relational,5|6,7,5/6,230221,5
1,1,23,222,0,38,1,11,5,6,6,single-choice,spatial-relational,5|6,7,5/6,230222,5
1,1,23,223,1,930,1,3,1,1,2,single-choice,spatial-relational,1|2,7,1/2,230223,1
1,1,23,224,1,937,1,5,2,2,3,single-choice,spatial-relational,2|3,7,2/3,230224,2
1,1,23,225,1,700,1,9,4,4,5,single-choice,spatial-relational,4|5,7,4/5,230225,4
1,1,23,226,0,931,1,9,4,5,5,single-choice,spatial-relational,4|5,7,4/5,230226,4
1,1,23,227,1,1375,1,13,6,6,7,single-choice,spatial-relational,6|7,7,6/7,230227,6
1,1,23,228,0,782,1,7,3,4,4,single-choice,spatial-relational,3|4,7,3/4,230228,3
1,1,23,229,0,1052,1,3,1,2,2,single-choice,spatial-relational,1|2,7,1/2,230229,1
1,1,23,230,1,664,1,3,1,1,2,single-choice,spatial-relational,1|2,7,1/2,230230,1
1,1,23,231,1,698,1,5,2,2,3,single-choice,spatial-relational,2|3,7,2/3,230231,2
1,1,23,232,1,839,1,9,4,4,5,single-choice,spatial-relational,4|5,7,4/5,230232,4
1,1,23,233,0,961,1,13,6,7,7,single-choice,spatial-relational,6|7,7,6/7,230233,6
1,1,23,234,0,977,1,11,5,6,6,single-choice,spatial-relational,5|6,7,5/6,230234,5
1,1,23,235,1,976,1,7,3,3,4,single-choice,spatial-relational,3|4,7,3/4,230235,3
1,1,23,236,1,902,1,7,3,3,4,single-choice,spatial-relational,3|4,7,3/4,230236,3
1,1,23,237,0,1084,1,9,4,5,5,single-choice,spatial-relational,4|5,7,4/5,230237,4
1,1,23,238,0,710,1,13,6,7,7,single-choice,spatial-relational,6|7,7,6/7,230238,6
1,1,23,239,0,604,1,11,5,6,6,single-choice,spatial-relational,5|6,7,5/6,230239,5
1,1,23,240,0,875,1,5,2,3,3,single-choice,spatial-relational,2|3,7,2/3,230240,2
1,1,23,241,1,1094,1,9,4,4,5,single-choice,spatial-relational,4|5,7,4/5,230241,4
1,1,23,242,1,812,1,7,3,3,4,single-choice,spatial-relational,3|4,7,3/4,230242,3
1,1,23,243,1,846,1,3,1,1,2,single-choice,spatial-relational,1|2,7,1/2,230243,1
1,1,23,244,0,1084,1,3,1,2,2,single-choice,spatial-relational,1|2,7,1/2,230244,1
1,1,23,245,0,930,1,5,2,3,3,single-choice,spatial-relational,2|3,7,2/3,230245,2
1,1,23,246,1,22,1,9,4,4,5,single-choice,spatial-relational,4|5,7,4/5,230246,4
1,1,23,247,0,658,1,7,3,4,4,single-choice,spatial-relational,3|4,7,3/4,230247,3
1,1,23,248,0,785,1,5,2,3,3,single-choice,spatial-relational,2|3,7,2/3,230248,2
1,1,23,249,0,1180,1,13,6,7,7,single-choice,spatial-relational,6|7,7,6/7,230249,6
1,1,23,250,0,1103,1,13,6,7,7,single-choice,spatial-relational,6|7,7,6/7,230250,6
1,1,23,251,0,747,1,11,5,6,6,single-choice,spatial-relational,5|6,7,5/6,230251,5
1,1,23,252,0,906,1,11,5,6,6,single-choice,spatial-relational,5|6,7,5/6,230252,5
1,1,23,253,1,746,1,7,3,3,4,single-choice,spatial-relational,3|4,7,3/4,230253,3
1,1,23,254,0,950,1,13,6,7,7,single-choice,spatial-relational,6|7,7,6/7,230254,6
1,1,23,255,1,960,1,9,4,4,5,single-choice,spatial-relational,4|5,7,4/5,230255,4
1,1,23,256,1,913,1,5,2,2,3,single-choice,spatial-relational,2|3,7,2/3,230256,2
1,1,23,257,0,1042,1,3,1,2,2,single-choice,spatial-relational,1|2,7,1/2,230257,1
1,1,23,258,1,954,1,9,4,4,5,single-choice,spatial-relational,4|5,7,4/5,230258,4
1,1,23,259,0,1117,1,11,5,6,6,single-choice,spatial-relational,5|6,7,5/6,230259,5
1,1,23,260,1,998,1,13,6,6,7,single-choice,spatial-relational,6|7,7,6/7,230260,6
1,1,23,261,1,903,1,3,1,1,2,single-choice,spatial-relational,1|2,7,1/2,230261,1
1,1,23,262,0,690,1,11,5,6,6,single-choice,spatial-relational,5|6,7,5/6,230262,5
1,1,23,263,1,81,1,7,3,3,4,single-choice,spatial-relational,3|4,7,3/4,230263,3
1,1,23,264,0,927,1,5,2,3,3,single-choice,spatial-relational,2|3,7,2/3,230264,2
1,1,23,265,0,638,1,5,2,3,3,single-choice,spatial-relational,2|3,7,2/3,230265,2
1,1,23,266,1,813,1,13,6,6,7,single-choice,spatial-relational,6|7,7,6/7,230266,6
1,1,23,267,0,1054,1,11,5,6,6,single-choice,spatial-relational,5|6,7,5/6,230267,5
1,1,23,268,1,562,1,9,4,4,5,single-choice,spatial-relational,4|5,7,4/5,230268,4
1,1,23,269,0,1381,1,7,3,4,4,single-choice,spatial-relational,3|4,7,3/4,230269,3
1,1,23,270,1,19,1,11,5,5,6,single-choice,spatial-relational,5|6,7,5/6,230270,5
1,1,23,271,1,879,1,7,3,3,4,single-choice,spatial-relational,3|4,7,3/4,230271,3
1,1,23,272,1,931,1,9,4,4,5,single-choice,spatial-relational,4|5,7,4/5,230272,4
1,1,23,273,1,825,1,3,1,1,2,single-choice,spatial-relational,1|2,7,1/2,230273,1
1,1,23,274,0,793,1,13,6,7,7,single-choice,spatial-relational,6|7,7,6/7,230274,6
1,1,23,275,0,883,1,5,2,3,3,single-choice,spatial-relational,2|3,7,2/3,230275,2
1,1,23,276,0,792,1,3,1,2,2,single-choice,spatial-relational,1|2,7,1/2,230276,1
1,1,23,277,0,965,1,11,5,6,6,single-choice,spatial-relational,5|6,7,5/6,230277,5
1,1,23,278,0,869,1,3,1,2,2,single-choice,spatial-relational,1|2,7,1/2,230278,1
1,1,23,279,1,848,1,7,3,3,4,single-choice,spatial-relational,3|4,7,3/4,230279,3
1,1,23,280,1,917,1,9,4,4,5,single-choice,spatial-relational,4|5,7,4/5,230280,4
1,1,23,281,0,1097,1,9,4,5,5,single-choice,spatial-relational,4|5,7,4/5,230281,4
1,1,23,282,1,699,1,3,1,1,2,single-choice,spatial-relational,1|2,7,1/2,230282,1
1,1,23,283,0,924,1,5,2,3,3,single-choice,spatial-relational,2|3,7,2/3,230283,2
1,1,23,284,1,1291,1,13,6,6,7,single-choice,spatial-relational,6|7,7,6/7,230284,6
1,1,23,285,0,843,1,11,5,6,6,single-choice,spatial-relational,5|6,7,5/6,230285,5
1,1,23,286,1,1323,1,5,2,2,3,single-choice,spatial-relational,2|3,7,2/3,230286,2
1,1,23,287,1,1368,1,13,6,6,7,single-choice,spatial-relational,6|7,7,6/7,230287,6
1,1,23,288,0,1021,1,7,3,4,4,single-choice,spatial-relational,3|4,7,3/4,230288,3
1,1,23,289,1,804,1,7,3,3,4,single-choice,spatial-relational,3|4,7,3/4,230289,3
1,1,23,290,0,1079,1,5,2,3,3,single-choice,spatial-relational,2|3,7,2/3,230290,2
1,1,23,291,0,669,1,11,5,6,6,single-choice,spatial-relational,5|6,7,5/6,230291,5
1,1,23,292,1,787,1,13,6,6,7,single-choice,spatial-relational,6|7,7,6/7,230292,6
1,1,23,293,0,1693,1,7,3,4,4,single-choice,spatial-relational,3|4,7,3/4,230293,3
1,1,23,294,1,802,1,5,2,2,3,single-choice,spatial-relational,2|3,7,2/3,230294,2
1,1,23,295,1,963,1,9,4,4,5,single-choice,spatial-relational,4|5,7,4/5,230295,4
1,1,23,296,0,952,1,3,1,2,2,single-choice,spatial-relational,1|2,7,1/2,230296,1
1,1,23,297,1,966,1,9,4,4,5,single-choice,spatial-relational,4|5,7,4/5,230297,4
1,1,23,298,1,1097,1,13,6,6,7,single-choice,spatial-relational,6|7,7,6/7,230298,6
1,1,23,299,1,1034,1,3,1,1,2,single-choice,spatial-relational,1|2,7,1/2,230299,1
1,1,23,300,1,965,1,11,5,5,6,single-choice,spatial-relational,5|6,7,5/6,230300,5
1,1,23,301,1,1449,1,9,4,4,5,single-choice,spatial-relational,4|5,7,4/5,230301,4
1,1,23,302,1,1008,1,7,3,3,4,single-choice,spatial-relational,3|4,7,3/4,230302,3
1,1,23,303,1,1081,1,13,6,6,7,single-choice,spatial-relational,6|7,7,6/7,230303,6
1,1,23,304,1,718,1,5,2,2,3,single-choice,spatial-relational,2|3,7,2/3,230304,2
1,1,23,305,1,640,1,3,1,1,2,single-choice,spatial-relational,1|2,7,1/2,230305,1
1,1,23,306,0,773,1,11,5,6,6,single-choice,spatial-relational,5|6,7,5/6,230306,5
1,1,23,307,0,1019,1,7,3,4,4,single-choice,spatial-relational,3|4,7,3/4,230307,3
1,1,23,308,0,831,1,11,5,6,6,single-choice,spatial-relational,5|6,7,5/6,230308,5
1,1,23,309,1,857,1,13,6,6,7,single-choice,spatial-relational,6|7,7,6/7,230309,6
1,1,23,310,0,1335,1,3,1,2,2,single-choice,spatial-relational,1|2,7,1/2,230310,1
1,1,23,311,1,986,1,9,4,4,5,single-choice,spatial-relational,4|5,7,4/5,230311,4
1,1,23,312,1,1262,1,5,2,2,3,single-choice,spatial-relational,2|3,7,2/3,230312,2
1,1,23,313,1,1165,1,11,5,5,6,single-choice,spatial-relational,5|6,7,5/6,230313,5
1,1,23,314,0,1286,1,5,2,3,3,single-choice,spatial-relational,2|3,7,2/3,230314,2
1,1,23,315,1,1031,1,7,3,3,4,single-choice,spatial-relational,3|4,7,3/4,230315,3
1,1,23,316,1,1600,1,13,6,6,7,single-choice,spatial-relational,6|7,7,6/7,230316,6
1,1,23,317,0,1102,1,9,4,5,5,single-choice,spatial-relational,4|5,7,4/5,230317,4
1,1,23,318,1,1224,1,13,6,6,7,single-choice,spatial-relational,6|7,7,6/7,230318,6
1,1,23,319,0,1537,1,3,1,2,2,single-choice,spatial-relational,1|2,7,1/2,230319,1
1,1,23,320,1,870,1,9,4,4,5,single-choice,spatial-relational,4|5,7,4/5,230320,4
1,1,23,321,0,1338,1,7,3,4,4,single-choice,spatial-relational,3|4,7,3/4,230321,3
1,1,23,322,0,725,1,3,1,2,2,single-choice,spatial-relational,1|2,7,1/2,230322,1
1,1,23,323,0,706,1,11,5,6,6,single-choice,spatial-relational,5|6,7,5/6,230323,5
1,1,23,324,1,724,1,5,2,2,3,single-choice,spatial-relational,2|3,7,2/3,230324,2
1,1,23,325,0,960,1,5,2,3,3,single-choice,spatial-relational,2|3,7,2/3,230325,2
1,1,23,326,1,991,1,9,4,4,5,single-choice,spatial-relational,4|5,7,4/5,230326,4
1,1,23,327,0,939,1,3,1,2,2,single-choice,spatial-relational,1|2,7,1/2,230327,1
1,1,23,328,1,871,1,7,3,3,4,single-choice,spatial-relational,3|4,7,3/4,230328,3
1,1,23,329,1,1127,1,13,6,6,7,single-choice,spatial-relational,6|7,7,6/7,230329,6
1,1,23,330,1,924,1,5,2,2,3,single-choice,spatial-relational,2|3,7,2/3,230330,2
1,1,23,331,0,934,1,9,4,5,5,single-choice,spatial-relational,4|5,7,4/5,230331,4
1,1,23,332,0,1466,1,3,1,2,2,single-choice,spatial-relational,1|2,7,1/2,230332,1
1,1,23,333,0,965,1,11,5,6,6,single-choice,spatial-relational,5|6,7,5/6,230333,5
1,1,23,334,1,1030,1,13,6,6,7,single-choice,spatial-relational,6|7,7,6/7,230334,6
1,1,23,335,0,1223,1,11,5,6,6,single-choice,spatial-relational,5|6,7,5/6,230335,5
1,1,23,336,0,867,1,7,3,4,4,single-choice,spatial-relational,3|4,7,3/4,230336,3
1,1,23,337,0,737,1,3,1,2,2,single-choice,spatial-relational,1|2,7,1/2,230337,1
1,1,23,338,1,802,1,9,4,4,5,single-choice,spatial-relational,4|5,7,4/5,230338,4
1,1,23,339,1,1161,1,13,6,6,7,single-choice,spatial-relational,6|7,7,6/7,230339,6
1,1,23,340,1,838,1,7,3,3,4,single-choice,spatial-relational,3|4,7,3/4,230340,3
1,1,23,341,0,1113,1,11,5,6,6,single-choice,spatial-relational,5|6,7,5/6,230341,5
1,1,23,342,0,844,1,5,2,3,3,single-choice,spatial-relational,2|3,7,2/3,230342,2
1,1,23,343,0,1101,1,7,3,4,4,single-choice,spatial-relational,3|4,7,3/4,230343,3
1,1,23,344,1,1145,1,5,2,2,3,single-choice,spatial-relational,2|3,7,2/3,230344,2
1,1,23,345,0,573,1,11,5,6,6,single-choice,spatial-relational,5|6,7,5/6,230345,5
1,1,23,346,1,670,1,3,1,1,2,single-choice,spatial-relational,1|2,7,1/2,230346,1
1,1,23,347,1,9547,1,13,6,6,7,single-choice,spatial-relational,6|7,7,6/7,230347,6
1,1,23,348,1,849,1,9,4,4,5,single-choice,spatial-relational,4|5,7,4/5,230348,4
1,1,23,349,0,1266,1,5,2,3,3,single-choice,spatial-relational,2|3,7,2/3,230349,2
1,1,23,350,1,829,1,3,1,1,2,single-choice,spatial-relational,1|2,7,1/2,230350,1
1,1,23,351,1,852,1,13,6,6,7,single-choice,spatial-relational,6|7,7,6/7,230351,6
1,1,23,352,1,959,1,7,3,3,4,single-choice,spatial-relational,3|4,7,3/4,230352,3
1,1,23,353,0,872,1,11,5,6,6,single-choice,spatial-relational,5|6,7,5/6,230353,5
1,1,23,354,0,977,1,13,6,7,7,single-choice,spatial-relational,6|7,7,6/7,230354,6
1,1,23,355,1,1166,1,9,4,4,5,single-choice,spatial-relational,4|5,7,4/5,230355,4
1,1,23,356,1,894,1,7,3,3,4,single-choice,spatial-relational,3|4,7,3/4,230356,3
1,1,23,357,0,990,1,11,5,6,6,single-choice,spatial-relational,5|6,7,5/6,230357,5
1,1,23,358,1,718,1,3,1,1,2,single-choice,spatial-relational,1|2,7,1/2,230358,1
1,1,23,359,1,971,1,9,4,4,5,single-choice,spatial-relational,4|5,7,4/5,230359,4
1,1,23,360,0,876,1,5,2,3,3,single-choice,spatial-relational,2|3,7,2/3,230360,2
1,1,23,361,1,719,1,13,6,6,7,single-choice,spatial-relational,6|7,7,6/7,230361,6
1,1,23,362,0,1611,1,3,1,2,2,single-choice,spatial-relational,1|2,7,1/2,230362,1
1,1,23,363,0,869,1,5,2,3,3,single-choice,spatial-relational,2|3,7,2/3,230363,2
1,1,23,364,0,814,1,11,5,6,6,single-choice,spatial-relational,5|6,7,5/6,230364,5
1,1,23,365,0,897,1,7,3,4,4,single-choice,spatial-relational,3|4,7,3/4,230365,3
1,1,23,366,1,9,1,11,5,5,6,single-choice,spatial-relational,5|6,7,5/6,230366,5
1,1,23,367,1,866,1,5,2,2,3,single-choice,spatial-relational,2|3,7,2/3,230367,2
1,1,23,368,1,968,1,9,4,4,5,single-choice,spatial-relational,4|5,7,4/5,230368,4
1,1,23,369,1,794,1,7,3,3,4,single-choice,spatial-relational,3|4,7,3/4,230369,3
1,1,23,370,1,522,1,13,6,6,7,single-choice,spatial-relational,6|7,7,6/7,230370,6
1,1,23,371,0,1285,1,9,4,5,5,single-choice,spatial-relational,4|5,7,4/5,230371,4
1,1,23,372,1,1170,1,3,1,1,2,single-choice,spatial-relational,1|2,7,1/2,230372,1
1,1,23,373,1,869,1,3,1,1,2,single-choice,spatial-relational,1|2,7,1/2,230373,1
1,1,23,374,0,678,1,7,3,4,4,single-choice,spatial-relational,3|4,7,3/4,230374,3
1,1,23,375,1,681,1,3,1,1,2,single-choice,spatial-relational,1|2,7,1/2,230375,1
1,1,23,376,1,577,1,13,6,6,7,single-choice,spatial-relational,6|7,7,6/7,230376,6
1,1,23,377,1,1305,1,13,6,6,7,single-choice,spatial-relational,6|7,7,6/7,230377,6
1,1,23,378,0,1279,1,5,2,3,3,single-choice,spatial-relational,2|3,7,2/3,230378,2
1,1,23,379,0,904,1,5,2,3,3,single-choice,spatial-relational,2|3,7,2/3,230379,2
1,1,23,380,0,1159,1,9,4,5,5,single-choice,spatial-relational,4|5,7,4/5,230380,4
1,1,23,381,0,694,1,11,5,6,6,single-choice,spatial-relational,5|6,7,5/6,230381,5
1,1,23,382,1,766,1,7,3,3,4,single-choice,spatial-relational,3|4,7,3/4,230382,3
1,1,23,383,0,923,1,11,5,6,6,single-choice,spatial-relational,5|6,7,5/6,230383,5
1,1,23,384,1,975,1,9,4,4,5,single-choice,spatial-relational,4|5,7,4/5,230384,4
1,1,23,385,0,1371,1,11,5,6,6,single-choice,spatial-relational,5|6,7,5/6,230385,5
1,1,23,386,0,870,1,5,2,3,3,single-choice,spatial-relational,2|3,7,2/3,230386,2
1,1,23,387,1,1255,1,5,2,2,3,single-choice,spatial-relational,2|3,7,2/3,230387,2
1,1,23,388,1,1158,1,13,6,6,7,single-choice,spatial-relational,6|7,7,6/7,230388,6
1,1,23,389,1,933,1,9,4,4,5,single-choice,spatial-relational,4|5,7,4/5,230389,4
1,1,23,390,1,1053,1,13,6,6,7,single-choice,spatial-relational,6|7,7,6/7,230390,6
1,1,23,391,0,778,1,11,5,6,6,single-choice,spatial-relational,5|6,7,5/6,230391,5
1,1,23,392,1,996,1,9,4,4,5,single-choice,spatial-relational,4|5,7,4/5,230392,4
1,1,23,393,0,1224,1,3,1,2,2,single-choice,spatial-relational,1|2,7,1/2,230393,1
1,1,23,394,1,980,1,3,1,1,2,single-choice,spatial-relational,1|2,7,1/2,230394,1
1,1,23,395,0,1093,1,7,3,4,4,single-choice,spatial-relational,3|4,7,3/4,230395,3
1,1,23,396,0,808,1,7,3,4,4,single-choice,spatial-relational,3|4,7,3/4,230396,3
1,1,23,397,1,903,1,3,1,1,2,single-choice,spatial-relational,1|2,7,1/2,230397,1
1,1,23,398,1,1301,1,5,2,2,3,single-choice,spatial-relational,2|3,7,2/3,230398,2
1,1,23,399,1,883,1,9,4,4,5,single-choice,spatial-relational,4|5,7,4/5,230399,4
1,1,23,400,0,1030,1,5,2,3,3,single-choice,spatial-relational,2|3,7,2/3,230400,2
1,1,23,401,0,1123,1,11,5,6,6,single-choice,spatial-relational,5|6,7,5/6,230401,5
1,1,23,402,1,919,1,7,3,3,4,single-choice,spatial-relational,3|4,7,3/4,230402,3
1,1,23,403,0,1213,1,13,6,7,7,single-choice,spatial-relational,6|7,7,6/7,230403,6
1,1,23,404,0,941,1,13,6,7,7,single-choice,spatial-relational,6|7,7,6/7,230404,6
1,1,23,405,0,622,1,11,5,6,6,single-choice,spatial-relational,5|6,7,5/6,230405,5
1,1,23,406,1,3,1,3,1,1,2,single-choice,spatial-relational,1|2,7,1/2,230406,1
1,1,23,407,0,15,1,9,4,5,5,single-choice,spatial-relational,4|5,7,4/5,230407,4
1,1,23,408,0,648,1,7,3,4,4,single-choice,spatial-relational,3|4,7,3/4,230408,3
1,1,23,409,1,597,1,5,2,2,3,single-choice,spatial-relational,2|3,7,2/3,230409,2
1,1,23,410,0,1099,1,5,2,3,3,single-choice,spatial-relational,2|3,7,2/3,230410,2
1,1,23,411,0,1227,1,9,4,5,5,single-choice,spatial-relational,4|5,7,4/5,230411,4
1,1,23,412,0,770,1,3,1,2,2,single-choice,spatial-relational,1|2,7,1/2,230412,1
1,1,23,413,1,792,1,3,1,1,2,single-choice,spatial-relational,1|2,7,1/2,230413,1
1,1,23,414,0,931,1,7,3,4,4,single-choice,spatial-relational,3|4,7,3/4,230414,3
1,1,23,415,1,889,1,7,3,3,4,single-choice,spatial-relational,3|4,7,3/4,230415,3
1,1,23,416,0,1345,1,11,5,6,6,single-choice,spatial-relational,5|6,7,5/6,230416,5
1,1,23,417,1,784,1,13,6,6,7,single-choice,spatial-relational,6|7,7,6/7,230417,6
1,1,23,418,0,1530,1,13,6,7,7,single-choice,spatial-relational,6|7,7,6/7,230418,6
1,1,23,419,1,1098,1,9,4,4,5,single-choice,spatial-relational,4|5,7,4/5,230419,4
1,1,23,420,0,943,1,11,5,6,6,single-choice,spatial-relational,5|6,7,5/6,230420,5
1,1,23,421,1,1062,1,9,4,4,5,single-choice,spatial-relational,4|5,7,4/5,230421,4
1,1,23,422,0,1204,1,7,3,4,4,single-choice,spatial-relational,3|4,7,3/4,230422,3
1,1,23,423,0,756,1,11,5,6,6,single-choice,spatial-relational,5|6,7,5/6,230423,5
1,1,23,424,1,886,1,13,6,6,7,single-choice,spatial-relational,6|7,7,6/7,230424,6
1,1,23,425,1,1115,1,7,3,3,4,single-choice,spatial-relational,3|4,7,3/4,230425,3
1,1,23,426,1,1167,1,13,6,6,7,single-choice,spatial-relational,6|7,7,6/7,230426,6
1,1,23,427,0,696,1,3,1,2,2,single-choice,spatial-relational,1|2,7,1/2,230427,1
1,1,23,428,1,969,1,9,4,4,5,single-choice,spatial-relational,4|5,7,4/5,230428,4
1,1,23,429,0,1439,1,5,2,3,3,single-choice,spatial-relational,2|3,7,2/3,230429,2
1,1,23,430,0,20,1,3,1,2,2,single-choice,spatial-relational,1|2,7,1/2,230430,1
1,1,23,431,0,615,1,11,5,6,6,single-choice,spatial-relational,5|6,7,5/6,230431,5
1,1,23,432,1,872,1,5,2,2,3,single-choice,spatial-relational,2|3,7,2/3,230432,2
1,1,23,433,0,871,1,11,5,6,6,single-choice,spatial-relational,5|6,7,5/6,230433,5
1,1,23,434,1,1234,1,13,6,6,7,single-choice,spatial-relational,6|7,7,6/7,230434,6
1,1,23,435,1,908,1,7,3,3,4,single-choice,spatial-relational,3|4,7,3/4,230435,3
1,1,23,436,0,841,1,7,3,4,4,single-choice,spatial-relational,3|4,7,3/4,230436,3
1,1,23,437,0,888,1,5,2,3,3,single-choice,spatial-relational,2|3,7,2/3,230437,2
1,1,23,438,1,947,1,5,2,2,3,single-choice,spatial-relational,2|3,7,2/3,230438,2
1,1,23,439,1,1851,1,9,4,4,5,single-choice,spatial-relational,4|5,7,4/5,230439,4
1,1,23,440,1,1006,1,9,4,4,5,single-choice,spatial-relational,4|5,7,4/5,230440,4
1,1,23,441,0,862,1,11,5,6,6,single-choice,spatial-relational,5|6,7,5/6,230441,5
1,1,23,442,1,808,1,3,1,1,2,single-choice,spatial-relational,1|2,7,1/2,230442,1
1,1,23,443,1,1150,1,13,6,6,7,single-choice,spatial-relational,6|7,7,6/7,230443,6
1,1,23,444,0,1054,1,3,1,2,2,single-choice,spatial-relational,1|2,7,1/2,230444,1
1,1,23,445,0,899,1,11,5,6,6,single-choice,spatial-relational,5|6,7,5/6,230445,5
1,1,23,446,0,745,1,5,2,3,3,single-choice,spatial-relational,2|3,7,2/3,230446,2
1,1,23,447,1,750,1,7,3,3,4,single-choice,spatial-relational,3|4,7,3/4,230447,3
1,1,23,448,1,1007,1,3,1,1,2,single-choice,spatial-relational,1|2,7,1/2,230448,1
1,1,23,449,0,819,1,5,2,3,3,single-choice,spatial-relational,2|3,7,2/3,230449,2
1,1,23,450,0,836,1,3,1,2,2,single-choice,spatial-relational,1|2,7,1/2,230450,1
1,1,23,451,1,862,1,9,4,4,5,single-choice,spatial-relational,4|5,7,4/5,230451,4
1,1,23,452,1,1906,1,11,5,5,6,single-choice,spatial-relational,5|6,7,5/6,230452,5
1,1,23,453,1,950,1,9,4,4,5,single-choice,spatial-relational,4|5,7,4/5,230453,4
1,1,23,454,0,1278,1,13,6,7,7,single-choice,spatial-relational,6|7,7,6/7,230454,6
1,1,23,455,1,1342,1,13,6,6,7,single-choice,spatial-relational,6|7,7,6/7,230455,6
1,1,23,456,0,761,1,7,3,4,4,single-choice,spatial-relational,3|4,7,3/4,230456,3
1,1,23,457,0,820,1,9,4,5,5,single-choice,spatial-relational,4|5,7,4/5,230457,4
1,1,23,458,1,610,1,9,4,4,5,single-choice,spatial-relational,4|5,7,4/5,230458,4
1,1,23,459,0,1106,1,7,3,4,4,single-choice,spatial-relational,3|4,7,3/4,230459,3
1,1,23,460,0,691,1,3,1,2,2,single-choice,spatial-relational,1|2,7,1/2,230460,1
1,1,23,461,0,564,1,11,5,6,6,single-choice,spatial-relational,5|6,7,5/6,230461,5
1,1,23,462,1,618,1,7,3,3,4,single-choice,spatial-relational,3|4,7,3/4,230462,3
1,1,23,463,0,1208,1,13,6,7,7,single-choice,spatial-relational,6|7,7,6/7,230463,6
1,1,23,464,0,781,1,11,5,6,6,single-choice,spatial-relational,5|6,7,5/6,230464,5
1,1,23,465,1,770,1,3,1,1,2,single-choice,spatial-relational,1|2,7,1/2,230465,1
1,1,23,466,0,22,1,13,6,7,7,single-choice,spatial-relational,6|7,7,6/7,230466,6
1,1,23,467,1,590,1,5,2,2,3,single-choice,spatial-relational,2|3,7,2/3,230467,2
1,1,23,468,0,1118,1,5,2,3,3,single-choice,spatial-relational,2|3,7,2/3,230468,2
1,1,23,469,0,591,1,3,1,2,2,single-choice,spatial-relational,1|2,7,1/2,230469,1
1,1,23,470,1,798,1,13,6,6,7,single-choice,spatial-relational,6|7,7,6/7,230470,6
1,1,23,471,0,828,1,11,5,6,6,single-choice,spatial-relational,5|6,7,5/6,230471,5
1,1,23,472,0,7,1,9,4,5,5,single-choice,spatial-relational,4|5,7,4/5,230472,4
1,1,23,473,1,918,1,13,6,6,7,single-choice,spatial-relational,6|7,7,6/7,230473,6
1,1,23,474,0,1905,1,5,2,3,3,single-choice,spatial-relational,2|3,7,2/3,230474,2
1,1,23,475,0,82,1,7,3,4,4,single-choice,spatial-relational,3|4,7,3/4,230475,3
1,1,23,476,0,17,1,9,4,5,5,single-choice,spatial-relational,4|5,7,4/5,230476,4
1,1,23,477,1,750,1,3,1,1,2,single-choice,spatial-relational,1|2,7,1/2,230477,1
1,1,23,478,0,975,1,11,5,6,6,single-choice,spatial-relational,5|6,7,5/6,230478,5
1,1,23,479,0,635,1,7,3,4,4,single-choice,spatial-relational,3|4,7,3/4,230479,3
1,1,23,480,1,950,1,5,2,2,3,single-choice,spatial-relational,2|3,7,2/3,230480,2
1,1,23,481,1,1068,1,3,1,1,2,single-choice,spatial-relational,1|2,7,1/2,230481,1
1,1,23,482,0,1014,1,5,2,3,3,single-choice,spatial-relational,2|3,7,2/3,230482,2
1,1,23,483,0,1200,1,11,5,6,6,single-choice,spatial-relational,5|6,7,5/6,230483,5
1,1,23,484,0,752,1,11,5,6,6,single-choice,spatial-relational,5|6,7,5/6,230484,5
1,1,23,485,1,1565,1,7,3,3,4,single-choice,spatial-relational,3|4,7,3/4,230485,3
1,1,23,486,1,996,1,9,4,4,5,single-choice,spatial-relational,4|5,7,4/5,230486,4
1,1,23,487,1,880,1,5,2,2,3,single-choice,spatial-relational,2|3,7,2/3,230487,2
1,1,23,488,1,891,1,9,4,4,5,single-choice,spatial-relational,4|5,7,4/5,230488,4
1,1,23,489,1,1398,1,13,6,6,7,single-choice,spatial-relational,6|7,7,6/7,230489,6
1,1,23,490,0,764,1,3,1,2,2,single-choice,spatial-relational,1|2,7,1/2,230490,1
1,1,23,491,0,901,1,7,3,4,4,single-choice,spatial-relational,3|4,7,3/4,230491,3
1,1,23,492,1,793,1,13,6,6,7,single-choice,spatial-relational,6|7,7,6/7,230492,6
1,1,23,493,1,1534,1,13,6,6,7,single-choice,spatial-relational,6|7,7,6/7,230493,6
1,1,23,494,0,915,1,5,2,3,3,single-choice,spatial-relational,2|3,7,2/3,230494,2
1,1,23,495,1,908,1,7,3,3,4,single-choice,spatial-relational,3|4,7,3/4,230495,3
1,1,23,496,1,803,1,5,2,2,3,single-choice,spatial-relational,2|3,7,2/3,230496,2
1,1,23,497,1,866,1,9,4,4,5,single-choice,spatial-relational,4|5,7,4/5,230497,4
1,1,23,498,0,1044,1,13,6,7,7,single-choice,spatial-relational,6|7,7,6/7,230498,6
1,1,23,499,1,827,1,3,1,1,2,single-choice,spatial-relational,1|2,7,1/2,230499,1
1,1,23,500,0,1012,1,3,1,2,2,single-choice,spatial-relational,1|2,7,1/2,230500,1
1,1,23,501,0,575,1,11,5,6,6,single-choice,spatial-relational,5|6,7,5/6,230501,5
1,1,23,502,0,767,1,7,3,4,4,single-choice,spatial-relational,3|4,7,3/4,230502,3
1,1,23,503,1,822,1,9,4,4,5,single-choice,spatial-relational,4|5,7,4/5,230503,4
1,1,23,504,0,1218,1,11,5,6,6,single-choice,spatial-relational,5|6,7,5/6,230504,5
1,1,23,505,1,614,1,13,6,6,7,single-choice,spatial-relational,6|7,7,6/7,230505,6
1,1,23,506,1,950,1,5,2,2,3,single-choice,spatial-relational,2|3,7,2/3,230506,2
1,1,23,507,0,792,1,3,1,2,2,single-choice,spatial-relational,1|2,7,1/2,230507,1
1,1,23,508,1,63,1,11,5,5,6,single-choice,spatial-relational,5|6,7,5/6,230508,5
1,1,23,509,0,1229,1,13,6,7,7,single-choice,spatial-relational,6|7,7,6/7,230509,6
1,1,23,510,0,893,1,5,2,3,3,single-choice,spatial-relational,2|3,7,2/3,230510,2
1,1,23,511,0,912,1,7,3,4,4,single-choice,spatial-relational,3|4,7,3/4,230511,3
1,1,23,512,1,695,1,3,1,1,2,single-choice,spatial-relational,1|2,7,1/2,230512,1
1,1,23,513,1,724,1,9,4,4,5,single-choice,spatial-relational,4|5,7,4/5,230513,4
1,1,23,514,1,984,1,7,3,3,4,single-choice,spatial-relational,3|4,7,3/4,230514,3
1,1,23,515,0,838,1,11,5,6,6,single-choice,spatial-relational,5|6,7,5/6,230515,5
1,1,23,516,0,997,1,9,4,5,5,single-choice,spatial-relational,4|5,7,4/5,230516,4
1,1,23,517,0,811,1,7,3,4,4,single-choice,spatial-relational,3|4,7,3/4,230517,3
1,1,23,518,1,937,1,7,3,3,4,single-choice,spatial-relational,3|4,7,3/4,230518,3
1,1,23,519,1,966,1,9,4,4,5,single-choice,spatial-relational,4|5,7,4/5,230519,4
1,1,23,520,1,915,1,9,4,4,5,single-choice,spatial-relational,4|5,7,4/5,230520,4
1,1,23,521,1,987,1,3,1,1,2,single-choice,spatial-relational,1|2,7,1/2,230521,1
1,1,23,522,1,898,1,5,2,2,3,single-choice,spatial-relational,2|3,7,2/3,230522,2
1,1,23,523,0,831,1,3,1,2,2,single-choice,spatial-relational,1|2,7,1/2,230523,1
1,1,23,524,0,1489,1,13,6,7,7,single-choice,spatial-relational,6|7,7,6/7,230524,6
1,1,23,525,1,1114,1,11,5,5,6,single-choice,spatial-relational,5|6,7,5/6,230525,5
1,1,23,526,1,1183,1,11,5,5,6,single-choice,spatial-relational,5|6,7,5/6,230526,5
1,1,23,527,1,845,1,5,2,2,3,single-choice,spatial-relational,2|3,7,2/3,230527,2
1,1,23,528,1,985,1,13,6,6,7,single-choice,spatial-relational,6|7,7,6/7,230528,6
1,1,23,529,1,1116,1,13,6,6,7,single-choice,spatial-relational,6|7,7,6/7,230529,6
1,1,23,530,1,909,1,5,2,2,3,single-choice,spatial-relational,2|3,7,2/3,230530,2
1,1,23,531,1,869,1,9,4,4,5,single-choice,spatial-relational,4|5,7,4/5,230531,4
1,1,23,532,0,759,1,7,3,4,4,single-choice,spatial-relational,3|4,7,3/4,230532,3
1,1,23,533,1,931,1,9,4,4,5,single-choice,spatial-relational,4|5,7,4/5,230533,4
1,1,23,534,0,966,1,5,2,3,3,single-choice,spatial-relational,2|3,7,2/3,230534,2
1,1,23,535,1,810,1,7,3,3,4,single-choice,spatial-relational,3|4,7,3/4,230535,3
1,1,23,536,1,961,1,3,1,1,2,single-choice,spatial-relational,1|2,7,1/2,230536,1
1,1,23,537,0,1102,1,11,5,6,6,single-choice,spatial-relational,5|6,7,5/6,230537,5
1,1,23,538,0,833,1,3,1,2,2,single-choice,spatial-relational,1|2,7,1/2,230538,1
1,1,23,539,0,64,1,13,6,7,7,single-choice,spatial-relational,6|7,7,6/7,230539,6
1,1,23,540,0,585,1,11,5,6,6,single-choice,spatial-relational,5|6,7,5/6,230540,5
1,1,23,541,1,610,1,13,6,6,7,single-choice,spatial-relational,6|7,7,6/7,230541,6
1,1,23,542,1,1600,1,13,6,6,7,single-choice,spatial-relational,6|7,7,6/7,230542,6
1,1,23,543,0,777,1,3,1,2,2,single-choice,spatial-relational,1|2,7,1/2,230543,1
1,1,23,544,0,880,1,3,1,2,2,single-choice,spatial-relational,1|2,7,1/2,230544,1
1,1,23,545,0,66,1,5,2,3,3,single-choice,spatial-relational,2|3,7,2/3,230545,2
1,1,23,546,1,968,1,11,5,5,6,single-choice,spatial-relational,5|6,7,5/6,230546,5
1,1,23,547,1,1405,1,9,4,4,5,single-choice,spatial-relational,4|5,7,4/5,230547,4
1,1,23,548,1,1223,1,7,3,3,4,single-choice,spatial-relational,3|4,7,3/4,230548,3
1,1,23,549,0,1151,1,11,5,6,6,single-choice,spatial-relational,5|6,7,5/6,230549,5
1,1,23,550,1,801,1,5,2,2,3,single-choice,spatial-relational,2|3,7,2/3,230550,2
1,1,23,551,1,910,1,9,4,4,5,single-choice,spatial-relational,4|5,7,4/5,230551,4
1,1,23,552,0,1203,1,7,3,4,4,single-choice,spatial-relational,3|4,7,3/4,230552,3
1,1,23,553,0,767,1,3,1,2,2,single-choice,spatial-relational,1|2,7,1/2,230553,1
1,1,23,554,1,690,1,13,6,6,7,single-choice,spatial-relational,6|7,7,6/7,230554,6
1,1,23,555,0,1624,1,9,4,5,5,single-choice,spatial-relational,4|5,7,4/5,230555,4
1,1,23,556,1,787,1,3,1,1,2,single-choice,spatial-relational,1|2,7,1/2,230556,1
1,1,23,557,1,741,1,9,4,4,5,single-choice,spatial-relational,4|5,7,4/5,230557,4
1,1,23,558,0,1194,1,5,2,3,3,single-choice,spatial-relational,2|3,7,2/3,230558,2
1,1,23,559,0,50,1,11,5,6,6,single-choice,spatial-relational,5|6,7,5/6,230559,5
1,1,23,560,1,903,1,5,2,2,3,single-choice,spatial-relational,2|3,7,2/3,230560,2
1,1,23,561,1,1808,1,7,3,3,4,single-choice,spatial-relational,3|4,7,3/4,230561,3
1,1,23,562,0,785,1,11,5,6,6,single-choice,spatial-relational,5|6,7,5/6,230562,5
1,1,23,563,0,521,1,7,3,4,4,single-choice,spatial-relational,3|4,7,3/4,230563,3
1,1,23,564,1,910,1,13,6,6,7,single-choice,spatial-relational,6|7,7,6/7,230564,6
1,1,23,565,1,1411,1,13,6,6,7,single-choice,spatial-relational,6|7,7,6/7,230565,6
1,1,23,566,1,1094,1,13,6,6,7,single-choice,spatial-relational,6|7,7,6/7,230566,6
1,1,23,567,1,829,1,5,2,2,3,single-choice,spatial-relational,2|3,7,2/3,230567,2
1,1,23,568,0,767,1,3,1,2,2,single-choice,spatial-relational,1|2,7,1/2,230568,1
1,1,23,569,0,551,1,7,3,4,4,single-choice,spatial-relational,3|4,7,3/4,230569,3
1,1,23,570,0,783,1,11,5,6,6,single-choice,spatial-relational,5|6,7,5/6,230570,5
1,1,23,571,0,984,1,5,2,3,3,single-choice,spatial-relational,2|3,7,2/3,230571,2
1,1,23,572,1,928,1,9,4,4,5,single-choice,spatial-relational,4|5,7,4/5,230572,4
1,1,23,573,1,888,1,11,5,5,6,single-choice,spatial-relational,5|6,7,5/6,230573,5
1,1,23,574,0,1025,1,7,3,4,4,single-choice,spatial-relational,3|4,7,3/4,230574,3
1,1,23,575,1,891,1,9,4,4,5,single-choice,spatial-relational,4|5,7,4/5,230575,4
1,1,23,576,0,788,1,3,1,2,2,single-choice,spatial-relational,1|2,7,1/2,230576,1
1,1,23,577,0,806,1,5,2,3,3,single-choice,spatial-relational,2|3,7,2/3,230577,2
1,1,23,578,0,900,1,11,5,6,6,single-choice,spatial-relational,5|6,7,5/6,230578,5
1,1,23,579,0,623,1,11,5,6,6,single-choice,spatial-relational,5|6,7,5/6,230579,5
1,1,23,580,1,1095,1,9,4,4,5,single-choice,spatial-relational,4|5,7,4/5,230580,4
1,1,23,581,0,983,1,13,6,7,7,single-choice,spatial-relational,6|7,7,6/7,230581,6
1,1,23,582,0,1177,1,3,1,2,2,single-choice,spatial-relational,1|2,7,1/2,230582,1
1,1,23,583,0,604,1,7,3,4,4,single-choice,spatial-relational,3|4,7,3/4,230583,3
1,1,23,584,1,776,1,9,4,4,5,single-choice,spatial-relational,4|5,7,4/5,230584,4
1,1,23,585,1,756,1,5,2,2,3,single-choice,spatial-relational,2|3,7,2/3,230585,2
1,1,23,586,0,1076,1,13,6,7,7,single-choice,spatial-relational,6|7,7,6/7,230586,6
1,1,23,587,1,1134,1,7,3,3,4,single-choice,spatial-relational,3|4,7,3/4,230587,3
1,1,23,588,0,833,1,3,1,2,2,single-choice,spatial-relational,1|2,7,1/2,230588,1
1,1,23,589,1,770,1,9,4,4,5,single-choice,spatial-relational,4|5,7,4/5,230589,4
1,1,23,590,0,1102,1,11,5,6,6,single-choice,spatial-relational,5|6,7,5/6,230590,5
1,1,23,591,0,820,1,5,2,3,3,single-choice,spatial-relational,2|3,7,2/3,230591,2
1,1,23,592,1,756,1,9,4,4,5,single-choice,spatial-relational,4|5,7,4/5,230592,4
1,1,23,593,0,1373,1,3,1,2,2,single-choice,spatial-relational,1|2,7,1/2,230593,1
1,1,23,594,1,801,1,5,2,2,3,single-choice,spatial-relational,2|3,7,2/3,230594,2
1,1,23,595,1,995,1,13,6,6,7,single-choice,spatial-relational,6|7,7,6/7,230595,6
1,1,23,596,0,1017,1,7,3,4,4,single-choice,spatial-relational,3|4,7,3/4,230596,3
1,1,23,597,1,850,1,13,6,6,7,single-choice,spatial-relational,6|7,7,6/7,230597,6
1,1,23,598,0,843,1,11,5,6,6,single-choice,spatial-relational,5|6,7,5/6,230598,5
1,1,23,599,0,649,1,3,1,2,2,single-choice,spatial-relational,1|2,7,1/2,230599,1
1,1,23,600,0,554,1,7,3,4,4,single-choice,spatial-relational,3|4,7,3/4,230600,3
2,1,23,1,1,975,1,3,1,1,2,single-choice,spatial-relational,1|2,7,1/2,230001,1
2,1,23,2,0,775,1,11,5,6,6,single-choice,spatial-relational,5|6,7,5/6,230002,5
2,1,23,3,0,596,1,11,5,6,6,single-choice,spatial-relational,5|6,7,5/6,230003,5
2,1,23,4,0,528,1,7,3,4,4,single-choice,spatial-relational,3|4,7,3/4,230004,3
2,1,23,5,0,625,1,3,1,2,2,single-choice,spatial-relational,1|2,7,1/2,230005,1
2,1,23,6,1,704,1,9,4,4,5,single-choice,spatial-relational,4|5,7,4/5,230006,4
2,1,23,7,0,12,1,5,2,3,3,single-choice,spatial-relational,2|3,7,2/3,230007,2
2,1,23,8,0,633,1,7,3,4,4,single-choice,spatial-relational,3|4,7,3/4,230008,3
2,1,23,9,1,613,1,9,4,4,5,single-choice,spatial-relational,4|5,7,4/5,230009,4
2,1,23,10,1,625,1,5,2,2,3,single-choice,spatial-relational,2|3,7,2/3,230010,2
2,1,23,11,0,51,1,13,6,7,7,single-choice,spatial-relational,6|7,7,6/7,230011,6
2,1,23,12,1,742,1,13,6,6,7,single-choice,spatial-relational,6|7,7,6/7,230012,6
2,1,23,13,0,26,1,11,5,6,6,single-choice,spatial-relational,5|6,7,5/6,230013,5
2,1,23,14,0,937,1,7,3,4,4,single-choice,spatial-relational,3|4,7,3/4,230014,3
2,1,23,15,0,721,1,11,5,6,6,single-choice,spatial-relational,5|6,7,5/6,230015,5
2,1,23,16,1,550,1,5,2,2,3,single-choice,spatial-relational,2|3,7,2/3,230016,2
2,1,23,17,0,560,1,5,2,3,3,single-choice,spatial-relational,2|3,7,2/3,230017,2
2,1,23,18,0,25,1,13,6,7,7,single-choice,spatial-relational,6|7,7,6/7,230018,6
2,1,23,19,1,724,1,9,4,4,5,single-choice,spatial-relational,4|5,7,4/5,230019,4
2,1,23,20,0,573,1,7,3,4,4,single-choice,spatial-relational,3|4,7,3/4,230020,3
2,1,23,21,1,758,1,3,1,1,2,single-choice,spatial-relational,1|2,7,1/2,230021,1
2,1,23,22,0,714,1,3,1,2,2,single-choice,spatial-relational,1|2,7,1/2,230022,1
2,1,23,23,1,784,1,9,4,4,5,single-choice,spatial-relational,4|5,7,4/5,230023,4
2,1,23,24,1,781,1,13,6,6,7,single-choice,spatial-relational,6|7,7,6/7,230024,6
2,1,23,25,1,1131,1,13,6,6,7,single-choice,spatial-relational,6|7,7,6/7,230025,6
2,1,23,26,1,676,1,3,1,1,2,single-choice,spatial-relational,1|2,7,1/2,230026,1
2,1,23,27,0,599,1,11,5,6,6,single-choice,spatial-relational,5|6,7,5/6,230027,5
2,1,23,28,0,602,1,11,5,6,6,single-choice,spatial-relational,5|6,7,5/6,230028,5
2,1,23,29,1,649,1,9,4,4,5,single-choice,spatial-relational,4|5,7,4/5,230029,4
2,1,23,30,1,979,1,7,3,3,4,single-choice,spatial-relational,3|4,7,3/4,230030,3
2,1,23,31,1,935,1,9,4,4,5,single-choice,spatial-relational,4|5,7,4/5,230031,4
2,1,23,32,1,938,1,13,6,6,7,single-choice,spatial-relational,6|7,7,6/7,230032,6
2,1,23,33,1,753,1,5,2,2,3,single-choice,spatial-relational,2|3,7,2/3,230033,2
2,1,23,34,1,595,1,5,2,2,3,single-choice,spatial-relational,2|3,7,2/3,230034,2
2,1,23,35,0,612,1,3,1,2,2,single-choice,spatial-relational,1|2,7,1/2,230035,1
2,1,23,36,0,582,1,7,3,4,4,single-choice,spatial-relational,3|4,7,3/4,230036,3
2,1,23,37,0,861,1,3,1,2,2,single-choice,spatial-relational,1|2,7,1/2,230037,1
2,1,23,38,0,23,1,5,2,3,3,single-choice,spatial-relational,2|3,7,2/3,230038,2
2,1,23,39,1,851,1,5,2,2,3,single-choice,spatial-relational,2|3,7,2/3,230039,2
2,1,23,40,0,727,1,11,5,6,6,single-choice,spatial-relational,5|6,7,5/6,230040,5
2,1,23,41,1,1007,1,13,6,6,7,single-choice,spatial-relational,6|7,7,6/7,230041,6
2,1,23,42,1,731,1,9,4,4,5,single-choice,spatial-relational,4|5,7,4/5,230042,4
2,1,23,43,0,613,1,7,3,4,4,single-choice,spatial-relational,3|4,7,3/4,230043,3
2,1,23,44,1,996,1,13,6,6,7,single-choice,spatial-relational,6|7,7,6/7,230044,6
2,1,23,45,1,1239,1,9,4,4,5,single-choice,spatial-relational,4|5,7,4/5,230045,4
2,1,23,46,1,868,1,3,1,1,2,single-choice,spatial-relational,1|2,7,1/2,230046,1
2,1,23,47,1,808,1,7,3,3,4,single-choice,spatial-relational,3|4,7,3/4,230047,3
2,1,23,48,0,1010,1,11,5,6,6,single-choice,spatial-relational,5|6,7,5/6,230048,5
2,1,23,49,0,1049,1,9,4,5,5,single-choice,spatial-relational,4|5,7,4/5,230049,4
2,1,23,50,1,816,1,3,1,1,2,single-choice,spatial-relational,1|2,7,1/2,230050,1
2,1,23,51,1,924,1,11,5,5,6,single-choice,spatial-relational,5|6,7,5/6,230051,5
2,1,23,52,1,1424,1,13,6,6,7,single-choice,spatial-relational,6|7,7,6/7,230052,6
2,1,23,53,0,740,1,7,3,4,4,single-choice,spatial-relational,3|4,7,3/4,230053,3
2,1,23,54,1,1008,1,7,3,3,4,single-choice,spatial-relational,3|4,7,3/4,230054,3
2,1,23,55,1,717,1,9,4,4,5,single-choice,spatial-relational,4|5,7,4/5,230055,4
2,1,23,56,0,952,1,5,2,3,3,single-choice,spatial-relational,2|3,7,2/3,230056,2
2,1,23,57,1,547,1,13,6,6,7,single-choice,spatial-relational,6|7,7,6/7,230057,6
2,1,23,58,1,794,1,5,2,2,3,single-choice,spatial-relational,2|3,7,2/3,230058,2
2,1,23,59,0,673,1,11,5,6,6,single-choice,spatial-relational,5|6,7,5/6,230059,5
2,1,23,60,0,743,1,3,1,2,2,single-choice,spatial-relational,1|2,7,1/2,230060,1
2,1,23,61,0,637,1,7,3,4,4,single-choice,spatial-relational,3|4,7,3/4,230061,3
2,1,23,62,1,622,1,9,4,4,5,single-choice,spatial-relational,4|5,7,4/5,230062,4
2,1,23,63,0,719,1,11,5,6,6,single-choice,spatial-relational,5|6,7,5/6,230063,5
2,1,23,64,1,844,1,5,2,2,3,single-choice,spatial-relational,2|3,7,2/3,230064,2
2,1,23,65,0,778,1,13,6,7,7,single-choice,spatial-relational,6|7,7,6/7,230065,6
2,1,23,66,0,540,1,11,5,6,6,single-choice,spatial-relational,5|6,7,5/6,230066,5
2,1,23,67,0,816,1,5,2,3,3,single-choice,spatial-relational,2|3,7,2/3,230067,2
2,1,23,68,0,815,1,7,3,4,4,single-choice,spatial-relational,3|4,7,3/4,230068,3
2,1,23,69,1,860,1,3,1,1,2,single-choice,spatial-relational,1|2,7,1/2,230069,1
2,1,23,70,0,1220,1,13,6,7,7,single-choice,spatial-relational,6|7,7,6/7,230070,6
2,1,23,71,0,1100,1,9,4,5,5,single-choice,spatial-relational,4|5,7,4/5,230071,4
2,1,23,72,0,876,1,3,1,2,2,single-choice,spatial-relational,1|2,7,1/2,230072,1
2,1,23,73,1,980,1,11,5,5,6,single-choice,spatial-relational,5|6,7,5/6,230073,5
2,1,23,74,1,939,1,3,1,1,2,single-choice,spatial-relational,1|2,7,1/2,230074,1
2,1,23,75,1,1163,1,13,6,6,7,single-choice,spatial-relational,6|7,7,6/7,230075,6
2,1,23,76,1,731,1,9,4,4,5,single-choice,spatial-relational,4|5,7,4/5,230076,4
2,1,23,77,1,1086,1,13,6,6,7,single-choice,spatial-relational,6|7,7,6/7,230077,6
2,1,23,78,0,976,1,11,5,6,6,single-choice,spatial-relational,5|6,7,5/6,230078,5
2,1,23,79,0,854,1,9,4,5,5,single-choice,spatial-relational,4|5,7,4/5,230079,4
2,1,23,80,1,833,1,7,3,3,4,single-choice,spatial-relational,3|4,7,3/4,230080,3
2,1,23,81,0,933,1,7,3,4,4,single-choice,spatial-relational,3|4,7,3/4,230081,3
2,1,23,82,0,878,1,5,2,3,3,single-choice,spatial-relational,2|3,7,2/3,230082,2
2,1,23,83,1,1025,1,5,2,2,3,single-choice,spatial-relational,2|3,7,2/3,230083,2
2,1,23,84,0,887,1,3,1,2,2,single-choice,spatial-relational,1|2,7,1/2,230084,1
2,1,23,85,1,1241,1,9,4,4,5,single-choice,spatial-relational,4|5,7,4/5,230085,4
2,1,23,86,1,1060,1,11,5,5,6,single-choice,spatial-relational,5|6,7,5/6,230086,5
2,1,23,87,1,982,1,3,1,1,2,single-choice,spatial-relational,1|2,7,1/2,230087,1
2,1,23,88,1,1029,1,5,2,2,3,single-choice,spatial-relational,2|3,7,2/3,230088,2
2,1,23,89,0,961,1,13,6,7,7,single-choice,spatial-relational,6|7,7,6/7,230089,6
2,1,23,90,0,1212,1,3,1,2,2,single-choice,spatial-relational,1|2,7,1/2,230090,1
2,1,23,91,0,1096,1,9,4,5,5,single-choice,spatial-relational,4|5,7,4/5,230091,4
2,1,23,92,1,14,1,7,3,3,4,single-choice,spatial-relational,3|4,7,3/4,230092,3
2,1,23,93,1,1042,1,13,6,6,7,single-choice,spatial-relational,6|7,7,6/7,230093,6
2,1,23,94,1,888,1,5,2,2,3,single-choice,spatial-relational,2|3,7,2/3,230094,2
2,1,23,95,0,1045,1,11,5,6,6,single-choice,spatial-relational,5|6,7,5/6,230095,5
2,1,23,96,0,1026,1,7,3,4,4,single-choice,spatial-relational,3|4,7,3/4,230096,3
2,1,23,97,0,1287,1,11,5,6,6,single-choice,spatial-relational,5|6,7,5/6,230097,5
2,1,23,98,1,1428,1,9,4,4,5,single-choice,spatial-relational,4|5,7,4/5,230098,4
2,1,23,99,0,1167,1,5,2,3,3,single-choice,spatial-relational,2|3,7,2/3,230099,2
2,1,23,100,1,986,1,13,6,6,7,single-choice,spatial-relational,6|7,7,6/7,230100,6
2,1,23,101,1,910,1,3,1,1,2,single-choice,spatial-relational,1|2,7,1/2,230101,1
2,1,23,102,1,1041,1,11,5,5,6,single-choice,spatial-relational,5|6,7,5/6,230102,5
2,1,23,103,1,974,1,5,2,2,3,single-choice,spatial-relational,2|3,7,2/3,230103,2
2,1,23,104,1,784,1,7,3,3,4,single-choice,spatial-relational,3|4,7,3/4,230104,3
2,1,23,105,0,1089,1,13,6,7,7,single-choice,spatial-relational,6|7,7,6/7,230105,6
2,1,23,106,1,1219,1,3,1,1,2,single-choice,spatial-relational,1|2,7,1/2,230106,1
2,1,23,107,1,1133,1,7,3,3,4,single-choice,spatial-relational,3|4,7,3/4,230107,3
2,1,23,108,0,850,1,9,4,5,5,single-choice,spatial-relational,4|5,7,4/5,230108,4
2,1,23,109,0,1357,1,9,4,5,5,single-choice,spatial-relational,4|5,7,4/5,230109,4
2,1,23,110,1,71,1,13,6,6,7,single-choice,spatial-relational,6|7,7,6/7,230110,6
2,1,23,111,0,1323,1,11,5,6,6,single-choice,spatial-relational,5|6,7,5/6,230111,5
2,1,23,112,0,734,1,3,1,2,2,single-choice,spatial-relational,1|2,7,1/2,230112,1
2,1,23,113,1,833,1,7,3,3,4,single-choice,spatial-relational,3|4,7,3/4,230113,3
2,1,23,114,1,1425,1,13,6,6,7,single-choice,spatial-relational,6|7,7,6/7,230114,6
2,1,23,115,0,938,1,9,4,5,5,single-choice,spatial-relational,4|5,7,4/5,230115,4
2,1,23,116,0,970,1,5,2,3,3,single-choice,spatial-relational,2|3,7,2/3,230116,2
2,1,23,117,1,1122,1,3,1,1,2,single-choice,spatial-relational,1|2,7,1/2,230117,1
2,1,23,118,1,1069,1,11,5,5,6,single-choice,spatial-relational,5|6,7,5/6,230118,5
2,1,23,119,0,875,1,7,3,4,4,single-choice,spatial-relational,3|4,7,3/4,230119,3
2,1,23,120,1,627,1,5,2,2,3,single-choice,spatial-relational,2|3,7,2/3,230120,2
2,1,23,121,0,1100,1,5,2,3,3,single-choice,spatial-relational,2|3,7,2/3,230121,2
2,1,23,122,1,1253,1,7,3,3,4,single-choice,spatial-relational,3|4,7,3/4,230122,3
2,1,23,123,0,1282,1,7,3,4,4,single-choice,spatial-relational,3|4,7,3/4,230123,3
2,1,23,124,0,832,1,9,4,5,5,single-choice,spatial-relational,4|5,7,4/5,230124,4
2,1,23,125,1,920,1,3,1,1,2,single-choice,spatial-relational,1|2,7,1/2,230125,1
2,1,23,126,1,1039,1,9,4,4,5,single-choice,spatial-relational,4|5,7,4/5,230126,4
2,1,23,127,1,831,1,11,5,5,6,single-choice,spatial-relational,5|6,7,5/6,230127,5
2,1,23,128,1,935,1,5,2,2,3,single-choice,spatial-relational,2|3,7,2/3,230128,2
2,1,23,129,1,1415,1,13,6,6,7,single-choice,spatial-relational,6|7,7,6/7,230129,6
2,1,23,130,0,859,1,3,1,2,2,single-choice,spatial-relational,1|2,7,1/2,230130,1
2,1,23,131,1,1010,1,11,5,5,6,single-choice,spatial-relational,5|6,7,5/6,230131,5
2,1,23,132,0,1244,1,13,6,7,7,single-choice,spatial-relational,6|7,7,6/7,230132,6
2,1,23,133,1,940,1,11,5,5,6,single-choice,spatial-relational,5|6,7,5/6,230133,5
2,1,23,134,1,1325,1,11,5,5,6,single-choice,spatial-relational,5|6,7,5/6,230134,5
2,1,23,135,1,1155,1,9,4,4,5,single-choice,spatial-relational,4|5,7,4/5,230135,4
2,1,23,136,1,1547,1,9,4,4,5,single-choice,spatial-relational,4|5,7,4/5,230136,4
2,1,23,137,1,1046,1,13,6,6,7,single-choice,spatial-relational,6|7,7,6/7,230137,6
2,1,23,138,1,914,1,13,6,6,7,single-choice,spatial-relational,6|7,7,6/7,230138,6
2,1,23,139,0,946,1,3,1,2,2,single-choice,spatial-relational,1|2,7,1/2,230139,1
2,1,23,140,1,1254,1,5,2,2,3,single-choice,spatial-relational,2|3,7,2/3,230140,2
2,1,23,141,1,1000,1,7,3,3,4,single-choice,spatial-relational,3|4,7,3/4,230141,3
2,1,23,142,1,1133,1,5,2,2,3,single-choice,spatial-relational,2|3,7,2/3,230142,2
2,1,23,143,1,867,1,3,1,1,2,single-choice,spatial-relational,1|2,7,1/2,230143,1
2,1,23,144,0,863,1,7,3,4,4,single-choice,spatial-relational,3|4,7,3/4,230144,3
2,1,23,145,1,949,1,7,3,3,4,single-choice,spatial-relational,3|4,7,3/4,230145,3
2,1,23,146,1,799,1,5,2,2,3,single-choice,spatial-relational,2|3,7,2/3,230146,2
2,1,23,147,0,720,1,3,1,2,2,single-choice,spatial-relational,1|2,7,1/2,230147,1
2,1,23,148,1,1265,1,9,4,4,5,single-choice,spatial-relational,4|5,7,4/5,230148,4
2,1,23,149,0,903,1,5,2,3,3,single-choice,spatial-relational,2|3,7,2/3,230149,2
2,1,23,150,1,1284,1,7,3,3,4,single-choice,spatial-relational,3|4,7,3/4,230150,3
2,1,23,151,0,1066,1,13,6,7,7,single-choice,spatial-relational,6|7,7,6/7,230151,6
2,1,23,152,1,80,1,11,5,5,6,single-choice,spatial-relational,5|6,7,5/6,230152,5
2,1,23,153,0,160,1,9,4,5,5,single-choice,spatial-relational,4|5,7,4/5,230153,4
2,1,23,154,0,758,1,3,1,2,2,single-choice,spatial-relational,1|2,7,1/2,230154,1
2,1,23,155,0,972,1,11,5,6,6,single-choice,spatial-relational,5|6,7,5/6,230155,5
2,1,23,156,1,1020,1,13,6,6,7,single-choice,spatial-relational,6|7,7,6/7,230156,6
2,1,23,157,1,1114,1,11,5,5,6,single-choice,spatial-relational,5|6,7,5/6,230157,5
2,1,23,158,0,1443,1,11,5,6,6,single-choice,spatial-relational,5|6,7,5/6,230158,5
2,1,23,159,0,1357,1,13,6,7,7,single-choice,spatial-relational,6|7,7,6/7,230159,6
2,1,23,160,1,1006,1,7,3,3,4,single-choice,spatial-relational,3|4,7,3/4,230160,3
2,1,23,161,1,939,1,9,4,4,5,single-choice,spatial-relational,4|5,7,4/5,230161,4
2,1,23,162,0,1026,1,5,2,3,3,single-choice,spatial-relational,2|3,7,2/3,230162,2
2,1,23,163,1,1168,1,3,1,1,2,single-choice,spatial-relational,1|2,7,1/2,230163,1
2,1,23,164,1,901,1,5,2,2,3,single-choice,spatial-relational,2|3,7,2/3,230164,2
2,1,23,165,1,763,1,3,1,1,2,single-choice,spatial-relational,1|2,7,1/2,230165,1
2,1,23,166,1,1142,1,7,3,3,4,single-choice,spatial-relational,3|4,7,3/4,230166,3
2,1,23,167,0,898,1,9,4,5,5,single-choice,spatial-relational,4|5,7,4/5,230167,4
2,1,23,168,1,886,1,13,6,6,7,single-choice,spatial-relational,6|7,7,6/7,230168,6
2,1,23,169,0,1429,1,5,2,3,3,single-choice,spatial-relational,2|3,7,2/3,230169,2
2,1,23,170,0,844,1,5,2,3,3,single-choice,spatial-relational,2|3,7,2/3,230170,2
2,1,23,171,1,1033,1,13,6,6,7,single-choice,spatial-relational,6|7,7,6/7,230171,6
2,1,23,172,0,1189,1,3,1,2,2,single-choice,spatial-relational,1|2,7,1/2,230172,1
2,1,23,173,1,1121,1,3,1,1,2,single-choice,spatial-relational,1|2,7,1/2,230173,1
2,1,23,174,0,863,1,7,3,4,4,single-choice,spatial-relational,3|4,7,3/4,230174,3
2,1,23,175,0,1392,1,13,6,7,7,single-choice,spatial-relational,6|7,7,6/7,230175,6
2,1,23,176,0,1018,1,9,4,5,5,single-choice,spatial-relational,4|5,7,4/5,230176,4
2,1,23,177,1,1298,1,9,4,4,5,single-choice,spatial-relational,4|5,7,4/5,230177,4
2,1,23,178,1,1143,1,11,5,5,6,single-choice,spatial-relational,5|6,7,5/6,230178,5
2,1,23,179,0,1162,1,7,3,4,4,single-choice,spatial-relational,3|4,7,3/4,230179,3
2,1,23,180,1,1615,1,11,5,5,6,single-choice,spatial-relational,5|6,7,5/6,230180,5
2,1,23,181,1,1480,1,7,3,3,4,single-choice,spatial-relational,3|4,7,3/4,230181,3
2,1,23,182,1,905,1,3,1,1,2,single-choice,spatial-relational,1|2,7,1/2,230182,1
2,1,23,183,0,1158,1,11,5,6,6,single-choice,spatial-relational,5|6,7,5/6,230183,5
2,1,23,184,1,1228,1,5,2,2,3,single-choice,spatial-relational,2|3,7,2/3,230184,2
2,1,23,185,1,851,1,5,2,2,3,single-choice,spatial-relational,2|3,7,2/3,230185,2
2,1,23,186,1,688,1,3,1,1,2,single-choice,spatial-relational,1|2,7,1/2,230186,1
2,1,23,187,0,982,1,7,3,4,4,single-choice,spatial-relational,3|4,7,3/4,230187,3
2,1,23,188,0,875,1,9,4,5,5,single-choice,spatial-relational,4|5,7,4/5,230188,4
2,1,23,189,1,1170,1,13,6,6,7,single-choice,spatial-relational,6|7,7,6/7,230189,6
2,1,23,190,0,1070,1,11,5,6,6,single-choice,spatial-relational,5|6,7,5/6,230190,5
2,1,23,191,0,884,1,9,4,5,5,single-choice,spatial-relational,4|5,7,4/5,230191,4
2,1,23,192,0,1364,1,13,6,7,7,single-choice,spatial-relational,6|7,7,6/7,230192,6
2,1,23,193,0,1414,1,13,6,7,7,single-choice,spatial-relational,6|7,7,6/7,230193,6
2,1,23,194,0,1145,1,3,1,2,2,single-choice,spatial-relational,1|2,7,1/2,230194,1
2,1,23,195,1,906,1,11,5,5,6,single-choice,spatial-relational,5|6,7,5/6,230195,5
2,1,23,196,1,1126,1,11,5,5,6,single-choice,spatial-relational,5|6,7,5/6,230196,5
2,1,23,197,1,903,1,5,2,2,3,single-choice,spatial-relational,2|3,7,2/3,230197,2
2,1,23,198,1,1120,1,9,4,4,5,single-choice,spatial-relational,4|5,7,4/5,230198,4
2,1,23,199,1,1045,1,5,2,2,3,single-choice,spatial-relational,2|3,7,2/3,230199,2
2,1,23,200,1,1027,1,13,6,6,7,single-choice,spatial-relational,6|7,7,6/7,230200,6
2,1,23,201,0,812,1,7,3,4,4,single-choice,spatial-relational,3|4,7,3/4,230201,3
2,1,23,202,1,899,1,7,3,3,4,single-choice,spatial-relational,3|4,7,3/4,230202,3
2,1,23,203,1,918,1,3,1,1,2,single-choice,spatial-relational,1|2,7,1/2,230203,1
2,1,23,204,0,1686,1,9,4,5,5,single-choice,spatial-relational,4|5,7,4/5,230204,4
2,1,23,205,1,1387,1,9,4,4,5,single-choice,spatial-relational,4|5,7,4/5,230205,4
2,1,23,206,0,1015,1,3,1,2,2,single-choice,spatial-relational,1|2,7,1/2,230206,1
2,1,23,207,1,1351,1,13,6,6,7,single-choice,spatial-relational,6|7,7,6/7,230207,6
2,1,23,208,1,1140,1,5,2,2,3,single-choice,spatial-relational,2|3,7,2/3,230208,2
2,1,23,209,1,1516,1,9,4,4,5,single-choice,spatial-relational,4|5,7,4/5,230209,4
2,1,23,210,0,1138,1,7,3,4,4,single-choice,spatial-relational,3|4,7,3/4,230210,3
2,1,23,211,0,1179,1,5,2,3,3,single-choice,spatial-relational,2|3,7,2/3,230211,2
2,1,23,212,0,77,1,7,3,4,4,single-choice,spatial-relational,3|4,7,3/4,230212,3
2,1,23,213,0,1017,1,11,5,6,6,single-choice,spatial-relational,5|6,7,5/6,230213,5
2,1,23,214,0,935,1,11,5,6,6,single-choice,spatial-relational,5|6,7,5/6,230214,5
2,1,23,215,0,1407,1,13,6,7,7,single-choice,spatial-relational,6|7,7,6/7,230215,6
2,1,23,216,1,959,1,3,1,1,2,single-choice,spatial-relational,1|2,7,1/2,230216,1
2,1,23,217,1,1385,1,9,4,4,5,single-choice,spatial-relational,4|5,7,4/5,230217,4
2,1,23,218,0,1005,1,9,4,5,5,single-choice,spatial-relational,4|5,7,4/5,230218,4
2,1,23,219,1,825,1,11,5,5,6,single-choice,spatial-relational,5|6,7,5/6,230219,5
2,1,23,220,0,1121,1,7,3,4,4,single-choice,spatial-relational,3|4,7,3/4,230220,3
2,1,23,221,1,1103,1,3,1,1,2,single-choice,spatial-relational,1|2,7,1/2,230221,1
2,1,23,222,0,806,1,5,2,3,3,single-choice,spatial-relational,2|3,7,2/3,230222,2
2,1,23,223,0,65,1,13,6,7,7,single-choice,spatial-relational,6|7,7,6/7,230223,6
2,1,23,224,1,990,1,13,6,6,7,single-choice,spatial-relational,6|7,7,6/7,230224,6
2,1,23,225,0,1050,1,5,2,3,3,single-choice,spatial-relational,2|3,7,2/3,230225,2
2,1,23,226,0,1538,1,11,5,6,6,single-choice,spatial-relational,5|6,7,5/6,230226,5
2,1,23,227,1,875,1,7,3,3,4,single-choice,spatial-relational,3|4,7,3/4,230227,3
2,1,23,228,0,1026,1,3,1,2,2,single-choice,spatial-relational,1|2,7,1/2,230228,1
2,1,23,229,1,994,1,3,1,1,2,single-choice,spatial-relational,1|2,7,1/2,230229,1
2,1,23,230,1,1095,1,11,5,5,6,single-choice,spatial-relational,5|6,7,5/6,230230,5
2,1,23,231,1,772,1,5,2,2,3,single-choice,spatial-relational,2|3,7,2/3,230231,2
2,1,23,232,1,763,1,7,3,3,4,single-choice,spatial-relational,3|4,7,3/4,230232,3
2,1,23,233,0,906,1,5,2,3,3,single-choice,spatial-relational,2|3,7,2/3,230233,2
2,1,23,234,0,1206,1,9,4,5,5,single-choice,spatial-relational,4|5,7,4/5,230234,4
2,1,23,235,0,1218,1,9,4,5,5,single-choice,spatial-relational,4|5,7,4/5,230235,4
2,1,23,236,1,782,1,3,1,1,2,single-choice,spatial-relational,1|2,7,1/2,230236,1
2,1,23,237,1,790,1,7,3,3,4,single-choice,spatial-relational,3|4,7,3/4,230237,3
2,1,23,238,0,991,1,11,5,6,6,single-choice,spatial-relational,5|6,7,5/6,230238,5
2,1,23,239,1,1383,1,13,6,6,7,single-choice,spatial-relational,6|7,7,6/7,230239,6
2,1,23,240,1,970,1,13,6,6,7,single-choice,spatial-relational,6|7,7,6/7,230240,6
2,1,23,241,0,859,1,9,4,5,5,single-choice,spatial-relational,4|5,7,4/5,230241,4
2,1,23,242,0,1084,1,5,2,3,3,single-choice,spatial-relational,2|3,7,2/3,230242,2
2,1,23,243,1,1095,1,9,4,4,5,single-choice,spatial-relational,4|5,7,4/5,230243,4
2,1,23,244,1,1216,1,11,5,5,6,single-choice,spatial-relational,5|6,7,5/6,230244,5
2,1,23,245,0,1494,1,11,5,6,6,single-choice,spatial-relational,5|6,7,5/6,230245,5
2,1,23,246,0,1323,1,13,6,7,7,single-choice,spatial-relational,6|7,7,6/7,230246,6
2,1,23,247,0,1094,1,5,2,3,3,single-choice,spatial-relational,2|3,7,2/3,230247,2
2,1,23,248,0,1183,1,7,3,4,4,single-choice,spatial-relational,3|4,7,3/4,230248,3
2,1,23,249,0,1248,1,13,6,7,7,single-choice,spatial-relational,6|7,7,6/7,230249,6
2,1,23,250,1,1039,1,3,1,1,2,single-choice,spatial-relational,1|2,7,1/2,230250,1
2,1,23,251,1,878,1,3,1,1,2,single-choice,spatial-relational,1|2,7,1/2,230251,1
2,1,23,252,1,1239,1,7,3,3,4,single-choice,spatial-relational,3|4,7,3/4,230252,3
2,1,23,253,1,898,1,11,5,5,6,single-choice,spatial-relational,5|6,7,5/6,230253,5
2,1,23,254,1,1471,1,3,1,1,2,single-choice,spatial-relational,1|2,7,1/2,230254,1
2,1,23,255,1,813,1,13,6,6,7,single-choice,spatial-relational,6|7,7,6/7,230255,6
2,1,23,256,0,840,1,9,4,5,5,single-choice,spatial-relational,4|5,7,4/5,230256,4
2,1,23,257,1,1319,1,7,3,3,4,single-choice,spatial-relational,3|4,7,3/4,230257,3
2,1,23,258,1,1471,1,9,4,4,5,single-choice,spatial-relational,4|5,7,4/5,230258,4
2,1,23,259,1,865,1,5,2,2,3,single-choice,spatial-relational,2|3,7,2/3,230259,2
2,1,23,260,1,735,1,13,6,6,7,single-choice,spatial-relational,6|7,7,6/7,230260,6
2,1,23,261,1,997,1,3,1,1,2,single-choice,spatial-relational,1|2,7,1/2,230261,1
2,1,23,262,1,697,1,11,5,5,6,single-choice,spatial-relational,5|6,7,5/6,230262,5
2,1,23,263,1,1446,1,5,2,2,3,single-choice,spatial-relational,2|3,7,2/3,230263,2
2,1,23,264,1,837,1,7,3,3,4,single-choice,spatial-relational,3|4,7,3/4,230264,3
2,1,23,265,1,1208,1,3,1,1,2,single-choice,spatial-relational,1|2,7,1/2,230265,1
2,1,23,266,1,772,1,13,6,6,7,single-choice,spatial-relational,6|7,7,6/7,230266,6
2,1,23,267,0,1628,1,9,4,5,5,single-choice,spatial-relational,4|5,7,4/5,230267,4
2,1,23,268,1,1068,1,7,3,3,4,single-choice,spatial-relational,3|4,7,3/4,230268,3
2,1,23,269,0,796,1,9,4,5,5,single-choice,spatial-relational,4|5,7,4/5,230269,4
2,1,23,270,1,907,1,7,3,3,4,single-choice,spatial-relational,3|4,7,3/4,230270,3
2,1,23,271,0,1758,1,11,5,6,6,single-choice,spatial-relational,5|6,7,5/6,230271,5
2,1,23,272,0,830,1,3,1,2,2,single-choice,spatial-relational,1|2,7,1/2,230272,1
2,1,23,273,1,1139,1,13,6,6,7,single-choice,spatial-relational,6|7,7,6/7,230273,6
2,1,23,274,0,1456,1,11,5,6,6,single-choice,spatial-relational,5|6,7,5/6,230274,5
2,1,23,275,1,1063,1,5,2,2,3,single-choice,spatial-relational,2|3,7,2/3,230275,2
2,1,23,276,0,790,1,5,2,3,3,single-choice,spatial-relational,2|3,7,2/3,230276,2
2,1,23,277,0,1045,1,13,6,7,7,single-choice,spatial-relational,6|7,7,6/7,230277,6
2,1,23,278,1,1230,1,5,2,2,3,single-choice,spatial-relational,2|3,7,2/3,230278,2
2,1,23,279,0,848,1,3,1,2,2,single-choice,spatial-relational,1|2,7,1/2,230279,1
2,1,23,280,1,840,1,7,3,3,4,single-choice,spatial-relational,3|4,7,3/4,230280,3
2,1,23,281,1,1268,1,9,4,4,5,single-choice,spatial-relational,4|5,7,4/5,230281,4
2,1,23,282,1,1079,1,3,1,1,2,single-choice,spatial-relational,1|2,7,1/2,230282,1
2,1,23,283,1,949,1,5,2,2,3,single-choice,spatial-relational,2|3,7,2/3,230283,2
2,1,23,284,0,830,1,7,3,4,4,single-choice,spatial-relational,3|4,7,3/4,230284,3
2,1,23,285,1,1187,1,13,6,6,7,single-choice,spatial-relational,6|7,7,6/7,230285,6
2,1,23,286,1,1402,1,9,4,4,5,single-choice,spatial-relational,4|5,7,4/5,230286,4
2,1,23,287,1,1135,1,11,5,5,6,single-choice,spatial-relational,5|6,7,5/6,230287,5
2,1,23,288,0,1227,1,11,5,6,6,single-choice,spatial-relational,5|6,7,5/6,230288,5
2,1,23,289,0,1227,1,13,6,7,7,single-choice,spatial-relational,6|7,7,6/7,230289,6
2,1,23,290,1,1036,1,3,1,1,2,single-choice,spatial-relational,1|2,7,1/2,230290,1
2,1,23,291,0,893,1,9,4,5,5,single-choice,spatial-relational,4|5,7,4/5,230291,4
2,1,23,292,0,1287,1,13,6,7,7,single-choice,spatial-relational,6|7,7,6/7,230292,6
2,1,23,293,1,1033,1,3,1,1,2,single-choice,spatial-relational,1|2,7,1/2,230293,1
2,1,23,294,1,742,1,11,5,5,6,single-choice,spatial-relational,5|6,7,5/6,230294,5
2,1,23,295,0,1686,1,9,4,5,5,single-choice,spatial-relational,4|5,7,4/5,230295,4
2,1,23,296,0,1074,1,5,2,3,3,single-choice,spatial-relational,2|3,7,2/3,230296,2
2,1,23,297,0,1425,1,11,5,6,6,single-choice,spatial-relational,5|6,7,5/6,230297,5
2,1,23,298,1,1284,1,7,3,3,4,single-choice,spatial-relational,3|4,7,3/4,230298,3
2,1,23,299,1,1601,1,5,2,2,3,single-choice,spatial-relational,2|3,7,2/3,230299,2
2,1,23,300,0,835,1,7,3,4,4,single-choice,spatial-relational,3|4,7,3/4,230300,3
2,1,23,301,1,1017,1,3,1,1,2,single-choice,spatial-relational,1|2,7,1/2,230301,1
2,1,23,302,1,848,1,3,1,1,2,single-choice,spatial-relational,1|2,7,1/2,230302,1
2,1,23,303,0,691,1,7,3,4,4,single-choice,spatial-relational,3|4,7,3/4,230303,3
2,1,23,304,1,1158,1,13,6,6,7,single-choice,spatial-relational,6|7,7,6/7,230304,6
2,1,23,305,1,1553,1,5,2,2,3,single-choice,spatial-relational,2|3,7,2/3,230305,2
2,1,23,306,1,1338,1,9,4,4,5,single-choice,spatial-relational,4|5,7,4/5,230306,4
2,1,23,307,0,1046,1,5,2,3,3,single-choice,spatial-relational,2|3,7,2/3,230307,2
2,1,23,308,0,1533,1,11,5,6,6,single-choice,spatial-relational,5|6,7,5/6,230308,5
2,1,23,309,1,1033,1,7,3,3,4,single-choice,spatial-relational,3|4,7,3/4,230309,3
2,1,23,310,0,1081,1,9,4,5,5,single-choice,spatial-relational,4|5,7,4/5,230310,4
2,1,23,311,0,94,1,13,6,7,7,single-choice,spatial-relational,6|7,7,6/7,230311,6
2,1,23,312,0,1276,1,11,5,6,6,single-choice,spatial-relational,5|6,7,5/6,230312,5
2,1,23,313,1,846,1,11,5,5,6,single-choice,spatial-relational,5|6,7,5/6,230313,5
2,1,23,314,1,1109,1,3,1,1,2,single-choice,spatial-relational,1|2,7,1/2,230314,1
2,1,23,315,1,868,1,13,6,6,7,single-choice,spatial-relational,6|7,7,6/7,230315,6
2,1,23,316,0,1366,1,7,3,4,4,single-choice,spatial-relational,3|4,7,3/4,230316,3
2,1,23,317,0,1042,1,5,2,3,3,single-choice,spatial-relational,2|3,7,2/3,230317,2
2,1,23,318,1,992,1,13,6,6,7,single-choice,spatial-relational,6|7,7,6/7,230318,6
2,1,23,319,0,1233,1,9,4,5,5,single-choice,spatial-relational,4|5,7,4/5,230319,4
2,1,23,320,1,1056,1,7,3,3,4,single-choice,spatial-relational,3|4,7,3/4,230320,3
2,1,23,321,1,1229,1,5,2,2,3,single-choice,spatial-relational,2|3,7,2/3,230321,2
2,1,23,322,0,1133,1,9,4,5,5,single-choice,spatial-relational,4|5,7,4/5,230322,4
2,1,23,323,1,1075,1,3,1,1,2,single-choice,spatial-relational,1|2,7,1/2,230323,1
2,1,23,324,0,794,1,11,5,6,6,single-choice,spatial-relational,5|6,7,5/6,230324,5
2,1,23,325,1,1335,1,5,2,2,3,single-choice,spatial-relational,2|3,7,2/3,230325,2
2,1,23,326,0,1285,1,11,5,6,6,single-choice,spatial-relational,5|6,7,5/6,230326,5
2,1,23,327,1,1104,1,13,6,6,7,single-choice,spatial-relational,6|7,7,6/7,230327,6
2,1,23,328,1,1821,1,13,6,6,7,single-choice,spatial-relational,6|7,7,6/7,230328,6
2,1,23,329,1,1430,1,7,3,3,4,single-choice,spatial-relational,3|4,7,3/4,230329,3
2,1,23,330,0,1157,1,9,4,5,5,single-choice,spatial-relational,4|5,7,4/5,230330,4
2,1,23,331,1,889,1,3,1,1,2,single-choice,spatial-relational,1|2,7,1/2,230331,1
2,1,23,332,0,869,1,5,2,3,3,single-choice,spatial-relational,2|3,7,2/3,230332,2
2,1,23,333,0,1109,1,3,1,2,2,single-choice,spatial-relational,1|2,7,1/2,230333,1
2,1,23,334,0,63,1,11,5,6,6,single-choice,spatial-relational,5|6,7,5/6,230334,5
2,1,23,335,1,1051,1,9,4,4,5,single-choice,spatial-relational,4|5,7,4/5,230335,4
2,1,23,336,0,1384,1,7,3,4,4,single-choice,spatial-relational,3|4,7,3/4,230336,3
2,1,23,337,1,876,1,7,3,3,4,single-choice,spatial-relational,3|4,7,3/4,230337,3
2,1,23,338,0,897,1,5,2,3,3,single-choice,spatial-relational,2|3,7,2/3,230338,2
2,1,23,339,1,1100,1,9,4,4,5,single-choice,spatial-relational,4|5,7,4/5,230339,4
2,1,23,340,1,967,1,5,2,2,3,single-choice,spatial-relational,2|3,7,2/3,230340,2
2,1,23,341,1,1112,1,3,1,1,2,single-choice,spatial-relational,1|2,7,1/2,230341,1
2,1,23,342,0,1230,1,11,5,6,6,single-choice,spatial-relational,5|6,7,5/6,230342,5
2,1,23,343,0,911,1,9,4,5,5,single-choice,spatial-relational,4|5,7,4/5,230343,4
2,1,23,344,1,917,1,13,6,6,7,single-choice,spatial-relational,6|7,7,6/7,230344,6
2,1,23,345,1,1453,1,7,3,3,4,single-choice,spatial-relational,3|4,7,3/4,230345,3
2,1,23,346,1,1408,1,11,5,5,6,single-choice,spatial-relational,5|6,7,5/6,230346,5
2,1,23,347,0,951,1,3,1,2,2,single-choice,spatial-relational,1|2,7,1/2,230347,1
2,1,23,348,0,1331,1,13,6,7,7,single-choice,spatial-relational,6|7,7,6/7,230348,6
2,1,23,349,0,1502,1,11,5,6,6,single-choice,spatial-relational,5|6,7,5/6,230349,5
2,1,23,350,1,923,1,7,3,3,4,single-choice,spatial-relational,3|4,7,3/4,230350,3
2,1,23,351,1,1225,1,9,4,4,5,single-choice,spatial-relational,4|5,7,4/5,230351,4
2,1,23,352,1,960,1,13,6,6,7,single-choice,spatial-relational,6|7,7,6/7,230352,6
2,1,23,353,1,1086,1,13,6,6,7,single-choice,spatial-relational,6|7,7,6/7,230353,6
2,1,23,354,1,805,1,9,4,4,5,single-choice,spatial-relational,4|5,7,4/5,230354,4
2,1,23,355,0,713,1,11,5,6,6,single-choice,spatial-relational,5|6,7,5/6,230355,5
2,1,23,356,1,1187,1,7,3,3,4,single-choice,spatial-relational,3|4,7,3/4,230356,3
2,1,23,357,1,1157,1,5,2,2,3,single-choice,spatial-relational,2|3,7,2/3,230357,2
2,1,23,358,1,1039,1,5,2,2,3,single-choice,spatial-relational,2|3,7,2/3,230358,2
2,1,23,359,0,1082,1,3,1,2,2,single-choice,spatial-relational,1|2,7,1/2,230359,1
2,1,23,360,1,950,1,3,1,1,2,single-choice,spatial-relational,1|2,7,1/2,230360,1
2,1,23,361,0,1116,1,11,5,6,6,single-choice,spatial-relational,5|6,7,5/6,230361,5
2,1,23,362,1,1116,1,9,4,4,5,single-choice,spatial-relational,4|5,7,4/5,230362,4
2,1,23,363,1,1476,1,5,2,2,3,single-choice,spatial-relational,2|3,7,2/3,230363,2
2,1,23,364,1,712,1,3,1,1,2,single-choice,spatial-relational,1|2,7,1/2,230364,1
2,1,23,365,1,830,1,5,2,2,3,single-choice,spatial-relational,2|3,7,2/3,230365,2
2,1,23,366,1,1023,1,11,5,5,6,single-choice,spatial-relational,5|6,7,5/6,230366,5
2,1,23,367,0,1498,1,13,6,7,7,single-choice,spatial-relational,6|7,7,6/7,230367,6
2,1,23,368,1,1023,1,7,3,3,4,single-choice,spatial-relational,3|4,7,3/4,230368,3
2,1,23,369,0,1041,1,9,4,5,5,single-choice,spatial-relational,4|5,7,4/5,230369,4
2,1,23,370,0,1496,1,13,6,7,7,single-choice,spatial-relational,6|7,7,6/7,230370,6
2,1,23,371,1,1436,1,7,3,3,4,single-choice,spatial-relational,3|4,7,3/4,230371,3
2,1,23,372,1,786,1,3,1,1,2,single-choice,spatial-relational,1|2,7,1/2,230372,1
2,1,23,373,1,1186,1,9,4,4,5,single-choice,spatial-relational,4|5,7,4/5,230373,4
2,1,23,374,0,1233,1,11,5,6,6,single-choice,spatial-relational,5|6,7,5/6,230374,5
2,1,23,375,1,923,1,5,2,2,3,single-choice,spatial-relational,2|3,7,2/3,230375,2
2,1,23,376,1,948,1,7,3,3,4,single-choice,spatial-relational,3|4,7,3/4,230376,3
2,1,23,377,1,1234,1,13,6,6,7,single-choice,spatial-relational,6|7,7,6/7,230377,6
2,1,23,378,0,860,1,9,4,5,5,single-choice,spatial-relational,4|5,7,4/5,230378,4
2,1,23,379,1,842,1,3,1,1,2,single-choice,spatial-relational,1|2,7,1/2,230379,1
2,1,23,380,1,886,1,7,3,3,4,single-choice,spatial-relational,3|4,7,3/4,230380,3
2,1,23,381,0,1413,1,3,1,2,2,single-choice,spatial-relational,1|2,7,1/2,230381,1
2,1,23,382,1,1282,1,13,6,6,7,single-choice,spatial-relational,6|7,7,6/7,230382,6
2,1,23,383,1,1332,1,5,2,2,3,single-choice,spatial-relational,2|3,7,2/3,230383,2
2,1,23,384,1,1174,1,11,5,5,6,single-choice,spatial-relational,5|6,7,5/6,230384,5
2,1,23,385,0,835,1,7,3,4,4,single-choice,spatial-relational,3|4,7,3/4,230385,3
2,1,23,386,1,1336,1,11,5,5,6,single-choice,spatial-relational,5|6,7,5/6,230386,5
2,1,23,387,1,1638,1,13,6,6,7,single-choice,spatial-relational,6|7,7,6/7,230387,6
2,1,23,388,0,1132,1,3,1,2,2,single-choice,spatial-relational,1|2,7,1/2,230388,1
2,1,23,389,1,1189,1,9,4,4,5,single-choice,spatial-relational,4|5,7,4/5,230389,4
2,1,23,390,0,1362,1,5,2,3,3,single-choice,spatial-relational,2|3,7,2/3,230390,2
2,1,23,391,0,940,1,9,4,5,5,single-choice,spatial-relational,4|5,7,4/5,230391,4
2,1,23,392,1,902,1,5,2,2,3,single-choice,spatial-relational,2|3,7,2/3,230392,2
2,1,23,393,1,980,1,7,3,3,4,single-choice,spatial-relational,3|4,7,3/4,230393,3
2,1,23,394,1,1091,1,11,5,5,6,single-choice,spatial-relational,5|6,7,5/6,230394,5
2,1,23,395,1,1294,1,13,6,6,7,single-choice,spatial-relational,6|7,7,6/7,230395,6
2,1,23,396,1,859,1,3,1,1,2,single-choice,spatial-relational,1|2,7,1/2,230396,1
2,1,23,397,0,784,1,5,2,3,3,single-choice,spatial-relational,2|3,7,2/3,230397,2
2,1,23,398,1,1182,1,13,6,6,7,single-choice,spatial-relational,6|7,7,6/7,230398,6
2,1,23,399,0,1443,1,9,4,5,5,single-choice,spatial-relational,4|5,7,4/5,230399,4
2,1,23,400,1,988,1,7,3,3,4,single-choice,spatial-relational,3|4,7,3/4,230400,3
2,1,23,401,1,1319,1,9,4,4,5,single-choice,spatial-relational,4|5,7,4/5,230401,4
2,1,23,402,1,1165,1,11,5,5,6,single-choice,spatial-relational,5|6,7,5/6,230402,5
2,1,23,403,1,1358,1,7,3,3,4,single-choice,spatial-relational,3|4,7,3/4,230403,3
2,1,23,404,1,756,1,3,1,1,2,single-choice,spatial-relational,1|2,7,1/2,230404,1
2,1,23,405,1,817,1,3,1,1,2,single-choice,spatial-relational,1|2,7,1/2,230405,1
2,1,23,406,1,706,1,5,2,2,3,single-choice,spatial-relational,2|3,7,2/3,230406,2
2,1,23,407,1,1030,1,13,6,6,7,single-choice,spatial-relational,6|7,7,6/7,230407,6
2,1,23,408,0,1483,1,11,5,6,6,single-choice,spatial-relational,5|6,7,5/6,230408,5
2,1,23,409,1,1143,1,9,4,4,5,single-choice,spatial-relational,4|5,7,4/5,230409,4
2,1,23,410,0,1161,1,7,3,4,4,single-choice,spatial-relational,3|4,7,3/4,230410,3
2,1,23,411,1,861,1,13,6,6,7,single-choice,spatial-relational,6|7,7,6/7,230411,6
2,1,23,412,1,1228,1,13,6,6,7,single-choice,spatial-relational,6|7,7,6/7,230412,6
2,1,23,413,1,1451,1,11,5,5,6,single-choice,spatial-relational,5|6,7,5/6,230413,5
2,1,23,414,0,1050,1,3,1,2,2,single-choice,spatial-relational,1|2,7,1/2,230414,1
2,1,23,415,1,954,1,7,3,3,4,single-choice,spatial-relational,3|4,7,3/4,230415,3
2,1,23,416,1,1025,1,11,5,5,6,single-choice,spatial-relational,5|6,7,5/6,230416,5
2,1,23,417,1,810,1,5,2,2,3,single-choice,spatial-relational,2|3,7,2/3,230417,2
2,1,23,418,1,690,1,5,2,2,3,single-choice,spatial-relational,2|3,7,2/3,230418,2
2,1,23,419,1,877,1,3,1,1,2,single-choice,spatial-relational,1|2,7,1/2,230419,1
2,1,23,420,0,1300,1,9,4,5,5,single-choice,spatial-relational,4|5,7,4/5,230420,4
2,1,23,421,1,997,1,3,1,1,2,single-choice,spatial-relational,1|2,7,1/2,230421,1
2,1,23,422,0,957,1,9,4,5,5,single-choice,spatial-relational,4|5,7,4/5,230422,4
2,1,23,423,1,883,1,7,3,3,4,single-choice,spatial-relational,3|4,7,3/4,230423,3
2,1,23,424,1,922,1,13,6,6,7,single-choice,spatial-relational,6|7,7,6/7,230424,6
2,1,23,425,1,1276,1,13,6,6,7,single-choice,spatial-relational,6|7,7,6/7,230425,6
2,1,23,426,1,864,1,5,2,2,3,single-choice,spatial-relational,2|3,7,2/3,230426,2
2,1,23,427,0,696,1,11,5,6,6,single-choice,spatial-relational,5|6,7,5/6,230427,5
2,1,23,428,1,1182,1,9,4,4,5,single-choice,spatial-relational,4|5,7,4/5,230428,4
2,1,23,429,1,986,1,11,5,5,6,single-choice,spatial-relational,5|6,7,5/6,230429,5
2,1,23,430,0,914,1,7,3,4,4,single-choice,spatial-relational,3|4,7,3/4,230430,3
2,1,23,431,1,923,1,5,2,2,3,single-choice,spatial-relational,2|3,7,2/3,230431,2
2,1,23,432,1,806,1,3,1,1,2,single-choice,spatial-relational,1|2,7,1/2,230432,1
2,1,23,433,1,787,1,13,6,6,7,single-choice,spatial-relational,6|7,7,6/7,230433,6
2,1,23,434,0,1159,1,5,2,3,3,single-choice,spatial-relational,2|3,7,2/3,230434,2
2,1,23,435,0,1240,1,9,4,5,5,single-choice,spatial-relational,4|5,7,4/5,230435,4
2,1,23,436,0,1039,1,7,3,4,4,single-choice,spatial-relational,3|4,7,3/4,230436,3
2,1,23,437,1,1521,1,11,5,5,6,single-choice,spatial-relational,5|6,7,5/6,230437,5
2,1,23,438,0,887,1,9,4,5,5,single-choice,spatial-relational,4|5,7,4/5,230438,4
2,1,23,439,0,11,1,13,6,7,7,single-choice,spatial-relational,6|7,7,6/7,230439,6
2,1,23,440,0,1035,1,11,5,6,6,single-choice,spatial-relational,5|6,7,5/6,230440,5
2,1,23,441,1,856,1,5,2,2,3,single-choice,spatial-relational,2|3,7,2/3,230441,2
2,1,23,442,1,959,1,3,1,1,2,single-choice,spatial-relational,1|2,7,1/2,230442,1
2,1,23,443,1,1542,1,7,3,3,4,single-choice,spatial-relational,3|4,7,3/4,230443,3
2,1,23,444,0,1000,1,3,1,2,2,single-choice,spatial-relational,1|2,7,1/2,230444,1
2,1,23,445,0,1201,1,11,5,6,6,single-choice,spatial-relational,5|6,7,5/6,230445,5
2,1,23,446,1,962,1,13,6,6,7,single-choice,spatial-relational,6|7,7,6/7,230446,6
2,1,23,447,1,1041,1,9,4,4,5,single-choice,spatial-relational,4|5,7,4/5,230447,4
2,1,23,448,0,1352,1,7,3,4,4,single-choice,spatial-relational,3|4,7,3/4,230448,3
2,1,23,449,1,862,1,13,6,6,7,single-choice,spatial-relational,6|7,7,6/7,230449,6
2,1,23,450,0,782,1,11,5,6,6,single-choice,spatial-relational,5|6,7,5/6,230450,5
2,1,23,451,1,1278,1,3,1,1,2,single-choice,spatial-relational,1|2,7,1/2,230451,1
2,1,23,452,0,954,1,7,3,4,4,single-choice,spatial-relational,3|4,7,3/4,230452,3
2,1,23,453,0,971,1,3,1,2,2,single-choice,spatial-relational,1|2,7,1/2,230453,1
2,1,23,454,1,1297,1,9,4,4,5,single-choice,spatial-relational,4|5,7,4/5,230454,4
2,1,23,455,0,959,1,5,2,3,3,single-choice,spatial-relational,2|3,7,2/3,230455,2
2,1,23,456,0,989,1,5,2,3,3,single-choice,spatial-relational,2|3,7,2/3,230456,2
2,1,23,457,1,799,1,3,1,1,2,single-choice,spatial-relational,1|2,7,1/2,230457,1
2,1,23,458,0,1000,1,7,3,4,4,single-choice,spatial-relational,3|4,7,3/4,230458,3
2,1,23,459,0,1016,1,11,5,6,6,single-choice,spatial-relational,5|6,7,5/6,230459,5
2,1,23,460,0,893,1,5,2,3,3,single-choice,spatial-relational,2|3,7,2/3,230460,2
2,1,23,461,1,935,1,11,5,5,6,single-choice,spatial-relational,5|6,7,5/6,230461,5
2,1,23,462,0,1350,1,9,4,5,5,single-choice,spatial-relational,4|5,7,4/5,230462,4
2,1,23,463,1,808,1,5,2,2,3,single-choice,spatial-relational,2|3,7,2/3,230463,2
2,1,23,464,1,956,1,7,3,3,4,single-choice,spatial-relational,3|4,7,3/4,230464,3
2,1,23,465,0,842,1,9,4,5,5,single-choice,spatial-relational,4|5,7,4/5,230465,4
2,1,23,466,1,818,1,13,6,6,7,single-choice,spatial-relational,6|7,7,6/7,230466,6
2,1,23,467,1,931,1,3,1,1,2,single-choice,spatial-relational,1|2,7,1/2,230467,1
2,1,23,468,1,872,1,13,6,6,7,single-choice,spatial-relational,6|7,7,6/7,230468,6
2,1,23,469,1,875,1,7,3,3,4,single-choice,spatial-relational,3|4,7,3/4,230469,3
2,1,23,470,1,1060,1,13,6,6,7,single-choice,spatial-relational,6|7,7,6/7,230470,6
2,1,23,471,1,1091,1,5,2,2,3,single-choice,spatial-relational,2|3,7,2/3,230471,2
2,1,23,472,1,993,1,13,6,6,7,single-choice,spatial-relational,6|7,7,6/7,230472,6
2,1,23,473,1,1112,1,11,5,5,6,single-choice,spatial-relational,5|6,7,5/6,230473,5
2,1,23,474,1,1268,1,11,5,5,6,single-choice,spatial-relational,5|6,7,5/6,230474,5
2,1,23,475,1,730,1,7,3,3,4,single-choice,spatial-relational,3|4,7,3/4,230475,3
2,1,23,476,1,890,1,5,2,2,3,single-choice,spatial-relational,2|3,7,2/3,230476,2
2,1,23,477,1,1245,1,9,4,4,5,single-choice,spatial-relational,4|5,7,4/5,230477,4
2,1,23,478,0,1074,1,9,4,5,5,single-choice,spatial-relational,4|5,7,4/5,230478,4
2,1,23,479,1,901,1,3,1,1,2,single-choice,spatial-relational,1|2,7,1/2,230479,1
2,1,23,480,1,1126,1,3,1,1,2,single-choice,spatial-relational,1|2,7,1/2,230480,1
2,1,23,481,0,943,1,3,1,2,2,single-choice,spatial-relational,1|2,7,1/2,230481,1
2,1,23,482,1,979,1,13,6,6,7,single-choice,spatial-relational,6|7,7,6/7,230482,6
2,1,23,483,1,1424,1,7,3,3,4,single-choice,spatial-relational,3|4,7,3/4,230483,3
2,1,23,484,1,897,1,11,5,5,6,single-choice,spatial-relational,5|6,7,5/6,230484,5
2,1,23,485,1,1369,1,11,5,5,6,single-choice,spatial-relational,5|6,7,5/6,230485,5
2,1,23,486,1,885,1,5,2,2,3,single-choice,spatial-relational,2|3,7,2/3,230486,2
2,1,23,487,1,1087,1,3,1,1,2,single-choice,spatial-relational,1|2,7,1/2,230487,1
2,1,23,488,1,770,1,5,2,2,3,single-choice,spatial-relational,2|3,7,2/3,230488,2
2,1,23,489,0,796,1,9,4,5,5,single-choice,spatial-relational,4|5,7,4/5,230489,4
2,1,23,490,1,1012,1,7,3,3,4,single-choice,spatial-relational,3|4,7,3/4,230490,3
2,1,23,491,1,898,1,13,6,6,7,single-choice,spatial-relational,6|7,7,6/7,230491,6
2,1,23,492,0,1250,1,9,4,5,5,single-choice,spatial-relational,4|5,7,4/5,230492,4
2,1,23,493,0,1099,1,11,5,6,6,single-choice,spatial-relational,5|6,7,5/6,230493,5
2,1,23,494,1,913,1,3,1,1,2,single-choice,spatial-relational,1|2,7,1/2,230494,1
2,1,23,495,1,1054,1,13,6,6,7,single-choice,spatial-relational,6|7,7,6/7,230495,6
2,1,23,496,1,856,1,7,3,3,4,single-choice,spatial-relational,3|4,7,3/4,230496,3
2,1,23,497,0,1255,1,13,6,7,7,single-choice,spatial-relational,6|7,7,6/7,230497,6
2,1,23,498,1,1045,1,5,2,2,3,single-choice,spatial-relational,2|3,7,2/3,230498,2
2,1,23,499,0,758,1,9,4,5,5,single-choice,spatial-relational,4|5,7,4/5,230499,4
2,1,23,500,0,1037,1,5,2,3,3,single-choice,spatial-relational,2|3,7,2/3,230500,2
2,1,23,501,1,917,1,9,4,4,5,single-choice,spatial-relational,4|5,7,4/5,230501,4
2,1,23,502,0,1383,1,7,3,4,4,single-choice,spatial-relational,3|4,7,3/4,230502,3
2,1,23,503,1,762,1,3,1,1,2,single-choice,spatial-relational,1|2,7,1/2,230503,1
2,1,23,504,1,973,1,11,5,5,6,single-choice,spatial-relational,5|6,7,5/6,230504,5
2,1,23,505,0,1168,1,3,1,2,2,single-choice,spatial-relational,1|2,7,1/2,230505,1
2,1,23,506,0,940,1,9,4,5,5,single-choice,spatial-relational,4|5,7,4/5,230506,4
2,1,23,507,0,886,1,5,2,3,3,single-choice,spatial-relational,2|3,7,2/3,230507,2
2,1,23,508,0,1068,1,11,5,6,6,single-choice,spatial-relational,5|6,7,5/6,230508,5
2,1,23,509,1,879,1,13,6,6,7,single-choice,spatial-relational,6|7,7,6/7,230509,6
2,1,23,510,1,2567,1,7,3,3,4,single-choice,spatial-relational,3|4,7,3/4,230510,3
2,1,23,511,1,827,1,13,6,6,7,single-choice,spatial-relational,6|7,7,6/7,230511,6
2,1,23,512,1,791,1,3,1,1,2,single-choice,spatial-relational,1|2,7,1/2,230512,1
2,1,23,513,1,773,1,5,2,2,3,single-choice,spatial-relational,2|3,7,2/3,230513,2
2,1,23,514,1,792,1,7,3,3,4,single-choice,spatial-relational,3|4,7,3/4,230514,3
2,1,23,515,0,1112,1,9,4,5,5,single-choice,spatial-relational,4|5,7,4/5,230515,4
2,1,23,516,1,1405,1,11,5,5,6,single-choice,spatial-relational,5|6,7,5/6,230516,5
2,1,23,517,0,841,1,9,4,5,5,single-choice,spatial-relational,4|5,7,4/5,230517,4
2,1,23,518,1,808,1,13,6,6,7,single-choice,spatial-relational,6|7,7,6/7,230518,6
2,1,23,519,0,849,1,11,5,6,6,single-choice,spatial-relational,5|6,7,5/6,230519,5
2,1,23,520,1,816,1,3,1,1,2,single-choice,spatial-relational,1|2,7,1/2,230520,1
2,1,23,521,0,1002,1,5,2,3,3,single-choice,spatial-relational,2|3,7,2/3,230521,2
2,1,23,522,1,807,1,7,3,3,4,single-choice,spatial-relational,3|4,7,3/4,230522,3
2,1,23,523,1,988,1,11,5,5,6,single-choice,spatial-relational,5|6,7,5/6,230523,5
2,1,23,524,0,1171,1,7,3,4,4,single-choice,spatial-relational,3|4,7,3/4,230524,3
2,1,23,525,1,825,1,3,1,1,2,single-choice,spatial-relational,1|2,7,1/2,230525,1
2,1,23,526,1,19,1,13,6,6,7,single-choice,spatial-relational,6|7,7,6/7,230526,6
2,1,23,527,1,1054,1,5,2,2,3,single-choice,spatial-relational,2|3,7,2/3,230527,2
2,1,23,528,1,930,1,9,4,4,5,single-choice,spatial-relational,4|5,7,4/5,230528,4
2,1,23,529,0,1008,1,9,4,5,5,single-choice,spatial-relational,4|5,7,4/5,230529,4
2,1,23,530,1,1052,1,13,6,6,7,single-choice,spatial-relational,6|7,7,6/7,230530,6
2,1,23,531,1,880,1,5,2,2,3,single-choice,spatial-relational,2|3,7,2/3,230531,2
2,1,23,532,1,818,1,7,3,3,4,single-choice,spatial-relational,3|4,7,3/4,230532,3
2,1,23,533,0,895,1,11,5,6,6,single-choice,spatial-relational,5|6,7,5/6,230533,5
2,1,23,534,1,922,1,3,1,1,2,single-choice,spatial-relational,1|2,7,1/2,230534,1
2,1,23,535,1,851,1,13,6,6,7,single-choice,spatial-relational,6|7,7,6/7,230535,6
2,1,23,536,0,1138,1,3,1,2,2,single-choice,spatial-relational,1|2,7,1/2,230536,1
2,1,23,537,0,909,1,9,4,5,5,single-choice,spatial-relational,4|5,7,4/5,230537,4
2,1,23,538,0,1030,1,5,2,3,3,single-choice,spatial-relational,2|3,7,2/3,230538,2
2,1,23,539,1,1137,1,11,5,5,6,single-choice,spatial-relational,5|6,7,5/6,230539,5
2,1,23,540,0,1367,1,7,3,4,4,single-choice,spatial-relational,3|4,7,3/4,230540,3
2,1,23,541,0,936,1,3,1,2,2,single-choice,spatial-relational,1|2,7,1/2,230541,1
2,1,23,542,0,720,1,11,5,6,6,single-choice,spatial-relational,5|6,7,5/6,230542,5
2,1,23,543,1,1008,1,3,1,1,2,single-choice,spatial-relational,1|2,7,1/2,230543,1
2,1,23,544,1,909,1,11,5,5,6,single-choice,spatial-relational,5|6,7,5/6,230544,5
2,1,23,545,1,799,1,7,3,3,4,single-choice,spatial-relational,3|4,7,3/4,230545,3
2,1,23,546,1,859,1,13,6,6,7,single-choice,spatial-relational,6|7,7,6/7,230546,6
2,1,23,547,1,1074,1,5,2,2,3,single-choice,spatial-relational,2|3,7,2/3,230547,2
2,1,23,548,1,846,1,7,3,3,4,single-choice,spatial-relational,3|4,7,3/4,230548,3
2,1,23,549,0,1046,1,9,4,5,5,single-choice,spatial-relational,4|5,7,4/5,230549,4
2,1,23,550,1,933,1,13,6,6,7,single-choice,spatial-relational,6|7,7,6/7,230550,6
2,1,23,551,0,751,1,5,2,3,3,single-choice,spatial-relational,2|3,7,2/3,230551,2
2,1,23,552,0,1266,1,9,4,5,5,single-choice,spatial-relational,4|5,7,4/5,230552,4
2,1,23,553,1,1220,1,13,6,6,7,single-choice,spatial-relational,6|7,7,6/7,230553,6
2,1,23,554,1,822,1,3,1,1,2,single-choice,spatial-relational,1|2,7,1/2,230554,1
2,1,23,555,1,808,1,5,2,2,3,single-choice,spatial-relational,2|3,7,2/3,230555,2
2,1,23,556,1,830,1,7,3,3,4,single-choice,spatial-relational,3|4,7,3/4,230556,3
2,1,23,557,1,1245,1,7,3,3,4,single-choice,spatial-relational,3|4,7,3/4,230557,3
2,1,23,558,0,704,1,9,4,5,5,single-choice,spatial-relational,4|5,7,4/5,230558,4
2,1,23,559,1,984,1,13,6,6,7,single-choice,spatial-relational,6|7,7,6/7,230559,6
2,1,23,560,0,1497,1,11,5,6,6,single-choice,spatial-relational,5|6,7,5/6,230560,5
2,1,23,561,1,868,1,3,1,1,2,single-choice,spatial-relational,1|2,7,1/2,230561,1
2,1,23,562,0,898,1,5,2,3,3,single-choice,spatial-relational,2|3,7,2/3,230562,2
2,1,23,563,1,927,1,11,5,5,6,single-choice,spatial-relational,5|6,7,5/6,230563,5
2,1,23,564,1,2207,1,9,4,4,5,single-choice,spatial-relational,4|5,7,4/5,230564,4
2,1,23,565,1,980,1,13,6,6,7,single-choice,spatial-relational,6|7,7,6/7,230565,6
2,1,23,566,0,734,1,3,1,2,2,single-choice,spatial-relational,1|2,7,1/2,230566,1
2,1,23,567,1,1138,1,3,1,1,2,single-choice,spatial-relational,1|2,7,1/2,230567,1
2,1,23,568,1,978,1,9,4,4,5,single-choice,spatial-relational,4|5,7,4/5,230568,4
2,1,23,569,1,1039,1,5,2,2,3,single-choice,spatial-relational,2|3,7,2/3,230569,2
2,1,23,570,1,791,1,13,6,6,7,single-choice,spatial-relational,6|7,7,6/7,230570,6
2,1,23,571,0,669,1,11,5,6,6,single-choice,spatial-relational,5|6,7,5/6,230571,5
2,1,23,572,0,1254,1,7,3,4,4,single-choice,spatial-relational,3|4,7,3/4,230572,3
2,1,23,573,0,866,1,9,4,5,5,single-choice,spatial-relational,4|5,7,4/5,230573,4
2,1,23,574,0,1143,1,11,5,6,6,single-choice,spatial-relational,5|6,7,5/6,230574,5
2,1,23,575,1,1229,1,7,3,3,4,single-choice,spatial-relational,3|4,7,3/4,230575,3
2,1,23,576,0,745,1,5,2,3,3,single-choice,spatial-relational,2|3,7,2/3,230576,2
2,1,23,577,1,1315,1,7,3,3,4,single-choice,spatial-relational,3|4,7,3/4,230577,3
2,1,23,578,1,953,1,5,2,2,3,single-choice,spatial-relational,2|3,7,2/3,230578,2
2,1,23,579,1,791,1,13,6,6,7,single-choice,spatial-relational,6|7,7,6/7,230579,6
2,1,23,580,1,1231,1,5,2,2,3,single-choice,spatial-relational,2|3,7,2/3,230580,2
2,1,23,581,1,1109,1,9,4,4,5,single-choice,spatial-relational,4|5,7,4/5,230581,4
2,1,23,582,0,1094,1,13,6,7,7,single-choice,spatial-relational,6|7,7,6/7,230582,6
2,1,23,583,1,762,1,3,1,1,2,single-choice,spatial-relational,1|2,7,1/2,230583,1
2,1,23,584,1,873,1,9,4,4,5,single-choice,spatial-relational,4|5,7,4/5,230584,4
2,1,23,585,1,1260,1,11,5,5,6,single-choice,spatial-relational,5|6,7,5/6,230585,5
2,1,23,586,1,1193,1,11,5,5,6,single-choice,spatial-relational,5|6,7,5/6,230586,5
2,1,23,587,1,1212,1,7,3,3,4,single-choice,spatial-relational,3|4,7,3/4,230587,3
2,1,23,588,1,826,1,3,1,1,2,single-choice,spatial-relational,1|2,7,1/2,230588,1
2,1,23,589,1,834,1,5,2,2,3,single-choice,spatial-relational,2|3,7,2/3,230589,2
2,1,23,590,1,673,1,5,2,2,3,single-choice,spatial-relational,2|3,7,2/3,230590,2
2,1,23,591,1,737,1,13,6,6,7,single-choice,spatial-relational,6|7,7,6/7,230591,6
2,1,23,592,0,723,1,9,4,5,5,single-choice,spatial-relational,4|5,7,4/5,230592,4
2,1,23,593,1,785,1,7,3,3,4,single-choice,spatial-relational,3|4,7,3/4,230593,3
2,1,23,594,1,983,1,13,6,6,7,single-choice,spatial-relational,6|7,7,6/7,230594,6
2,1,23,595,0,812,1,11,5,6,6,single-choice,spatial-relational,5|6,7,5/6,230595,5
2,1,23,596,1,30,1,11,5,5,6,single-choice,spatial-relational,5|6,7,5/6,230596,5
2,1,23,597,0,958,1,3,1,2,2,single-choice,spatial-relational,1|2,7,1/2,230597,1
2,1,23,598,1,66,1,3,1,1,2,single-choice,spatial-relational,1|2,7,1/2,230598,1
2,1,23,599,1,1070,1,9,4,4,5,single-choice,spatial-relational,4|5,7,4/5,230599,4
2,1,23,600,0,1068,1,7,3,4,4,single-choice,spatial-relational,3|4,7,3/4,230600,3
3,1,23,1,1,1177,1,9,4,4,5,single-choice,spatial-relational,4|5,7,4/5,230001,4
3,1,23,2,1,808,1,13,6,6,7,single-choice,spatial-relational,6|7,7,6/7,230002,6
3,1,23,3,1,14,1,11,5,5,6,single-choice,spatial-relational,5|6,7,5/6,230003,5
3,1,23,4,1,605,1,7,3,3,4,single-choice,spatial-relational,3|4,7,3/4,230004,3
3,1,23,5,0,658,1,11,5,6,6,single-choice,spatial-relational,5|6,7,5/6,230005,5
3,1,23,6,1,604,1,5,2,2,3,single-choice,spatial-relational,2|3,7,2/3,230006,2
3,1,23,7,0,674,1,5,2,3,3,single-choice,spatial-relational,2|3,7,2/3,230007,2
3,1,23,8,1,513,1,13,6,6,7,single-choice,spatial-relational,6|7,7,6/7,230008,6
3,1,23,9,0,704,1,3,1,2,2,single-choice,spatial-relational,1|2,7,1/2,230009,1
3,1,23,10,1,784,1,3,1,1,2,single-choice,spatial-relational,1|2,7,1/2,230010,1
3,1,23,11,0,705,1,7,3,4,4,single-choice,spatial-relational,3|4,7,3/4,230011,3
3,1,23,12,1,733,1,9,4,4,5,single-choice,spatial-relational,4|5,7,4/5,230012,4
3,1,23,13,0,765,1,3,1,2,2,single-choice,spatial-relational,1|2,7,1/2,230013,1
3,1,23,14,0,799,1,3,1,2,2,single-choice,spatial-relational,1|2,7,1/2,230014,1
3,1,23,15,1,834,1,9,4,4,5,single-choice,spatial-relational,4|5,7,4/5,230015,4
3,1,23,16,1,1004,1,13,6,6,7,single-choice,spatial-relational,6|7,7,6/7,230016,6
3,1,23,17,1,730,1,5,2,2,3,single-choice,spatial-relational,2|3,7,2/3,230017,2
3,1,23,18,0,685,1,7,3,4,4,single-choice,spatial-relational,3|4,7,3/4,230018,3
3,1,23,19,0,651,1,11,5,6,6,single-choice,spatial-relational,5|6,7,5/6,230019,5
3,1,23,20,1,571,1,9,4,4,5,single-choice,spatial-relational,4|5,7,4/5,230020,4
3,1,23,21,0,894,1,5,2,3,3,single-choice,spatial-relational,2|3,7,2/3,230021,2
3,1,23,22,0,697,1,7,3,4,4,single-choice,spatial-relational,3|4,7,3/4,230022,3
3,1,23,23,1,5,1,11,5,5,6,single-choice,spatial-relational,5|6,7,5/6,230023,5
3,1,23,24,1,1188,1,13,6,6,7,single-choice,spatial-relational,6|7,7,6/7,230024,6
3,1,23,25,1,1461,1,13,6,6,7,single-choice,spatial-relational,6|7,7,6/7,230025,6
3,1,23,26,1,664,1,9,4,4,5,single-choice,spatial-relational,4|5,7,4/5,230026,4
3,1,23,27,1,847,1,7,3,3,4,single-choice,spatial-relational,3|4,7,3/4,230027,3
3,1,23,28,0,1060,1,9,4,5,5,single-choice,spatial-relational,4|5,7,4/5,230028,4
3,1,23,29,0,702,1,11,5,6,6,single-choice,spatial-relational,5|6,7,5/6,230029,5
3,1,23,30,1,874,1,5,2,2,3,single-choice,spatial-relational,2|3,7,2/3,230030,2
3,1,23,31,0,815,1,5,2,3,3,single-choice,spatial-relational,2|3,7,2/3,230031,2
3,1,23,32,1,746,1,3,1,1,2,single-choice,spatial-relational,1|2,7,1/2,230032,1
3,1,23,33,0,579,1,3,1,2,2,single-choice,spatial-relational,1|2,7,1/2,230033,1
3,1,23,34,0,732,1,11,5,6,6,single-choice,spatial-relational,5|6,7,5/6,230034,5
3,1,23,35,0,659,1,7,3,4,4,single-choice,spatial-relational,3|4,7,3/4,230035,3
3,1,23,36,1,756,1,13,6,6,7,single-choice,spatial-relational,6|7,7,6/7,230036,6
3,1,23,37,1,922,1,13,6,6,7,single-choice,spatial-relational,6|7,7,6/7,230037,6
3,1,23,38,1,749,1,7,3,3,4,single-choice,spatial-relational,3|4,7,3/4,230038,3
3,1,23,39,0,751,1,5,2,3,3,single-choice,spatial-relational,2|3,7,2/3,230039,2
3,1,23,40,0,842,1,9,4,5,5,single-choice,spatial-relational,4|5,7,4/5,230040,4
3,1,23,41,1,692,1,9,4,4,5,single-choice,spatial-relational,4|5,7,4/5,230041,4
3,1,23,42,1,1028,1,3,1,1,2,single-choice,spatial-relational,1|2,7,1/2,230042,1
3,1,23,43,1,737,1,5,2,2,3,single-choice,spatial-relational,2|3,7,2/3,230043,2
3,1,23,44,0,516,1,11,5,6,6,single-choice,spatial-relational,5|6,7,5/6,230044,5
3,1,23,45,1,5,1,13,6,6,7,single-choice,spatial-relational,6|7,7,6/7,230045,6
3,1,23,46,0,1142,1,11,5,6,6,single-choice,spatial-relational,5|6,7,5/6,230046,5
3,1,23,47,0,874,1,7,3,4,4,single-choice,spatial-relational,3|4,7,3/4,230047,3
3,1,23,48,0,832,1,3,1,2,2,single-choice,spatial-relational,1|2,7,1/2,230048,1
3,1,23,49,0,749,1,3,1,2,2,single-choice,spatial-relational,1|2,7,1/2,230049,1
3,1,23,50,1,986,1,13,6,6,7,single-choice,spatial-relational,6|7,7,6/7,230050,6
3,1,23,51,1,1063,1,11,5,5,6,single-choice,spatial-relational,5|6,7,5/6,230051,5
3,1,23,52,1,1433,1,7,3,3,4,single-choice,spatial-relational,3|4,7,3/4,230052,3
3,1,23,53,0,988,1,5,2,3,3,single-choice,spatial-relational,2|3,7,2/3,230053,2
3,1,23,54,0,939,1,3,1,2,2,single-choice,spatial-relational,1|2,7,1/2,230054,1
3,1,23,55,0,658,1,11,5,6,6,single-choice,spatial-relational,5|6,7,5/6,230055,5
3,1,23,56,1,970,1,9,4,4,5,single-choice,spatial-relational,4|5,7,4/5,230056,4
3,1,23,57,1,1236,1,13,6,6,7,single-choice,spatial-relational,6|7,7,6/7,230057,6
3,1,23,58,0,886,1,9,4,5,5,single-choice,spatial-relational,4|5,7,4/5,230058,4
3,1,23,59,1,897,1,7,3,3,4,single-choice,spatial-relational,3|4,7,3/4,230059,3
3,1,23,60,1,906,1,5,2,2,3,single-choice,spatial-relational,2|3,7,2/3,230060,2
3,1,23,61,1,767,1,7,3,3,4,single-choice,spatial-relational,3|4,7,3/4,230061,3
3,1,23,62,0,812,1,9,4,5,5,single-choice,spatial-relational,4|5,7,4/5,230062,4
3,1,23,63,1,966,1,13,6,6,7,single-choice,spatial-relational,6|7,7,6/7,230063,6
3,1,23,64,0,1199,1,11,5,6,6,single-choice,spatial-relational,5|6,7,5/6,230064,5
3,1,23,65,1,1065,1,5,2,2,3,single-choice,spatial-relational,2|3,7,2/3,230065,2
3,1,23,66,0,942,1,3,1,2,2,single-choice,spatial-relational,1|2,7,1/2,230066,1
3,1,23,67,0,791,1,3,1,2,2,single-choice,spatial-relational,1|2,7,1/2,230067,1
3,1,23,68,0,791,1,5,2,3,3,single-choice,spatial-relational,2|3,7,2/3,230068,2
3,1,23,69,1,863,1,7,3,3,4,single-choice,spatial-relational,3|4,7,3/4,230069,3
3,1,23,70,1,1493,1,9,4,4,5,single-choice,spatial-relational,4|5,7,4/5,230070,4
3,1,23,71,0,1044,1,11,5,6,6,single-choice,spatial-relational,5|6,7,5/6,230071,5
3,1,23,72,1,1017,1,13,6,6,7,single-choice,spatial-relational,6|7,7,6/7,230072,6
3,1,23,73,1,865,1,13,6,6,7,single-choice,spatial-relational,6|7,7,6/7,230073,6
3,1,23,74,1,1136,1,11,5,5,6,single-choice,spatial-relational,5|6,7,5/6,230074,5
3,1,23,75,0,803,1,5,2,3,3,single-choice,spatial-relational,2|3,7,2/3,230075,2
3,1,23,76,1,1047,1,9,4,4,5,single-choice,spatial-relational,4|5,7,4/5,230076,4
3,1,23,77,1,1374,1,9,4,4,5,single-choice,spatial-relational,4|5,7,4/5,230077,4
3,1,23,78,1,1198,1,7,3,3,4,single-choice,spatial-relational,3|4,7,3/4,230078,3
3,1,23,79,1,936,1,7,3,3,4,single-choice,spatial-relational,3|4,7,3/4,230079,3
3,1,23,80,0,772,1,3,1,2,2,single-choice,spatial-relational,1|2,7,1/2,230080,1
3,1,23,81,1,914,1,11,5,5,6,single-choice,spatial-relational,5|6,7,5/6,230081,5
3,1,23,82,0,1153,1,5,2,3,3,single-choice,spatial-relational,2|3,7,2/3,230082,2
3,1,23,83,1,787,1,3,1,1,2,single-choice,spatial-relational,1|2,7,1/2,230083,1
3,1,23,84,1,972,1,13,6,6,7,single-choice,spatial-relational,6|7,7,6/7,230084,6
3,1,23,85,1,979,1,3,1,1,2,single-choice,spatial-relational,1|2,7,1/2,230085,1
3,1,23,86,0,616,1,11,5,6,6,single-choice,spatial-relational,5|6,7,5/6,230086,5
3,1,23,87,1,909,1,11,5,5,6,single-choice,spatial-relational,5|6,7,5/6,230087,5
3,1,23,88,0,1219,1,7,3,4,4,single-choice,spatial-relational,3|4,7,3/4,230088,3
3,1,23,89,0,855,1,5,2,3,3,single-choice,spatial-relational,2|3,7,2/3,230089,2
3,1,23,90,1,967,1,13,6,6,7,single-choice,spatial-relational,6|7,7,6/7,230090,6
3,1,23,91,1,1086,1,7,3,3,4,single-choice,spatial-relational,3|4,7,3/4,230091,3
3,1,23,92,1,883,1,13,6,6,7,single-choice,spatial-relational,6|7,7,6/7,230092,6
3,1,23,93,1,1092,1,5,2,2,3,single-choice,spatial-relational,2|3,7,2/3,230093,2
3,1,23,94,0,850,1,3,1,2,2,single-choice,spatial-relational,1|2,7,1/2,230094,1
3,1,23,95,1,913,1,9,4,4,5,single-choice,spatial-relational,4|5,7,4/5,230095,4
3,1,23,96,0,852,1,9,4,5,5,single-choice,spatial-relational,4|5,7,4/5,230096,4
3,1,23,97,0,863,1,11,5,6,6,single-choice,spatial-relational,5|6,7,5/6,230097,5
3,1,23,98,1,983,1,11,5,5,6,single-choice,spatial-relational,5|6,7,5/6,230098,5
3,1,23,99,1,1169,1,3,1,1,2,single-choice,spatial-relational,1|2,7,1/2,230099,1
3,1,23,100,1,795,1,3,1,1,2,single-choice,spatial-relational,1|2,7,1/2,230100,1
3,1,23,101,1,885,1,7,3,3,4,single-choice,spatial-relational,3|4,7,3/4,230101,3
3,1,23,102,0,749,1,5,2,3,3,single-choice,spatial-relational,2|3,7,2/3,230102,2
3,1,23,103,1,1014,1,9,4,4,5,single-choice,spatial-relational,4|5,7,4/5,230103,4
3,1,23,104,1,1050,1,13,6,6,7,single-choice,spatial-relational,6|7,7,6/7,230104,6
3,1,23,105,1,1308,1,13,6,6,7,single-choice,spatial-relational,6|7,7,6/7,230105,6
3,1,23,106,1,998,1,7,3,3,4,single-choice,spatial-relational,3|4,7,3/4,230106,3
3,1,23,107,0,727,1,9,4,5,5,single-choice,spatial-relational,4|5,7,4/5,230107,4
3,1,23,108,0,943,1,5,2,3,3,single-choice,spatial-relational,2|3,7,2/3,230108,2
3,1,23,109,0,1127,1,11,5,6,6,single-choice,spatial-relational,5|6,7,5/6,230109,5
3,1,23,110,1,1097,1,7,3,3,4,single-choice,spatial-relational,3|4,7,3/4,230110,3
3,1,23,111,1,809,1,3,1,1,2,single-choice,spatial-relational,1|2,7,1/2,230111,1
3,1,23,112,1,663,1,3,1,1,2,single-choice,spatial-relational,1|2,7,1/2,230112,1
3,1,23,113,0,805,1,11,5,6,6,single-choice,spatial-relational,5|6,7,5/6,230113,5
3,1,23,114,1,1047,1,9,4,4,5,single-choice,spatial-relational,4|5,7,4/5,230114,4
3,1,23,115,1,961,1,13,6,6,7,single-choice,spatial-relational,6|7,7,6/7,230115,6
3,1,23,116,1,1155,1,13,6,6,7,single-choice,spatial-relational,6|7,7,6/7,230116,6
3,1,23,117,0,759,1,5,2,3,3,single-choice,spatial-relational,2|3,7,2/3,230117,2
3,1,23,118,0,888,1,9,4,5,5,single-choice,spatial-relational,4|5,7,4/5,230118,4
3,1,23,119,0,864,1,5,2,3,3,single-choice,spatial-relational,2|3,7,2/3,230119,2
3,1,23,120,0,98,1,7,3,4,4,single-choice,spatial-relational,3|4,7,3/4,230120,3
3,1,23,121,1,1327,1,11,5,5,6,single-choice,spatial-relational,5|6,7,5/6,230121,5
3,1,23,122,1,1408,1,9,4,4,5,single-choice,spatial-relational,4|5,7,4/5,230122,4
3,1,23,123,0,1257,1,7,3,4,4,single-choice,spatial-relational,3|4,7,3/4,230123,3
3,1,23,124,0,1085,1,11,5,6,6,single-choice,spatial-relational,5|6,7,5/6,230124,5
3,1,23,125,1,744,1,7,3,3,4,single-choice,spatial-relational,3|4,7,3/4,230125,3
3,1,23,126,1,984,1,3,1,1,2,single-choice,spatial-relational,1|2,7,1/2,230126,1
3,1,23,127,1,700,1,3,1,1,2,single-choice,spatial-relational,1|2,7,1/2,230127,1
3,1,23,128,1,815,1,5,2,2,3,single-choice,spatial-relational,2|3,7,2/3,230128,2
3,1,23,129,1,691,1,5,2,2,3,single-choice,spatial-relational,2|3,7,2/3,230129,2
3,1,23,130,1,1075,1,13,6,6,7,single-choice,spatial-relational,6|7,7,6/7,230130,6
3,1,23,131,0,1034,1,9,4,5,5,single-choice,spatial-relational,4|5,7,4/5,230131,4
3,1,23,132,1,1011,1,13,6,6,7,single-choice,spatial-relational,6|7,7,6/7,230132,6
3,1,23,133,1,1615,1,13,6,6,7,single-choice,spatial-relational,6|7,7,6/7,230133,6
3,1,23,134,1,1325,1,11,5,5,6,single-choice,spatial-relational,5|6,7,5/6,230134,5
3,1,23,135,1,1133,1,7,3,3,4,single-choice,spatial-relational,3|4,7,3/4,230135,3
3,1,23,136,1,785,1,7,3,3,4,single-choice,spatial-relational,3|4,7,3/4,230136,3
3,1,23,137,1,1030,1,9,4,4,5,single-choice,spatial-relational,4|5,7,4/5,230137,4
3,1,23,138,1,767,1,3,1,1,2,single-choice,spatial-relational,1|2,7,1/2,230138,1
3,1,23,139,1,927,1,13,6,6,7,single-choice,spatial-relational,6|7,7,6/7,230139,6
3,1,23,140,0,1440,1,11,5,6,6,single-choice,spatial-relational,5|6,7,5/6,230140,5
3,1,23,141,0,1154,1,9,4,5,5,single-choice,spatial-relational,4|5,7,4/5,230141,4
3,1,23,142,1,962,1,5,2,2,3,single-choice,spatial-relational,2|3,7,2/3,230142,2
3,1,23,143,1,999,1,3,1,1,2,single-choice,spatial-relational,1|2,7,1/2,230143,1
3,1,23,144,1,646,1,5,2,2,3,single-choice,spatial-relational,2|3,7,2/3,230144,2
3,1,23,145,1,936,1,9,4,4,5,single-choice,spatial-relational,4|5,7,4/5,230145,4
3,1,23,146,1,1233,1,9,4,4,5,single-choice,spatial-relational,4|5,7,4/5,230146,4
3,1,23,147,1,1244,1,11,5,5,6,single-choice,spatial-relational,5|6,7,5/6,230147,5
3,1,23,148,0,842,1,3,1,2,2,single-choice,spatial-relational,1|2,7,1/2,230148,1
3,1,23,149,1,928,1,7,3,3,4,single-choice,spatial-relational,3|4,7,3/4,230149,3
3,1,23,150,1,882,1,13,6,6,7,single-choice,spatial-relational,6|7,7,6/7,230150,6
3,1,23,151,1,996,1,5,2,2,3,single-choice,spatial-relational,2|3,7,2/3,230151,2
3,1,23,152,1,773,1,5,2,2,3,single-choice,spatial-relational,2|3,7,2/3,230152,2
3,1,23,153,1,700,1,3,1,1,2,single-choice,spatial-relational,1|2,7,1/2,230153,1
3,1,23,154,1,882,1,13,6,6,7,single-choice,spatial-relational,6|7,7,6/7,230154,6
3,1,23,155,0,1377,1,7,3,4,4,single-choice,spatial-relational,3|4,7,3/4,230155,3
3,1,23,156,1,1097,1,11,5,5,6,single-choice,spatial-relational,5|6,7,5/6,230156,5
3,1,23,157,1,711,1,7,3,3,4,single-choice,spatial-relational,3|4,7,3/4,230157,3
3,1,23,158,1,1322,1,11,5,5,6,single-choice,spatial-relational,5|6,7,5/6,230158,5
3,1,23,159,1,1036,1,13,6,6,7,single-choice,spatial-relational,6|7,7,6/7,230159,6
3,1,23,160,0,677,1,5,2,3,3,single-choice,spatial-relational,2|3,7,2/3,230160,2
3,1,23,161,0,1047,1,3,1,2,2,single-choice,spatial-relational,1|2,7,1/2,230161,1
3,1,23,162,1,1033,1,9,4,4,5,single-choice,spatial-relational,4|5,7,4/5,230162,4
3,1,23,163,0,1230,1,9,4,5,5,single-choice,spatial-relational,4|5,7,4/5,230163,4
3,1,23,164,1,990,1,13,6,6,7,single-choice,spatial-relational,6|7,7,6/7,230164,6
3,1,23,165,0,1106,1,11,5,6,6,single-choice,spatial-relational,5|6,7,5/6,230165,5
3,1,23,166,1,915,1,7,3,3,4,single-choice,spatial-relational,3|4,7,3/4,230166,3
3,1,23,167,0,1162,1,5,2,3,3,single-choice,spatial-relational,2|3,7,2/3,230167,2
3,1,23,168,1,829,1,3,1,1,2,single-choice,spatial-relational,1|2,7,1/2,230168,1
3,1,23,169,1,865,1,13,6,6,7,single-choice,spatial-relational,6|7,7,6/7,230169,6
3,1,23,170,1,1185,1,5,2,2,3,single-choice,spatial-relational,2|3,7,2/3,230170,2
3,1,23,171,1,1013,1,7,3,3,4,single-choice,spatial-relational,3|4,7,3/4,230171,3
3,1,23,172,1,863,1,13,6,6,7,single-choice,spatial-relational,6|7,7,6/7,230172,6
3,1,23,173,1,851,1,9,4,4,5,single-choice,spatial-relational,4|5,7,4/5,230173,4
3,1,23,174,1,1148,1,11,5,5,6,single-choice,spatial-relational,5|6,7,5/6,230174,5
3,1,23,175,1,1198,1,7,3,3,4,single-choice,spatial-relational,3|4,7,3/4,230175,3
3,1,23,176,0,764,1,5,2,3,3,single-choice,spatial-relational,2|3,7,2/3,230176,2
3,1,23,177,0,913,1,3,1,2,2,single-choice,spatial-relational,1|2,7,1/2,230177,1
3,1,23,178,0,1195,1,9,4,5,5,single-choice,spatial-relational,4|5,7,4/5,230178,4
3,1,23,179,0,947,1,11,5,6,6,single-choice,spatial-relational,5|6,7,5/6,230179,5
3,1,23,180,1,832,1,3,1,1,2,single-choice,spatial-relational,1|2,7,1/2,230180,1
3,1,23,181,0,698,1,7,3,4,4,single-choice,spatial-relational,3|4,7,3/4,230181,3
3,1,23,182,1,957,1,13,6,6,7,single-choice,spatial-relational,6|7,7,6/7,230182,6
3,1,23,183,1,1475,1,5,2,2,3,single-choice,spatial-relational,2|3,7,2/3,230183,2
3,1,23,184,1,678,1,5,2,2,3,single-choice,spatial-relational,2|3,7,2/3,230184,2
3,1,23,185,1,897,1,13,6,6,7,single-choice,spatial-relational,6|7,7,6/7,230185,6
3,1,23,186,0,1007,1,9,4,5,5,single-choice,spatial-relational,4|5,7,4/5,230186,4
3,1,23,187,1,1045,1,7,3,3,4,single-choice,spatial-relational,3|4,7,3/4,230187,3
3,1,23,188,1,1064,1,11,5,5,6,single-choice,spatial-relational,5|6,7,5/6,230188,5
3,1,23,189,0,1125,1,9,4,5,5,single-choice,spatial-relational,4|5,7,4/5,230189,4
3,1,23,190,1,955,1,11,5,5,6,single-choice,spatial-relational,5|6,7,5/6,230190,5
3,1,23,191,0,906,1,3,1,2,2,single-choice,spatial-relational,1|2,7,1/2,230191,1
3,1,23,192,1,998,1,3,1,1,2,single-choice,spatial-relational,1|2,7,1/2,230192,1
3,1,23,193,0,679,1,3,1,2,2,single-choice,spatial-relational,1|2,7,1/2,230193,1
3,1,23,194,1,969,1,13,6,6,7,single-choice,spatial-relational,6|7,7,6/7,230194,6
3,1,23,195,0,848,1,7,3,4,4,single-choice,spatial-relational,3|4,7,3/4,230195,3
3,1,23,196,0,1063,1,11,5,6,6,single-choice,spatial-relational,5|6,7,5/6,230196,5
3,1,23,197,0,951,1,5,2,3,3,single-choice,spatial-relational,2|3,7,2/3,230197,2
3,1,23,198,0,915,1,9,4,5,5,single-choice,spatial-relational,4|5,7,4/5,230198,4
3,1,23,199,0,1018,1,3,1,2,2,single-choice,spatial-relational,1|2,7,1/2,230199,1
3,1,23,200,1,1005,1,9,4,4,5,single-choice,spatial-relational,4|5,7,4/5,230200,4
3,1,23,201,1,861,1,5,2,2,3,single-choice,spatial-relational,2|3,7,2/3,230201,2
3,1,23,202,1,806,1,13,6,6,7,single-choice,spatial-relational,6|7,7,6/7,230202,6
3,1,23,203,0,730,1,7,3,4,4,single-choice,spatial-relational,3|4,7,3/4,230203,3
3,1,23,204,1,938,1,11,5,5,6,single-choice,spatial-relational,5|6,7,5/6,230204,5
3,1,23,205,0,1246,1,3,1,2,2,single-choice,spatial-relational,1|2,7,1/2,230205,1
3,1,23,206,1,971,1,7,3,3,4,single-choice,spatial-relational,3|4,7,3/4,230206,3
3,1,23,207,1,852,1,11,5,5,6,single-choice,spatial-relational,5|6,7,5/6,230207,5
3,1,23,208,1,972,1,7,3,3,4,single-choice,spatial-relational,3|4,7,3/4,230208,3
3,1,23,209,0,950,1,13,6,7,7,single-choice,spatial-relational,6|7,7,6/7,230209,6
3,1,23,210,1,1059,1,9,4,4,5,single-choice,spatial-relational,4|5,7,4/5,230210,4
3,1,23,211,1,1280,1,3,1,1,2,single-choice,spatial-relational,1|2,7,1/2,230211,1
3,1,23,212,1,680,1,13,6,6,7,single-choice,spatial-relational,6|7,7,6/7,230212,6
3,1,23,213,0,893,1,9,4,5,5,single-choice,spatial-relational,4|5,7,4/5,230213,4
3,1,23,214,1,1113,1,5,2,2,3,single-choice,spatial-relational,2|3,7,2/3,230214,2
3,1,23,215,0,612,1,5,2,3,3,single-choice,spatial-relational,2|3,7,2/3,230215,2
3,1,23,216,0,675,1,11,5,6,6,single-choice,spatial-relational,5|6,7,5/6,230216,5
3,1,23,217,1,845,1,9,4,4,5,single-choice,spatial-relational,4|5,7,4/5,230217,4
3,1,23,218,0,1017,1,5,2,3,3,single-choice,spatial-relational,2|3,7,2/3,230218,2
3,1,23,219,0,883,1,3,1,2,2,single-choice,spatial-relational,1|2,7,1/2,230219,1
3,1,23,220,1,1142,1,9,4,4,5,single-choice,spatial-relational,4|5,7,4/5,230220,4
3,1,23,221,0,692,1,5,2,3,3,single-choice,spatial-relational,2|3,7,2/3,230221,2
3,1,23,222,1,1021,1,7,3,3,4,single-choice,spatial-relational,3|4,7,3/4,230222,3
3,1,23,223,0,1181,1,11,5,6,6,single-choice,spatial-relational,5|6,7,5/6,230223,5
3,1,23,224,1,835,1,7,3,3,4,single-choice,spatial-relational,3|4,7,3/4,230224,3
3,1,23,225,0,917,1,11,5,6,6,single-choice,spatial-relational,5|6,7,5/6,230225,5
3,1,23,226,1,867,1,13,6,6,7,single-choice,spatial-relational,6|7,7,6/7,230226,6
3,1,23,227,1,1005,1,13,6,6,7,single-choice,spatial-relational,6|7,7,6/7,230227,6
3,1,23,228,1,739,1,3,1,1,2,single-choice,spatial-relational,1|2,7,1/2,230228,1
3,1,23,229,1,642,1,9,4,4,5,single-choice,spatial-relational,4|5,7,4/5,230229,4
3,1,23,230,1,836,1,13,6,6,7,single-choice,spatial-relational,6|7,7,6/7,230230,6
3,1,23,231,1,1007,1,5,2,2,3,single-choice,spatial-relational,2|3,7,2/3,230231,2
3,1,23,232,0,580,1,11,5,6,6,single-choice,spatial-relational,5|6,7,5/6,230232,5
3,1,23,233,0,878,1,7,3,4,4,single-choice,spatial-relational,3|4,7,3/4,230233,3
3,1,23,234,0,723,1,11,5,6,6,single-choice,spatial-relational,5|6,7,5/6,230234,5
3,1,23,235,1,959,1,7,3,3,4,single-choice,spatial-relational,3|4,7,3/4,230235,3
3,1,23,236,1,1072,1,5,2,2,3,single-choice,spatial-relational,2|3,7,2/3,230236,2
3,1,23,237,0,1078,1,3,1,2,2,single-choice,spatial-relational,1|2,7,1/2,230237,1
3,1,23,238,1,958,1,9,4,4,5,single-choice,spatial-relational,4|5,7,4/5,230238,4
3,1,23,239,1,1270,1,13,6,6,7,single-choice,spatial-relational,6|7,7,6/7,230239,6
3,1,23,240,0,746,1,3,1,2,2,single-choice,spatial-relational,1|2,7,1/2,230240,1
3,1,23,241,1,698,1,3,1,1,2,single-choice,spatial-relational,1|2,7,1/2,230241,1
3,1,23,242,1,907,1,7,3,3,4,single-choice,spatial-relational,3|4,7,3/4,230242,3
3,1,23,243,1,769,1,5,2,2,3,single-choice,spatial-relational,2|3,7,2/3,230243,2
3,1,23,244,1,854,1,13,6,6,7,single-choice,spatial-relational,6|7,7,6/7,230244,6
3,1,23,245,1,979,1,11,5,5,6,single-choice,spatial-relational,5|6,7,5/6,230245,5
3,1,23,246,1,1069,1,13,6,6,7,single-choice,spatial-relational,6|7,7,6/7,230246,6
3,1,23,247,0,821,1,3,1,2,2,single-choice,spatial-relational,1|2,7,1/2,230247,1
3,1,23,248,0,1101,1,9,4,5,5,single-choice,spatial-relational,4|5,7,4/5,230248,4
3,1,23,249,1,943,1,11,5,5,6,single-choice,spatial-relational,5|6,7,5/6,230249,5
3,1,23,250,1,901,1,5,2,2,3,single-choice,spatial-relational,2|3,7,2/3,230250,2
3,1,23,251,1,1320,1,7,3,3,4,single-choice,spatial-relational,3|4,7,3/4,230251,3
3,1,23,252,0,820,1,9,4,5,5,single-choice,spatial-relational,4|5,7,4/5,230252,4
3,1,23,253,0,1314,1,11,5,6,6,single-choice,spatial-relational,5|6,7,5/6,230253,5
3,1,23,254,1,1012,1,3,1,1,2,single-choice,spatial-relational,1|2,7,1/2,230254,1
3,1,23,255,1,918,1,13,6,6,7,single-choice,spatial-relational,6|7,7,6/7,230255,6
3,1,23,256,0,827,1,7,3,4,4,single-choice,spatial-relational,3|4,7,3/4,230256,3
3,1,23,257,0,1121,1,9,4,5,5,single-choice,spatial-relational,4|5,7,4/5,230257,4
3,1,23,258,1,817,1,9,4,4,5,single-choice,spatial-relational,4|5,7,4/5,230258,4
3,1,23,259,1,1651,1,11,5,5,6,single-choice,spatial-relational,5|6,7,5/6,230259,5
3,1,23,260,1,1577,1,7,3,3,4,single-choice,spatial-relational,3|4,7,3/4,230260,3
3,1,23,261,1,1226,1,5,2,2,3,single-choice,spatial-relational,2|3,7,2/3,230261,2
3,1,23,262,1,791,1,5,2,2,3,single-choice,spatial-relational,2|3,7,2/3,230262,2
3,1,23,263,0,1085,1,3,1,2,2,single-choice,spatial-relational,1|2,7,1/2,230263,1
3,1,23,264,1,1051,1,13,6,6,7,single-choice,spatial-relational,6|7,7,6/7,230264,6
3,1,23,265,0,1044,1,7,3,4,4,single-choice,spatial-relational,3|4,7,3/4,230265,3
3,1,23,266,0,844,1,5,2,3,3,single-choice,spatial-relational,2|3,7,2/3,230266,2
3,1,23,267,0,881,1,3,1,2,2,single-choice,spatial-relational,1|2,7,1/2,230267,1
3,1,23,268,1,904,1,13,6,6,7,single-choice,spatial-relational,6|7,7,6/7,230268,6
3,1,23,269,1,1056,1,5,2,2,3,single-choice,spatial-relational,2|3,7,2/3,230269,2
3,1,23,270,0,856,1,11,5,6,6,single-choice,spatial-relational,5|6,7,5/6,230270,5
3,1,23,271,1,1396,1,9,4,4,5,single-choice,spatial-relational,4|5,7,4/5,230271,4
3,1,23,272,1,1253,1,3,1,1,2,single-choice,spatial-relational,1|2,7,1/2,230272,1
3,1,23,273,1,643,1,7,3,3,4,single-choice,spatial-relational,3|4,7,3/4,230273,3
3,1,23,274,1,1225,1,11,5,5,6,single-choice,spatial-relational,5|6,7,5/6,230274,5
3,1,23,275,0,1031,1,13,6,7,7,single-choice,spatial-relational,6|7,7,6/7,230275,6
3,1,23,276,0,941,1,9,4,5,5,single-choice,spatial-relational,4|5,7,4/5,230276,4
3,1,23,277,1,1153,1,7,3,3,4,single-choice,spatial-relational,3|4,7,3/4,230277,3
3,1,23,278,1,1176,1,9,4,4,5,single-choice,spatial-relational,4|5,7,4/5,230278,4
3,1,23,279,0,1272,1,11,5,6,6,single-choice,spatial-relational,5|6,7,5/6,230279,5
3,1,23,280,0,778,1,9,4,5,5,single-choice,spatial-relational,4|5,7,4/5,230280,4
3,1,23,281,1,841,1,13,6,6,7,single-choice,spatial-relational,6|7,7,6/7,230281,6
3,1,23,282,1,1342,1,5,2,2,3,single-choice,spatial-relational,2|3,7,2/3,230282,2
3,1,23,283,1,703,1,5,2,2,3,single-choice,spatial-relational,2|3,7,2/3,230283,2
3,1,23,284,0,823,1,3,1,2,2,single-choice,spatial-relational,1|2,7,1/2,230284,1
3,1,23,285,1,1116,1,3,1,1,2,single-choice,spatial-relational,1|2,7,1/2,230285,1
3,1,23,286,1,825,1,13,6,6,7,single-choice,spatial-relational,6|7,7,6/7,230286,6
3,1,23,287,0,1179,1,7,3,4,4,single-choice,spatial-relational,3|4,7,3/4,230287,3
3,1,23,288,1,925,1,11,5,5,6,single-choice,spatial-relational,5|6,7,5/6,230288,5
3,1,23,289,1,1044,1,11,5,5,6,single-choice,spatial-relational,5|6,7,5/6,230289,5
3,1,23,290,0,686,1,5,2,3,3,single-choice,spatial-relational,2|3,7,2/3,230290,2
3,1,23,291,0,1246,1,9,4,5,5,single-choice,spatial-relational,4|5,7,4/5,230291,4
3,1,23,292,1,944,1,13,6,6,7,single-choice,spatial-relational,6|7,7,6/7,230292,6
3,1,23,293,0,1638,1,11,5,6,6,single-choice,spatial-relational,5|6,7,5/6,230293,5
3,1,23,294,1,845,1,7,3,3,4,single-choice,spatial-relational,3|4,7,3/4,230294,3
3,1,23,295,1,782,1,9,4,4,5,single-choice,spatial-relational,4|5,7,4/5,230295,4
3,1,23,296,1,1318,1,7,3,3,4,single-choice,spatial-relational,3|4,7,3/4,230296,3
3,1,23,297,1,700,1,5,2,2,3,single-choice,spatial-relational,2|3,7,2/3,230297,2
3,1,23,298,1,1261,1,13,6,6,7,single-choice,spatial-relational,6|7,7,6/7,230298,6
3,1,23,299,1,1131,1,3,1,1,2,single-choice,spatial-relational,1|2,7,1/2,230299,1
3,1,23,300,1,633,1,3,1,1,2,single-choice,spatial-relational,1|2,7,1/2,230300,1
3,1,23,301,0,777,1,7,3,4,4,single-choice,spatial-relational,3|4,7,3/4,230301,3
3,1,23,302,1,871,1,5,2,2,3,single-choice,spatial-relational,2|3,7,2/3,230302,2
3,1,23,303,1,990,1,11,5,5,6,single-choice,spatial-relational,5|6,7,5/6,230303,5
3,1,23,304,1,1209,1,11,5,5,6,single-choice,spatial-relational,5|6,7,5/6,230304,5
3,1,23,305,1,803,1,5,2,2,3,single-choice,spatial-relational,2|3,7,2/3,230305,2
3,1,23,306,1,654,1,3,1,1,2,single-choice,spatial-relational,1|2,7,1/2,230306,1
3,1,23,307,1,866,1,13,6,6,7,single-choice,spatial-relational,6|7,7,6/7,230307,6
3,1,23,308,0,1010,1,9,4,5,5,single-choice,spatial-relational,4|5,7,4/5,230308,4
3,1,23,309,1,976,1,3,1,1,2,single-choice,spatial-relational,1|2,7,1/2,230309,1
3,1,23,310,1,771,1,7,3,3,4,single-choice,spatial-relational,3|4,7,3/4,230310,3
3,1,23,311,1,1070,1,13,6,6,7,single-choice,spatial-relational,6|7,7,6/7,230311,6
3,1,23,312,0,1341,1,9,4,5,5,single-choice,spatial-relational,4|5,7,4/5,230312,4
3,1,23,313,0,891,1,3,1,2,2,single-choice,spatial-relational,1|2,7,1/2,230313,1
3,1,23,314,0,1095,1,9,4,5,5,single-choice,spatial-relational,4|5,7,4/5,230314,4
3,1,23,315,1,1050,1,7,3,3,4,single-choice,spatial-relational,3|4,7,3/4,230315,3
3,1,23,316,1,989,1,7,3,3,4,single-choice,spatial-relational,3|4,7,3/4,230316,3
3,1,23,317,1,1300,1,11,5,5,6,single-choice,spatial-relational,5|6,7,5/6,230317,5
3,1,23,318,0,1247,1,9,4,5,5,single-choice,spatial-relational,4|5,7,4/5,230318,4
3,1,23,319,1,1184,1,13,6,6,7,single-choice,spatial-relational,6|7,7,6/7,230319,6
3,1,23,320,0,1319,1,3,1,2,2,single-choice,spatial-relational,1|2,7,1/2,230320,1
3,1,23,321,1,995,1,5,2,2,3,single-choice,spatial-relational,2|3,7,2/3,230321,2
3,1,23,322,1,832,1,11,5,5,6,single-choice,spatial-relational,5|6,7,5/6,230322,5
3,1,23,323,1,739,1,5,2,2,3,single-choice,spatial-relational,2|3,7,2/3,230323,2
3,1,23,324,1,1282,1,13,6,6,7,single-choice,spatial-relational,6|7,7,6/7,230324,6
3,1,23,325,1,698,1,3,1,1,2,single-choice,spatial-relational,1|2,7,1/2,230325,1
3,1,23,326,1,797,1,3,1,1,2,single-choice,spatial-relational,1|2,7,1/2,230326,1
3,1,23,327,1,1297,1,13,6,6,7,single-choice,spatial-relational,6|7,7,6/7,230327,6
3,1,23,328,1,1048,1,9,4,4,5,single-choice,spatial-relational,4|5,7,4/5,230328,4
3,1,23,329,1,737,1,7,3,3,4,single-choice,spatial-relational,3|4,7,3/4,230329,3
3,1,23,330,1,795,1,7,3,3,4,single-choice,spatial-relational,3|4,7,3/4,230330,3
3,1,23,331,0,1079,1,11,5,6,6,single-choice,spatial-relational,5|6,7,5/6,230331,5
3,1,23,332,1,868,1,5,2,2,3,single-choice,spatial-relational,2|3,7,2/3,230332,2
3,1,23,333,1,712,1,5,2,2,3,single-choice,spatial-relational,2|3,7,2/3,230333,2
3,1,23,334,0,944,1,11,5,6,6,single-choice,spatial-relational,5|6,7,5/6,230334,5
3,1,23,335,1,1515,1,9,4,4,5,single-choice,spatial-relational,4|5,7,4/5,230335,4
3,1,23,336,1,1293,1,13,6,6,7,single-choice,spatial-relational,6|7,7,6/7,230336,6
3,1,23,337,1,1573,1,11,5,5,6,single-choice,spatial-relational,5|6,7,5/6,230337,5
3,1,23,338,1,809,1,9,4,4,5,single-choice,spatial-relational,4|5,7,4/5,230338,4
3,1,23,339,0,734,1,5,2,3,3,single-choice,spatial-relational,2|3,7,2/3,230339,2
3,1,23,340,1,801,1,7,3,3,4,single-choice,spatial-relational,3|4,7,3/4,230340,3
3,1,23,341,1,1174,1,9,4,4,5,single-choice,spatial-relational,4|5,7,4/5,230341,4
3,1,23,342,1,1246,1,13,6,6,7,single-choice,spatial-relational,6|7,7,6/7,230342,6
3,1,23,343,1,1240,1,11,5,5,6,single-choice,spatial-relational,5|6,7,5/6,230343,5
3,1,23,344,0,991,1,3,1,2,2,single-choice,spatial-relational,1|2,7,1/2,230344,1
3,1,23,345,1,1212,1,13,6,6,7,single-choice,spatial-relational,6|7,7,6/7,230345,6
3,1,23,346,1,826,1,3,1,1,2,single-choice,spatial-relational,1|2,7,1/2,230346,1
3,1,23,347,1,782,1,7,3,3,4,single-choice,spatial-relational,3|4,7,3/4,230347,3
3,1,23,348,1,918,1,5,2,2,3,single-choice,spatial-relational,2|3,7,2/3,230348,2
3,1,23,349,1,861,1,3,1,1,2,single-choice,spatial-relational,1|2,7,1/2,230349,1
3,1,23,350,1,725,1,11,5,5,6,single-choice,spatial-relational,5|6,7,5/6,230350,5
3,1,23,351,1,721,1,9,4,4,5,single-choice,spatial-relational,4|5,7,4/5,230351,4
3,1,23,352,1,929,1,5,2,2,3,single-choice,spatial-relational,2|3,7,2/3,230352,2
3,1,23,353,0,959,1,7,3,4,4,single-choice,spatial-relational,3|4,7,3/4,230353,3
3,1,23,354,1,872,1,5,2,2,3,single-choice,spatial-relational,2|3,7,2/3,230354,2
3,1,23,355,0,745,1,7,3,4,4,single-choice,spatial-relational,3|4,7,3/4,230355,3
3,1,23,356,0,813,1,9,4,5,5,single-choice,spatial-relational,4|5,7,4/5,230356,4
3,1,23,357,1,1083,1,3,1,1,2,single-choice,spatial-relational,1|2,7,1/2,230357,1
3,1,23,358,1,842,1,13,6,6,7,single-choice,spatial-relational,6|7,7,6/7,230358,6
3,1,23,359,1,1325,1,11,5,5,6,single-choice,spatial-relational,5|6,7,5/6,230359,5
3,1,23,360,1,1525,1,13,6,6,7,single-choice,spatial-relational,6|7,7,6/7,230360,6
3,1,23,361,1,1164,1,5,2,2,3,single-choice,spatial-relational,2|3,7,2/3,230361,2
3,1,23,362,1,625,1,3,1,1,2,single-choice,spatial-relational,1|2,7,1/2,230362,1
3,1,23,363,0,851,1,11,5,6,6,single-choice,spatial-relational,5|6,7,5/6,230363,5
3,1,23,364,1,824,1,13,6,6,7,single-choice,spatial-relational,6|7,7,6/7,230364,6
3,1,23,365,0,1188,1,7,3,4,4,single-choice,spatial-relational,3|4,7,3/4,230365,3
3,1,23,366,1,1289,1,9,4,4,5,single-choice,spatial-relational,4|5,7,4/5,230366,4
3,1,23,367,1,969,1,3,1,1,2,single-choice,spatial-relational,1|2,7,1/2,230367,1
3,1,23,368,1,1007,1,7,3,3,4,single-choice,spatial-relational,3|4,7,3/4,230368,3
3,1,23,369,1,1017,1,13,6,6,7,single-choice,spatial-relational,6|7,7,6/7,230369,6
3,1,23,370,1,1127,1,5,2,2,3,single-choice,spatial-relational,2|3,7,2/3,230370,2
3,1,23,371,1,784,1,11,5,5,6,single-choice,spatial-relational,5|6,7,5/6,230371,5
3,1,23,372,1,828,1,9,4,4,5,single-choice,spatial-relational,4|5,7,4/5,230372,4
3,1,23,373,1,1098,1,5,2,2,3,single-choice,spatial-relational,2|3,7,2/3,230373,2
3,1,23,374,0,944,1,11,5,6,6,single-choice,spatial-relational,5|6,7,5/6,230374,5
3,1,23,375,1,1249,1,7,3,3,4,single-choice,spatial-relational,3|4,7,3/4,230375,3
3,1,23,376,1,993,1,13,6,6,7,single-choice,spatial-relational,6|7,7,6/7,230376,6
3,1,23,377,0,778,1,9,4,5,5,single-choice,spatial-relational,4|5,7,4/5,230377,4
3,1,23,378,1,813,1,7,3,3,4,single-choice,spatial-relational,3|4,7,3/4,230378,3
3,1,23,379,0,1315,1,9,4,5,5,single-choice,spatial-relational,4|5,7,4/5,230379,4
3,1,23,380,0,989,1,3,1,2,2,single-choice,spatial-relational,1|2,7,1/2,230380,1
3,1,23,381,1,1189,1,11,5,5,6,single-choice,spatial-relational,5|6,7,5/6,230381,5
3,1,23,382,1,939,1,5,2,2,3,single-choice,spatial-relational,2|3,7,2/3,230382,2
3,1,23,383,1,930,1,13,6,6,7,single-choice,spatial-relational,6|7,7,6/7,230383,6
3,1,23,384,1,1031,1,3,1,1,2,single-choice,spatial-relational,1|2,7,1/2,230384,1
3,1,23,385,1,792,1,5,2,2,3,single-choice,spatial-relational,2|3,7,2/3,230385,2
3,1,23,386,1,1076,1,3,1,1,2,single-choice,spatial-relational,1|2,7,1/2,230386,1
3,1,23,387,1,719,1,9,4,4,5,single-choice,spatial-relational,4|5,7,4/5,230387,4
3,1,23,388,1,1203,1,3,1,1,2,single-choice,spatial-relational,1|2,7,1/2,230388,1
3,1,23,389,1,786,1,13,6,6,7,single-choice,spatial-relational,6|7,7,6/7,230389,6
3,1,23,390,0,974,1,7,3,4,4,single-choice,spatial-relational,3|4,7,3/4,230390,3
3,1,23,391,1,951,1,11,5,5,6,single-choice,spatial-relational,5|6,7,5/6,230391,5
3,1,23,392,1,1132,1,5,2,2,3,single-choice,spatial-relational,2|3,7,2/3,230392,2
3,1,23,393,1,982,1,13,6,6,7,single-choice,spatial-relational,6|7,7,6/7,230393,6
3,1,23,394,1,1074,1,7,3,3,4,single-choice,spatial-relational,3|4,7,3/4,230394,3
3,1,23,395,1,800,1,9,4,4,5,single-choice,spatial-relational,4|5,7,4/5,230395,4
3,1,23,396,0,1018,1,11,5,6,6,single-choice,spatial-relational,5|6,7,5/6,230396,5
3,1,23,397,1,875,1,7,3,3,4,single-choice,spatial-relational,3|4,7,3/4,230397,3
3,1,23,398,1,1370,1,13,6,6,7,single-choice,spatial-relational,6|7,7,6/7,230398,6
3,1,23,399,0,1331,1,11,5,6,6,single-choice,spatial-relational,5|6,7,5/6,230399,5
3,1,23,400,0,1240,1,5,2,3,3,single-choice,spatial-relational,2|3,7,2/3,230400,2
3,1,23,401,1,970,1,5,2,2,3,single-choice,spatial-relational,2|3,7,2/3,230401,2
3,1,23,402,1,729,1,11,5,5,6,single-choice,spatial-relational,5|6,7,5/6,230402,5
3,1,23,403,1,776,1,3,1,1,2,single-choice,spatial-relational,1|2,7,1/2,230403,1
3,1,23,404,0,1046,1,7,3,4,4,single-choice,spatial-relational,3|4,7,3/4,230404,3
3,1,23,405,1,6451,1,9,4,4,5,single-choice,spatial-relational,4|5,7,4/5,230405,4
3,1,23,406,0,1152,1,9,4,5,5,single-choice,spatial-relational,4|5,7,4/5,230406,4
3,1,23,407,1,934,1,13,6,6,7,single-choice,spatial-relational,6|7,7,6/7,230407,6
3,1,23,408,1,1034,1,3,1,1,2,single-choice,spatial-relational,1|2,7,1/2,230408,1
3,1,23,409,0,1824,1,11,5,6,6,single-choice,spatial-relational,5|6,7,5/6,230409,5
3,1,23,410,0,1001,1,3,1,2,2,single-choice,spatial-relational,1|2,7,1/2,230410,1
3,1,23,411,1,872,1,13,6,6,7,single-choice,spatial-relational,6|7,7,6/7,230411,6
3,1,23,412,0,1797,1,11,5,6,6,single-choice,spatial-relational,5|6,7,5/6,230412,5
3,1,23,413,1,1208,1,3,1,1,2,single-choice,spatial-relational,1|2,7,1/2,230413,1
3,1,23,414,0,764,1,9,4,5,5,single-choice,spatial-relational,4|5,7,4/5,230414,4
3,1,23,415,1,1001,1,9,4,4,5,single-choice,spatial-relational,4|5,7,4/5,230415,4
3,1,23,416,1,1116,1,7,3,3,4,single-choice,spatial-relational,3|4,7,3/4,230416,3
3,1,23,417,1,953,1,7,3,3,4,single-choice,spatial-relational,3|4,7,3/4,230417,3
3,1,23,418,1,1576,1,13,6,6,7,single-choice,spatial-relational,6|7,7,6/7,230418,6
3,1,23,419,1,1017,1,5,2,2,3,single-choice,spatial-relational,2|3,7,2/3,230419,2
3,1,23,420,1,657,1,5,2,2,3,single-choice,spatial-relational,2|3,7,2/3,230420,2
3,1,23,421,1,1111,1,9,4,4,5,single-choice,spatial-relational,4|5,7,4/5,230421,4
3,1,23,422,1,1033,1,13,6,6,7,single-choice,spatial-relational,6|7,7,6/7,230422,6
3,1,23,423,0,1365,1,3,1,2,2,single-choice,spatial-relational,1|2,7,1/2,230423,1
3,1,23,424,1,969,1,3,1,1,2,single-choice,spatial-relational,1|2,7,1/2,230424,1
3,1,23,425,1,835,1,11,5,5,6,single-choice,spatial-relational,5|6,7,5/6,230425,5
3,1,23,426,1,899,1,5,2,2,3,single-choice,spatial-relational,2|3,7,2/3,230426,2
3,1,23,427,1,725,1,7,3,3,4,single-choice,spatial-relational,3|4,7,3/4,230427,3
3,1,23,428,1,1210,1,9,4,4,5,single-choice,spatial-relational,4|5,7,4/5,230428,4
3,1,23,429,1,1250,1,13,6,6,7,single-choice,spatial-relational,6|7,7,6/7,230429,6
3,1,23,430,0,883,1,7,3,4,4,single-choice,spatial-relational,3|4,7,3/4,230430,3
3,1,23,431,1,902,1,5,2,2,3,single-choice,spatial-relational,2|3,7,2/3,230431,2
3,1,23,432,0,1361,1,11,5,6,6,single-choice,spatial-relational,5|6,7,5/6,230432,5
3,1,23,433,1,1037,1,7,3,3,4,single-choice,spatial-relational,3|4,7,3/4,230433,3
3,1,23,434,1,898,1,13,6,6,7,single-choice,spatial-relational,6|7,7,6/7,230434,6
3,1,23,435,0,1042,1,5,2,3,3,single-choice,spatial-relational,2|3,7,2/3,230435,2
3,1,23,436,1,1006,1,11,5,5,6,single-choice,spatial-relational,5|6,7,5/6,230436,5
3,1,23,437,0,1514,1,7,3,4,4,single-choice,spatial-relational,3|4,7,3/4,230437,3
3,1,23,438,0,801,1,3,1,2,2,single-choice,spatial-relational,1|2,7,1/2,230438,1
3,1,23,439,1,1181,1,5,2,2,3,single-choice,spatial-relational,2|3,7,2/3,230439,2
3,1,23,440,1,898,1,9,4,4,5,single-choice,spatial-relational,4|5,7,4/5,230440,4
3,1,23,441,1,1188,1,11,5,5,6,single-choice,spatial-relational,5|6,7,5/6,230441,5
3,1,23,442,0,1373,1,13,6,7,7,single-choice,spatial-relational,6|7,7,6/7,230442,6
3,1,23,443,1,906,1,3,1,1,2,single-choice,spatial-relational,1|2,7,1/2,230443,1
3,1,23,444,0,787,1,9,4,5,5,single-choice,spatial-relational,4|5,7,4/5,230444,4
3,1,23,445,1,1013,1,9,4,4,5,single-choice,spatial-relational,4|5,7,4/5,230445,4
3,1,23,446,1,1240,1,5,2,2,3,single-choice,spatial-relational,2|3,7,2/3,230446,2
3,1,23,447,1,1124,1,13,6,6,7,single-choice,spatial-relational,6|7,7,6/7,230447,6
3,1,23,448,0,1353,1,3,1,2,2,single-choice,spatial-relational,1|2,7,1/2,230448,1
3,1,23,449,1,900,1,13,6,6,7,single-choice,spatial-relational,6|7,7,6/7,230449,6
3,1,23,450,1,911,1,5,2,2,3,single-choice,spatial-relational,2|3,7,2/3,230450,2
3,1,23,451,1,648,1,3,1,1,2,single-choice,spatial-relational,1|2,7,1/2,230451,1
3,1,23,452,0,726,1,7,3,4,4,single-choice,spatial-relational,3|4,7,3/4,230452,3
3,1,23,453,1,1253,1,9,4,4,5,single-choice,spatial-relational,4|5,7,4/5,230453,4
3,1,23,454,0,1118,1,11,5,6,6,single-choice,spatial-relational,5|6,7,5/6,230454,5
3,1,23,455,1,869,1,11,5,5,6,single-choice,spatial-relational,5|6,7,5/6,230455,5
3,1,23,456,0,1504,1,7,3,4,4,single-choice,spatial-relational,3|4,7,3/4,230456,3
3,1,23,457,1,1206,1,13,6,6,7,single-choice,spatial-relational,6|7,7,6/7,230457,6
3,1,23,458,0,1359,1,5,2,3,3,single-choice,spatial-relational,2|3,7,2/3,230458,2
3,1,23,459,0,856,1,3,1,2,2,single-choice,spatial-relational,1|2,7,1/2,230459,1
3,1,23,460,0,1035,1,7,3,4,4,single-choice,spatial-relational,3|4,7,3/4,230460,3
3,1,23,461,1,967,1,9,4,4,5,single-choice,spatial-relational,4|5,7,4/5,230461,4
3,1,23,462,1,1162,1,13,6,6,7,single-choice,spatial-relational,6|7,7,6/7,230462,6
3,1,23,463,0,1854,1,11,5,6,6,single-choice,spatial-relational,5|6,7,5/6,230463,5
3,1,23,464,0,1222,1,9,4,5,5,single-choice,spatial-relational,4|5,7,4/5,230464,4
3,1,23,465,0,1295,1,11,5,6,6,single-choice,spatial-relational,5|6,7,5/6,230465,5
3,1,23,466,1,1100,1,7,3,3,4,single-choice,spatial-relational,3|4,7,3/4,230466,3
3,1,23,467,0,1026,1,3,1,2,2,single-choice,spatial-relational,1|2,7,1/2,230467,1
3,1,23,468,1,1050,1,5,2,2,3,single-choice,spatial-relational,2|3,7,2/3,230468,2
3,1,23,469,1,1065,1,13,6,6,7,single-choice,spatial-relational,6|7,7,6/7,230469,6
3,1,23,470,0,837,1,3,1,2,2,single-choice,spatial-relational,1|2,7,1/2,230470,1
3,1,23,471,1,851,1,7,3,3,4,single-choice,spatial-relational,3|4,7,3/4,230471,3
3,1,23,472,1,948,1,5,2,2,3,single-choice,spatial-relational,2|3,7,2/3,230472,2
3,1,23,473,0,1445,1,11,5,6,6,single-choice,spatial-relational,5|6,7,5/6,230473,5
3,1,23,474,1,1603,1,9,4,4,5,single-choice,spatial-relational,4|5,7,4/5,230474,4
3,1,23,475,0,1197,1,7,3,4,4,single-choice,spatial-relational,3|4,7,3/4,230475,3
3,1,23,476,1,1066,1,9,4,4,5,single-choice,spatial-relational,4|5,7,4/5,230476,4
3,1,23,477,1,1212,1,13,6,6,7,single-choice,spatial-relational,6|7,7,6/7,230477,6
3,1,23,478,1,1228,1,5,2,2,3,single-choice,spatial-relational,2|3,7,2/3,230478,2
3,1,23,479,1,877,1,11,5,5,6,single-choice,spatial-relational,5|6,7,5/6,230479,5
3,1,23,480,0,1169,1,3,1,2,2,single-choice,spatial-relational,1|2,7,1/2,230480,1
3,1,23,481,1,1047,1,9,4,4,5,single-choice,spatial-relational,4|5,7,4/5,230481,4
3,1,23,482,1,1319,1,7,3,3,4,single-choice,spatial-relational,3|4,7,3/4,230482,3
3,1,23,483,0,1197,1,3,1,2,2,single-choice,spatial-relational,1|2,7,1/2,230483,1
3,1,23,484,0,982,1,3,1,2,2,single-choice,spatial-relational,1|2,7,1/2,230484,1
3,1,23,485,1,936,1,5,2,2,3,single-choice,spatial-relational,2|3,7,2/3,230485,2
3,1,23,486,1,1337,1,13,6,6,7,single-choice,spatial-relational,6|7,7,6/7,230486,6
3,1,23,487,1,1273,1,13,6,6,7,single-choice,spatial-relational,6|7,7,6/7,230487,6
3,1,23,488,1,1122,1,9,4,4,5,single-choice,spatial-relational,4|5,7,4/5,230488,4
3,1,23,489,1,1244,1,7,3,3,4,single-choice,spatial-relational,3|4,7,3/4,230489,3
3,1,23,490,1,884,1,11,5,5,6,single-choice,spatial-relational,5|6,7,5/6,230490,5
3,1,23,491,0,1738,1,11,5,6,6,single-choice,spatial-relational,5|6,7,5/6,230491,5
3,1,23,492,1,1059,1,5,2,2,3,single-choice,spatial-relational,2|3,7,2/3,230492,2
3,1,23,493,1,1632,1,9,4,4,5,single-choice,spatial-relational,4|5,7,4/5,230493,4
3,1,23,494,1,1143,1,13,6,6,7,single-choice,spatial-relational,6|7,7,6/7,230494,6
3,1,23,495,1,1267,1,5,2,2,3,single-choice,spatial-relational,2|3,7,2/3,230495,2
3,1,23,496,1,946,1,3,1,1,2,single-choice,spatial-relational,1|2,7,1/2,230496,1
3,1,23,497,1,784,1,13,6,6,7,single-choice,spatial-relational,6|7,7,6/7,230497,6
3,1,23,498,1,1140,1,7,3,3,4,single-choice,spatial-relational,3|4,7,3/4,230498,3
3,1,23,499,1,988,1,5,2,2,3,single-choice,spatial-relational,2|3,7,2/3,230499,2
3,1,23,500,0,921,1,9,4,5,5,single-choice,spatial-relational,4|5,7,4/5,230500,4
3,1,23,501,1,1363,1,11,5,5,6,single-choice,spatial-relational,5|6,7,5/6,230501,5
3,1,23,502,1,1619,1,11,5,5,6,single-choice,spatial-relational,5|6,7,5/6,230502,5
3,1,23,503,0,737,1,3,1,2,2,single-choice,spatial-relational,1|2,7,1/2,230503,1
3,1,23,504,1,880,1,7,3,3,4,single-choice,spatial-relational,3|4,7,3/4,230504,3
3,1,23,505,1,948,1,9,4,4,5,single-choice,spatial-relational,4|5,7,4/5,230505,4
3,1,23,506,0,1956,1,7,3,4,4,single-choice,spatial-relational,3|4,7,3/4,230506,3
3,1,23,507,1,1243,1,3,1,1,2,single-choice,spatial-relational,1|2,7,1/2,230507,1
3,1,23,508,0,1387,1,11,5,6,6,single-choice,spatial-relational,5|6,7,5/6,230508,5
3,1,23,509,1,865,1,5,2,2,3,single-choice,spatial-relational,2|3,7,2/3,230509,2
3,1,23,510,1,1051,1,7,3,3,4,single-choice,spatial-relational,3|4,7,3/4,230510,3
3,1,23,511,0,1021,1,11,5,6,6,single-choice,spatial-relational,5|6,7,5/6,230511,5
3,1,23,512,1,1059,1,13,6,6,7,single-choice,spatial-relational,6|7,7,6/7,230512,6
3,1,23,513,1,1139,1,13,6,6,7,single-choice,spatial-relational,6|7,7,6/7,230513,6
3,1,23,514,0,1887,1,9,4,5,5,single-choice,spatial-relational,4|5,7,4/5,230514,4
3,1,23,515,0,798,1,3,1,2,2,single-choice,spatial-relational,1|2,7,1/2,230515,1
3,1,23,516,1,1010,1,5,2,2,3,single-choice,spatial-relational,2|3,7,2/3,230516,2
3,1,23,517,1,1318,1,9,4,4,5,single-choice,spatial-relational,4|5,7,4/5,230517,4
3,1,23,518,1,1072,1,11,5,5,6,single-choice,spatial-relational,5|6,7,5/6,230518,5
3,1,23,519,1,839,1,13,6,6,7,single-choice,spatial-relational,6|7,7,6/7,230519,6
3,1,23,520,1,1554,1,7,3,3,4,single-choice,spatial-relational,3|4,7,3/4,230520,3
3,1,23,521,1,1053,1,9,4,4,5,single-choice,spatial-relational,4|5,7,4/5,230521,4
3,1,23,522,1,1293,1,3,1,1,2,single-choice,spatial-relational,1|2,7,1/2,230522,1
3,1,23,523,1,638,1,5,2,2,3,single-choice,spatial-relational,2|3,7,2/3,230523,2
3,1,23,524,1,1164,1,7,3,3,4,single-choice,spatial-relational,3|4,7,3/4,230524,3
3,1,23,525,1,1107,1,13,6,6,7,single-choice,spatial-relational,6|7,7,6/7,230525,6
3,1,23,526,1,1491,1,5,2,2,3,single-choice,spatial-relational,2|3,7,2/3,230526,2
3,1,23,527,1,1197,1,11,5,5,6,single-choice,spatial-relational,5|6,7,5/6,230527,5
3,1,23,528,1,1254,1,3,1,1,2,single-choice,spatial-relational,1|2,7,1/2,230528,1
3,1,23,529,1,1038,1,7,3,3,4,single-choice,spatial-relational,3|4,7,3/4,230529,3
3,1,23,530,0,828,1,3,1,2,2,single-choice,spatial-relational,1|2,7,1/2,230530,1
3,1,23,531,1,1051,1,5,2,2,3,single-choice,spatial-relational,2|3,7,2/3,230531,2
3,1,23,532,1,837,1,5,2,2,3,single-choice,spatial-relational,2|3,7,2/3,230532,2
3,1,23,533,0,764,1,9,4,5,5,single-choice,spatial-relational,4|5,7,4/5,230533,4
3,1,23,534,0,827,1,11,5,6,6,single-choice,spatial-relational,5|6,7,5/6,230534,5
3,1,23,535,0,1159,1,7,3,4,4,single-choice,spatial-relational,3|4,7,3/4,230535,3
3,1,23,536,0,812,1,13,6,7,7,single-choice,spatial-relational,6|7,7,6/7,230536,6
3,1,23,537,1,913,1,13,6,6,7,single-choice,spatial-relational,6|7,7,6/7,230537,6
3,1,23,538,0,1525,1,9,4,5,5,single-choice,spatial-relational,4|5,7,4/5,230538,4
3,1,23,539,0,891,1,11,5,6,6,single-choice,spatial-relational,5|6,7,5/6,230539,5
3,1,23,540,0,769,1,3,1,2,2,single-choice,spatial-relational,1|2,7,1/2,230540,1
3,1,23,541,0,919,1,11,5,6,6,single-choice,spatial-relational,5|6,7,5/6,230541,5
3,1,23,542,1,1375,1,5,2,2,3,single-choice,spatial-relational,2|3,7,2/3,230542,2
3,1,23,543,1,968,1,5,2,2,3,single-choice,spatial-relational,2|3,7,2/3,230543,2
3,1,23,544,1,800,1,3,1,1,2,single-choice,spatial-relational,1|2,7,1/2,230544,1
3,1,23,545,1,965,1,13,6,6,7,single-choice,spatial-relational,6|7,7,6/7,230545,6
3,1,23,546,1,784,1,7,3,3,4,single-choice,spatial-relational,3|4,7,3/4,230546,3
3,1,23,547,0,923,1,9,4,5,5,single-choice,spatial-relational,4|5,7,4/5,230547,4
3,1,23,548,1,1439,1,13,6,6,7,single-choice,spatial-relational,6|7,7,6/7,230548,6
3,1,23,549,1,1295,1,11,5,5,6,single-choice,spatial-relational,5|6,7,5/6,230549,5
3,1,23,550,1,1445,1,9,4,4,5,single-choice,spatial-relational,4|5,7,4/5,230550,4
3,1,23,551,1,635,1,7,3,3,4,single-choice,spatial-relational,3|4,7,3/4,230551,3
3,1,23,552,0,1043,1,3,1,2,2,single-choice,spatial-relational,1|2,7,1/2,230552,1
3,1,23,553,1,1283,1,3,1,1,2,single-choice,spatial-relational,1|2,7,1/2,230553,1
3,1,23,554,0,901,1,9,4,5,5,single-choice,spatial-relational,4|5,7,4/5,230554,4
3,1,23,555,1,766,1,7,3,3,4,single-choice,spatial-relational,3|4,7,3/4,230555,3
3,1,23,556,1,876,1,9,4,4,5,single-choice,spatial-relational,4|5,7,4/5,230556,4
3,1,23,557,1,694,1,3,1,1,2,single-choice,spatial-relational,1|2,7,1/2,230557,1
3,1,23,558,1,768,1,11,5,5,6,single-choice,spatial-relational,5|6,7,5/6,230558,5
3,1,23,559,1,993,1,13,6,6,7,single-choice,spatial-relational,6|7,7,6/7,230559,6
3,1,23,560,1,975,1,5,2,2,3,single-choice,spatial-relational,2|3,7,2/3,230560,2
3,1,23,561,1,874,1,13,6,6,7,single-choice,spatial-relational,6|7,7,6/7,230561,6
3,1,23,562,1,1207,1,11,5,5,6,single-choice,spatial-relational,5|6,7,5/6,230562,5
3,1,23,563,1,866,1,7,3,3,4,single-choice,spatial-relational,3|4,7,3/4,230563,3
3,1,23,564,1,1130,1,5,2,2,3,single-choice,spatial-relational,2|3,7,2/3,230564,2
3,1,23,565,1,845,1,7,3,3,4,single-choice,spatial-relational,3|4,7,3/4,230565,3
3,1,23,566,1,829,1,11,5,5,6,single-choice,spatial-relational,5|6,7,5/6,230566,5
3,1,23,567,0,1111,1,11,5,6,6,single-choice,spatial-relational,5|6,7,5/6,230567,5
3,1,23,568,0,984,1,9,4,5,5,single-choice,spatial-relational,4|5,7,4/5,230568,4
3,1,23,569,1,1045,1,3,1,1,2,single-choice,spatial-relational,1|2,7,1/2,230569,1
3,1,23,570,1,871,1,5,2,2,3,single-choice,spatial-relational,2|3,7,2/3,230570,2
3,1,23,571,1,914,1,5,2,2,3,single-choice,spatial-relational,2|3,7,2/3,230571,2
3,1,23,572,1,790,1,9,4,4,5,single-choice,spatial-relational,4|5,7,4/5,230572,4
3,1,23,573,1,1121,1,13,6,6,7,single-choice,spatial-relational,6|7,7,6/7,230573,6
3,1,23,574,0,798,1,3,1,2,2,single-choice,spatial-relational,1|2,7,1/2,230574,1
3,1,23,575,1,1128,1,13,6,6,7,single-choice,spatial-relational,6|7,7,6/7,230575,6
3,1,23,576,0,1544,1,7,3,4,4,single-choice,spatial-relational,3|4,7,3/4,230576,3
3,1,23,577,1,1144,1,13,6,6,7,single-choice,spatial-relational,6|7,7,6/7,230577,6
3,1,23,578,0,1493,1,13,6,7,7,single-choice,spatial-relational,6|7,7,6/7,230578,6
3,1,23,579,0,892,1,3,1,2,2,single-choice,spatial-relational,1|2,7,1/2,230579,1
3,1,23,580,1,1328,1,11,5,5,6,single-choice,spatial-relational,5|6,7,5/6,230580,5
3,1,23,581,1,991,1,7,3,3,4,single-choice,spatial-relational,3|4,7,3/4,230581,3
3,1,23,582,1,1007,1,5,2,2,3,single-choice,spatial-relational,2|3,7,2/3,230582,2
3,1,23,583,1,762,1,3,1,1,2,single-choice,spatial-relational,1|2,7,1/2,230583,1
3,1,23,584,0,803,1,7,3,4,4,single-choice,spatial-relational,3|4,7,3/4,230584,3
3,1,23,585,1,988,1,9,4,4,5,single-choice,spatial-relational,4|5,7,4/5,230585,4
3,1,23,586,1,1348,1,11,5,5,6,single-choice,spatial-relational,5|6,7,5/6,230586,5
3,1,23,587,0,1039,1,9,4,5,5,single-choice,spatial-relational,4|5,7,4/5,230587,4
3,1,23,588,1,1052,1,5,2,2,3,single-choice,spatial-relational,2|3,7,2/3,230588,2
3,1,23,589,1,798,1,11,5,5,6,single-choice,spatial-relational,5|6,7,5/6,230589,5
3,1,23,590,0,1578,1,11,5,6,6,single-choice,spatial-relational,5|6,7,5/6,230590,5
3,1,23,591,1,1016,1,3,1,1,2,single-choice,spatial-relational,1|2,7,1/2,230591,1
3,1,23,592,0,950,1,9,4,5,5,single-choice,spatial-relational,4|5,7,4/5,230592,4
3,1,23,593,1,1149,1,13,6,6,7,single-choice,spatial-relational,6|7,7,6/7,230593,6
3,1,23,594,1,1542,1,5,2,2,3,single-choice,spatial-relational,2|3,7,2/3,230594,2
3,1,23,595,1,975,1,13,6,6,7,single-choice,spatial-relational,6|7,7,6/7,230595,6
3,1,23,596,1,946,1,5,2,2,3,single-choice,spatial-relational,2|3,7,2/3,230596,2
3,1,23,597,0,789,1,7,3,4,4,single-choice,spatial-relational,3|4,7,3/4,230597,3
3,1,23,598,1,1002,1,9,4,4,5,single-choice,spatial-relational,4|5,7,4/5,230598,4
3,1,23,599,1,882,1,3,1,1,2,single-choice,spatial-relational,1|2,7,1/2,230599,1
3,1,23,600,0,937,1,7,3,4,4,single-choice,spatial-relational,3|4,7,3/4,230600,3
4,1,23,1,1,28,1,5,2,2,3,single-choice,spatial-relational,2|3,7,2/3,230001,2
4,1,23,2,1,659,1,3,1,1,2,single-choice,spatial-relational,1|2,7,1/2,230002,1
4,1,23,3,0,35,1,11,5,6,6,single-choice,spatial-relational,5|6,7,5/6,230003,5
4,1,23,4,0,704,1,7,3,4,4,single-choice,spatial-relational,3|4,7,3/4,230004,3
4,1,23,5,0,687,1,11,5,6,6,single-choice,spatial-relational,5|6,7,5/6,230005,5
4,1,23,6,0,761,1,5,2,3,3,single-choice,spatial-relational,2|3,7,2/3,230006,2
4,1,23,7,0,777,1,3,1,2,2,single-choice,spatial-relational,1|2,7,1/2,230007,1
4,1,23,8,1,853,1,13,6,6,7,single-choice,spatial-relational,6|7,7,6/7,230008,6
4,1,23,9,1,552,1,9,4,4,5,single-choice,spatial-relational,4|5,7,4/5,230009,4
4,1,23,10,1,998,1,13,6,6,7,single-choice,spatial-relational,6|7,7,6/7,230010,6
4,1,23,11,0,16,1,9,4,5,5,single-choice,spatial-relational,4|5,7,4/5,230011,4
4,1,23,12,1,857,1,7,3,3,4,single-choice,spatial-relational,3|4,7,3/4,230012,3
4,1,23,13,0,795,1,5,2,3,3,single-choice,spatial-relational,2|3,7,2/3,230013,2
4,1,23,14,1,933,1,7,3,3,4,single-choice,spatial-relational,3|4,7,3/4,230014,3
4,1,23,15,0,849,1,3,1,2,2,single-choice,spatial-relational,1|2,7,1/2,230015,1
4,1,23,16,0,1021,1,7,3,4,4,single-choice,spatial-relational,3|4,7,3/4,230016,3
4,1,23,17,0,788,1,11,5,6,6,single-choice,spatial-relational,5|6,7,5/6,230017,5
4,1,23,18,1,932,1,13,6,6,7,single-choice,spatial-relational,6|7,7,6/7,230018,6
4,1,23,19,1,1006,1,13,6,6,7,single-choice,spatial-relational,6|7,7,6/7,230019,6
4,1,23,20,0,1022,1,9,4,5,5,single-choice,spatial-relational,4|5,7,4/5,230020,4
4,1,23,21,0,824,1,3,1,2,2,single-choice,spatial-relational,1|2,7,1/2,230021,1
4,1,23,22,1,946,1,5,2,2,3,single-choice,spatial-relational,2|3,7,2/3,230022,2
4,1,23,23,1,1019,1,9,4,4,5,single-choice,spatial-relational,4|5,7,4/5,230023,4
4,1,23,24,0,1532,1,11,5,6,6,single-choice,spatial-relational,5|6,7,5/6,230024,5
4,1,23,25,0,808,1,5,2,3,3,single-choice,spatial-relational,2|3,7,2/3,230025,2
4,1,23,26,1,989,1,9,4,4,5,single-choice,spatial-relational,4|5,7,4/5,230026,4
4,1,23,27,1,1326,1,9,4,4,5,single-choice,spatial-relational,4|5,7,4/5,230027,4
4,1,23,28,0,1868,1,7,3,4,4,single-choice,spatial-relational,3|4,7,3/4,230028,3
4,1,23,29,1,925,1,13,6,6,7,single-choice,spatial-relational,6|7,7,6/7,230029,6
4,1,23,30,1,1323,1,13,6,6,7,single-choice,spatial-relational,6|7,7,6/7,230030,6
4,1,23,31,0,1261,1,11,5,6,6,single-choice,spatial-relational,5|6,7,5/6,230031,5
4,1,23,32,1,898,1,5,2,2,3,single-choice,spatial-relational,2|3,7,2/3,230032,2
4,1,23,33,1,988,1,7,3,3,4,single-choice,spatial-relational,3|4,7,3/4,230033,3
4,1,23,34,0,982,1,11,5,6,6,single-choice,spatial-relational,5|6,7,5/6,230034,5
4,1,23,35,1,812,1,3,1,1,2,single-choice,spatial-relational,1|2,7,1/2,230035,1
4,1,23,36,0,879,1,3,1,2,2,single-choice,spatial-relational,1|2,7,1/2,230036,1
4,1,23,37,0,1383,1,9,4,5,5,single-choice,spatial-relational,4|5,7,4/5,230037,4
4,1,23,38,0,983,1,7,3,4,4,single-choice,spatial-relational,3|4,7,3/4,230038,3
4,1,23,39,0,1019,1,11,5,6,6,single-choice,spatial-relational,5|6,7,5/6,230039,5
4,1,23,40,1,942,1,13,6,6,7,single-choice,spatial-relational,6|7,7,6/7,230040,6
4,1,23,41,0,1232,1,5,2,3,3,single-choice,spatial-relational,2|3,7,2/3,230041,2
4,1,23,42,1,922,1,11,5,5,6,single-choice,spatial-relational,5|6,7,5/6,230042,5
4,1,23,43,1,1027,1,3,1,1,2,single-choice,spatial-relational,1|2,7,1/2,230043,1
4,1,23,44,0,1052,1,13,6,7,7,single-choice,spatial-relational,6|7,7,6/7,230044,6
4,1,23,45,1,977,1,5,2,2,3,single-choice,spatial-relational,2|3,7,2/3,230045,2
4,1,23,46,1,945,1,7,3,3,4,single-choice,spatial-relational,3|4,7,3/4,230046,3
4,1,23,47,1,938,1,3,1,1,2,single-choice,spatial-relational,1|2,7,1/2,230047,1
4,1,23,48,1,851,1,9,4,4,5,single-choice,spatial-relational,4|5,7,4/5,230048,4
4,1,23,49,1,1502,1,9,4,4,5,single-choice,spatial-relational,4|5,7,4/5,230049,4
4,1,23,50,1,1105,1,7,3,3,4,single-choice,spatial-relational,3|4,7,3/4,230050,3
4,1,23,51,1,849,1,7,3,3,4,single-choice,spatial-relational,3|4,7,3/4,230051,3
4,1,23,52,0,1041,1,11,5,6,6,single-choice,spatial-relational,5|6,7,5/6,230052,5
4,1,23,53,0,1047,1,9,4,5,5,single-choice,spatial-relational,4|5,7,4/5,230053,4
4,1,23,54,1,1063,1,13,6,6,7,single-choice,spatial-relational,6|7,7,6/7,230054,6
4,1,23,55,1,1058,1,5,2,2,3,single-choice,spatial-relational,2|3,7,2/3,230055,2
4,1,23,56,0,967,1,3,1,2,2,single-choice,spatial-relational,1|2,7,1/2,230056,1
4,1,23,57,0,1037,1,11,5,6,6,single-choice,spatial-relational,5|6,7,5/6,230057,5
4,1,23,58,1,1007,1,5,2,2,3,single-choice,spatial-relational,2|3,7,2/3,230058,2
4,1,23,59,1,1167,1,13,6,6,7,single-choice,spatial-relational,6|7,7,6/7,230059,6
4,1,23,60,1,1409,1,3,1,1,2,single-choice,spatial-relational,1|2,7,1/2,230060,1
4,1,23,61,1,773,1,3,1,1,2,single-choice,spatial-relational,1|2,7,1/2,230061,1
4,1,23,62,1,785,1,7,3,3,4,single-choice,spatial-relational,3|4,7,3/4,230062,3
4,1,23,63,1,1031,1,7,3,3,4,single-choice,spatial-relational,3|4,7,3/4,230063,3
4,1,23,64,1,1446,1,9,4,4,5,single-choice,spatial-relational,4|5,7,4/5,230064,4
4,1,23,65,1,809,1,3,1,1,2,single-choice,spatial-relational,1|2,7,1/2,230065,1
4,1,23,66,1,877,1,5,2,2,3,single-choice,spatial-relational,2|3,7,2/3,230066,2
4,1,23,67,1,881,1,13,6,6,7,single-choice,spatial-relational,6|7,7,6/7,230067,6
4,1,23,68,1,1188,1,5,2,2,3,single-choice,spatial-relational,2|3,7,2/3,230068,2
4,1,23,69,1,978,1,11,5,5,6,single-choice,spatial-relational,5|6,7,5/6,230069,5
4,1,23,70,1,1562,1,9,4,4,5,single-choice,spatial-relational,4|5,7,4/5,230070,4
4,1,23,71,1,1426,1,13,6,6,7,single-choice,spatial-relational,6|7,7,6/7,230071,6
4,1,23,72,1,1266,1,11,5,5,6,single-choice,spatial-relational,5|6,7,5/6,230072,5
4,1,23,73,1,888,1,7,3,3,4,single-choice,spatial-relational,3|4,7,3/4,230073,3
4,1,23,74,0,1270,1,7,3,4,4,single-choice,spatial-relational,3|4,7,3/4,230074,3
4,1,23,75,1,1331,1,5,2,2,3,single-choice,spatial-relational,2|3,7,2/3,230075,2
4,1,23,76,1,861,1,3,1,1,2,single-choice,spatial-relational,1|2,7,1/2,230076,1
4,1,23,77,1,958,1,11,5,5,6,single-choice,spatial-relational,5|6,7,5/6,230077,5
4,1,23,78,1,956,1,5,2,2,3,single-choice,spatial-relational,2|3,7,2/3,230078,2
4,1,23,79,1,861,1,11,5,5,6,single-choice,spatial-relational,5|6,7,5/6,230079,5
4,1,23,80,0,944,1,3,1,2,2,single-choice,spatial-relational,1|2,7,1/2,230080,1
4,1,23,81,1,816,1,13,6,6,7,single-choice,spatial-relational,6|7,7,6/7,230081,6
4,1,23,82,1,1315,1,13,6,6,7,single-choice,spatial-relational,6|7,7,6/7,230082,6
4,1,23,83,0,1239,1,9,4,5,5,single-choice,spatial-relational,4|5,7,4/5,230083,4
4,1,23,84,0,1118,1,9,4,5,5,single-choice,spatial-relational,4|5,7,4/5,230084,4
4,1,23,85,1,1087,1,9,4,4,5,single-choice,spatial-relational,4|5,7,4/5,230085,4
4,1,23,86,1,1058,1,11,5,5,6,single-choice,spatial-relational,5|6,7,5/6,230086,5
4,1,23,87,0,1605,1,11,5,6,6,single-choice,spatial-relational,5|6,7,5/6,230087,5
4,1,23,88,0,901,1,13,6,7,7,single-choice,spatial-relational,6|7,7,6/7,230088,6
4,1,23,89,1,1057,1,3,1,1,2,single-choice,spatial-relational,1|2,7,1/2,230089,1
4,1,23,90,0,963,1,9,4,5,5,single-choice,spatial-relational,4|5,7,4/5,230090,4
4,1,23,91,1,865,1,7,3,3,4,single-choice,spatial-relational,3|4,7,3/4,230091,3
4,1,23,92,1,924,1,7,3,3,4,single-choice,spatial-relational,3|4,7,3/4,230092,3
4,1,23,93,1,693,1,5,2,2,3,single-choice,spatial-relational,2|3,7,2/3,230093,2
4,1,23,94,1,938,1,5,2,2,3,single-choice,spatial-relational,2|3,7,2/3,230094,2
4,1,23,95,1,1217,1,3,1,1,2,single-choice,spatial-relational,1|2,7,1/2,230095,1
4,1,23,96,1,954,1,13,6,6,7,single-choice,spatial-relational,6|7,7,6/7,230096,6
4,1,23,97,1,1315,1,13,6,6,7,single-choice,spatial-relational,6|7,7,6/7,230097,6
4,1,23,98,1,1354,1,11,5,5,6,single-choice,spatial-relational,5|6,7,5/6,230098,5
4,1,23,99,1,1200,1,3,1,1,2,single-choice,spatial-relational,1|2,7,1/2,230099,1
4,1,23,100,1,867,1,5,2,2,3,single-choice,spatial-relational,2|3,7,2/3,230100,2
4,1,23,101,1,891,1,7,3,3,4,single-choice,spatial-relational,3|4,7,3/4,230101,3
4,1,23,102,1,1252,1,11,5,5,6,single-choice,spatial-relational,5|6,7,5/6,230102,5
4,1,23,103,1,1149,1,9,4,4,5,single-choice,spatial-relational,4|5,7,4/5,230103,4
4,1,23,104,0,1388,1,7,3,4,4,single-choice,spatial-relational,3|4,7,3/4,230104,3
4,1,23,105,0,1274,1,9,4,5,5,single-choice,spatial-relational,4|5,7,4/5,230105,4
4,1,23,106,1,1042,1,3,1,1,2,single-choice,spatial-relational,1|2,7,1/2,230106,1
4,1,23,107,1,807,1,5,2,2,3,single-choice,spatial-relational,2|3,7,2/3,230107,2
4,1,23,108,1,1265,1,13,6,6,7,single-choice,spatial-relational,6|7,7,6/7,230108,6
4,1,23,109,0,1376,1,11,5,6,6,single-choice,spatial-relational,5|6,7,5/6,230109,5
4,1,23,110,0,881,1,3,1,2,2,single-choice,spatial-relational,1|2,7,1/2,230110,1
4,1,23,111,1,945,1,3,1,1,2,single-choice,spatial-relational,1|2,7,1/2,230111,1
4,1,23,112,1,757,1,5,2,2,3,single-choice,spatial-relational,2|3,7,2/3,230112,2
4,1,23,113,0,1105,1,11,5,6,6,single-choice,spatial-relational,5|6,7,5/6,230113,5
4,1,23,114,1,824,1,7,3,3,4,single-choice,spatial-relational,3|4,7,3/4,230114,3
4,1,23,115,0,1273,1,9,4,5,5,single-choice,spatial-relational,4|5,7,4/5,230115,4
4,1,23,116,1,1181,1,7,3,3,4,single-choice,spatial-relational,3|4,7,3/4,230116,3
4,1,23,117,1,1129,1,13,6,6,7,single-choice,spatial-relational,6|7,7,6/7,230117,6
4,1,23,118,0,1324,1,9,4,5,5,single-choice,spatial-relational,4|5,7,4/5,230118,4
4,1,23,119,1,1255,1,13,6,6,7,single-choice,spatial-relational,6|7,7,6/7,230119,6
4,1,23,120,1,1085,1,5,2,2,3,single-choice,spatial-relational,2|3,7,2/3,230120,2
4,1,23,121,0,1022,1,3,1,2,2,single-choice,spatial-relational,1|2,7,1/2,230121,1
4,1,23,122,0,1204,1,7,3,4,4,single-choice,spatial-relational,3|4,7,3/4,230122,3
4,1,23,123,1,1046,1,7,3,3,4,single-choice,spatial-relational,3|4,7,3/4,230123,3
4,1,23,124,0,1048,1,13,6,7,7,single-choice,spatial-relational,6|7,7,6/7,230124,6
4,1,23,125,1,940,1,9,4,4,5,single-choice,spatial-relational,4|5,7,4/5,230125,4
4,1,23,126,0,1591,1,9,4,5,5,single-choice,spatial-relational,4|5,7,4/5,230126,4
4,1,23,127,1,1163,1,13,6,6,7,single-choice,spatial-relational,6|7,7,6/7,230127,6
4,1,23,128,1,1415,1,11,5,5,6,single-choice,spatial-relational,5|6,7,5/6,230128,5
4,1,23,129,0,1723,1,5,2,3,3,single-choice,spatial-relational,2|3,7,2/3,230129,2
4,1,23,130,0,928,1,3,1,2,2,single-choice,spatial-relational,1|2,7,1/2,230130,1
4,1,23,131,1,70,1,5,2,2,3,single-choice,spatial-relational,2|3,7,2/3,230131,2
4,1,23,132,0,1549,1,11,5,6,6,single-choice,spatial-relational,5|6,7,5/6,230132,5
4,1,23,133,0,889,1,3,1,2,2,single-choice,spatial-relational,1|2,7,1/2,230133,1
4,1,23,134,0,121,1,13,6,7,7,single-choice,spatial-relational,6|7,7,6/7,230134,6
4,1,23,135,1,1376,1,13,6,6,7,single-choice,spatial-relational,6|7,7,6/7,230135,6
4,1,23,136,1,757,1,5,2,2,3,single-choice,spatial-relational,2|3,7,2/3,230136,2
4,1,23,137,0,1270,1,7,3,4,4,single-choice,spatial-relational,3|4,7,3/4,230137,3
4,1,23,138,1,1270,1,11,5,5,6,single-choice,spatial-relational,5|6,7,5/6,230138,5
4,1,23,139,0,917,1,7,3,4,4,single-choice,spatial-relational,3|4,7,3/4,230139,3
4,1,23,140,1,955,1,5,2,2,3,single-choice,spatial-relational,2|3,7,2/3,230140,2
4,1,23,141,0,1687,1,11,5,6,6,single-choice,spatial-relational,5|6,7,5/6,230141,5
4,1,23,142,1,1027,1,9,4,4,5,single-choice,spatial-relational,4|5,7,4/5,230142,4
4,1,23,143,1,881,1,3,1,1,2,single-choice,spatial-relational,1|2,7,1/2,230143,1
4,1,23,144,0,812,1,9,4,5,5,single-choice,spatial-relational,4|5,7,4/5,230144,4
4,1,23,145,1,948,1,5,2,2,3,single-choice,spatial-relational,2|3,7,2/3,230145,2
4,1,23,146,1,982,1,13,6,6,7,single-choice,spatial-relational,6|7,7,6/7,230146,6
4,1,23,147,1,1503,1,7,3,3,4,single-choice,spatial-relational,3|4,7,3/4,230147,3
4,1,23,148,1,880,1,3,1,1,2,single-choice,spatial-relational,1|2,7,1/2,230148,1
4,1,23,149,0,907,1,7,3,4,4,single-choice,spatial-relational,3|4,7,3/4,230149,3
4,1,23,150,1,1502,1,9,4,4,5,single-choice,spatial-relational,4|5,7,4/5,230150,4
4,1,23,151,0,1321,1,11,5,6,6,single-choice,spatial-relational,5|6,7,5/6,230151,5
4,1,23,152,0,1175,1,11,5,6,6,single-choice,spatial-relational,5|6,7,5/6,230152,5
4,1,23,153,1,1054,1,9,4,4,5,single-choice,spatial-relational,4|5,7,4/5,230153,4
4,1,23,154,1,987,1,5,2,2,3,single-choice,spatial-relational,2|3,7,2/3,230154,2
4,1,23,155,1,668,1,3,1,1,2,single-choice,spatial-relational,1|2,7,1/2,230155,1
4,1,23,156,1,1368,1,13,6,6,7,single-choice,spatial-relational,6|7,7,6/7,230156,6
4,1,23,157,1,1232,1,3,1,1,2,single-choice,spatial-relational,1|2,7,1/2,230157,1
4,1,23,158,1,894,1,13,6,6,7,single-choice,spatial-relational,6|7,7,6/7,230158,6
4,1,23,159,1,2131,1,11,5,5,6,single-choice,spatial-relational,5|6,7,5/6,230159,5
4,1,23,160,1,1395,1,13,6,6,7,single-choice,spatial-relational,6|7,7,6/7,230160,6
4,1,23,161,0,994,1,3,1,2,2,single-choice,spatial-relational,1|2,7,1/2,230161,1
4,1,23,162,0,1273,1,9,4,5,5,single-choice,spatial-relational,4|5,7,4/5,230162,4
4,1,23,163,1,1684,1,11,5,5,6,single-choice,spatial-relational,5|6,7,5/6,230163,5
4,1,23,164,1,1061,1,9,4,4,5,single-choice,spatial-relational,4|5,7,4/5,230164,4
4,1,23,165,1,1522,1,7,3,3,4,single-choice,spatial-relational,3|4,7,3/4,230165,3
4,1,23,166,1,717,1,5,2,2,3,single-choice,spatial-relational,2|3,7,2/3,230166,2
4,1,23,167,1,1246,1,7,3,3,4,single-choice,spatial-relational,3|4,7,3/4,230167,3
4,1,23,168,1,886,1,5,2,2,3,single-choice,spatial-relational,2|3,7,2/3,230168,2
4,1,23,169,1,669,1,3,1,1,2,single-choice,spatial-relational,1|2,7,1/2,230169,1
4,1,23,170,0,934,1,11,5,6,6,single-choice,spatial-relational,5|6,7,5/6,230170,5
4,1,23,171,1,1239,1,11,5,5,6,single-choice,spatial-relational,5|6,7,5/6,230171,5
4,1,23,172,1,1286,1,13,6,6,7,single-choice,spatial-relational,6|7,7,6/7,230172,6
4,1,23,173,1,1549,1,9,4,4,5,single-choice,spatial-relational,4|5,7,4/5,230173,4
4,1,23,174,0,1205,1,13,6,7,7,single-choice,spatial-relational,6|7,7,6/7,230174,6
4,1,23,175,0,904,1,3,1,2,2,single-choice,spatial-relational,1|2,7,1/2,230175,1
4,1,23,176,0,1444,1,7,3,4,4,single-choice,spatial-relational,3|4,7,3/4,230176,3
4,1,23,177,1,1185,1,9,4,4,5,single-choice,spatial-relational,4|5,7,4/5,230177,4
4,1,23,178,1,980,1,5,2,2,3,single-choice,spatial-relational,2|3,7,2/3,230178,2
4,1,23,179,1,1139,1,7,3,3,4,single-choice,spatial-relational,3|4,7,3/4,230179,3
4,1,23,180,1,721,1,5,2,2,3,single-choice,spatial-relational,2|3,7,2/3,230180,2
4,1,23,181,1,1112,1,7,3,3,4,single-choice,spatial-relational,3|4,7,3/4,230181,3
4,1,23,182,1,893,1,3,1,1,2,single-choice,spatial-relational,1|2,7,1/2,230182,1
4,1,23,183,1,827,1,11,5,5,6,single-choice,spatial-relational,5|6,7,5/6,230183,5
4,1,23,184,1,1065,1,13,6,6,7,single-choice,spatial-relational,6|7,7,6/7,230184,6
4,1,23,185,1,1000,1,3,1,1,2,single-choice,spatial-relational,1|2,7,1/2,230185,1
4,1,23,186,0,1939,1,11,5,6,6,single-choice,spatial-relational,5|6,7,5/6,230186,5
4,1,23,187,1,1227,1,13,6,6,7,single-choice,spatial-relational,6|7,7,6/7,230187,6
4,1,23,188,1,1425,1,9,4,4,5,single-choice,spatial-relational,4|5,7,4/5,230188,4
4,1,23,189,1,776,1,5,2,2,3,single-choice,spatial-relational,2|3,7,2/3,230189,2
4,1,23,190,0,1020,1,7,3,4,4,single-choice,spatial-relational,3|4,7,3/4,230190,3
4,1,23,191,1,969,1,5,2,2,3,single-choice,spatial-relational,2|3,7,2/3,230191,2
4,1,23,192,1,1030,1,9,4,4,5,single-choice,spatial-relational,4|5,7,4/5,230192,4
4,1,23,193,0,1379,1,7,3,4,4,single-choice,spatial-relational,3|4,7,3/4,230193,3
4,1,23,194,1,1355,1,11,5,5,6,single-choice,spatial-relational,5|6,7,5/6,230194,5
4,1,23,195,1,1881,1,9,4,4,5,single-choice,spatial-relational,4|5,7,4/5,230195,4
4,1,23,196,1,771,1,3,1,1,2,single-choice,spatial-relational,1|2,7,1/2,230196,1
4,1,23,197,1,958,1,13,6,6,7,single-choice,spatial-relational,6|7,7,6/7,230197,6
4,1,23,198,0,1432,1,7,3,4,4,single-choice,spatial-relational,3|4,7,3/4,230198,3
4,1,23,199,1,1242,1,13,6,6,7,single-choice,spatial-relational,6|7,7,6/7,230199,6
4,1,23,200,1,802,1,5,2,2,3,single-choice,spatial-relational,2|3,7,2/3,230200,2
4,1,23,201,1,902,1,11,5,5,6,single-choice,spatial-relational,5|6,7,5/6,230201,5
4,1,23,202,0,792,1,3,1,2,2,single-choice,spatial-relational,1|2,7,1/2,230202,1
4,1,23,203,1,942,1,5,2,2,3,single-choice,spatial-relational,2|3,7,2/3,230203,2
4,1,23,204,0,1034,1,9,4,5,5,single-choice,spatial-relational,4|5,7,4/5,230204,4
4,1,23,205,1,921,1,5,2,2,3,single-choice,spatial-relational,2|3,7,2/3,230205,2
4,1,23,206,1,944,1,11,5,5,6,single-choice,spatial-relational,5|6,7,5/6,230206,5
4,1,23,207,1,1196,1,3,1,1,2,single-choice,spatial-relational,1|2,7,1/2,230207,1
4,1,23,208,1,1220,1,11,5,5,6,single-choice,spatial-relational,5|6,7,5/6,230208,5
4,1,23,209,0,1011,1,9,4,5,5,single-choice,spatial-relational,4|5,7,4/5,230209,4
4,1,23,210,1,1018,1,13,6,6,7,single-choice,spatial-relational,6|7,7,6/7,230210,6
4,1,23,211,1,976,1,7,3,3,4,single-choice,spatial-relational,3|4,7,3/4,230211,3
4,1,23,212,1,746,1,5,2,2,3,single-choice,spatial-relational,2|3,7,2/3,230212,2
4,1,23,213,1,920,1,3,1,1,2,single-choice,spatial-relational,1|2,7,1/2,230213,1
4,1,23,214,1,956,1,13,6,6,7,single-choice,spatial-relational,6|7,7,6/7,230214,6
4,1,23,215,0,948,1,7,3,4,4,single-choice,spatial-relational,3|4,7,3/4,230215,3
4,1,23,216,1,72,1,9,4,4,5,single-choice,spatial-relational,4|5,7,4/5,230216,4
4,1,23,217,0,1042,1,3,1,2,2,single-choice,spatial-relational,1|2,7,1/2,230217,1
4,1,23,218,1,1355,1,11,5,5,6,single-choice,spatial-relational,5|6,7,5/6,230218,5
4,1,23,219,1,1146,1,5,2,2,3,single-choice,spatial-relational,2|3,7,2/3,230219,2
4,1,23,220,1,1104,1,11,5,5,6,single-choice,spatial-relational,5|6,7,5/6,230220,5
4,1,23,221,1,1323,1,9,4,4,5,single-choice,spatial-relational,4|5,7,4/5,230221,4
4,1,23,222,1,1120,1,13,6,6,7,single-choice,spatial-relational,6|7,7,6/7,230222,6
4,1,23,223,0,1100,1,5,2,3,3,single-choice,spatial-relational,2|3,7,2/3,230223,2
4,1,23,224,1,1746,1,7,3,3,4,single-choice,spatial-relational,3|4,7,3/4,230224,3
4,1,23,225,1,959,1,9,4,4,5,single-choice,spatial-relational,4|5,7,4/5,230225,4
4,1,23,226,0,1346,1,7,3,4,4,single-choice,spatial-relational,3|4,7,3/4,230226,3
4,1,23,227,1,859,1,13,6,6,7,single-choice,spatial-relational,6|7,7,6/7,230227,6
4,1,23,228,1,844,1,3,1,1,2,single-choice,spatial-relational,1|2,7,1/2,230228,1
4,1,23,229,0,1058,1,3,1,2,2,single-choice,spatial-relational,1|2,7,1/2,230229,1
4,1,23,230,1,907,1,13,6,6,7,single-choice,spatial-relational,6|7,7,6/7,230230,6
4,1,23,231,1,1032,1,5,2,2,3,single-choice,spatial-relational,2|3,7,2/3,230231,2
4,1,23,232,1,1272,1,7,3,3,4,single-choice,spatial-relational,3|4,7,3/4,230232,3
4,1,23,233,1,1177,1,11,5,5,6,single-choice,spatial-relational,5|6,7,5/6,230233,5
4,1,23,234,1,1577,1,9,4,4,5,single-choice,spatial-relational,4|5,7,4/5,230234,4
4,1,23,235,1,1216,1,9,4,4,5,single-choice,spatial-relational,4|5,7,4/5,230235,4
4,1,23,236,1,806,1,3,1,1,2,single-choice,spatial-relational,1|2,7,1/2,230236,1
4,1,23,237,1,1069,1,11,5,5,6,single-choice,spatial-relational,5|6,7,5/6,230237,5
4,1,23,238,1,1087,1,5,2,2,3,single-choice,spatial-relational,2|3,7,2/3,230238,2
4,1,23,239,0,1089,1,13,6,7,7,single-choice,spatial-relational,6|7,7,6/7,230239,6
4,1,23,240,0,1086,1,7,3,4,4,single-choice,spatial-relational,3|4,7,3/4,230240,3
4,1,23,241,0,983,1,3,1,2,2,single-choice,spatial-relational,1|2,7,1/2,230241,1
4,1,23,242,1,943,1,13,6,6,7,single-choice,spatial-relational,6|7,7,6/7,230242,6
4,1,23,243,1,1239,1,11,5,5,6,single-choice,spatial-relational,5|6,7,5/6,230243,5
4,1,23,244,1,1827,1,9,4,4,5,single-choice,spatial-relational,4|5,7,4/5,230244,4
4,1,23,245,1,1450,1,11,5,5,6,single-choice,spatial-relational,5|6,7,5/6,230245,5
4,1,23,246,1,858,1,5,2,2,3,single-choice,spatial-relational,2|3,7,2/3,230246,2
4,1,23,247,1,673,1,7,3,3,4,single-choice,spatial-relational,3|4,7,3/4,230247,3
4,1,23,248,1,887,1,5,2,2,3,single-choice,spatial-relational,2|3,7,2/3,230248,2
4,1,23,249,0,1147,1,3,1,2,2,single-choice,spatial-relational,1|2,7,1/2,230249,1
4,1,23,250,1,1179,1,7,3,3,4,single-choice,spatial-relational,3|4,7,3/4,230250,3
4,1,23,251,1,1309,1,13,6,6,7,single-choice,spatial-relational,6|7,7,6/7,230251,6
4,1,23,252,0,1096,1,9,4,5,5,single-choice,spatial-relational,4|5,7,4/5,230252,4
4,1,23,253,1,1265,1,13,6,6,7,single-choice,spatial-relational,6|7,7,6/7,230253,6
4,1,23,254,1,1108,1,13,6,6,7,single-choice,spatial-relational,6|7,7,6/7,230254,6
4,1,23,255,0,1270,1,7,3,4,4,single-choice,spatial-relational,3|4,7,3/4,230255,3
4,1,23,256,0,839,1,3,1,2,2,single-choice,spatial-relational,1|2,7,1/2,230256,1
4,1,23,257,1,1044,1,9,4,4,5,single-choice,spatial-relational,4|5,7,4/5,230257,4
4,1,23,258,1,997,1,5,2,2,3,single-choice,spatial-relational,2|3,7,2/3,230258,2
4,1,23,259,1,722,1,5,2,2,3,single-choice,spatial-relational,2|3,7,2/3,230259,2
4,1,23,260,1,752,1,3,1,1,2,single-choice,spatial-relational,1|2,7,1/2,230260,1
4,1,23,261,1,760,1,11,5,5,6,single-choice,spatial-relational,5|6,7,5/6,230261,5
4,1,23,262,0,1531,1,9,4,5,5,single-choice,spatial-relational,4|5,7,4/5,230262,4
4,1,23,263,1,1252,1,11,5,5,6,single-choice,spatial-relational,5|6,7,5/6,230263,5
4,1,23,264,1,954,1,7,3,3,4,single-choice,spatial-relational,3|4,7,3/4,230264,3
4,1,23,265,1,1051,1,11,5,5,6,single-choice,spatial-relational,5|6,7,5/6,230265,5
4,1,23,266,1,752,1,3,1,1,2,single-choice,spatial-relational,1|2,7,1/2,230266,1
4,1,23,267,1,927,1,13,6,6,7,single-choice,spatial-relational,6|7,7,6/7,230267,6
4,1,23,268,0,1403,1,7,3,4,4,single-choice,spatial-relational,3|4,7,3/4,230268,3
4,1,23,269,1,1140,1,3,1,1,2,single-choice,spatial-relational,1|2,7,1/2,230269,1
4,1,23,270,0,861,1,7,3,4,4,single-choice,spatial-relational,3|4,7,3/4,230270,3
4,1,23,271,1,1063,1,5,2,2,3,single-choice,spatial-relational,2|3,7,2/3,230271,2
4,1,23,272,1,1474,1,13,6,6,7,single-choice,spatial-relational,6|7,7,6/7,230272,6
4,1,23,273,0,1560,1,9,4,5,5,single-choice,spatial-relational,4|5,7,4/5,230273,4
4,1,23,274,1,1148,1,9,4,4,5,single-choice,spatial-relational,4|5,7,4/5,230274,4
4,1,23,275,1,1158,1,5,2,2,3,single-choice,spatial-relational,2|3,7,2/3,230275,2
4,1,23,276,0,1548,1,11,5,6,6,single-choice,spatial-relational,5|6,7,5/6,230276,5
4,1,23,277,1,983,1,9,4,4,5,single-choice,spatial-relational,4|5,7,4/5,230277,4
4,1,23,278,1,989,1,7,3,3,4,single-choice,spatial-relational,3|4,7,3/4,230278,3
4,1,23,279,1,855,1,5,2,2,3,single-choice,spatial-relational,2|3,7,2/3,230279,2
4,1,23,280,1,706,1,5,2,2,3,single-choice,spatial-relational,2|3,7,2/3,230280,2
4,1,23,281,0,714,1,3,1,2,2,single-choice,spatial-relational,1|2,7,1/2,230281,1
4,1,23,282,1,89,1,13,6,6,7,single-choice,spatial-relational,6|7,7,6/7,230282,6
4,1,23,283,0,1100,1,7,3,4,4,single-choice,spatial-relational,3|4,7,3/4,230283,3
4,1,23,284,1,1016,1,13,6,6,7,single-choice,spatial-relational,6|7,7,6/7,230284,6
4,1,23,285,0,1310,1,11,5,6,6,single-choice,spatial-relational,5|6,7,5/6,230285,5
4,1,23,286,1,1039,1,11,5,5,6,single-choice,spatial-relational,5|6,7,5/6,230286,5
4,1,23,287,1,778,1,3,1,1,2,single-choice,spatial-relational,1|2,7,1/2,230287,1
4,1,23,288,0,1260,1,9,4,5,5,single-choice,spatial-relational,4|5,7,4/5,230288,4
4,1,23,289,1,1031,1,13,6,6,7,single-choice,spatial-relational,6|7,7,6/7,230289,6
4,1,23,290,1,1745,1,7,3,3,4,single-choice,spatial-relational,3|4,7,3/4,230290,3
4,1,23,291,1,1182,1,9,4,4,5,single-choice,spatial-relational,4|5,7,4/5,230291,4
4,1,23,292,1,1181,1,11,5,5,6,single-choice,spatial-relational,5|6,7,5/6,230292,5
4,1,23,293,0,1368,1,7,3,4,4,single-choice,spatial-relational,3|4,7,3/4,230293,3
4,1,23,294,0,1108,1,9,4,5,5,single-choice,spatial-relational,4|5,7,4/5,230294,4
4,1,23,295,0,834,1,3,1,2,2,single-choice,spatial-relational,1|2,7,1/2,230295,1
4,1,23,296,1,1444,1,11,5,5,6,single-choice,spatial-relational,5|6,7,5/6,230296,5
4,1,23,297,1,1014,1,5,2,2,3,single-choice,spatial-relational,2|3,7,2/3,230297,2
4,1,23,298,1,706,1,3,1,1,2,single-choice,spatial-relational,1|2,7,1/2,230298,1
4,1,23,299,1,1130,1,5,2,2,3,single-choice,spatial-relational,2|3,7,2/3,230299,2
4,1,23,300,0,1041,1,13,6,7,7,single-choice,spatial-relational,6|7,7,6/7,230300,6
4,1,23,301,1,1355,1,11,5,5,6,single-choice,spatial-relational,5|6,7,5/6,230301,5
4,1,23,302,1,876,1,13,6,6,7,single-choice,spatial-relational,6|7,7,6/7,230302,6
4,1,23,303,1,1321,1,5,2,2,3,single-choice,spatial-relational,2|3,7,2/3,230303,2
4,1,23,304,1,801,1,5,2,2,3,single-choice,spatial-relational,2|3,7,2/3,230304,2
4,1,23,305,1,923,1,9,4,4,5,single-choice,spatial-relational,4|5,7,4/5,230305,4
4,1,23,306,1,999,1,3,1,1,2,single-choice,spatial-relational,1|2,7,1/2,230306,1
4,1,23,307,1,830,1,7,3,3,4,single-choice,spatial-relational,3|4,7,3/4,230307,3
4,1,23,308,1,1315,1,11,5,5,6,single-choice,spatial-relational,5|6,7,5/6,230308,5
4,1,23,309,1,1344,1,13,6,6,7,single-choice,spatial-relational,6|7,7,6/7,230309,6
4,1,23,310,0,879,1,3,1,2,2,single-choice,spatial-relational,1|2,7,1/2,230310,1
4,1,23,311,1,1771,1,7,3,3,4,single-choice,spatial-relational,3|4,7,3/4,230311,3
4,1,23,312,1,1125,1,9,4,4,5,single-choice,spatial-relational,4|5,7,4/5,230312,4
4,1,23,313,1,1441,1,9,4,4,5,single-choice,spatial-relational,4|5,7,4/5,230313,4
4,1,23,314,0,966,1,9,4,5,5,single-choice,spatial-relational,4|5,7,4/5,230314,4
4,1,23,315,1,1070,1,11,5,5,6,single-choice,spatial-relational,5|6,7,5/6,230315,5
4,1,23,316,1,1209,1,3,1,1,2,single-choice,spatial-relational,1|2,7,1/2,230316,1
4,1,23,317,1,1131,1,7,3,3,4,single-choice,spatial-relational,3|4,7,3/4,230317,3
4,1,23,318,1,1007,1,13,6,6,7,single-choice,spatial-relational,6|7,7,6/7,230318,6
4,1,23,319,1,1281,1,5,2,2,3,single-choice,spatial-relational,2|3,7,2/3,230319,2
4,1,23,320,1,882,1,13,6,6,7,single-choice,spatial-relational,6|7,7,6/7,230320,6
4,1,23,321,0,1107,1,3,1,2,2,single-choice,spatial-relational,1|2,7,1/2,230321,1
4,1,23,322,0,1421,1,11,5,6,6,single-choice,spatial-relational,5|6,7,5/6,230322,5
4,1,23,323,1,830,1,7,3,3,4,single-choice,spatial-relational,3|4,7,3/4,230323,3
4,1,23,324,1,901,1,5,2,2,3,single-choice,spatial-relational,2|3,7,2/3,230324,2
4,1,23,325,1,1040,1,13,6,6,7,single-choice,spatial-relational,6|7,7,6/7,230325,6
4,1,23,326,0,1407,1,11,5,6,6,single-choice,spatial-relational,5|6,7,5/6,230326,5
4,1,23,327,0,932,1,3,1,2,2,single-choice,spatial-relational,1|2,7,1/2,230327,1
4,1,23,328,1,1006,1,5,2,2,3,single-choice,spatial-relational,2|3,7,2/3,230328,2
4,1,23,329,1,1103,1,9,4,4,5,single-choice,spatial-relational,4|5,7,4/5,230329,4
4,1,23,330,1,1033,1,5,2,2,3,single-choice,spatial-relational,2|3,7,2/3,230330,2
4,1,23,331,1,924,1,9,4,4,5,single-choice,spatial-relational,4|5,7,4/5,230331,4
4,1,23,332,1,1217,1,11,5,5,6,single-choice,spatial-relational,5|6,7,5/6,230332,5
4,1,23,333,0,1700,1,7,3,4,4,single-choice,spatial-relational,3|4,7,3/4,230333,3
4,1,23,334,0,1459,1,3,1,2,2,single-choice,spatial-relational,1|2,7,1/2,230334,1
4,1,23,335,1,1498,1,13,6,6,7,single-choice,spatial-relational,6|7,7,6/7,230335,6
4,1,23,336,0,1580,1,7,3,4,4,single-choice,spatial-relational,3|4,7,3/4,230336,3
4,1,23,337,0,77,1,13,6,7,7,single-choice,spatial-relational,6|7,7,6/7,230337,6
4,1,23,338,1,1002,1,7,3,3,4,single-choice,spatial-relational,3|4,7,3/4,230338,3
4,1,23,339,0,1274,1,11,5,6,6,single-choice,spatial-relational,5|6,7,5/6,230339,5
4,1,23,340,1,903,1,5,2,2,3,single-choice,spatial-relational,2|3,7,2/3,230340,2
4,1,23,341,1,780,1,5,2,2,3,single-choice,spatial-relational,2|3,7,2/3,230341,2
4,1,23,342,0,753,1,3,1,2,2,single-choice,spatial-relational,1|2,7,1/2,230342,1
4,1,23,343,1,1093,1,3,1,1,2,single-choice,spatial-relational,1|2,7,1/2,230343,1
4,1,23,344,1,1023,1,9,4,4,5,single-choice,spatial-relational,4|5,7,4/5,230344,4
4,1,23,345,1,1352,1,7,3,3,4,single-choice,spatial-relational,3|4,7,3/4,230345,3
4,1,23,346,1,1247,1,13,6,6,7,single-choice,spatial-relational,6|7,7,6/7,230346,6
4,1,23,347,1,1127,1,9,4,4,5,single-choice,spatial-relational,4|5,7,4/5,230347,4
4,1,23,348,1,1005,1,11,5,5,6,single-choice,spatial-relational,5|6,7,5/6,230348,5
4,1,23,349,0,1410,1,7,3,4,4,single-choice,spatial-relational,3|4,7,3/4,230349,3
4,1,23,350,0,811,1,3,1,2,2,single-choice,spatial-relational,1|2,7,1/2,230350,1
4,1,23,351,0,1064,1,7,3,4,4,single-choice,spatial-relational,3|4,7,3/4,230351,3
4,1,23,352,1,1043,1,5,2,2,3,single-choice,spatial-relational,2|3,7,2/3,230352,2
4,1,23,353,1,859,1,13,6,6,7,single-choice,spatial-relational,6|7,7,6/7,230353,6
4,1,23,354,0,1457,1,11,5,6,6,single-choice,spatial-relational,5|6,7,5/6,230354,5
4,1,23,355,1,976,1,9,4,4,5,single-choice,spatial-relational,4|5,7,4/5,230355,4
4,1,23,356,1,1100,1,9,4,4,5,single-choice,spatial-relational,4|5,7,4/5,230356,4
4,1,23,357,1,1101,1,5,2,2,3,single-choice,spatial-relational,2|3,7,2/3,230357,2
4,1,23,358,1,1176,1,3,1,1,2,single-choice,spatial-relational,1|2,7,1/2,230358,1
4,1,23,359,1,1040,1,11,5,5,6,single-choice,spatial-relational,5|6,7,5/6,230359,5
4,1,23,360,1,1759,1,13,6,6,7,single-choice,spatial-relational,6|7,7,6/7,230360,6
4,1,23,361,1,788,1,5,2,2,3,single-choice,spatial-relational,2|3,7,2/3,230361,2
4,1,23,362,1,772,1,3,1,1,2,single-choice,spatial-relational,1|2,7,1/2,230362,1
4,1,23,363,1,813,1,13,6,6,7,single-choice,spatial-relational,6|7,7,6/7,230363,6
4,1,23,364,1,940,1,3,1,1,2,single-choice,spatial-relational,1|2,7,1/2,230364,1
4,1,23,365,1,1154,1,5,2,2,3,single-choice,spatial-relational,2|3,7,2/3,230365,2
4,1,23,366,0,1022,1,11,5,6,6,single-choice,spatial-relational,5|6,7,5/6,230366,5
4,1,23,367,1,1504,1,7,3,3,4,single-choice,spatial-relational,3|4,7,3/4,230367,3
4,1,23,368,1,1081,1,11,5,5,6,single-choice,spatial-relational,5|6,7,5/6,230368,5
4,1,23,369,0,790,1,9,4,5,5,single-choice,spatial-relational,4|5,7,4/5,230369,4
4,1,23,370,1,802,1,7,3,3,4,single-choice,spatial-relational,3|4,7,3/4,230370,3
4,1,23,371,1,993,1,13,6,6,7,single-choice,spatial-relational,6|7,7,6/7,230371,6
4,1,23,372,1,1110,1,9,4,4,5,single-choice,spatial-relational,4|5,7,4/5,230372,4
4,1,23,373,1,1345,1,7,3,3,4,single-choice,spatial-relational,3|4,7,3/4,230373,3
4,1,23,374,1,935,1,13,6,6,7,single-choice,spatial-relational,6|7,7,6/7,230374,6
4,1,23,375,0,1257,1,11,5,6,6,single-choice,spatial-relational,5|6,7,5/6,230375,5
4,1,23,376,0,1030,1,3,1,2,2,single-choice,spatial-relational,1|2,7,1/2,230376,1
4,1,23,377,1,1071,1,13,6,6,7,single-choice,spatial-relational,6|7,7,6/7,230377,6
4,1,23,378,0,1755,1,9,4,5,5,single-choice,spatial-relational,4|5,7,4/5,230378,4
4,1,23,379,0,747,1,3,1,2,2,single-choice,spatial-relational,1|2,7,1/2,230379,1
4,1,23,380,1,1025,1,11,5,5,6,single-choice,spatial-relational,5|6,7,5/6,230380,5
4,1,23,381,1,953,1,5,2,2,3,single-choice,spatial-relational,2|3,7,2/3,230381,2
4,1,23,382,1,778,1,5,2,2,3,single-choice,spatial-relational,2|3,7,2/3,230382,2
4,1,23,383,1,1079,1,7,3,3,4,single-choice,spatial-relational,3|4,7,3/4,230383,3
4,1,23,384,1,1143,1,9,4,4,5,single-choice,spatial-relational,4|5,7,4/5,230384,4
4,1,23,385,1,1382,1,3,1,1,2,single-choice,spatial-relational,1|2,7,1/2,230385,1
4,1,23,386,1,883,1,13,6,6,7,single-choice,spatial-relational,6|7,7,6/7,230386,6
4,1,23,387,1,1470,1,5,2,2,3,single-choice,spatial-relational,2|3,7,2/3,230387,2
4,1,23,388,1,1577,1,9,4,4,5,single-choice,spatial-relational,4|5,7,4/5,230388,4
4,1,23,389,1,944,1,5,2,2,3,single-choice,spatial-relational,2|3,7,2/3,230389,2
4,1,23,390,1,1084,1,9,4,4,5,single-choice,spatial-relational,4|5,7,4/5,230390,4
4,1,23,391,1,1087,1,13,6,6,7,single-choice,spatial-relational,6|7,7,6/7,230391,6
4,1,23,392,0,1282,1,7,3,4,4,single-choice,spatial-relational,3|4,7,3/4,230392,3
4,1,23,393,1,889,1,3,1,1,2,single-choice,spatial-relational,1|2,7,1/2,230393,1
4,1,23,394,0,1174,1,11,5,6,6,single-choice,spatial-relational,5|6,7,5/6,230394,5
4,1,23,395,0,931,1,11,5,6,6,single-choice,spatial-relational,5|6,7,5/6,230395,5
4,1,23,396,1,1109,1,7,3,3,4,single-choice,spatial-relational,3|4,7,3/4,230396,3
4,1,23,397,1,1071,1,3,1,1,2,single-choice,spatial-relational,1|2,7,1/2,230397,1
4,1,23,398,0,779,1,9,4,5,5,single-choice,spatial-relational,4|5,7,4/5,230398,4
4,1,23,399,1,1061,1,5,2,2,3,single-choice,spatial-relational,2|3,7,2/3,230399,2
4,1,23,400,1,1327,1,7,3,3,4,single-choice,spatial-relational,3|4,7,3/4,230400,3
4,1,23,401,1,1638,1,9,4,4,5,single-choice,spatial-relational,4|5,7,4/5,230401,4
4,1,23,402,0,800,1,3,1,2,2,single-choice,spatial-relational,1|2,7,1/2,230402,1
4,1,23,403,1,1142,1,13,6,6,7,single-choice,spatial-relational,6|7,7,6/7,230403,6
4,1,23,404,1,1332,1,11,5,5,6,single-choice,spatial-relational,5|6,7,5/6,230404,5
4,1,23,405,0,1238,1,5,2,3,3,single-choice,spatial-relational,2|3,7,2/3,230405,2
4,1,23,406,0,1173,1,11,5,6,6,single-choice,spatial-relational,5|6,7,5/6,230406,5
4,1,23,407,1,861,1,13,6,6,7,single-choice,spatial-relational,6|7,7,6/7,230407,6
4,1,23,408,1,978,1,7,3,3,4,single-choice,spatial-relational,3|4,7,3/4,230408,3
4,1,23,409,1,968,1,5,2,2,3,single-choice,spatial-relational,2|3,7,2/3,230409,2
4,1,23,410,1,686,1,3,1,1,2,single-choice,spatial-relational,1|2,7,1/2,230410,1
4,1,23,411,1,832,1,13,6,6,7,single-choice,spatial-relational,6|7,7,6/7,230411,6
4,1,23,412,1,1009,1,3,1,1,2,single-choice,spatial-relational,1|2,7,1/2,230412,1
4,1,23,413,0,787,1,9,4,5,5,single-choice,spatial-relational,4|5,7,4/5,230413,4
4,1,23,414,1,1143,1,7,3,3,4,single-choice,spatial-relational,3|4,7,3/4,230414,3
4,1,23,415,1,1199,1,9,4,4,5,single-choice,spatial-relational,4|5,7,4/5,230415,4
4,1,23,416,1,1407,1,5,2,2,3,single-choice,spatial-relational,2|3,7,2/3,230416,2
4,1,23,417,0,754,1,7,3,4,4,single-choice,spatial-relational,3|4,7,3/4,230417,3
4,1,23,418,1,1292,1,11,5,5,6,single-choice,spatial-relational,5|6,7,5/6,230418,5
4,1,23,419,1,1585,1,11,5,5,6,single-choice,spatial-relational,5|6,7,5/6,230419,5
4,1,23,420,0,789,1,13,6,7,7,single-choice,spatial-relational,6|7,7,6/7,230420,6
4,1,23,421,1,1333,1,7,3,3,4,single-choice,spatial-relational,3|4,7,3/4,230421,3
4,1,23,422,1,1044,1,11,5,5,6,single-choice,spatial-relational,5|6,7,5/6,230422,5
4,1,23,423,1,1146,1,13,6,6,7,single-choice,spatial-relational,6|7,7,6/7,230423,6
4,1,23,424,1,1097,1,13,6,6,7,single-choice,spatial-relational,6|7,7,6/7,230424,6
4,1,23,425,1,1405,1,7,3,3,4,single-choice,spatial-relational,3|4,7,3/4,230425,3
4,1,23,426,1,1205,1,9,4,4,5,single-choice,spatial-relational,4|5,7,4/5,230426,4
4,1,23,427,1,1003,1,9,4,4,5,single-choice,spatial-relational,4|5,7,4/5,230427,4
4,1,23,428,1,1189,1,3,1,1,2,single-choice,spatial-relational,1|2,7,1/2,230428,1
4,1,23,429,0,1044,1,11,5,6,6,single-choice,spatial-relational,5|6,7,5/6,230429,5
4,1,23,430,0,1348,1,5,2,3,3,single-choice,spatial-relational,2|3,7,2/3,230430,2
4,1,23,431,1,976,1,5,2,2,3,single-choice,spatial-relational,2|3,7,2/3,230431,2
4,1,23,432,1,824,1,3,1,1,2,single-choice,spatial-relational,1|2,7,1/2,230432,1
4,1,23,433,1,796,1,13,6,6,7,single-choice,spatial-relational,6|7,7,6/7,230433,6
4,1,23,434,1,1164,1,13,6,6,7,single-choice,spatial-relational,6|7,7,6/7,230434,6
4,1,23,435,0,1297,1,9,4,5,5,single-choice,spatial-relational,4|5,7,4/5,230435,4
4,1,23,436,1,960,1,5,2,2,3,single-choice,spatial-relational,2|3,7,2/3,230436,2
4,1,23,437,1,1500,1,11,5,5,6,single-choice,spatial-relational,5|6,7,5/6,230437,5
4,1,23,438,1,1318,1,5,2,2,3,single-choice,spatial-relational,2|3,7,2/3,230438,2
4,1,23,439,1,1095,1,9,4,4,5,single-choice,spatial-relational,4|5,7,4/5,230439,4
4,1,23,440,1,1061,1,11,5,5,6,single-choice,spatial-relational,5|6,7,5/6,230440,5
4,1,23,441,0,1069,1,3,1,2,2,single-choice,spatial-relational,1|2,7,1/2,230441,1
4,1,23,442,1,878,1,3,1,1,2,single-choice,spatial-relational,1|2,7,1/2,230442,1
4,1,23,443,1,1314,1,7,3,3,4,single-choice,spatial-relational,3|4,7,3/4,230443,3
4,1,23,444,1,1340,1,7,3,3,4,single-choice,spatial-relational,3|4,7,3/4,230444,3
4,1,23,445,1,1190,1,11,5,5,6,single-choice,spatial-relational,5|6,7,5/6,230445,5
4,1,23,446,1,1295,1,9,4,4,5,single-choice,spatial-relational,4|5,7,4/5,230446,4
4,1,23,447,1,836,1,7,3,3,4,single-choice,spatial-relational,3|4,7,3/4,230447,3
4,1,23,448,1,764,1,5,2,2,3,single-choice,spatial-relational,2|3,7,2/3,230448,2
4,1,23,449,1,1056,1,7,3,3,4,single-choice,spatial-relational,3|4,7,3/4,230449,3
4,1,23,450,1,910,1,3,1,1,2,single-choice,spatial-relational,1|2,7,1/2,230450,1
4,1,23,451,0,903,1,5,2,3,3,single-choice,spatial-relational,2|3,7,2/3,230451,2
4,1,23,452,1,1548,1,3,1,1,2,single-choice,spatial-relational,1|2,7,1/2,230452,1
4,1,23,453,0,900,1,11,5,6,6,single-choice,spatial-relational,5|6,7,5/6,230453,5
4,1,23,454,1,1314,1,13,6,6,7,single-choice,spatial-relational,6|7,7,6/7,230454,6
4,1,23,455,1,1049,1,9,4,4,5,single-choice,spatial-relational,4|5,7,4/5,230455,4
4,1,23,456,1,906,1,13,6,6,7,single-choice,spatial-relational,6|7,7,6/7,230456,6
4,1,23,457,1,1568,1,9,4,4,5,single-choice,spatial-relational,4|5,7,4/5,230457,4
4,1,23,458,1,1098,1,13,6,6,7,single-choice,spatial-relational,6|7,7,6/7,230458,6
4,1,23,459,1,930,1,11,5,5,6,single-choice,spatial-relational,5|6,7,5/6,230459,5
4,1,23,460,0,826,1,9,4,5,5,single-choice,spatial-relational,4|5,7,4/5,230460,4
4,1,23,461,1,1036,1,5,2,2,3,single-choice,spatial-relational,2|3,7,2/3,230461,2
4,1,23,462,1,778,1,3,1,1,2,single-choice,spatial-relational,1|2,7,1/2,230462,1
4,1,23,463,1,802,1,7,3,3,4,single-choice,spatial-relational,3|4,7,3/4,230463,3
4,1,23,464,1,954,1,3,1,1,2,single-choice,spatial-relational,1|2,7,1/2,230464,1
4,1,23,465,1,672,1,7,3,3,4,single-choice,spatial-relational,3|4,7,3/4,230465,3
4,1,23,466,1,935,1,5,2,2,3,single-choice,spatial-relational,2|3,7,2/3,230466,2
4,1,23,467,1,1113,1,11,5,5,6,single-choice,spatial-relational,5|6,7,5/6,230467,5
4,1,23,468,1,999,1,13,6,6,7,single-choice,spatial-relational,6|7,7,6/7,230468,6
4,1,23,469,0,1259,1,11,5,6,6,single-choice,spatial-relational,5|6,7,5/6,230469,5
4,1,23,470,0,1151,1,9,4,5,5,single-choice,spatial-relational,4|5,7,4/5,230470,4
4,1,23,471,1,919,1,7,3,3,4,single-choice,spatial-relational,3|4,7,3/4,230471,3
4,1,23,472,1,844,1,13,6,6,7,single-choice,spatial-relational,6|7,7,6/7,230472,6
4,1,23,473,1,1258,1,7,3,3,4,single-choice,spatial-relational,3|4,7,3/4,230473,3
4,1,23,474,0,1156,1,3,1,2,2,single-choice,spatial-relational,1|2,7,1/2,230474,1
4,1,23,475,1,1169,1,5,2,2,3,single-choice,spatial-relational,2|3,7,2/3,230475,2
4,1,23,476,1,902,1,5,2,2,3,single-choice,spatial-relational,2|3,7,2/3,230476,2
4,1,23,477,1,855,1,11,5,5,6,single-choice,spatial-relational,5|6,7,5/6,230477,5
4,1,23,478,0,1076,1,3,1,2,2,single-choice,spatial-relational,1|2,7,1/2,230478,1
4,1,23,479,1,1210,1,9,4,4,5,single-choice,spatial-relational,4|5,7,4/5,230479,4
4,1,23,480,1,1159,1,13,6,6,7,single-choice,spatial-relational,6|7,7,6/7,230480,6
4,1,23,481,0,1145,1,9,4,5,5,single-choice,spatial-relational,4|5,7,4/5,230481,4
4,1,23,482,0,1372,1,11,5,6,6,single-choice,spatial-relational,5|6,7,5/6,230482,5
4,1,23,483,1,1284,1,7,3,3,4,single-choice,spatial-relational,3|4,7,3/4,230483,3
4,1,23,484,1,892,1,3,1,1,2,single-choice,spatial-relational,1|2,7,1/2,230484,1
4,1,23,485,1,1003,1,9,4,4,5,single-choice,spatial-relational,4|5,7,4/5,230485,4
4,1,23,486,1,926,1,3,1,1,2,single-choice,spatial-relational,1|2,7,1/2,230486,1
4,1,23,487,0,1306,1,11,5,6,6,single-choice,spatial-relational,5|6,7,5/6,230487,5
4,1,23,488,1,962,1,5,2,2,3,single-choice,spatial-relational,2|3,7,2/3,230488,2
4,1,23,489,1,915,1,13,6,6,7,single-choice,spatial-relational,6|7,7,6/7,230489,6
4,1,23,490,1,830,1,7,3,3,4,single-choice,spatial-relational,3|4,7,3/4,230490,3
4,1,23,491,1,745,1,5,2,2,3,single-choice,spatial-relational,2|3,7,2/3,230491,2
4,1,23,492,0,1274,1,13,6,7,7,single-choice,spatial-relational,6|7,7,6/7,230492,6
4,1,23,493,1,1131,1,7,3,3,4,single-choice,spatial-relational,3|4,7,3/4,230493,3
4,1,23,494,1,1084,1,9,4,4,5,single-choice,spatial-relational,4|5,7,4/5,230494,4
4,1,23,495,0,1117,1,3,1,2,2,single-choice,spatial-relational,1|2,7,1/2,230495,1
4,1,23,496,1,981,1,9,4,4,5,single-choice,spatial-relational,4|5,7,4/5,230496,4
4,1,23,497,1,1160,1,11,5,5,6,single-choice,spatial-relational,5|6,7,5/6,230497,5
4,1,23,498,0,973,1,5,2,3,3,single-choice,spatial-relational,2|3,7,2/3,230498,2
4,1,23,499,0,1328,1,13,6,7,7,single-choice,spatial-relational,6|7,7,6/7,230499,6
4,1,23,500,1,1604,1,11,5,5,6,single-choice,spatial-relational,5|6,7,5/6,230500,5
4,1,23,501,1,953,1,3,1,1,2,single-choice,spatial-relational,1|2,7,1/2,230501,1
4,1,23,502,1,847,1,5,2,2,3,single-choice,spatial-relational,2|3,7,2/3,230502,2
4,1,23,503,1,875,1,13,6,6,7,single-choice,spatial-relational,6|7,7,6/7,230503,6
4,1,23,504,1,1309,1,7,3,3,4,single-choice,spatial-relational,3|4,7,3/4,230504,3
4,1,23,505,0,1083,1,7,3,4,4,single-choice,spatial-relational,3|4,7,3/4,230505,3
4,1,23,506,0,1249,1,3,1,2,2,single-choice,spatial-relational,1|2,7,1/2,230506,1
4,1,23,507,1,1252,1,5,2,2,3,single-choice,spatial-relational,2|3,7,2/3,230507,2
4,1,23,508,1,940,1,11,5,5,6,single-choice,spatial-relational,5|6,7,5/6,230508,5
4,1,23,509,1,1295,1,7,3,3,4,single-choice,spatial-relational,3|4,7,3/4,230509,3
4,1,23,510,1,1183,1,13,6,6,7,single-choice,spatial-relational,6|7,7,6/7,230510,6
4,1,23,511,0,990,1,9,4,5,5,single-choice,spatial-relational,4|5,7,4/5,230511,4
4,1,23,512,0,985,1,11,5,6,6,single-choice,spatial-relational,5|6,7,5/6,230512,5
4,1,23,513,1,1029,1,3,1,1,2,single-choice,spatial-relational,1|2,7,1/2,230513,1
4,1,23,514,0,1288,1,13,6,7,7,single-choice,spatial-relational,6|7,7,6/7,230514,6
4,1,23,515,0,1009,1,9,4,5,5,single-choice,spatial-relational,4|5,7,4/5,230515,4
4,1,23,516,1,960,1,5,2,2,3,single-choice,spatial-relational,2|3,7,2/3,230516,2
4,1,23,517,0,912,1,3,1,2,2,single-choice,spatial-relational,1|2,7,1/2,230517,1
4,1,23,518,1,830,1,7,3,3,4,single-choice,spatial-relational,3|4,7,3/4,230518,3
4,1,23,519,1,1250,1,13,6,6,7,single-choice,spatial-relational,6|7,7,6/7,230519,6
4,1,23,520,1,1041,1,5,2,2,3,single-choice,spatial-relational,2|3,7,2/3,230520,2
4,1,23,521,1,931,1,11,5,5,6,single-choice,spatial-relational,5|6,7,5/6,230521,5
4,1,23,522,0,867,1,7,3,4,4,single-choice,spatial-relational,3|4,7,3/4,230522,3
4,1,23,523,1,1404,1,11,5,5,6,single-choice,spatial-relational,5|6,7,5/6,230523,5
4,1,23,524,1,1130,1,3,1,1,2,single-choice,spatial-relational,1|2,7,1/2,230524,1
4,1,23,525,0,766,1,9,4,5,5,single-choice,spatial-relational,4|5,7,4/5,230525,4
4,1,23,526,1,1508,1,9,4,4,5,single-choice,spatial-relational,4|5,7,4/5,230526,4
4,1,23,527,1,1026,1,5,2,2,3,single-choice,spatial-relational,2|3,7,2/3,230527,2
4,1,23,528,1,917,1,13,6,6,7,single-choice,spatial-relational,6|7,7,6/7,230528,6
4,1,23,529,1,1269,1,13,6,6,7,single-choice,spatial-relational,6|7,7,6/7,230529,6
4,1,23,530,0,1139,1,11,5,6,6,single-choice,spatial-relational,5|6,7,5/6,230530,5
4,1,23,531,1,1051,1,9,4,4,5,single-choice,spatial-relational,4|5,7,4/5,230531,4
4,1,23,532,1,944,1,13,6,6,7,single-choice,spatial-relational,6|7,7,6/7,230532,6
4,1,23,533,1,955,1,3,1,1,2,single-choice,spatial-relational,1|2,7,1/2,230533,1
4,1,23,534,0,906,1,7,3,4,4,single-choice,spatial-relational,3|4,7,3/4,230534,3
4,1,23,535,1,1129,1,5,2,2,3,single-choice,spatial-relational,2|3,7,2/3,230535,2
4,1,23,536,0,1017,1,9,4,5,5,single-choice,spatial-relational,4|5,7,4/5,230536,4
4,1,23,537,1,1073,1,11,5,5,6,single-choice,spatial-relational,5|6,7,5/6,230537,5
4,1,23,538,1,909,1,5,2,2,3,single-choice,spatial-relational,2|3,7,2/3,230538,2
4,1,23,539,1,898,1,7,3,3,4,single-choice,spatial-relational,3|4,7,3/4,230539,3
4,1,23,540,0,910,1,3,1,2,2,single-choice,spatial-relational,1|2,7,1/2,230540,1
4,1,23,541,1,1241,1,9,4,4,5,single-choice,spatial-relational,4|5,7,4/5,230541,4
4,1,23,542,1,1361,1,13,6,6,7,single-choice,spatial-relational,6|7,7,6/7,230542,6
4,1,23,543,1,1121,1,5,2,2,3,single-choice,spatial-relational,2|3,7,2/3,230543,2
4,1,23,544,1,1052,1,7,3,3,4,single-choice,spatial-relational,3|4,7,3/4,230544,3
4,1,23,545,1,960,1,11,5,5,6,single-choice,spatial-relational,5|6,7,5/6,230545,5
4,1,23,546,1,872,1,13,6,6,7,single-choice,spatial-relational,6|7,7,6/7,230546,6
4,1,23,547,0,1120,1,7,3,4,4,single-choice,spatial-relational,3|4,7,3/4,230547,3
4,1,23,548,1,1037,1,11,5,5,6,single-choice,spatial-relational,5|6,7,5/6,230548,5
4,1,23,549,1,1305,1,9,4,4,5,single-choice,spatial-relational,4|5,7,4/5,230549,4
4,1,23,550,1,930,1,3,1,1,2,single-choice,spatial-relational,1|2,7,1/2,230550,1
4,1,23,551,1,847,1,5,2,2,3,single-choice,spatial-relational,2|3,7,2/3,230551,2
4,1,23,552,0,988,1,3,1,2,2,single-choice,spatial-relational,1|2,7,1/2,230552,1
4,1,23,553,1,861,1,13,6,6,7,single-choice,spatial-relational,6|7,7,6/7,230553,6
4,1,23,554,0,837,1,9,4,5,5,single-choice,spatial-relational,4|5,7,4/5,230554,4
4,1,23,555,1,825,1,7,3,3,4,single-choice,spatial-relational,3|4,7,3/4,230555,3
4,1,23,556,1,1569,1,5,2,2,3,single-choice,spatial-relational,2|3,7,2/3,230556,2
4,1,23,557,1,939,1,3,1,1,2,single-choice,spatial-relational,1|2,7,1/2,230557,1
4,1,23,558,1,1317,1,13,6,6,7,single-choice,spatial-relational,6|7,7,6/7,230558,6
4,1,23,559,0,1398,1,7,3,4,4,single-choice,spatial-relational,3|4,7,3/4,230559,3
4,1,23,560,0,1799,1,11,5,6,6,single-choice,spatial-relational,5|6,7,5/6,230560,5
4,1,23,561,1,1528,1,5,2,2,3,single-choice,spatial-relational,2|3,7,2/3,230561,2
4,1,23,562,1,1167,1,9,4,4,5,single-choice,spatial-relational,4|5,7,4/5,230562,4
4,1,23,563,0,1285,1,11,5,6,6,single-choice,spatial-relational,5|6,7,5/6,230563,5
4,1,23,564,1,830,1,3,1,1,2,single-choice,spatial-relational,1|2,7,1/2,230564,1
4,1,23,565,1,1091,1,7,3,3,4,single-choice,spatial-relational,3|4,7,3/4,230565,3
4,1,23,566,1,888,1,13,6,6,7,single-choice,spatial-relational,6|7,7,6/7,230566,6
4,1,23,567,1,1312,1,5,2,2,3,single-choice,spatial-relational,2|3,7,2/3,230567,2
4,1,23,568,1,995,1,9,4,4,5,single-choice,spatial-relational,4|5,7,4/5,230568,4
4,1,23,569,1,834,1,5,2,2,3,single-choice,spatial-relational,2|3,7,2/3,230569,2
4,1,23,570,0,1123,1,13,6,7,7,single-choice,spatial-relational,6|7,7,6/7,230570,6
4,1,23,571,0,863,1,11,5,6,6,single-choice,spatial-relational,5|6,7,5/6,230571,5
4,1,23,572,0,1098,1,11,5,6,6,single-choice,spatial-relational,5|6,7,5/6,230572,5
4,1,23,573,0,826,1,9,4,5,5,single-choice,spatial-relational,4|5,7,4/5,230573,4
4,1,23,574,1,1098,1,3,1,1,2,single-choice,spatial-relational,1|2,7,1/2,230574,1
4,1,23,575,1,1450,1,7,3,3,4,single-choice,spatial-relational,3|4,7,3/4,230575,3
4,1,23,576,1,923,1,3,1,1,2,single-choice,spatial-relational,1|2,7,1/2,230576,1
4,1,23,577,1,890,1,7,3,3,4,single-choice,spatial-relational,3|4,7,3/4,230577,3
4,1,23,578,0,1095,1,9,4,5,5,single-choice,spatial-relational,4|5,7,4/5,230578,4
4,1,23,579,1,1125,1,5,2,2,3,single-choice,spatial-relational,2|3,7,2/3,230579,2
4,1,23,580,1,1154,1,11,5,5,6,single-choice,spatial-relational,5|6,7,5/6,230580,5
4,1,23,581,0,1780,1,13,6,7,7,single-choice,spatial-relational,6|7,7,6/7,230581,6
4,1,23,582,0,821,1,7,3,4,4,single-choice,spatial-relational,3|4,7,3/4,230582,3
4,1,23,583,0,901,1,3,1,2,2,single-choice,spatial-relational,1|2,7,1/2,230583,1
4,1,23,584,1,1151,1,13,6,6,7,single-choice,spatial-relational,6|7,7,6/7,230584,6
4,1,23,585,0,1528,1,11,5,6,6,single-choice,spatial-relational,5|6,7,5/6,230585,5
4,1,23,586,1,838,1,5,2,2,3,single-choice,spatial-relational,2|3,7,2/3,230586,2
4,1,23,587,0,1120,1,3,1,2,2,single-choice,spatial-relational,1|2,7,1/2,230587,1
4,1,23,588,1,1045,1,9,4,4,5,single-choice,spatial-relational,4|5,7,4/5,230588,4
4,1,23,589,1,1278,1,13,6,6,7,single-choice,spatial-relational,6|7,7,6/7,230589,6
4,1,23,590,0,914,1,3,1,2,2,single-choice,spatial-relational,1|2,7,1/2,230590,1
4,1,23,591,1,937,1,13,6,6,7,single-choice,spatial-relational,6|7,7,6/7,230591,6
4,1,23,592,0,1413,1,9,4,5,5,single-choice,spatial-relational,4|5,7,4/5,230592,4
4,1,23,593,1,800,1,5,2,2,3,single-choice,spatial-relational,2|3,7,2/3,230593,2
4,1,23,594,1,896,1,9,4,4,5,single-choice,spatial-relational,4|5,7,4/5,230594,4
4,1,23,595,1,851,1,3,1,1,2,single-choice,spatial-relational,1|2,7,1/2,230595,1
4,1,23,596,1,1090,1,11,5,5,6,single-choice,spatial-relational,5|6,7,5/6,230596,5
4,1,23,597,1,942,1,11,5,5,6,single-choice,spatial-relational,5|6,7,5/6,230597,5
4,1,23,598,1,1177,1,5,2,2,3,single-choice,spatial-relational,2|3,7,2/3,230598,2
4,1,23,599,1,913,1,7,3,3,4,single-choice,spatial-relational,3|4,7,3/4,230599,3
4,1,23,600,1,882,1,7,3,3,4,single-choice,spatial-relational,3|4,7,3/4,230600,3
5,1,23,1,1,20,1,13,6,6,7,single-choice,spatial-relational,6|7,7,6/7,230001,6
5,1,23,2,0,731,1,3,1,2,2,single-choice,spatial-relational,1|2,7,1/2,230002,1
5,1,23,3,0,624,1,11,5,6,6,single-choice,spatial-relational,5|6,7,5/6,230003,5
5,1,23,4,0,732,1,5,2,3,3,single-choice,spatial-relational,2|3,7,2/3,230004,2
5,1,23,5,0,832,1,11,5,6,6,single-choice,spatial-relational,5|6,7,5/6,230005,5
5,1,23,6,0,794,1,3,1,2,2,single-choice,spatial-relational,1|2,7,1/2,230006,1
5,1,23,7,1,1038,1,13,6,6,7,single-choice,spatial-relational,6|7,7,6/7,230007,6
5,1,23,8,0,937,1,9,4,5,5,single-choice,spatial-relational,4|5,7,4/5,230008,4
5,1,23,9,1,732,1,9,4,4,5,single-choice,spatial-relational,4|5,7,4/5,230009,4
5,1,23,10,1,1187,1,7,3,3,4,single-choice,spatial-relational,3|4,7,3/4,230010,3
5,1,23,11,0,779,1,5,2,3,3,single-choice,spatial-relational,2|3,7,2/3,230011,2
5,1,23,12,1,786,1,7,3,3,4,single-choice,spatial-relational,3|4,7,3/4,230012,3
5,1,23,13,0,958,1,9,4,5,5,single-choice,spatial-relational,4|5,7,4/5,230013,4
5,1,23,14,1,819,1,3,1,1,2,single-choice,spatial-relational,1|2,7,1/2,230014,1
5,1,23,15,0,799,1,9,4,5,5,single-choice,spatial-relational,4|5,7,4/5,230015,4
5,1,23,16,1,991,1,5,2,2,3,single-choice,spatial-relational,2|3,7,2/3,230016,2
5,1,23,17,1,987,1,13,6,6,7,single-choice,spatial-relational,6|7,7,6/7,230017,6
5,1,23,18,0,840,1,11,5,6,6,single-choice,spatial-relational,5|6,7,5/6,230018,5
5,1,23,19,0,889,1,11,5,6,6,single-choice,spatial-relational,5|6,7,5/6,230019,5
5,1,23,20,0,843,1,7,3,4,4,single-choice,spatial-relational,3|4,7,3/4,230020,3
5,1,23,21,0,672,1,5,2,3,3,single-choice,spatial-relational,2|3,7,2/3,230021,2
5,1,23,22,0,802,1,3,1,2,2,single-choice,spatial-relational,1|2,7,1/2,230022,1
5,1,23,23,1,844,1,13,6,6,7,single-choice,spatial-relational,6|7,7,6/7,230023,6
5,1,23,24,1,1028,1,7,3,3,4,single-choice,spatial-relational,3|4,7,3/4,230024,3
5,1,23,25,0,823,1,11,5,6,6,single-choice,spatial-relational,5|6,7,5/6,230025,5
5,1,23,26,0,834,1,9,4,5,5,single-choice,spatial-relational,4|5,7,4/5,230026,4
5,1,23,27,1,853,1,13,6,6,7,single-choice,spatial-relational,6|7,7,6/7,230027,6
5,1,23,28,1,1042,1,3,1,1,2,single-choice,spatial-relational,1|2,7,1/2,230028,1
5,1,23,29,0,777,1,5,2,3,3,single-choice,spatial-relational,2|3,7,2/3,230029,2
5,1,23,30,1,884,1,7,3,3,4,single-choice,spatial-relational,3|4,7,3/4,230030,3
5,1,23,31,1,1566,1,5,2,2,3,single-choice,spatial-relational,2|3,7,2/3,230031,2
5,1,23,32,0,756,1,13,6,7,7,single-choice,spatial-relational,6|7,7,6/7,230032,6
5,1,23,33,0,962,1,7,3,4,4,single-choice,spatial-relational,3|4,7,3/4,230033,3
5,1,23,34,0,854,1,3,1,2,2,single-choice,spatial-relational,1|2,7,1/2,230034,1
5,1,23,35,0,1031,1,9,4,5,5,single-choice,spatial-relational,4|5,7,4/5,230035,4
5,1,23,36,1,1162,1,11,5,5,6,single-choice,spatial-relational,5|6,7,5/6,230036,5
5,1,23,37,1,1016,1,5,2,2,3,single-choice,spatial-relational,2|3,7,2/3,230037,2
5,1,23,38,0,692,1,3,1,2,2,single-choice,spatial-relational,1|2,7,1/2,230038,1
5,1,23,39,1,881,1,3,1,1,2,single-choice,spatial-relational,1|2,7,1/2,230039,1
5,1,23,40,0,804,1,5,2,3,3,single-choice,spatial-relational,2|3,7,2/3,230040,2
5,1,23,41,1,921,1,13,6,6,7,single-choice,spatial-relational,6|7,7,6/7,230041,6
5,1,23,42,1,1105,1,7,3,3,4,single-choice,spatial-relational,3|4,7,3/4,230042,3
5,1,23,43,0,1792,1,9,4,5,5,single-choice,spatial-relational,4|5,7,4/5,230043,4
5,1,23,44,0,927,1,11,5,6,6,single-choice,spatial-relational,5|6,7,5/6,230044,5
5,1,23,45,1,1325,1,13,6,6,7,single-choice,spatial-relational,6|7,7,6/7,230045,6
5,1,23,46,1,1642,1,9,4,4,5,single-choice,spatial-relational,4|5,7,4/5,230046,4
5,1,23,47,1,1693,1,7,3,3,4,single-choice,spatial-relational,3|4,7,3/4,230047,3
5,1,23,48,0,1227,1,11,5,6,6,single-choice,spatial-relational,5|6,7,5/6,230048,5
5,1,23,49,0,846,1,7,3,4,4,single-choice,spatial-relational,3|4,7,3/4,230049,3
5,1,23,50,0,1119,1,13,6,7,7,single-choice,spatial-relational,6|7,7,6/7,230050,6
5,1,23,51,1,852,1,7,3,3,4,single-choice,spatial-relational,3|4,7,3/4,230051,3
5,1,23,52,1,1010,1,3,1,1,2,single-choice,spatial-relational,1|2,7,1/2,230052,1
5,1,23,53,0,794,1,5,2,3,3,single-choice,spatial-relational,2|3,7,2/3,230053,2
5,1,23,54,1,1410,1,11,5,5,6,single-choice,spatial-relational,5|6,7,5/6,230054,5
5,1,23,55,1,1227,1,5,2,2,3,single-choice,spatial-relational,2|3,7,2/3,230055,2
5,1,23,56,0,943,1,9,4,5,5,single-choice,spatial-relational,4|5,7,4/5,230056,4
5,1,23,57,0,1638,1,11,5,6,6,single-choice,spatial-relational,5|6,7,5/6,230057,5
5,1,23,58,1,1040,1,13,6,6,7,single-choice,spatial-relational,6|7,7,6/7,230058,6
5,1,23,59,0,1958,1,9,4,5,5,single-choice,spatial-relational,4|5,7,4/5,230059,4
5,1,23,60,0,1097,1,3,1,2,2,single-choice,spatial-relational,1|2,7,1/2,230060,1
5,1,23,61,1,959,1,3,1,1,2,single-choice,spatial-relational,1|2,7,1/2,230061,1
5,1,23,62,1,994,1,13,6,6,7,single-choice,spatial-relational,6|7,7,6/7,230062,6
5,1,23,63,1,1045,1,11,5,5,6,single-choice,spatial-relational,5|6,7,5/6,230063,5
5,1,23,64,1,931,1,9,4,4,5,single-choice,spatial-relational,4|5,7,4/5,230064,4
5,1,23,65,1,897,1,3,1,1,2,single-choice,spatial-relational,1|2,7,1/2,230065,1
5,1,23,66,1,774,1,7,3,3,4,single-choice,spatial-relational,3|4,7,3/4,230066,3
5,1,23,67,0,793,1,5,2,3,3,single-choice,spatial-relational,2|3,7,2/3,230067,2
5,1,23,68,0,894,1,11,5,6,6,single-choice,spatial-relational,5|6,7,5/6,230068,5
5,1,23,69,1,1233,1,7,3,3,4,single-choice,spatial-relational,3|4,7,3/4,230069,3
5,1,23,70,0,1476,1,5,2,3,3,single-choice,spatial-relational,2|3,7,2/3,230070,2
5,1,23,71,1,945,1,9,4,4,5,single-choice,spatial-relational,4|5,7,4/5,230071,4
5,1,23,72,0,1188,1,13,6,7,7,single-choice,spatial-relational,6|7,7,6/7,230072,6
5,1,23,73,1,1281,1,7,3,3,4,single-choice,spatial-relational,3|4,7,3/4,230073,3
5,1,23,74,0,847,1,3,1,2,2,single-choice,spatial-relational,1|2,7,1/2,230074,1
5,1,23,75,1,890,1,13,6,6,7,single-choice,spatial-relational,6|7,7,6/7,230075,6
5,1,23,76,1,1233,1,5,2,2,3,single-choice,spatial-relational,2|3,7,2/3,230076,2
5,1,23,77,1,795,1,5,2,2,3,single-choice,spatial-relational,2|3,7,2/3,230077,2
5,1,23,78,1,930,1,9,4,4,5,single-choice,spatial-relational,4|5,7,4/5,230078,4
5,1,23,79,1,1445,1,9,4,4,5,single-choice,spatial-relational,4|5,7,4/5,230079,4
5,1,23,80,1,950,1,7,3,3,4,single-choice,spatial-relational,3|4,7,3/4,230080,3
5,1,23,81,0,1945,1,11,5,6,6,single-choice,spatial-relational,5|6,7,5/6,230081,5
5,1,23,82,0,593,1,3,1,2,2,single-choice,spatial-relational,1|2,7,1/2,230082,1
5,1,23,83,1,1050,1,11,5,5,6,single-choice,spatial-relational,5|6,7,5/6,230083,5
5,1,23,84,1,1282,1,13,6,6,7,single-choice,spatial-relational,6|7,7,6/7,230084,6
5,1,23,85,1,755,1,7,3,3,4,single-choice,spatial-relational,3|4,7,3/4,230085,3
5,1,23,86,1,1133,1,9,4,4,5,single-choice,spatial-relational,4|5,7,4/5,230086,4
5,1,23,87,0,1140,1,13,6,7,7,single-choice,spatial-relational,6|7,7,6/7,230087,6
5,1,23,88,0,1856,1,9,4,5,5,single-choice,spatial-relational,4|5,7,4/5,230088,4
5,1,23,89,1,753,1,3,1,1,2,single-choice,spatial-relational,1|2,7,1/2,230089,1
5,1,23,90,0,736,1,13,6,7,7,single-choice,spatial-relational,6|7,7,6/7,230090,6
5,1,23,91,0,893,1,3,1,2,2,single-choice,spatial-relational,1|2,7,1/2,230091,1
5,1,23,92,0,621,1,5,2,3,3,single-choice,spatial-relational,2|3,7,2/3,230092,2
5,1,23,93,0,613,1,5,2,3,3,single-choice,spatial-relational,2|3,7,2/3,230093,2
5,1,23,94,0,503,1,11,5,6,6,single-choice,spatial-relational,5|6,7,5/6,230094,5
5,1,23,95,1,861,1,7,3,3,4,single-choice,spatial-relational,3|4,7,3/4,230095,3
5,1,23,96,1,1184,1,11,5,5,6,single-choice,spatial-relational,5|6,7,5/6,230096,5
5,1,23,97,0,1458,1,13,6,7,7,single-choice,spatial-relational,6|7,7,6/7,230097,6
5,1,23,98,0,967,1,11,5,6,6,single-choice,spatial-relational,5|6,7,5/6,230098,5
5,1,23,99,0,814,1,9,4,5,5,single-choice,spatial-relational,4|5,7,4/5,230099,4
5,1,23,100,1,874,1,9,4,4,5,single-choice,spatial-relational,4|5,7,4/5,230100,4
5,1,23,101,1,910,1,5,2,2,3,single-choice,spatial-relational,2|3,7,2/3,230101,2
5,1,23,102,0,763,1,3,1,2,2,single-choice,spatial-relational,1|2,7,1/2,230102,1
5,1,23,103,1,1106,1,11,5,5,6,single-choice,spatial-relational,5|6,7,5/6,230103,5
5,1,23,104,0,932,1,3,1,2,2,single-choice,spatial-relational,1|2,7,1/2,230104,1
5,1,23,105,1,913,1,5,2,2,3,single-choice,spatial-relational,2|3,7,2/3,230105,2
5,1,23,106,0,948,1,13,6,7,7,single-choice,spatial-relational,6|7,7,6/7,230106,6
5,1,23,107,0,930,1,7,3,4,4,single-choice,spatial-relational,3|4,7,3/4,230107,3
5,1,23,108,1,993,1,7,3,3,4,single-choice,spatial-relational,3|4,7,3/4,230108,3
5,1,23,109,1,1318,1,13,6,6,7,single-choice,spatial-relational,6|7,7,6/7,230109,6
5,1,23,110,1,841,1,3,1,1,2,single-choice,spatial-relational,1|2,7,1/2,230110,1
5,1,23,111,1,687,1,3,1,1,2,single-choice,spatial-relational,1|2,7,1/2,230111,1
5,1,23,112,1,840,1,5,2,2,3,single-choice,spatial-relational,2|3,7,2/3,230112,2
5,1,23,113,0,937,1,5,2,3,3,single-choice,spatial-relational,2|3,7,2/3,230113,2
5,1,23,114,1,1001,1,7,3,3,4,single-choice,spatial-relational,3|4,7,3/4,230114,3
5,1,23,115,0,1025,1,7,3,4,4,single-choice,spatial-relational,3|4,7,3/4,230115,3
5,1,23,116,1,1322,1,11,5,5,6,single-choice,spatial-relational,5|6,7,5/6,230116,5
5,1,23,117,1,1027,1,9,4,4,5,single-choice,spatial-relational,4|5,7,4/5,230117,4
5,1,23,118,0,1119,1,11,5,6,6,single-choice,spatial-relational,5|6,7,5/6,230118,5
5,1,23,119,1,1087,1,9,4,4,5,single-choice,spatial-relational,4|5,7,4/5,230119,4
5,1,23,120,1,1015,1,13,6,6,7,single-choice,spatial-relational,6|7,7,6/7,230120,6
5,1,23,121,0,1025,1,13,6,7,7,single-choice,spatial-relational,6|7,7,6/7,230121,6
5,1,23,122,0,1114,1,11,5,6,6,single-choice,spatial-relational,5|6,7,5/6,230122,5
5,1,23,123,0,1266,1,9,4,5,5,single-choice,spatial-relational,4|5,7,4/5,230123,4
5,1,23,124,1,1141,1,11,5,5,6,single-choice,spatial-relational,5|6,7,5/6,230124,5
5,1,23,125,1,1159,1,7,3,3,4,single-choice,spatial-relational,3|4,7,3/4,230125,3
5,1,23,126,0,972,1,3,1,2,2,single-choice,spatial-relational,1|2,7,1/2,230126,1
5,1,23,127,0,844,1,7,3,4,4,single-choice,spatial-relational,3|4,7,3/4,230127,3
5,1,23,128,1,877,1,9,4,4,5,single-choice,spatial-relational,4|5,7,4/5,230128,4
5,1,23,129,1,944,1,5,2,2,3,single-choice,spatial-relational,2|3,7,2/3,230129,2
5,1,23,130,0,819,1,3,1,2,2,single-choice,spatial-relational,1|2,7,1/2,230130,1
5,1,23,131,0,478,1,5,2,3,3,single-choice,spatial-relational,2|3,7,2/3,230131,2
5,1,23,132,1,1869,1,13,6,6,7,single-choice,spatial-relational,6|7,7,6/7,230132,6
5,1,23,133,0,711,1,5,2,3,3,single-choice,spatial-relational,2|3,7,2/3,230133,2
5,1,23,134,0,549,1,7,3,4,4,single-choice,spatial-relational,3|4,7,3/4,230134,3
5,1,23,135,0,663,1,5,2,3,3,single-choice,spatial-relational,2|3,7,2/3,230135,2
5,1,23,136,0,553,1,3,1,2,2,single-choice,spatial-relational,1|2,7,1/2,230136,1
5,1,23,137,1,956,1,13,6,6,7,single-choice,spatial-relational,6|7,7,6/7,230137,6
5,1,23,138,1,1085,1,9,4,4,5,single-choice,spatial-relational,4|5,7,4/5,230138,4
5,1,23,139,1,1014,1,11,5,5,6,single-choice,spatial-relational,5|6,7,5/6,230139,5
5,1,23,140,0,759,1,3,1,2,2,single-choice,spatial-relational,1|2,7,1/2,230140,1
5,1,23,141,0,803,1,9,4,5,5,single-choice,spatial-relational,4|5,7,4/5,230141,4
5,1,23,142,1,966,1,13,6,6,7,single-choice,spatial-relational,6|7,7,6/7,230142,6
5,1,23,143,1,1248,1,11,5,5,6,single-choice,spatial-relational,5|6,7,5/6,230143,5
5,1,23,144,1,871,1,7,3,3,4,single-choice,spatial-relational,3|4,7,3/4,230144,3
5,1,23,145,1,996,1,13,6,6,7,single-choice,spatial-relational,6|7,7,6/7,230145,6
5,1,23,146,0,1172,1,9,4,5,5,single-choice,spatial-relational,4|5,7,4/5,230146,4
5,1,23,147,1,881,1,3,1,1,2,single-choice,spatial-relational,1|2,7,1/2,230147,1
5,1,23,148,1,851,1,5,2,2,3,single-choice,spatial-relational,2|3,7,2/3,230148,2
5,1,23,149,0,904,1,9,4,5,5,single-choice,spatial-relational,4|5,7,4/5,230149,4
5,1,23,150,1,984,1,13,6,6,7,single-choice,spatial-relational,6|7,7,6/7,230150,6
5,1,23,151,0,1345,1,3,1,2,2,single-choice,spatial-relational,1|2,7,1/2,230151,1
5,1,23,152,1,1085,1,7,3,3,4,single-choice,spatial-relational,3|4,7,3/4,230152,3
5,1,23,153,1,829,1,5,2,2,3,single-choice,spatial-relational,2|3,7,2/3,230153,2
5,1,23,154,0,781,1,11,5,6,6,single-choice,spatial-relational,5|6,7,5/6,230154,5
5,1,23,155,1,900,1,11,5,5,6,single-choice,spatial-relational,5|6,7,5/6,230155,5
5,1,23,156,0,1558,1,7,3,4,4,single-choice,spatial-relational,3|4,7,3/4,230156,3
5,1,23,157,1,1298,1,11,5,5,6,single-choice,spatial-relational,5|6,7,5/6,230157,5
5,1,23,158,0,982,1,7,3,4,4,single-choice,spatial-relational,3|4,7,3/4,230158,3
5,1,23,159,0,763,1,3,1,2,2,single-choice,spatial-relational,1|2,7,1/2,230159,1
5,1,23,160,1,1301,1,11,5,5,6,single-choice,spatial-relational,5|6,7,5/6,230160,5
5,1,23,161,0,1021,1,5,2,3,3,single-choice,spatial-relational,2|3,7,2/3,230161,2
5,1,23,162,1,974,1,7,3,3,4,single-choice,spatial-relational,3|4,7,3/4,230162,3
5,1,23,163,1,926,1,5,2,2,3,single-choice,spatial-relational,2|3,7,2/3,230163,2
5,1,23,164,0,826,1,9,4,5,5,single-choice,spatial-relational,4|5,7,4/5,230164,4
5,1,23,165,1,793,1,13,6,6,7,single-choice,spatial-relational,6|7,7,6/7,230165,6
5,1,23,166,1,1148,1,3,1,1,2,single-choice,spatial-relational,1|2,7,1/2,230166,1
5,1,23,167,1,757,1,13,6,6,7,single-choice,spatial-relational,6|7,7,6/7,230167,6
5,1,23,168,0,1197,1,9,4,5,5,single-choice,spatial-relational,4|5,7,4/5,230168,4
5,1,23,169,1,901,1,5,2,2,3,single-choice,spatial-relational,2|3,7,2/3,230169,2
5,1,23,170,1,1049,1,7,3,3,4,single-choice,spatial-relational,3|4,7,3/4,230170,3
5,1,23,171,0,1107,1,9,4,5,5,single-choice,spatial-relational,4|5,7,4/5,230171,4
5,1,23,172,1,822,1,5,2,2,3,single-choice,spatial-relational,2|3,7,2/3,230172,2
5,1,23,173,1,640,1,3,1,1,2,single-choice,spatial-relational,1|2,7,1/2,230173,1
5,1,23,174,0,1173,1,9,4,5,5,single-choice,spatial-relational,4|5,7,4/5,230174,4
5,1,23,175,1,855,1,13,6,6,7,single-choice,spatial-relational,6|7,7,6/7,230175,6
5,1,23,176,1,876,1,3,1,1,2,single-choice,spatial-relational,1|2,7,1/2,230176,1
5,1,23,177,1,1101,1,11,5,5,6,single-choice,spatial-relational,5|6,7,5/6,230177,5
5,1,23,178,1,1229,1,7,3,3,4,single-choice,spatial-relational,3|4,7,3/4,230178,3
5,1,23,179,0,1340,1,11,5,6,6,single-choice,spatial-relational,5|6,7,5/6,230179,5
5,1,23,180,1,995,1,13,6,6,7,single-choice,spatial-relational,6|7,7,6/7,230180,6
5,1,23,181,0,1385,1,9,4,5,5,single-choice,spatial-relational,4|5,7,4/5,230181,4
5,1,23,182,1,1050,1,7,3,3,4,single-choice,spatial-relational,3|4,7,3/4,230182,3
5,1,23,183,1,857,1,5,2,2,3,single-choice,spatial-relational,2|3,7,2/3,230183,2
5,1,23,184,1,933,1,13,6,6,7,single-choice,spatial-relational,6|7,7,6/7,230184,6
5,1,23,185,0,1397,1,11,5,6,6,single-choice,spatial-relational,5|6,7,5/6,230185,5
5,1,23,186,1,842,1,3,1,1,2,single-choice,spatial-relational,1|2,7,1/2,230186,1
5,1,23,187,1,771,1,5,2,2,3,single-choice,spatial-relational,2|3,7,2/3,230187,2
5,1,23,188,1,960,1,11,5,5,6,single-choice,spatial-relational,5|6,7,5/6,230188,5
5,1,23,189,1,1309,1,9,4,4,5,single-choice,spatial-relational,4|5,7,4/5,230189,4
5,1,23,190,1,1605,1,13,6,6,7,single-choice,spatial-relational,6|7,7,6/7,230190,6
5,1,23,191,1,742,1,7,3,3,4,single-choice,spatial-relational,3|4,7,3/4,230191,3
5,1,23,192,1,800,1,3,1,1,2,single-choice,spatial-relational,1|2,7,1/2,230192,1
5,1,23,193,1,837,1,13,6,6,7,single-choice,spatial-relational,6|7,7,6/7,230193,6
5,1,23,194,0,933,1,3,1,2,2,single-choice,spatial-relational,1|2,7,1/2,230194,1
5,1,23,195,0,915,1,7,3,4,4,single-choice,spatial-relational,3|4,7,3/4,230195,3
5,1,23,196,1,952,1,7,3,3,4,single-choice,spatial-relational,3|4,7,3/4,230196,3
5,1,23,197,1,1914,1,13,6,6,7,single-choice,spatial-relational,6|7,7,6/7,230197,6
5,1,23,198,0,1781,1,11,5,6,6,single-choice,spatial-relational,5|6,7,5/6,230198,5
5,1,23,199,1,887,1,3,1,1,2,single-choice,spatial-relational,1|2,7,1/2,230199,1
5,1,23,200,0,989,1,5,2,3,3,single-choice,spatial-relational,2|3,7,2/3,230200,2
5,1,23,201,1,1209,1,11,5,5,6,single-choice,spatial-relational,5|6,7,5/6,230201,5
5,1,23,202,1,976,1,9,4,4,5,single-choice,spatial-relational,4|5,7,4/5,230202,4
5,1,23,203,1,985,1,9,4,4,5,single-choice,spatial-relational,4|5,7,4/5,230203,4
5,1,23,204,1,855,1,5,2,2,3,single-choice,spatial-relational,2|3,7,2/3,230204,2
5,1,23,205,0,731,1,11,5,6,6,single-choice,spatial-relational,5|6,7,5/6,230205,5
5,1,23,206,0,772,1,3,1,2,2,single-choice,spatial-relational,1|2,7,1/2,230206,1
5,1,23,207,1,822,1,5,2,2,3,single-choice,spatial-relational,2|3,7,2/3,230207,2
5,1,23,208,0,892,1,9,4,5,5,single-choice,spatial-relational,4|5,7,4/5,230208,4
5,1,23,209,0,901,1,3,1,2,2,single-choice,spatial-relational,1|2,7,1/2,230209,1
5,1,23,210,1,932,1,5,2,2,3,single-choice,spatial-relational,2|3,7,2/3,230210,2
5,1,23,211,1,917,1,9,4,4,5,single-choice,spatial-relational,4|5,7,4/5,230211,4
5,1,23,212,1,770,1,7,3,3,4,single-choice,spatial-relational,3|4,7,3/4,230212,3
5,1,23,213,0,1132,1,13,6,7,7,single-choice,spatial-relational,6|7,7,6/7,230213,6
5,1,23,214,1,776,1,13,6,6,7,single-choice,spatial-relational,6|7,7,6/7,230214,6
5,1,23,215,1,1217,1,11,5,5,6,single-choice,spatial-relational,5|6,7,5/6,230215,5
5,1,23,216,1,1177,1,7,3,3,4,single-choice,spatial-relational,3|4,7,3/4,230216,3
5,1,23,217,1,718,1,9,4,4,5,single-choice,spatial-relational,4|5,7,4/5,230217,4
5,1,23,218,0,2276,1,11,5,6,6,single-choice,spatial-relational,5|6,7,5/6,230218,5
5,1,23,219,0,827,1,3,1,2,2,single-choice,spatial-relational,1|2,7,1/2,230219,1
5,1,23,220,1,860,1,5,2,2,3,single-choice,spatial-relational,2|3,7,2/3,230220,2
5,1,23,221,1,886,1,9,4,4,5,single-choice,spatial-relational,4|5,7,4/5,230221,4
5,1,23,222,1,2054,1,7,3,3,4,single-choice,spatial-relational,3|4,7,3/4,230222,3
5,1,23,223,1,961,1,7,3,3,4,single-choice,spatial-relational,3|4,7,3/4,230223,3
5,1,23,224,1,1528,1,13,6,6,7,single-choice,spatial-relational,6|7,7,6/7,230224,6
5,1,23,225,1,1780,1,11,5,5,6,single-choice,spatial-relational,5|6,7,5/6,230225,5
5,1,23,226,1,1543,1,13,6,6,7,single-choice,spatial-relational,6|7,7,6/7,230226,6
5,1,23,227,1,705,1,3,1,1,2,single-choice,spatial-relational,1|2,7,1/2,230227,1
5,1,23,228,1,1513,1,5,2,2,3,single-choice,spatial-relational,2|3,7,2/3,230228,2
5,1,23,229,0,2502,1,3,1,2,2,single-choice,spatial-relational,1|2,7,1/2,230229,1
5,1,23,230,0,958,1,7,3,4,4,single-choice,spatial-relational,3|4,7,3/4,230230,3
5,1,23,231,1,785,1,3,1,1,2,single-choice,spatial-relational,1|2,7,1/2,230231,1
5,1,23,232,1,1876,1,11,5,5,6,single-choice,spatial-relational,5|6,7,5/6,230232,5
5,1,23,233,1,979,1,9,4,4,5,single-choice,spatial-relational,4|5,7,4/5,230233,4
5,1,23,234,1,962,1,11,5,5,6,single-choice,spatial-relational,5|6,7,5/6,230234,5
5,1,23,235,1,1172,1,7,3,3,4,single-choice,spatial-relational,3|4,7,3/4,230235,3
5,1,23,236,0,674,1,5,2,3,3,single-choice,spatial-relational,2|3,7,2/3,230236,2
5,1,23,237,1,890,1,13,6,6,7,single-choice,spatial-relational,6|7,7,6/7,230237,6
5,1,23,238,0,1086,1,5,2,3,3,single-choice,spatial-relational,2|3,7,2/3,230238,2
5,1,23,239,0,888,1,9,4,5,5,single-choice,spatial-relational,4|5,7,4/5,230239,4
5,1,23,240,1,1093,1,13,6,6,7,single-choice,spatial-relational,6|7,7,6/7,230240,6
5,1,23,241,1,1238,1,13,6,6,7,single-choice,spatial-relational,6|7,7,6/7,230241,6
5,1,23,242,0,964,1,3,1,2,2,single-choice,spatial-relational,1|2,7,1/2,230242,1
5,1,23,243,1,1263,1,11,5,5,6,single-choice,spatial-relational,5|6,7,5/6,230243,5
5,1,23,244,0,1071,1,7,3,4,4,single-choice,spatial-relational,3|4,7,3/4,230244,3
5,1,23,245,1,699,1,13,6,6,7,single-choice,spatial-relational,6|7,7,6/7,230245,6
5,1,23,246,0,1226,1,11,5,6,6,single-choice,spatial-relational,5|6,7,5/6,230246,5
5,1,23,247,1,972,1,7,3,3,4,single-choice,spatial-relational,3|4,7,3/4,230247,3
5,1,23,248,1,725,1,3,1,1,2,single-choice,spatial-relational,1|2,7,1/2,230248,1
5,1,23,249,1,833,1,5,2,2,3,single-choice,spatial-relational,2|3,7,2/3,230249,2
5,1,23,250,1,1148,1,5,2,2,3,single-choice,spatial-relational,2|3,7,2/3,230250,2
5,1,23,251,1,1091,1,9,4,4,5,single-choice,spatial-relational,4|5,7,4/5,230251,4
5,1,23,252,0,1075,1,9,4,5,5,single-choice,spatial-relational,4|5,7,4/5,230252,4
5,1,23,253,1,878,1,13,6,6,7,single-choice,spatial-relational,6|7,7,6/7,230253,6
5,1,23,254,1,1368,1,11,5,5,6,single-choice,spatial-relational,5|6,7,5/6,230254,5
5,1,23,255,1,928,1,5,2,2,3,single-choice,spatial-relational,2|3,7,2/3,230255,2
5,1,23,256,1,743,1,5,2,2,3,single-choice,spatial-relational,2|3,7,2/3,230256,2
5,1,23,257,1,862,1,13,6,6,7,single-choice,spatial-relational,6|7,7,6/7,230257,6
5,1,23,258,1,1028,1,11,5,5,6,single-choice,spatial-relational,5|6,7,5/6,230258,5
5,1,23,259,1,1497,1,9,4,4,5,single-choice,spatial-relational,4|5,7,4/5,230259,4
5,1,23,260,0,1490,1,9,4,5,5,single-choice,spatial-relational,4|5,7,4/5,230260,4
5,1,23,261,1,1015,1,7,3,3,4,single-choice,spatial-relational,3|4,7,3/4,230261,3
5,1,23,262,0,1039,1,3,1,2,2,single-choice,spatial-relational,1|2,7,1/2,230262,1
5,1,23,263,0,886,1,3,1,2,2,single-choice,spatial-relational,1|2,7,1/2,230263,1
5,1,23,264,0,1077,1,7,3,4,4,single-choice,spatial-relational,3|4,7,3/4,230264,3
5,1,23,265,1,898,1,5,2,2,3,single-choice,spatial-relational,2|3,7,2/3,230265,2
5,1,23,266,1,1397,1,13,6,6,7,single-choice,spatial-relational,6|7,7,6/7,230266,6
5,1,23,267,1,1340,1,11,5,5,6,single-choice,spatial-relational,5|6,7,5/6,230267,5
5,1,23,268,1,747,1,13,6,6,7,single-choice,spatial-relational,6|7,7,6/7,230268,6
5,1,23,269,1,1116,1,3,1,1,2,single-choice,spatial-relational,1|2,7,1/2,230269,1
5,1,23,270,1,836,1,9,4,4,5,single-choice,spatial-relational,4|5,7,4/5,230270,4
5,1,23,271,1,1231,1,11,5,5,6,single-choice,spatial-relational,5|6,7,5/6,230271,5
5,1,23,272,1,1007,1,3,1,1,2,single-choice,spatial-relational,1|2,7,1/2,230272,1
5,1,23,273,1,804,1,7,3,3,4,single-choice,spatial-relational,3|4,7,3/4,230273,3
5,1,23,274,1,813,1,5,2,2,3,single-choice,spatial-relational,2|3,7,2/3,230274,2
5,1,23,275,0,868,1,9,4,5,5,single-choice,spatial-relational,4|5,7,4/5,230275,4
5,1,23,276,1,992,1,7,3,3,4,single-choice,spatial-relational,3|4,7,3/4,230276,3
5,1,23,277,0,1556,1,3,1,2,2,single-choice,spatial-relational,1|2,7,1/2,230277,1
5,1,23,278,1,885,1,13,6,6,7,single-choice,spatial-relational,6|7,7,6/7,230278,6
5,1,23,279,1,1404,1,7,3,3,4,single-choice,spatial-relational,3|4,7,3/4,230279,3
5,1,23,280,1,680,1,5,2,2,3,single-choice,spatial-relational,2|3,7,2/3,230280,2
5,1,23,281,1,1167,1,7,3,3,4,single-choice,spatial-relational,3|4,7,3/4,230281,3
5,1,23,282,0,1512,1,5,2,3,3,single-choice,spatial-relational,2|3,7,2/3,230282,2
5,1,23,283,1,1292,1,11,5,5,6,single-choice,spatial-relational,5|6,7,5/6,230283,5
5,1,23,284,0,650,1,9,4,5,5,single-choice,spatial-relational,4|5,7,4/5,230284,4
5,1,23,285,1,866,1,13,6,6,7,single-choice,spatial-relational,6|7,7,6/7,230285,6
5,1,23,286,1,1192,1,9,4,4,5,single-choice,spatial-relational,4|5,7,4/5,230286,4
5,1,23,287,0,1336,1,11,5,6,6,single-choice,spatial-relational,5|6,7,5/6,230287,5
5,1,23,288,1,902,1,3,1,1,2,single-choice,spatial-relational,1|2,7,1/2,230288,1
5,1,23,289,1,1143,1,5,2,2,3,single-choice,spatial-relational,2|3,7,2/3,230289,2
5,1,23,290,1,800,1,11,5,5,6,single-choice,spatial-relational,5|6,7,5/6,230290,5
5,1,23,291,0,1199,1,7,3,4,4,single-choice,spatial-relational,3|4,7,3/4,230291,3
5,1,23,292,1,938,1,3,1,1,2,single-choice,spatial-relational,1|2,7,1/2,230292,1
5,1,23,293,0,860,1,13,6,7,7,single-choice,spatial-relational,6|7,7,6/7,230293,6
5,1,23,294,0,859,1,7,3,4,4,single-choice,spatial-relational,3|4,7,3/4,230294,3
5,1,23,295,0,1076,1,11,5,6,6,single-choice,spatial-relational,5|6,7,5/6,230295,5
5,1,23,296,1,812,1,9,4,4,5,single-choice,spatial-relational,4|5,7,4/5,230296,4
5,1,23,297,1,1233,1,9,4,4,5,single-choice,spatial-relational,4|5,7,4/5,230297,4
5,1,23,298,1,948,1,3,1,1,2,single-choice,spatial-relational,1|2,7,1/2,230298,1
5,1,23,299,1,876,1,13,6,6,7,single-choice,spatial-relational,6|7,7,6/7,230299,6
5,1,23,300,1,884,1,5,2,2,3,single-choice,spatial-relational,2|3,7,2/3,230300,2
5,1,23,301,1,830,1,9,4,4,5,single-choice,spatial-relational,4|5,7,4/5,230301,4
5,1,23,302,0,984,1,7,3,4,4,single-choice,spatial-relational,3|4,7,3/4,230302,3
5,1,23,303,1,848,1,13,6,6,7,single-choice,spatial-relational,6|7,7,6/7,230303,6
5,1,23,304,1,1386,1,9,4,4,5,single-choice,spatial-relational,4|5,7,4/5,230304,4
5,1,23,305,1,1119,1,11,5,5,6,single-choice,spatial-relational,5|6,7,5/6,230305,5
5,1,23,306,1,864,1,7,3,3,4,single-choice,spatial-relational,3|4,7,3/4,230306,3
5,1,23,307,1,781,1,5,2,2,3,single-choice,spatial-relational,2|3,7,2/3,230307,2
5,1,23,308,1,739,1,5,2,2,3,single-choice,spatial-relational,2|3,7,2/3,230308,2
5,1,23,309,1,863,1,11,5,5,6,single-choice,spatial-relational,5|6,7,5/6,230309,5
5,1,23,310,1,849,1,3,1,1,2,single-choice,spatial-relational,1|2,7,1/2,230310,1
5,1,23,311,1,791,1,3,1,1,2,single-choice,spatial-relational,1|2,7,1/2,230311,1
5,1,23,312,1,867,1,13,6,6,7,single-choice,spatial-relational,6|7,7,6/7,230312,6
5,1,23,313,1,1419,1,9,4,4,5,single-choice,spatial-relational,4|5,7,4/5,230313,4
5,1,23,314,1,947,1,13,6,6,7,single-choice,spatial-relational,6|7,7,6/7,230314,6
5,1,23,315,0,803,1,5,2,3,3,single-choice,spatial-relational,2|3,7,2/3,230315,2
5,1,23,316,1,861,1,7,3,3,4,single-choice,spatial-relational,3|4,7,3/4,230316,3
5,1,23,317,1,1170,1,11,5,5,6,single-choice,spatial-relational,5|6,7,5/6,230317,5
5,1,23,318,1,829,1,5,2,2,3,single-choice,spatial-relational,2|3,7,2/3,230318,2
5,1,23,319,1,936,1,13,6,6,7,single-choice,spatial-relational,6|7,7,6/7,230319,6
5,1,23,320,0,743,1,3,1,2,2,single-choice,spatial-relational,1|2,7,1/2,230320,1
5,1,23,321,0,864,1,9,4,5,5,single-choice,spatial-relational,4|5,7,4/5,230321,4
5,1,23,322,1,1092,1,7,3,3,4,single-choice,spatial-relational,3|4,7,3/4,230322,3
5,1,23,323,0,1117,1,11,5,6,6,single-choice,spatial-relational,5|6,7,5/6,230323,5
5,1,23,324,1,926,1,3,1,1,2,single-choice,spatial-relational,1|2,7,1/2,230324,1
5,1,23,325,1,812,1,5,2,2,3,single-choice,spatial-relational,2|3,7,2/3,230325,2
5,1,23,326,1,1493,1,13,6,6,7,single-choice,spatial-relational,6|7,7,6/7,230326,6
5,1,23,327,1,974,1,5,2,2,3,single-choice,spatial-relational,2|3,7,2/3,230327,2
5,1,23,328,0,904,1,9,4,5,5,single-choice,spatial-relational,4|5,7,4/5,230328,4
5,1,23,329,0,1267,1,9,4,5,5,single-choice,spatial-relational,4|5,7,4/5,230329,4
5,1,23,330,0,940,1,7,3,4,4,single-choice,spatial-relational,3|4,7,3/4,230330,3
5,1,23,331,1,798,1,3,1,1,2,single-choice,spatial-relational,1|2,7,1/2,230331,1
5,1,23,332,1,839,1,3,1,1,2,single-choice,spatial-relational,1|2,7,1/2,230332,1
5,1,23,333,0,840,1,11,5,6,6,single-choice,spatial-relational,5|6,7,5/6,230333,5
5,1,23,334,0,877,1,11,5,6,6,single-choice,spatial-relational,5|6,7,5/6,230334,5
5,1,23,335,1,891,1,7,3,3,4,single-choice,spatial-relational,3|4,7,3/4,230335,3
5,1,23,336,1,1630,1,13,6,6,7,single-choice,spatial-relational,6|7,7,6/7,230336,6
5,1,23,337,1,877,1,5,2,2,3,single-choice,spatial-relational,2|3,7,2/3,230337,2
5,1,23,338,0,855,1,9,4,5,5,single-choice,spatial-relational,4|5,7,4/5,230338,4
5,1,23,339,1,844,1,13,6,6,7,single-choice,spatial-relational,6|7,7,6/7,230339,6
5,1,23,340,0,874,1,5,2,3,3,single-choice,spatial-relational,2|3,7,2/3,230340,2
5,1,23,341,1,858,1,9,4,4,5,single-choice,spatial-relational,4|5,7,4/5,230341,4
5,1,23,342,0,1348,1,7,3,4,4,single-choice,spatial-relational,3|4,7,3/4,230342,3
5,1,23,343,1,842,1,11,5,5,6,single-choice,spatial-relational,5|6,7,5/6,230343,5
5,1,23,344,1,1013,1,3,1,1,2,single-choice,spatial-relational,1|2,7,1/2,230344,1
5,1,23,345,0,1275,1,11,5,6,6,single-choice,spatial-relational,5|6,7,5/6,230345,5
5,1,23,346,1,939,1,7,3,3,4,single-choice,spatial-relational,3|4,7,3/4,230346,3
5,1,23,347,1,1304,1,13,6,6,7,single-choice,spatial-relational,6|7,7,6/7,230347,6
5,1,23,348,0,867,1,3,1,2,2,single-choice,spatial-relational,1|2,7,1/2,230348,1
5,1,23,349,1,874,1,5,2,2,3,single-choice,spatial-relational,2|3,7,2/3,230349,2
5,1,23,350,1,826,1,9,4,4,5,single-choice,spatial-relational,4|5,7,4/5,230350,4
5,1,23,351,1,752,1,7,3,3,4,single-choice,spatial-relational,3|4,7,3/4,230351,3
5,1,23,352,0,1190,1,13,6,7,7,single-choice,spatial-relational,6|7,7,6/7,230352,6
5,1,23,353,1,1103,1,11,5,5,6,single-choice,spatial-relational,5|6,7,5/6,230353,5
5,1,23,354,1,950,1,5,2,2,3,single-choice,spatial-relational,2|3,7,2/3,230354,2
5,1,23,355,1,1150,1,13,6,6,7,single-choice,spatial-relational,6|7,7,6/7,230355,6
5,1,23,356,1,950,1,7,3,3,4,single-choice,spatial-relational,3|4,7,3/4,230356,3
5,1,23,357,1,795,1,3,1,1,2,single-choice,spatial-relational,1|2,7,1/2,230357,1
5,1,23,358,1,1231,1,11,5,5,6,single-choice,spatial-relational,5|6,7,5/6,230358,5
5,1,23,359,0,829,1,9,4,5,5,single-choice,spatial-relational,4|5,7,4/5,230359,4
5,1,23,360,1,822,1,3,1,1,2,single-choice,spatial-relational,1|2,7,1/2,230360,1
5,1,23,361,1,1180,1,9,4,4,5,single-choice,spatial-relational,4|5,7,4/5,230361,4
5,1,23,362,0,1003,1,7,3,4,4,single-choice,spatial-relational,3|4,7,3/4,230362,3
5,1,23,363,1,1345,1,11,5,5,6,single-choice,spatial-relational,5|6,7,5/6,230363,5
5,1,23,364,1,1004,1,11,5,5,6,single-choice,spatial-relational,5|6,7,5/6,230364,5
5,1,23,365,0,838,1,7,3,4,4,single-choice,spatial-relational,3|4,7,3/4,230365,3
5,1,23,366,1,961,1,9,4,4,5,single-choice,spatial-relational,4|5,7,4/5,230366,4
5,1,23,367,1,855,1,5,2,2,3,single-choice,spatial-relational,2|3,7,2/3,230367,2
5,1,23,368,1,709,1,5,2,2,3,single-choice,spatial-relational,2|3,7,2/3,230368,2
5,1,23,369,1,723,1,3,1,1,2,single-choice,spatial-relational,1|2,7,1/2,230369,1
5,1,23,370,0,669,1,3,1,2,2,single-choice,spatial-relational,1|2,7,1/2,230370,1
5,1,23,371,1,827,1,13,6,6,7,single-choice,spatial-relational,6|7,7,6/7,230371,6
5,1,23,372,1,1275,1,13,6,6,7,single-choice,spatial-relational,6|7,7,6/7,230372,6
5,1,23,373,1,1053,1,11,5,5,6,single-choice,spatial-relational,5|6,7,5/6,230373,5
5,1,23,374,1,4114,1,7,3,3,4,single-choice,spatial-relational,3|4,7,3/4,230374,3
5,1,23,375,0,12257,1,3,1,2,2,single-choice,spatial-relational,1|2,7,1/2,230375,1
5,1,23,376,1,787,1,5,2,2,3,single-choice,spatial-relational,2|3,7,2/3,230376,2
5,1,23,377,1,1279,1,7,3,3,4,single-choice,spatial-relational,3|4,7,3/4,230377,3
5,1,23,378,1,854,1,13,6,6,7,single-choice,spatial-relational,6|7,7,6/7,230378,6
5,1,23,379,0,745,1,9,4,5,5,single-choice,spatial-relational,4|5,7,4/5,230379,4
5,1,23,380,1,1003,1,13,6,6,7,single-choice,spatial-relational,6|7,7,6/7,230380,6
5,1,23,381,0,1268,1,9,4,5,5,single-choice,spatial-relational,4|5,7,4/5,230381,4
5,1,23,382,1,847,1,5,2,2,3,single-choice,spatial-relational,2|3,7,2/3,230382,2
5,1,23,383,1,749,1,3,1,1,2,single-choice,spatial-relational,1|2,7,1/2,230383,1
5,1,23,384,0,1089,1,11,5,6,6,single-choice,spatial-relational,5|6,7,5/6,230384,5
5,1,23,385,1,911,1,7,3,3,4,single-choice,spatial-relational,3|4,7,3/4,230385,3
5,1,23,386,1,1293,1,11,5,5,6,single-choice,spatial-relational,5|6,7,5/6,230386,5
5,1,23,387,0,1006,1,7,3,4,4,single-choice,spatial-relational,3|4,7,3/4,230387,3
5,1,23,388,0,809,1,3,1,2,2,single-choice,spatial-relational,1|2,7,1/2,230388,1
5,1,23,389,1,790,1,13,6,6,7,single-choice,spatial-relational,6|7,7,6/7,230389,6
5,1,23,390,0,729,1,3,1,2,2,single-choice,spatial-relational,1|2,7,1/2,230390,1
5,1,23,391,1,1403,1,5,2,2,3,single-choice,spatial-relational,2|3,7,2/3,230391,2
5,1,23,392,1,852,1,5,2,2,3,single-choice,spatial-relational,2|3,7,2/3,230392,2
5,1,23,393,0,765,1,9,4,5,5,single-choice,spatial-relational,4|5,7,4/5,230393,4
5,1,23,394,1,1027,1,13,6,6,7,single-choice,spatial-relational,6|7,7,6/7,230394,6
5,1,23,395,1,1201,1,11,5,5,6,single-choice,spatial-relational,5|6,7,5/6,230395,5
5,1,23,396,1,1262,1,9,4,4,5,single-choice,spatial-relational,4|5,7,4/5,230396,4
5,1,23,397,1,986,1,13,6,6,7,single-choice,spatial-relational,6|7,7,6/7,230397,6
5,1,23,398,0,919,1,3,1,2,2,single-choice,spatial-relational,1|2,7,1/2,230398,1
5,1,23,399,1,942,1,9,4,4,5,single-choice,spatial-relational,4|5,7,4/5,230399,4
5,1,23,400,0,1163,1,11,5,6,6,single-choice,spatial-relational,5|6,7,5/6,230400,5
5,1,23,401,1,863,1,13,6,6,7,single-choice,spatial-relational,6|7,7,6/7,230401,6
5,1,23,402,1,849,1,7,3,3,4,single-choice,spatial-relational,3|4,7,3/4,230402,3
5,1,23,403,1,892,1,11,5,5,6,single-choice,spatial-relational,5|6,7,5/6,230403,5
5,1,23,404,1,695,1,7,3,3,4,single-choice,spatial-relational,3|4,7,3/4,230404,3
5,1,23,405,1,915,1,5,2,2,3,single-choice,spatial-relational,2|3,7,2/3,230405,2
5,1,23,406,1,819,1,9,4,4,5,single-choice,spatial-relational,4|5,7,4/5,230406,4
5,1,23,407,1,741,1,5,2,2,3,single-choice,spatial-relational,2|3,7,2/3,230407,2
5,1,23,408,1,785,1,3,1,1,2,single-choice,spatial-relational,1|2,7,1/2,230408,1
5,1,23,409,1,1103,1,9,4,4,5,single-choice,spatial-relational,4|5,7,4/5,230409,4
5,1,23,410,0,1159,1,11,5,6,6,single-choice,spatial-relational,5|6,7,5/6,230410,5
5,1,23,411,0,1098,1,7,3,4,4,single-choice,spatial-relational,3|4,7,3/4,230411,3
5,1,23,412,1,835,1,5,2,2,3,single-choice,spatial-relational,2|3,7,2/3,230412,2
5,1,23,413,1,1058,1,9,4,4,5,single-choice,spatial-relational,4|5,7,4/5,230413,4
5,1,23,414,0,1579,1,7,3,4,4,single-choice,spatial-relational,3|4,7,3/4,230414,3
5,1,23,415,1,1409,1,13,6,6,7,single-choice,spatial-relational,6|7,7,6/7,230415,6
5,1,23,416,0,1014,1,5,2,3,3,single-choice,spatial-relational,2|3,7,2/3,230416,2
5,1,23,417,0,2045,1,11,5,6,6,single-choice,spatial-relational,5|6,7,5/6,230417,5
5,1,23,418,1,1387,1,13,6,6,7,single-choice,spatial-relational,6|7,7,6/7,230418,6
5,1,23,419,1,1392,1,3,1,1,2,single-choice,spatial-relational,1|2,7,1/2,230419,1
5,1,23,420,0,666,1,3,1,2,2,single-choice,spatial-relational,1|2,7,1/2,230420,1
5,1,23,421,1,908,1,7,3,3,4,single-choice,spatial-relational,3|4,7,3/4,230421,3
5,1,23,422,1,716,1,5,2,2,3,single-choice,spatial-relational,2|3,7,2/3,230422,2
5,1,23,423,0,743,1,3,1,2,2,single-choice,spatial-relational,1|2,7,1/2,230423,1
5,1,23,424,0,1030,1,7,3,4,4,single-choice,spatial-relational,3|4,7,3/4,230424,3
5,1,23,425,1,804,1,5,2,2,3,single-choice,spatial-relational,2|3,7,2/3,230425,2
5,1,23,426,1,907,1,13,6,6,7,single-choice,spatial-relational,6|7,7,6/7,230426,6
5,1,23,427,0,895,1,9,4,5,5,single-choice,spatial-relational,4|5,7,4/5,230427,4
5,1,23,428,0,1206,1,11,5,6,6,single-choice,spatial-relational,5|6,7,5/6,230428,5
5,1,23,429,1,1132,1,11,5,5,6,single-choice,spatial-relational,5|6,7,5/6,230429,5
5,1,23,430,1,968,1,3,1,1,2,single-choice,spatial-relational,1|2,7,1/2,230430,1
5,1,23,431,0,1044,1,9,4,5,5,single-choice,spatial-relational,4|5,7,4/5,230431,4
5,1,23,432,1,960,1,13,6,6,7,single-choice,spatial-relational,6|7,7,6/7,230432,6
5,1,23,433,1,1258,1,11,5,5,6,single-choice,spatial-relational,5|6,7,5/6,230433,5
5,1,23,434,1,1008,1,5,2,2,3,single-choice,spatial-relational,2|3,7,2/3,230434,2
5,1,23,435,1,880,1,9,4,4,5,single-choice,spatial-relational,4|5,7,4/5,230435,4
5,1,23,436,1,1059,1,13,6,6,7,single-choice,spatial-relational,6|7,7,6/7,230436,6
5,1,23,437,0,931,1,3,1,2,2,single-choice,spatial-relational,1|2,7,1/2,230437,1
5,1,23,438,0,1339,1,9,4,5,5,single-choice,spatial-relational,4|5,7,4/5,230438,4
5,1,23,439,0,1181,1,7,3,4,4,single-choice,spatial-relational,3|4,7,3/4,230439,3
5,1,23,440,1,774,1,3,1,1,2,single-choice,spatial-relational,1|2,7,1/2,230440,1
5,1,23,441,1,1300,1,7,3,3,4,single-choice,spatial-relational,3|4,7,3/4,230441,3
5,1,23,442,1,915,1,5,2,2,3,single-choice,spatial-relational,2|3,7,2/3,230442,2
5,1,23,443,1,892,1,13,6,6,7,single-choice,spatial-relational,6|7,7,6/7,230443,6
5,1,23,444,1,1266,1,11,5,5,6,single-choice,spatial-relational,5|6,7,5/6,230444,5
5,1,23,445,1,814,1,5,2,2,3,single-choice,spatial-relational,2|3,7,2/3,230445,2
5,1,23,446,0,1132,1,11,5,6,6,single-choice,spatial-relational,5|6,7,5/6,230446,5
5,1,23,447,1,844,1,5,2,2,3,single-choice,spatial-relational,2|3,7,2/3,230447,2
5,1,23,448,0,761,1,3,1,2,2,single-choice,spatial-relational,1|2,7,1/2,230448,1
5,1,23,449,1,869,1,13,6,6,7,single-choice,spatial-relational,6|7,7,6/7,230449,6
5,1,23,450,0,1055,1,9,4,5,5,single-choice,spatial-relational,4|5,7,4/5,230450,4
5,1,23,451,1,1161,1,9,4,4,5,single-choice,spatial-relational,4|5,7,4/5,230451,4
5,1,23,452,1,1359,1,13,6,6,7,single-choice,spatial-relational,6|7,7,6/7,230452,6
5,1,23,453,1,786,1,3,1,1,2,single-choice,spatial-relational,1|2,7,1/2,230453,1
5,1,23,454,1,898,1,7,3,3,4,single-choice,spatial-relational,3|4,7,3/4,230454,3
5,1,23,455,0,1264,1,11,5,6,6,single-choice,spatial-relational,5|6,7,5/6,230455,5
5,1,23,456,1,797,1,7,3,3,4,single-choice,spatial-relational,3|4,7,3/4,230456,3
5,1,23,457,0,1162,1,13,6,7,7,single-choice,spatial-relational,6|7,7,6/7,230457,6
5,1,23,458,0,1453,1,11,5,6,6,single-choice,spatial-relational,5|6,7,5/6,230458,5
5,1,23,459,1,1638,1,11,5,5,6,single-choice,spatial-relational,5|6,7,5/6,230459,5
5,1,23,460,0,1015,1,7,3,4,4,single-choice,spatial-relational,3|4,7,3/4,230460,3
5,1,23,461,0,1934,1,9,4,5,5,single-choice,spatial-relational,4|5,7,4/5,230461,4
5,1,23,462,1,943,1,13,6,6,7,single-choice,spatial-relational,6|7,7,6/7,230462,6
5,1,23,463,1,872,1,5,2,2,3,single-choice,spatial-relational,2|3,7,2/3,230463,2
5,1,23,464,1,688,1,5,2,2,3,single-choice,spatial-relational,2|3,7,2/3,230464,2
5,1,23,465,1,928,1,9,4,4,5,single-choice,spatial-relational,4|5,7,4/5,230465,4
5,1,23,466,1,1210,1,7,3,3,4,single-choice,spatial-relational,3|4,7,3/4,230466,3
5,1,23,467,1,659,1,3,1,1,2,single-choice,spatial-relational,1|2,7,1/2,230467,1
5,1,23,468,0,609,1,3,1,2,2,single-choice,spatial-relational,1|2,7,1/2,230468,1
5,1,23,469,1,887,1,3,1,1,2,single-choice,spatial-relational,1|2,7,1/2,230469,1
5,1,23,470,1,870,1,13,6,6,7,single-choice,spatial-relational,6|7,7,6/7,230470,6
5,1,23,471,0,1129,1,11,5,6,6,single-choice,spatial-relational,5|6,7,5/6,230471,5
5,1,23,472,1,1032,1,11,5,5,6,single-choice,spatial-relational,5|6,7,5/6,230472,5
5,1,23,473,0,824,1,7,3,4,4,single-choice,spatial-relational,3|4,7,3/4,230473,3
5,1,23,474,1,933,1,9,4,4,5,single-choice,spatial-relational,4|5,7,4/5,230474,4
5,1,23,475,1,938,1,5,2,2,3,single-choice,spatial-relational,2|3,7,2/3,230475,2
5,1,23,476,1,1309,1,7,3,3,4,single-choice,spatial-relational,3|4,7,3/4,230476,3
5,1,23,477,1,865,1,5,2,2,3,single-choice,spatial-relational,2|3,7,2/3,230477,2
5,1,23,478,1,902,1,3,1,1,2,single-choice,spatial-relational,1|2,7,1/2,230478,1
5,1,23,479,1,871,1,13,6,6,7,single-choice,spatial-relational,6|7,7,6/7,230479,6
5,1,23,480,0,1329,1,9,4,5,5,single-choice,spatial-relational,4|5,7,4/5,230480,4
5,1,23,481,0,982,1,7,3,4,4,single-choice,spatial-relational,3|4,7,3/4,230481,3
5,1,23,482,0,1279,1,11,5,6,6,single-choice,spatial-relational,5|6,7,5/6,230482,5
5,1,23,483,1,843,1,5,2,2,3,single-choice,spatial-relational,2|3,7,2/3,230483,2
5,1,23,484,1,1085,1,9,4,4,5,single-choice,spatial-relational,4|5,7,4/5,230484,4
5,1,23,485,1,1531,1,13,6,6,7,single-choice,spatial-relational,6|7,7,6/7,230485,6
5,1,23,486,0,796,1,3,1,2,2,single-choice,spatial-relational,1|2,7,1/2,230486,1
5,1,23,487,1,971,1,9,4,4,5,single-choice,spatial-relational,4|5,7,4/5,230487,4
5,1,23,488,1,1345,1,11,5,5,6,single-choice,spatial-relational,5|6,7,5/6,230488,5
5,1,23,489,1,774,1,3,1,1,2,single-choice,spatial-relational,1|2,7,1/2,230489,1
5,1,23,490,1,755,1,5,2,2,3,single-choice,spatial-relational,2|3,7,2/3,230490,2
5,1,23,491,1,864,1,7,3,3,4,single-choice,spatial-relational,3|4,7,3/4,230491,3
5,1,23,492,1,684,1,13,6,6,7,single-choice,spatial-relational,6|7,7,6/7,230492,6
5,1,23,493,1,1323,1,13,6,6,7,single-choice,spatial-relational,6|7,7,6/7,230493,6
5,1,23,494,0,892,1,9,4,5,5,single-choice,spatial-relational,4|5,7,4/5,230494,4
5,1,23,495,1,688,1,3,1,1,2,single-choice,spatial-relational,1|2,7,1/2,230495,1
5,1,23,496,1,894,1,11,5,5,6,single-choice,spatial-relational,5|6,7,5/6,230496,5
5,1,23,497,0,1008,1,7,3,4,4,single-choice,spatial-relational,3|4,7,3/4,230497,3
5,1,23,498,0,832,1,9,4,5,5,single-choice,spatial-relational,4|5,7,4/5,230498,4
5,1,23,499,1,1134,1,13,6,6,7,single-choice,spatial-relational,6|7,7,6/7,230499,6
5,1,23,500,1,1477,1,11,5,5,6,single-choice,spatial-relational,5|6,7,5/6,230500,5
5,1,23,501,1,798,1,5,2,2,3,single-choice,spatial-relational,2|3,7,2/3,230501,2
5,1,23,502,1,639,1,5,2,2,3,single-choice,spatial-relational,2|3,7,2/3,230502,2
5,1,23,503,0,645,1,3,1,2,2,single-choice,spatial-relational,1|2,7,1/2,230503,1
5,1,23,504,1,1046,1,7,3,3,4,single-choice,spatial-relational,3|4,7,3/4,230504,3
5,1,23,505,1,1104,1,9,4,4,5,single-choice,spatial-relational,4|5,7,4/5,230505,4
5,1,23,506,1,722,1,7,3,3,4,single-choice,spatial-relational,3|4,7,3/4,230506,3
5,1,23,507,1,888,1,13,6,6,7,single-choice,spatial-relational,6|7,7,6/7,230507,6
5,1,23,508,1,843,1,5,2,2,3,single-choice,spatial-relational,2|3,7,2/3,230508,2
5,1,23,509,0,881,1,11,5,6,6,single-choice,spatial-relational,5|6,7,5/6,230509,5
5,1,23,510,1,743,1,3,1,1,2,single-choice,spatial-relational,1|2,7,1/2,230510,1
5,1,23,511,1,948,1,3,1,1,2,single-choice,spatial-relational,1|2,7,1/2,230511,1
5,1,23,512,0,650,1,5,2,3,3,single-choice,spatial-relational,2|3,7,2/3,230512,2
5,1,23,513,0,776,1,9,4,5,5,single-choice,spatial-relational,4|5,7,4/5,230513,4
5,1,23,514,0,940,1,11,5,6,6,single-choice,spatial-relational,5|6,7,5/6,230514,5
5,1,23,515,1,1296,1,13,6,6,7,single-choice,spatial-relational,6|7,7,6/7,230515,6
5,1,23,516,0,1197,1,7,3,4,4,single-choice,spatial-relational,3|4,7,3/4,230516,3
5,1,23,517,1,831,1,11,5,5,6,single-choice,spatial-relational,5|6,7,5/6,230517,5
5,1,23,518,1,1933,1,13,6,6,7,single-choice,spatial-relational,6|7,7,6/7,230518,6
5,1,23,519,0,934,1,3,1,2,2,single-choice,spatial-relational,1|2,7,1/2,230519,1
5,1,23,520,0,1311,1,9,4,5,5,single-choice,spatial-relational,4|5,7,4/5,230520,4
5,1,23,521,1,819,1,13,6,6,7,single-choice,spatial-relational,6|7,7,6/7,230521,6
5,1,23,522,1,885,1,7,3,3,4,single-choice,spatial-relational,3|4,7,3/4,230522,3
5,1,23,523,1,635,1,5,2,2,3,single-choice,spatial-relational,2|3,7,2/3,230523,2
5,1,23,524,0,1334,1,11,5,6,6,single-choice,spatial-relational,5|6,7,5/6,230524,5
5,1,23,525,1,886,1,3,1,1,2,single-choice,spatial-relational,1|2,7,1/2,230525,1
5,1,23,526,1,919,1,9,4,4,5,single-choice,spatial-relational,4|5,7,4/5,230526,4
5,1,23,527,1,895,1,5,2,2,3,single-choice,spatial-relational,2|3,7,2/3,230527,2
5,1,23,528,1,754,1,7,3,3,4,single-choice,spatial-relational,3|4,7,3/4,230528,3
5,1,23,529,1,913,1,5,2,2,3,single-choice,spatial-relational,2|3,7,2/3,230529,2
5,1,23,530,1,703,1,5,2,2,3,single-choice,spatial-relational,2|3,7,2/3,230530,2
5,1,23,531,1,1226,1,13,6,6,7,single-choice,spatial-relational,6|7,7,6/7,230531,6
5,1,23,532,1,1430,1,9,4,4,5,single-choice,spatial-relational,4|5,7,4/5,230532,4
5,1,23,533,0,744,1,7,3,4,4,single-choice,spatial-relational,3|4,7,3/4,230533,3
5,1,23,534,0,878,1,9,4,5,5,single-choice,spatial-relational,4|5,7,4/5,230534,4
5,1,23,535,0,1240,1,11,5,6,6,single-choice,spatial-relational,5|6,7,5/6,230535,5
5,1,23,536,1,1011,1,11,5,5,6,single-choice,spatial-relational,5|6,7,5/6,230536,5
5,1,23,537,1,1154,1,13,6,6,7,single-choice,spatial-relational,6|7,7,6/7,230537,6
5,1,23,538,0,1956,1,3,1,2,2,single-choice,spatial-relational,1|2,7,1/2,230538,1
5,1,23,539,0,823,1,3,1,2,2,single-choice,spatial-relational,1|2,7,1/2,230539,1
5,1,23,540,1,808,1,7,3,3,4,single-choice,spatial-relational,3|4,7,3/4,230540,3
5,1,23,541,1,946,1,3,1,1,2,single-choice,spatial-relational,1|2,7,1/2,230541,1
5,1,23,542,0,745,1,5,2,3,3,single-choice,spatial-relational,2|3,7,2/3,230542,2
5,1,23,543,1,830,1,11,5,5,6,single-choice,spatial-relational,5|6,7,5/6,230543,5
5,1,23,544,0,1254,1,7,3,4,4,single-choice,spatial-relational,3|4,7,3/4,230544,3
5,1,23,545,1,852,1,11,5,5,6,single-choice,spatial-relational,5|6,7,5/6,230545,5
5,1,23,546,0,1131,1,5,2,3,3,single-choice,spatial-relational,2|3,7,2/3,230546,2
5,1,23,547,1,981,1,9,4,4,5,single-choice,spatial-relational,4|5,7,4/5,230547,4
5,1,23,548,1,1370,1,9,4,4,5,single-choice,spatial-relational,4|5,7,4/5,230548,4
5,1,23,549,0,1077,1,7,3,4,4,single-choice,spatial-relational,3|4,7,3/4,230549,3
5,1,23,550,1,1492,1,13,6,6,7,single-choice,spatial-relational,6|7,7,6/7,230550,6
5,1,23,551,1,1290,1,3,1,1,2,single-choice,spatial-relational,1|2,7,1/2,230551,1
5,1,23,552,1,850,1,13,6,6,7,single-choice,spatial-relational,6|7,7,6/7,230552,6
5,1,23,553,1,1025,1,7,3,3,4,single-choice,spatial-relational,3|4,7,3/4,230553,3
5,1,23,554,1,662,1,5,2,2,3,single-choice,spatial-relational,2|3,7,2/3,230554,2
5,1,23,555,0,1076,1,9,4,5,5,single-choice,spatial-relational,4|5,7,4/5,230555,4
5,1,23,556,1,701,1,3,1,1,2,single-choice,spatial-relational,1|2,7,1/2,230556,1
5,1,23,557,0,1029,1,11,5,6,6,single-choice,spatial-relational,5|6,7,5/6,230557,5
5,1,23,558,1,1081,1,13,6,6,7,single-choice,spatial-relational,6|7,7,6/7,230558,6
5,1,23,559,1,1141,1,13,6,6,7,single-choice,spatial-relational,6|7,7,6/7,230559,6
5,1,23,560,1,963,1,11,5,5,6,single-choice,spatial-relational,5|6,7,5/6,230560,5
5,1,23,561,1,741,1,7,3,3,4,single-choice,spatial-relational,3|4,7,3/4,230561,3
5,1,23,562,1,1156,1,9,4,4,5,single-choice,spatial-relational,4|5,7,4/5,230562,4
5,1,23,563,1,910,1,5,2,2,3,single-choice,spatial-relational,2|3,7,2/3,230563,2
5,1,23,564,0,1196,1,3,1,2,2,single-choice,spatial-relational,1|2,7,1/2,230564,1
5,1,23,565,1,1043,1,5,2,2,3,single-choice,spatial-relational,2|3,7,2/3,230565,2
5,1,23,566,1,665,1,3,1,1,2,single-choice,spatial-relational,1|2,7,1/2,230566,1
5,1,23,567,1,939,1,13,6,6,7,single-choice,spatial-relational,6|7,7,6/7,230567,6
5,1,23,568,0,913,1,7,3,4,4,single-choice,spatial-relational,3|4,7,3/4,230568,3
5,1,23,569,1,1129,1,13,6,6,7,single-choice,spatial-relational,6|7,7,6/7,230569,6
5,1,23,570,0,1549,1,11,5,6,6,single-choice,spatial-relational,5|6,7,5/6,230570,5
5,1,23,571,0,854,1,7,3,4,4,single-choice,spatial-relational,3|4,7,3/4,230571,3
5,1,23,572,1,1007,1,9,4,4,5,single-choice,spatial-relational,4|5,7,4/5,230572,4
5,1,23,573,0,1816,1,9,4,5,5,single-choice,spatial-relational,4|5,7,4/5,230573,4
5,1,23,574,0,856,1,3,1,2,2,single-choice,spatial-relational,1|2,7,1/2,230574,1
5,1,23,575,1,743,1,5,2,2,3,single-choice,spatial-relational,2|3,7,2/3,230575,2
5,1,23,576,1,852,1,11,5,5,6,single-choice,spatial-relational,5|6,7,5/6,230576,5
5,1,23,577,0,52,1,11,5,6,6,single-choice,spatial-relational,5|6,7,5/6,230577,5
5,1,23,578,1,1081,1,11,5,5,6,single-choice,spatial-relational,5|6,7,5/6,230578,5
5,1,23,579,0,943,1,3,1,2,2,single-choice,spatial-relational,1|2,7,1/2,230579,1
5,1,23,580,1,1109,1,9,4,4,5,single-choice,spatial-relational,4|5,7,4/5,230580,4
5,1,23,581,1,1557,1,13,6,6,7,single-choice,spatial-relational,6|7,7,6/7,230581,6
5,1,23,582,0,1169,1,9,4,5,5,single-choice,spatial-relational,4|5,7,4/5,230582,4
5,1,23,583,1,857,1,3,1,1,2,single-choice,spatial-relational,1|2,7,1/2,230583,1
5,1,23,584,1,947,1,13,6,6,7,single-choice,spatial-relational,6|7,7,6/7,230584,6
5,1,23,585,0,1092,1,7,3,4,4,single-choice,spatial-relational,3|4,7,3/4,230585,3
5,1,23,586,1,818,1,5,2,2,3,single-choice,spatial-relational,2|3,7,2/3,230586,2
5,1,23,587,1,748,1,5,2,2,3,single-choice,spatial-relational,2|3,7,2/3,230587,2
5,1,23,588,1,60,1,7,3,3,4,single-choice,spatial-relational,3|4,7,3/4,230588,3
5,1,23,589,1,1179,1,11,5,5,6,single-choice,spatial-relational,5|6,7,5/6,230589,5
5,1,23,590,1,697,1,5,2,2,3,single-choice,spatial-relational,2|3,7,2/3,230590,2
5,1,23,591,1,963,1,13,6,6,7,single-choice,spatial-relational,6|7,7,6/7,230591,6
5,1,23,592,0,1199,1,7,3,4,4,single-choice,spatial-relational,3|4,7,3/4,230592,3
5,1,23,593,1,1059,1,7,3,3,4,single-choice,spatial-relational,3|4,7,3/4,230593,3
5,1,23,594,1,1864,1,11,5,5,6,single-choice,spatial-relational,5|6,7,5/6,230594,5
5,1,23,595,1,1031,1,9,4,4,5,single-choice,spatial-relational,4|5,7,4/5,230595,4
5,1,23,596,1,866,1,3,1,1,2,single-choice,spatial-relational,1|2,7,1/2,230596,1
5,1,23,597,1,891,1,5,2,2,3,single-choice,spatial-relational,2|3,7,2/3,230597,2
5,1,23,598,1,963,1,9,4,4,5,single-choice,spatial-relational,4|5,7,4/5,230598,4
5,1,23,599,0,996,1,13,6,7,7,single-choice,spatial-relational,6|7,7,6/7,230599,6
5,1,23,600,1,1051,1,3,1,1,2,single-choice,spatial-relational,1|2,7,1/2,230600,1
6,1,23,1,0,1172,1,13,6,7,7,single-choice,spatial-relational,6|7,7,6/7,230001,6
6,1,23,2,0,16,1,9,4,5,5,single-choice,spatial-relational,4|5,7,4/5,230002,4
6,1,23,3,1,749,1,13,6,6,7,single-choice,spatial-relational,6|7,7,6/7,230003,6
6,1,23,4,0,760,1,7,3,4,4,single-choice,spatial-relational,3|4,7,3/4,230004,3
6,1,23,5,1,575,1,5,2,2,3,single-choice,spatial-relational,2|3,7,2/3,230005,2
6,1,23,6,0,626,1,3,1,2,2,single-choice,spatial-relational,1|2,7,1/2,230006,1
6,1,23,7,0,1217,1,11,5,6,6,single-choice,spatial-relational,5|6,7,5/6,230007,5
6,1,23,8,1,500,1,9,4,4,5,single-choice,spatial-relational,4|5,7,4/5,230008,4
6,1,23,9,1,342,1,3,1,1,2,single-choice,spatial-relational,1|2,7,1/2,230009,1
6,1,23,10,0,699,1,7,3,4,4,single-choice,spatial-relational,3|4,7,3/4,230010,3
6,1,23,11,0,616,1,11,5,6,6,single-choice,spatial-relational,5|6,7,5/6,230011,5
6,1,23,12,0,545,1,5,2,3,3,single-choice,spatial-relational,2|3,7,2/3,230012,2
6,1,23,13,1,938,1,13,6,6,7,single-choice,spatial-relational,6|7,7,6/7,230013,6
6,1,23,14,1,839,1,7,3,3,4,single-choice,spatial-relational,3|4,7,3/4,230014,3
6,1,23,15,1,663,1,9,4,4,5,single-choice,spatial-relational,4|5,7,4/5,230015,4
6,1,23,16,0,695,1,9,4,5,5,single-choice,spatial-relational,4|5,7,4/5,230016,4
6,1,23,17,0,620,1,5,2,3,3,single-choice,spatial-relational,2|3,7,2/3,230017,2
6,1,23,18,0,516,1,11,5,6,6,single-choice,spatial-relational,5|6,7,5/6,230018,5
6,1,23,19,0,531,1,3,1,2,2,single-choice,spatial-relational,1|2,7,1/2,230019,1
6,1,23,20,1,508,1,5,2,2,3,single-choice,spatial-relational,2|3,7,2/3,230020,2
6,1,23,21,1,650,1,3,1,1,2,single-choice,spatial-relational,1|2,7,1/2,230021,1
6,1,23,22,0,717,1,11,5,6,6,single-choice,spatial-relational,5|6,7,5/6,230022,5
6,1,23,23,0,423,1,13,6,7,7,single-choice,spatial-relational,6|7,7,6/7,230023,6
6,1,23,24,0,32,1,7,3,4,4,single-choice,spatial-relational,3|4,7,3/4,230024,3
6,1,23,25,0,669,1,3,1,2,2,single-choice,spatial-relational,1|2,7,1/2,230025,1
6,1,23,26,0,514,1,13,6,7,7,single-choice,spatial-relational,6|7,7,6/7,230026,6
6,1,23,27,0,619,1,9,4,5,5,single-choice,spatial-relational,4|5,7,4/5,230027,4
6,1,23,28,1,754,1,9,4,4,5,single-choice,spatial-relational,4|5,7,4/5,230028,4
6,1,23,29,1,932,1,3,1,1,2,single-choice,spatial-relational,1|2,7,1/2,230029,1
6,1,23,30,1,49,1,7,3,3,4,single-choice,spatial-relational,3|4,7,3/4,230030,3
6,1,23,31,0,877,1,11,5,6,6,single-choice,spatial-relational,5|6,7,5/6,230031,5
6,1,23,32,1,841,1,5,2,2,3,single-choice,spatial-relational,2|3,7,2/3,230032,2
6,1,23,33,1,889,1,11,5,5,6,single-choice,spatial-relational,5|6,7,5/6,230033,5
6,1,23,34,0,769,1,7,3,4,4,single-choice,spatial-relational,3|4,7,3/4,230034,3
6,1,23,35,0,810,1,5,2,3,3,single-choice,spatial-relational,2|3,7,2/3,230035,2
6,1,23,36,1,887,1,13,6,6,7,single-choice,spatial-relational,6|7,7,6/7,230036,6
6,1,23,37,1,799,1,5,2,2,3,single-choice,spatial-relational,2|3,7,2/3,230037,2
6,1,23,38,1,844,1,13,6,6,7,single-choice,spatial-relational,6|7,7,6/7,230038,6
6,1,23,39,0,612,1,7,3,4,4,single-choice,spatial-relational,3|4,7,3/4,230039,3
6,1,23,40,0,919,1,9,4,5,5,single-choice,spatial-relational,4|5,7,4/5,230040,4
6,1,23,41,0,769,1,13,6,7,7,single-choice,spatial-relational,6|7,7,6/7,230041,6
6,1,23,42,1,861,1,3,1,1,2,single-choice,spatial-relational,1|2,7,1/2,230042,1
6,1,23,43,1,1155,1,11,5,5,6,single-choice,spatial-relational,5|6,7,5/6,230043,5
6,1,23,44,1,1007,1,7,3,3,4,single-choice,spatial-relational,3|4,7,3/4,230044,3
6,1,23,45,1,977,1,5,2,2,3,single-choice,spatial-relational,2|3,7,2/3,230045,2
6,1,23,46,1,1040,1,11,5,5,6,single-choice,spatial-relational,5|6,7,5/6,230046,5
6,1,23,47,0,706,1,3,1,2,2,single-choice,spatial-relational,1|2,7,1/2,230047,1
6,1,23,48,1,1135,1,9,4,4,5,single-choice,spatial-relational,4|5,7,4/5,230048,4
6,1,23,49,1,1590,1,11,5,5,6,single-choice,spatial-relational,5|6,7,5/6,230049,5
6,1,23,50,0,1028,1,13,6,7,7,single-choice,spatial-relational,6|7,7,6/7,230050,6
6,1,23,51,0,803,1,9,4,5,5,single-choice,spatial-relational,4|5,7,4/5,230051,4
6,1,23,52,0,960,1,5,2,3,3,single-choice,spatial-relational,2|3,7,2/3,230052,2
6,1,23,53,0,826,1,3,1,2,2,single-choice,spatial-relational,1|2,7,1/2,230053,1
6,1,23,54,0,974,1,7,3,4,4,single-choice,spatial-relational,3|4,7,3/4,230054,3
6,1,23,55,1,978,1,5,2,2,3,single-choice,spatial-relational,2|3,7,2/3,230055,2
6,1,23,56,1,839,1,7,3,3,4,single-choice,spatial-relational,3|4,7,3/4,230056,3
6,1,23,57,1,1689,1,11,5,5,6,single-choice,spatial-relational,5|6,7,5/6,230057,5
6,1,23,58,0,1444,1,9,4,5,5,single-choice,spatial-relational,4|5,7,4/5,230058,4
6,1,23,59,1,852,1,13,6,6,7,single-choice,spatial-relational,6|7,7,6/7,230059,6
6,1,23,60,1,936,1,3,1,1,2,single-choice,spatial-relational,1|2,7,1/2,230060,1
6,1,23,61,0,1302,1,5,2,3,3,single-choice,spatial-relational,2|3,7,2/3,230061,2
6,1,23,62,1,813,1,3,1,1,2,single-choice,spatial-relational,1|2,7,1/2,230062,1
6,1,23,63,0,950,1,7,3,4,4,single-choice,spatial-relational,3|4,7,3/4,230063,3
6,1,23,64,0,881,1,13,6,7,7,single-choice,spatial-relational,6|7,7,6/7,230064,6
6,1,23,65,0,920,1,5,2,3,3,single-choice,spatial-relational,2|3,7,2/3,230065,2
6,1,23,66,0,961,1,9,4,5,5,single-choice,spatial-relational,4|5,7,4/5,230066,4
6,1,23,67,1,1204,1,9,4,4,5,single-choice,spatial-relational,4|5,7,4/5,230067,4
6,1,23,68,1,1242,1,3,1,1,2,single-choice,spatial-relational,1|2,7,1/2,230068,1
6,1,23,69,1,1074,1,7,3,3,4,single-choice,spatial-relational,3|4,7,3/4,230069,3
6,1,23,70,0,1301,1,11,5,6,6,single-choice,spatial-relational,5|6,7,5/6,230070,5
6,1,23,71,0,923,1,11,5,6,6,single-choice,spatial-relational,5|6,7,5/6,230071,5
6,1,23,72,1,1035,1,13,6,6,7,single-choice,spatial-relational,6|7,7,6/7,230072,6
6,1,23,73,1,1052,1,3,1,1,2,single-choice,spatial-relational,1|2,7,1/2,230073,1
6,1,23,74,1,861,1,13,6,6,7,single-choice,spatial-relational,6|7,7,6/7,230074,6
6,1,23,75,1,1070,1,11,5,5,6,single-choice,spatial-relational,5|6,7,5/6,230075,5
6,1,23,76,0,774,1,3,1,2,2,single-choice,spatial-relational,1|2,7,1/2,230076,1
6,1,23,77,0,943,1,7,3,4,4,single-choice,spatial-relational,3|4,7,3/4,230077,3
6,1,23,78,1,1035,1,9,4,4,5,single-choice,spatial-relational,4|5,7,4/5,230078,4
6,1,23,79,0,1269,1,7,3,4,4,single-choice,spatial-relational,3|4,7,3/4,230079,3
6,1,23,80,1,40,1,13,6,6,7,single-choice,spatial-relational,6|7,7,6/7,230080,6
6,1,23,81,1,935,1,5,2,2,3,single-choice,spatial-relational,2|3,7,2/3,230081,2
6,1,23,82,1,664,1,5,2,2,3,single-choice,spatial-relational,2|3,7,2/3,230082,2
6,1,23,83,0,1159,1,11,5,6,6,single-choice,spatial-relational,5|6,7,5/6,230083,5
6,1,23,84,0,993,1,9,4,5,5,single-choice,spatial-relational,4|5,7,4/5,230084,4
6,1,23,85,1,1365,1,11,5,5,6,single-choice,spatial-relational,5|6,7,5/6,230085,5
6,1,23,86,0,1408,1,9,4,5,5,single-choice,spatial-relational,4|5,7,4/5,230086,4
6,1,23,87,0,902,1,11,5,6,6,single-choice,spatial-relational,5|6,7,5/6,230087,5
6,1,23,88,1,813,1,5,2,2,3,single-choice,spatial-relational,2|3,7,2/3,230088,2
6,1,23,89,1,1052,1,9,4,4,5,single-choice,spatial-relational,4|5,7,4/5,230089,4
6,1,23,90,1,1113,1,7,3,3,4,single-choice,spatial-relational,3|4,7,3/4,230090,3
6,1,23,91,1,871,1,13,6,6,7,single-choice,spatial-relational,6|7,7,6/7,230091,6
6,1,23,92,1,912,1,3,1,1,2,single-choice,spatial-relational,1|2,7,1/2,230092,1
6,1,23,93,0,773,1,13,6,7,7,single-choice,spatial-relational,6|7,7,6/7,230093,6
6,1,23,94,0,1048,1,3,1,2,2,single-choice,spatial-relational,1|2,7,1/2,230094,1
6,1,23,95,1,974,1,5,2,2,3,single-choice,spatial-relational,2|3,7,2/3,230095,2
6,1,23,96,1,953,1,7,3,3,4,single-choice,spatial-relational,3|4,7,3/4,230096,3
6,1,23,97,0,963,1,13,6,7,7,single-choice,spatial-relational,6|7,7,6/7,230097,6
6,1,23,98,0,1130,1,11,5,6,6,single-choice,spatial-relational,5|6,7,5/6,230098,5
6,1,23,99,0,753,1,3,1,2,2,single-choice,spatial-relational,1|2,7,1/2,230099,1
6,1,23,100,1,980,1,11,5,5,6,single-choice,spatial-relational,5|6,7,5/6,230100,5
6,1,23,101,1,821,1,3,1,1,2,single-choice,spatial-relational,1|2,7,1/2,230101,1
6,1,23,102,0,1278,1,9,4,5,5,single-choice,spatial-relational,4|5,7,4/5,230102,4
6,1,23,103,1,811,1,5,2,2,3,single-choice,spatial-relational,2|3,7,2/3,230103,2
6,1,23,104,1,862,1,7,3,3,4,single-choice,spatial-relational,3|4,7,3/4,230104,3
6,1,23,105,1,997,1,9,4,4,5,single-choice,spatial-relational,4|5,7,4/5,230105,4
6,1,23,106,1,667,1,7,3,3,4,single-choice,spatial-relational,3|4,7,3/4,230106,3
6,1,23,107,1,931,1,13,6,6,7,single-choice,spatial-relational,6|7,7,6/7,230107,6
6,1,23,108,1,851,1,5,2,2,3,single-choice,spatial-relational,2|3,7,2/3,230108,2
6,1,23,109,1,855,1,9,4,4,5,single-choice,spatial-relational,4|5,7,4/5,230109,4
6,1,23,110,1,1025,1,13,6,6,7,single-choice,spatial-relational,6|7,7,6/7,230110,6
6,1,23,111,1,963,1,3,1,1,2,single-choice,spatial-relational,1|2,7,1/2,230111,1
6,1,23,112,1,758,1,13,6,6,7,single-choice,spatial-relational,6|7,7,6/7,230112,6
6,1,23,113,1,904,1,7,3,3,4,single-choice,spatial-relational,3|4,7,3/4,230113,3
6,1,23,114,1,1053,1,9,4,4,5,single-choice,spatial-relational,4|5,7,4/5,230114,4
6,1,23,115,1,841,1,5,2,2,3,single-choice,spatial-relational,2|3,7,2/3,230115,2
6,1,23,116,0,852,1,11,5,6,6,single-choice,spatial-relational,5|6,7,5/6,230116,5
6,1,23,117,1,1007,1,3,1,1,2,single-choice,spatial-relational,1|2,7,1/2,230117,1
6,1,23,118,0,854,1,7,3,4,4,single-choice,spatial-relational,3|4,7,3/4,230118,3
6,1,23,119,1,1020,1,5,2,2,3,single-choice,spatial-relational,2|3,7,2/3,230119,2
6,1,23,120,0,1202,1,11,5,6,6,single-choice,spatial-relational,5|6,7,5/6,230120,5
6,1,23,121,1,1399,1,5,2,2,3,single-choice,spatial-relational,2|3,7,2/3,230121,2
6,1,23,122,1,943,1,5,2,2,3,single-choice,spatial-relational,2|3,7,2/3,230122,2
6,1,23,123,1,806,1,13,6,6,7,single-choice,spatial-relational,6|7,7,6/7,230123,6
6,1,23,124,0,178,1,7,3,4,4,single-choice,spatial-relational,3|4,7,3/4,230124,3
6,1,23,125,1,1089,1,7,3,3,4,single-choice,spatial-relational,3|4,7,3/4,230125,3
6,1,23,126,0,776,1,3,1,2,2,single-choice,spatial-relational,1|2,7,1/2,230126,1
6,1,23,127,0,1226,1,9,4,5,5,single-choice,spatial-relational,4|5,7,4/5,230127,4
6,1,23,128,1,918,1,9,4,4,5,single-choice,spatial-relational,4|5,7,4/5,230128,4
6,1,23,129,1,1336,1,11,5,5,6,single-choice,spatial-relational,5|6,7,5/6,230129,5
6,1,23,130,1,996,1,11,5,5,6,single-choice,spatial-relational,5|6,7,5/6,230130,5
6,1,23,131,1,1007,1,13,6,6,7,single-choice,spatial-relational,6|7,7,6/7,230131,6
6,1,23,132,0,761,1,3,1,2,2,single-choice,spatial-relational,1|2,7,1/2,230132,1
6,1,23,133,1,1298,1,11,5,5,6,single-choice,spatial-relational,5|6,7,5/6,230133,5
6,1,23,134,1,854,1,7,3,3,4,single-choice,spatial-relational,3|4,7,3/4,230134,3
6,1,23,135,1,869,1,7,3,3,4,single-choice,spatial-relational,3|4,7,3/4,230135,3
6,1,23,136,1,1045,1,11,5,5,6,single-choice,spatial-relational,5|6,7,5/6,230136,5
6,1,23,137,1,1170,1,13,6,6,7,single-choice,spatial-relational,6|7,7,6/7,230137,6
6,1,23,138,1,847,1,3,1,1,2,single-choice,spatial-relational,1|2,7,1/2,230138,1
6,1,23,139,1,849,1,13,6,6,7,single-choice,spatial-relational,6|7,7,6/7,230139,6
6,1,23,140,1,1014,1,5,2,2,3,single-choice,spatial-relational,2|3,7,2/3,230140,2
6,1,23,141,1,1266,1,9,4,4,5,single-choice,spatial-relational,4|5,7,4/5,230141,4
6,1,23,142,0,1126,1,5,2,3,3,single-choice,spatial-relational,2|3,7,2/3,230142,2
6,1,23,143,0,1042,1,9,4,5,5,single-choice,spatial-relational,4|5,7,4/5,230143,4
6,1,23,144,0,1001,1,3,1,2,2,single-choice,spatial-relational,1|2,7,1/2,230144,1
6,1,23,145,1,940,1,7,3,3,4,single-choice,spatial-relational,3|4,7,3/4,230145,3
6,1,23,146,1,1261,1,13,6,6,7,single-choice,spatial-relational,6|7,7,6/7,230146,6
6,1,23,147,1,1115,1,5,2,2,3,single-choice,spatial-relational,2|3,7,2/3,230147,2
6,1,23,148,1,699,1,7,3,3,4,single-choice,spatial-relational,3|4,7,3/4,230148,3
6,1,23,149,1,852,1,13,6,6,7,single-choice,spatial-relational,6|7,7,6/7,230149,6
6,1,23,150,0,933,1,3,1,2,2,single-choice,spatial-relational,1|2,7,1/2,230150,1
6,1,23,151,1,825,1,9,4,4,5,single-choice,spatial-relational,4|5,7,4/5,230151,4
6,1,23,152,1,1057,1,11,5,5,6,single-choice,spatial-relational,5|6,7,5/6,230152,5
6,1,23,153,0,748,1,5,2,3,3,single-choice,spatial-relational,2|3,7,2/3,230153,2
6,1,23,154,1,808,1,11,5,5,6,single-choice,spatial-relational,5|6,7,5/6,230154,5
6,1,23,155,1,1078,1,9,4,4,5,single-choice,spatial-relational,4|5,7,4/5,230155,4
6,1,23,156,1,893,1,3,1,1,2,single-choice,spatial-relational,1|2,7,1/2,230156,1
6,1,23,157,1,756,1,7,3,3,4,single-choice,spatial-relational,3|4,7,3/4,230157,3
6,1,23,158,1,1310,1,11,5,5,6,single-choice,spatial-relational,5|6,7,5/6,230158,5
6,1,23,159,1,1728,1,9,4,4,5,single-choice,spatial-relational,4|5,7,4/5,230159,4
6,1,23,160,1,1076,1,11,5,5,6,single-choice,spatial-relational,5|6,7,5/6,230160,5
6,1,23,161,1,1226,1,7,3,3,4,single-choice,spatial-relational,3|4,7,3/4,230161,3
6,1,23,162,1,1313,1,13,6,6,7,single-choice,spatial-relational,6|7,7,6/7,230162,6
6,1,23,163,1,1161,1,5,2,2,3,single-choice,spatial-relational,2|3,7,2/3,230163,2
6,1,23,164,1,1402,1,13,6,6,7,single-choice,spatial-relational,6|7,7,6/7,230164,6
6,1,23,165,1,1323,1,9,4,4,5,single-choice,spatial-relational,4|5,7,4/5,230165,4
6,1,23,166,1,902,1,5,2,2,3,single-choice,spatial-relational,2|3,7,2/3,230166,2
6,1,23,167,0,757,1,3,1,2,2,single-choice,spatial-relational,1|2,7,1/2,230167,1
6,1,23,168,1,792,1,3,1,1,2,single-choice,spatial-relational,1|2,7,1/2,230168,1
6,1,23,169,1,781,1,3,1,1,2,single-choice,spatial-relational,1|2,7,1/2,230169,1
6,1,23,170,1,766,1,7,3,3,4,single-choice,spatial-relational,3|4,7,3/4,230170,3
6,1,23,171,0,868,1,5,2,3,3,single-choice,spatial-relational,2|3,7,2/3,230171,2
6,1,23,172,1,812,1,13,6,6,7,single-choice,spatial-relational,6|7,7,6/7,230172,6
6,1,23,173,0,989,1,3,1,2,2,single-choice,spatial-relational,1|2,7,1/2,230173,1
6,1,23,174,1,991,1,13,6,6,7,single-choice,spatial-relational,6|7,7,6/7,230174,6
6,1,23,175,1,985,1,5,2,2,3,single-choice,spatial-relational,2|3,7,2/3,230175,2
6,1,23,176,1,1062,1,11,5,5,6,single-choice,spatial-relational,5|6,7,5/6,230176,5
6,1,23,177,1,1120,1,9,4,4,5,single-choice,spatial-relational,4|5,7,4/5,230177,4
6,1,23,178,1,1083,1,7,3,3,4,single-choice,spatial-relational,3|4,7,3/4,230178,3
6,1,23,179,1,761,1,11,5,5,6,single-choice,spatial-relational,5|6,7,5/6,230179,5
6,1,23,180,1,1327,1,9,4,4,5,single-choice,spatial-relational,4|5,7,4/5,230180,4
6,1,23,181,1,928,1,7,3,3,4,single-choice,spatial-relational,3|4,7,3/4,230181,3
6,1,23,182,1,830,1,5,2,2,3,single-choice,spatial-relational,2|3,7,2/3,230182,2
6,1,23,183,1,706,1,5,2,2,3,single-choice,spatial-relational,2|3,7,2/3,230183,2
6,1,23,184,1,825,1,13,6,6,7,single-choice,spatial-relational,6|7,7,6/7,230184,6
6,1,23,185,1,997,1,3,1,1,2,single-choice,spatial-relational,1|2,7,1/2,230185,1
6,1,23,186,0,720,1,11,5,6,6,single-choice,spatial-relational,5|6,7,5/6,230186,5
6,1,23,187,1,899,1,9,4,4,5,single-choice,spatial-relational,4|5,7,4/5,230187,4
6,1,23,188,1,1111,1,13,6,6,7,single-choice,spatial-relational,6|7,7,6/7,230188,6
6,1,23,189,1,977,1,11,5,5,6,single-choice,spatial-relational,5|6,7,5/6,230189,5
6,1,23,190,0,1048,1,9,4,5,5,single-choice,spatial-relational,4|5,7,4/5,230190,4
6,1,23,191,1,1240,1,7,3,3,4,single-choice,spatial-relational,3|4,7,3/4,230191,3
6,1,23,192,1,1140,1,3,1,1,2,single-choice,spatial-relational,1|2,7,1/2,230192,1
6,1,23,193,1,122,1,5,2,2,3,single-choice,spatial-relational,2|3,7,2/3,230193,2
6,1,23,194,1,771,1,13,6,6,7,single-choice,spatial-relational,6|7,7,6/7,230194,6
6,1,23,195,1,1184,1,7,3,3,4,single-choice,spatial-relational,3|4,7,3/4,230195,3
6,1,23,196,1,905,1,13,6,6,7,single-choice,spatial-relational,6|7,7,6/7,230196,6
6,1,23,197,1,1208,1,11,5,5,6,single-choice,spatial-relational,5|6,7,5/6,230197,5
6,1,23,198,1,792,1,5,2,2,3,single-choice,spatial-relational,2|3,7,2/3,230198,2
6,1,23,199,0,1377,1,11,5,6,6,single-choice,spatial-relational,5|6,7,5/6,230199,5
6,1,23,200,1,767,1,3,1,1,2,single-choice,spatial-relational,1|2,7,1/2,230200,1
6,1,23,201,0,95,1,7,3,4,4,single-choice,spatial-relational,3|4,7,3/4,230201,3
6,1,23,202,1,879,1,9,4,4,5,single-choice,spatial-relational,4|5,7,4/5,230202,4
6,1,23,203,0,1404,1,9,4,5,5,single-choice,spatial-relational,4|5,7,4/5,230203,4
6,1,23,204,0,964,1,3,1,2,2,single-choice,spatial-relational,1|2,7,1/2,230204,1
6,1,23,205,1,785,1,13,6,6,7,single-choice,spatial-relational,6|7,7,6/7,230205,6
6,1,23,206,1,926,1,9,4,4,5,single-choice,spatial-relational,4|5,7,4/5,230206,4
6,1,23,207,1,885,1,13,6,6,7,single-choice,spatial-relational,6|7,7,6/7,230207,6
6,1,23,208,1,1234,1,11,5,5,6,single-choice,spatial-relational,5|6,7,5/6,230208,5
6,1,23,209,1,791,1,3,1,1,2,single-choice,spatial-relational,1|2,7,1/2,230209,1
6,1,23,210,1,832,1,5,2,2,3,single-choice,spatial-relational,2|3,7,2/3,230210,2
6,1,23,211,1,919,1,11,5,5,6,single-choice,spatial-relational,5|6,7,5/6,230211,5
6,1,23,212,1,798,1,5,2,2,3,single-choice,spatial-relational,2|3,7,2/3,230212,2
6,1,23,213,0,692,1,3,1,2,2,single-choice,spatial-relational,1|2,7,1/2,230213,1
6,1,23,214,1,999,1,7,3,3,4,single-choice,spatial-relational,3|4,7,3/4,230214,3
6,1,23,215,1,1021,1,9,4,4,5,single-choice,spatial-relational,4|5,7,4/5,230215,4
6,1,23,216,1,1101,1,7,3,3,4,single-choice,spatial-relational,3|4,7,3/4,230216,3
6,1,23,217,1,846,1,5,2,2,3,single-choice,spatial-relational,2|3,7,2/3,230217,2
6,1,23,218,1,851,1,13,6,6,7,single-choice,spatial-relational,6|7,7,6/7,230218,6
6,1,23,219,1,1244,1,13,6,6,7,single-choice,spatial-relational,6|7,7,6/7,230219,6
6,1,23,220,1,1194,1,11,5,5,6,single-choice,spatial-relational,5|6,7,5/6,230220,5
6,1,23,221,0,1485,1,9,4,5,5,single-choice,spatial-relational,4|5,7,4/5,230221,4
6,1,23,222,1,839,1,3,1,1,2,single-choice,spatial-relational,1|2,7,1/2,230222,1
6,1,23,223,1,744,1,7,3,3,4,single-choice,spatial-relational,3|4,7,3/4,230223,3
6,1,23,224,1,686,1,5,2,2,3,single-choice,spatial-relational,2|3,7,2/3,230224,2
6,1,23,225,0,831,1,7,3,4,4,single-choice,spatial-relational,3|4,7,3/4,230225,3
6,1,23,226,1,888,1,9,4,4,5,single-choice,spatial-relational,4|5,7,4/5,230226,4
6,1,23,227,1,1125,1,11,5,5,6,single-choice,spatial-relational,5|6,7,5/6,230227,5
6,1,23,228,1,917,1,3,1,1,2,single-choice,spatial-relational,1|2,7,1/2,230228,1
6,1,23,229,1,810,1,9,4,4,5,single-choice,spatial-relational,4|5,7,4/5,230229,4
6,1,23,230,1,1018,1,9,4,4,5,single-choice,spatial-relational,4|5,7,4/5,230230,4
6,1,23,231,1,990,1,11,5,5,6,single-choice,spatial-relational,5|6,7,5/6,230231,5
6,1,23,232,0,806,1,7,3,4,4,single-choice,spatial-relational,3|4,7,3/4,230232,3
6,1,23,233,1,953,1,13,6,6,7,single-choice,spatial-relational,6|7,7,6/7,230233,6
6,1,23,234,1,1187,1,13,6,6,7,single-choice,spatial-relational,6|7,7,6/7,230234,6
6,1,23,235,0,976,1,3,1,2,2,single-choice,spatial-relational,1|2,7,1/2,230235,1
6,1,23,236,0,1096,1,3,1,2,2,single-choice,spatial-relational,1|2,7,1/2,230236,1
6,1,23,237,1,773,1,5,2,2,3,single-choice,spatial-relational,2|3,7,2/3,230237,2
6,1,23,238,1,750,1,5,2,2,3,single-choice,spatial-relational,2|3,7,2/3,230238,2
6,1,23,239,1,982,1,11,5,5,6,single-choice,spatial-relational,5|6,7,5/6,230239,5
6,1,23,240,0,743,1,7,3,4,4,single-choice,spatial-relational,3|4,7,3/4,230240,3
6,1,23,241,1,978,1,5,2,2,3,single-choice,spatial-relational,2|3,7,2/3,230241,2
6,1,23,242,1,1031,1,11,5,5,6,single-choice,spatial-relational,5|6,7,5/6,230242,5
6,1,23,243,1,1242,1,7,3,3,4,single-choice,spatial-relational,3|4,7,3/4,230243,3
6,1,23,244,1,915,1,13,6,6,7,single-choice,spatial-relational,6|7,7,6/7,230244,6
6,1,23,245,1,1238,1,9,4,4,5,single-choice,spatial-relational,4|5,7,4/5,230245,4
6,1,23,246,1,997,1,5,2,2,3,single-choice,spatial-relational,2|3,7,2/3,230246,2
6,1,23,247,1,825,1,3,1,1,2,single-choice,spatial-relational,1|2,7,1/2,230247,1
6,1,23,248,1,696,1,9,4,4,5,single-choice,spatial-relational,4|5,7,4/5,230248,4
6,1,23,249,0,692,1,3,1,2,2,single-choice,spatial-relational,1|2,7,1/2,230249,1
6,1,23,250,1,815,1,13,6,6,7,single-choice,spatial-relational,6|7,7,6/7,230250,6
6,1,23,251,1,920,1,7,3,3,4,single-choice,spatial-relational,3|4,7,3/4,230251,3
6,1,23,252,0,994,1,11,5,6,6,single-choice,spatial-relational,5|6,7,5/6,230252,5
6,1,23,253,1,903,1,5,2,2,3,single-choice,spatial-relational,2|3,7,2/3,230253,2
6,1,23,254,1,946,1,13,6,6,7,single-choice,spatial-relational,6|7,7,6/7,230254,6
6,1,23,255,1,1003,1,13,6,6,7,single-choice,spatial-relational,6|7,7,6/7,230255,6
6,1,23,256,0,992,1,9,4,5,5,single-choice,spatial-relational,4|5,7,4/5,230256,4
6,1,23,257,1,753,1,3,1,1,2,single-choice,spatial-relational,1|2,7,1/2,230257,1
6,1,23,258,1,824,1,7,3,3,4,single-choice,spatial-relational,3|4,7,3/4,230258,3
6,1,23,259,0,907,1,3,1,2,2,single-choice,spatial-relational,1|2,7,1/2,230259,1
6,1,23,260,0,1149,1,11,5,6,6,single-choice,spatial-relational,5|6,7,5/6,230260,5
6,1,23,261,0,880,1,7,3,4,4,single-choice,spatial-relational,3|4,7,3/4,230261,3
6,1,23,262,1,1017,1,5,2,2,3,single-choice,spatial-relational,2|3,7,2/3,230262,2
6,1,23,263,1,1003,1,9,4,4,5,single-choice,spatial-relational,4|5,7,4/5,230263,4
6,1,23,264,1,1333,1,11,5,5,6,single-choice,spatial-relational,5|6,7,5/6,230264,5
6,1,23,265,1,909,1,9,4,4,5,single-choice,spatial-relational,4|5,7,4/5,230265,4
6,1,23,266,1,960,1,13,6,6,7,single-choice,spatial-relational,6|7,7,6/7,230266,6
6,1,23,267,1,1246,1,11,5,5,6,single-choice,spatial-relational,5|6,7,5/6,230267,5
6,1,23,268,0,751,1,5,2,3,3,single-choice,spatial-relational,2|3,7,2/3,230268,2
6,1,23,269,0,1151,1,3,1,2,2,single-choice,spatial-relational,1|2,7,1/2,230269,1
6,1,23,270,1,740,1,5,2,2,3,single-choice,spatial-relational,2|3,7,2/3,230270,2
6,1,23,271,0,1632,1,11,5,6,6,single-choice,spatial-relational,5|6,7,5/6,230271,5
6,1,23,272,1,1008,1,7,3,3,4,single-choice,spatial-relational,3|4,7,3/4,230272,3
6,1,23,273,1,866,1,3,1,1,2,single-choice,spatial-relational,1|2,7,1/2,230273,1
6,1,23,274,1,764,1,9,4,4,5,single-choice,spatial-relational,4|5,7,4/5,230274,4
6,1,23,275,1,872,1,7,3,3,4,single-choice,spatial-relational,3|4,7,3/4,230275,3
6,1,23,276,1,1044,1,13,6,6,7,single-choice,spatial-relational,6|7,7,6/7,230276,6
6,1,23,277,0,776,1,3,1,2,2,single-choice,spatial-relational,1|2,7,1/2,230277,1
6,1,23,278,1,1082,1,5,2,2,3,single-choice,spatial-relational,2|3,7,2/3,230278,2
6,1,23,279,1,1307,1,11,5,5,6,single-choice,spatial-relational,5|6,7,5/6,230279,5
6,1,23,280,1,895,1,3,1,1,2,single-choice,spatial-relational,1|2,7,1/2,230280,1
6,1,23,281,1,747,1,9,4,4,5,single-choice,spatial-relational,4|5,7,4/5,230281,4
6,1,23,282,0,948,1,7,3,4,4,single-choice,spatial-relational,3|4,7,3/4,230282,3
6,1,23,283,1,970,1,11,5,5,6,single-choice,spatial-relational,5|6,7,5/6,230283,5
6,1,23,284,1,1124,1,13,6,6,7,single-choice,spatial-relational,6|7,7,6/7,230284,6
6,1,23,285,1,1050,1,13,6,6,7,single-choice,spatial-relational,6|7,7,6/7,230285,6
6,1,23,286,0,836,1,7,3,4,4,single-choice,spatial-relational,3|4,7,3/4,230286,3
6,1,23,287,1,786,1,5,2,2,3,single-choice,spatial-relational,2|3,7,2/3,230287,2
6,1,23,288,1,930,1,9,4,4,5,single-choice,spatial-relational,4|5,7,4/5,230288,4
6,1,23,289,1,1029,1,11,5,5,6,single-choice,spatial-relational,5|6,7,5/6,230289,5
6,1,23,290,0,841,1,13,6,7,7,single-choice,spatial-relational,6|7,7,6/7,230290,6
6,1,23,291,1,1123,1,5,2,2,3,single-choice,spatial-relational,2|3,7,2/3,230291,2
6,1,23,292,1,868,1,5,2,2,3,single-choice,spatial-relational,2|3,7,2/3,230292,2
6,1,23,293,1,898,1,7,3,3,4,single-choice,spatial-relational,3|4,7,3/4,230293,3
6,1,23,294,1,970,1,13,6,6,7,single-choice,spatial-relational,6|7,7,6/7,230294,6
6,1,23,295,0,1377,1,11,5,6,6,single-choice,spatial-relational,5|6,7,5/6,230295,5
6,1,23,296,0,921,1,9,4,5,5,single-choice,spatial-relational,4|5,7,4/5,230296,4
6,1,23,297,1,875,1,3,1,1,2,single-choice,spatial-relational,1|2,7,1/2,230297,1
6,1,23,298,1,828,1,3,1,1,2,single-choice,spatial-relational,1|2,7,1/2,230298,1
6,1,23,299,1,775,1,9,4,4,5,single-choice,spatial-relational,4|5,7,4/5,230299,4
6,1,23,300,1,870,1,7,3,3,4,single-choice,spatial-relational,3|4,7,3/4,230300,3
6,1,23,301,1,986,1,7,3,3,4,single-choice,spatial-relational,3|4,7,3/4,230301,3
6,1,23,302,1,1388,1,11,5,5,6,single-choice,spatial-relational,5|6,7,5/6,230302,5
6,1,23,303,1,935,1,5,2,2,3,single-choice,spatial-relational,2|3,7,2/3,230303,2
6,1,23,304,0,881,1,9,4,5,5,single-choice,spatial-relational,4|5,7,4/5,230304,4
6,1,23,305,0,935,1,7,3,4,4,single-choice,spatial-relational,3|4,7,3/4,230305,3
6,1,23,306,1,1993,1,11,5,5,6,single-choice,spatial-relational,5|6,7,5/6,230306,5
6,1,23,307,1,988,1,5,2,2,3,single-choice,spatial-relational,2|3,7,2/3,230307,2
6,1,23,308,1,841,1,13,6,6,7,single-choice,spatial-relational,6|7,7,6/7,230308,6
6,1,23,309,1,951,1,9,4,4,5,single-choice,spatial-relational,4|5,7,4/5,230309,4
6,1,23,310,0,787,1,3,1,2,2,single-choice,spatial-relational,1|2,7,1/2,230310,1
6,1,23,311,1,976,1,3,1,1,2,single-choice,spatial-relational,1|2,7,1/2,230311,1
6,1,23,312,1,804,1,13,6,6,7,single-choice,spatial-relational,6|7,7,6/7,230312,6
6,1,23,313,1,944,1,13,6,6,7,single-choice,spatial-relational,6|7,7,6/7,230313,6
6,1,23,314,1,901,1,9,4,4,5,single-choice,spatial-relational,4|5,7,4/5,230314,4
6,1,23,315,1,733,1,5,2,2,3,single-choice,spatial-relational,2|3,7,2/3,230315,2
6,1,23,316,1,797,1,5,2,2,3,single-choice,spatial-relational,2|3,7,2/3,230316,2
6,1,23,317,1,656,1,11,5,5,6,single-choice,spatial-relational,5|6,7,5/6,230317,5
6,1,23,318,1,1023,1,11,5,5,6,single-choice,spatial-relational,5|6,7,5/6,230318,5
6,1,23,319,1,1183,1,7,3,3,4,single-choice,spatial-relational,3|4,7,3/4,230319,3
6,1,23,320,0,645,1,13,6,7,7,single-choice,spatial-relational,6|7,7,6/7,230320,6
6,1,23,321,1,981,1,3,1,1,2,single-choice,spatial-relational,1|2,7,1/2,230321,1
6,1,23,322,0,933,1,7,3,4,4,single-choice,spatial-relational,3|4,7,3/4,230322,3
6,1,23,323,0,1263,1,9,4,5,5,single-choice,spatial-relational,4|5,7,4/5,230323,4
6,1,23,324,1,843,1,3,1,1,2,single-choice,spatial-relational,1|2,7,1/2,230324,1
6,1,23,325,1,840,1,9,4,4,5,single-choice,spatial-relational,4|5,7,4/5,230325,4
6,1,23,326,1,1013,1,13,6,6,7,single-choice,spatial-relational,6|7,7,6/7,230326,6
6,1,23,327,1,898,1,7,3,3,4,single-choice,spatial-relational,3|4,7,3/4,230327,3
6,1,23,328,0,1110,1,9,4,5,5,single-choice,spatial-relational,4|5,7,4/5,230328,4
6,1,23,329,0,1112,1,11,5,6,6,single-choice,spatial-relational,5|6,7,5/6,230329,5
6,1,23,330,1,880,1,5,2,2,3,single-choice,spatial-relational,2|3,7,2/3,230330,2
6,1,23,331,1,779,1,3,1,1,2,single-choice,spatial-relational,1|2,7,1/2,230331,1
6,1,23,332,1,1120,1,7,3,3,4,single-choice,spatial-relational,3|4,7,3/4,230332,3
6,1,23,333,1,862,1,13,6,6,7,single-choice,spatial-relational,6|7,7,6/7,230333,6
6,1,23,334,0,1245,1,3,1,2,2,single-choice,spatial-relational,1|2,7,1/2,230334,1
6,1,23,335,1,942,1,5,2,2,3,single-choice,spatial-relational,2|3,7,2/3,230335,2
6,1,23,336,1,920,1,11,5,5,6,single-choice,spatial-relational,5|6,7,5/6,230336,5
6,1,23,337,1,846,1,7,3,3,4,single-choice,spatial-relational,3|4,7,3/4,230337,3
6,1,23,338,1,1104,1,11,5,5,6,single-choice,spatial-relational,5|6,7,5/6,230338,5
6,1,23,339,1,1309,1,5,2,2,3,single-choice,spatial-relational,2|3,7,2/3,230339,2
6,1,23,340,0,824,1,3,1,2,2,single-choice,spatial-relational,1|2,7,1/2,230340,1
6,1,23,341,1,840,1,9,4,4,5,single-choice,spatial-relational,4|5,7,4/5,230341,4
6,1,23,342,1,780,1,3,1,1,2,single-choice,spatial-relational,1|2,7,1/2,230342,1
6,1,23,343,1,918,1,13,6,6,7,single-choice,spatial-relational,6|7,7,6/7,230343,6
6,1,23,344,1,1077,1,9,4,4,5,single-choice,spatial-relational,4|5,7,4/5,230344,4
6,1,23,345,1,938,1,13,6,6,7,single-choice,spatial-relational,6|7,7,6/7,230345,6
6,1,23,346,1,1483,1,11,5,5,6,single-choice,spatial-relational,5|6,7,5/6,230346,5
6,1,23,347,0,724,1,5,2,3,3,single-choice,spatial-relational,2|3,7,2/3,230347,2
6,1,23,348,1,1574,1,7,3,3,4,single-choice,spatial-relational,3|4,7,3/4,230348,3
6,1,23,349,1,767,1,13,6,6,7,single-choice,spatial-relational,6|7,7,6/7,230349,6
6,1,23,350,1,1051,1,3,1,1,2,single-choice,spatial-relational,1|2,7,1/2,230350,1
6,1,23,351,1,920,1,5,2,2,3,single-choice,spatial-relational,2|3,7,2/3,230351,2
6,1,23,352,1,1054,1,11,5,5,6,single-choice,spatial-relational,5|6,7,5/6,230352,5
6,1,23,353,1,902,1,7,3,3,4,single-choice,spatial-relational,3|4,7,3/4,230353,3
6,1,23,354,1,722,1,9,4,4,5,single-choice,spatial-relational,4|5,7,4/5,230354,4
6,1,23,355,1,958,1,5,2,2,3,single-choice,spatial-relational,2|3,7,2/3,230355,2
6,1,23,356,0,663,1,13,6,7,7,single-choice,spatial-relational,6|7,7,6/7,230356,6
6,1,23,357,1,1016,1,11,5,5,6,single-choice,spatial-relational,5|6,7,5/6,230357,5
6,1,23,358,0,939,1,3,1,2,2,single-choice,spatial-relational,1|2,7,1/2,230358,1
6,1,23,359,1,845,1,9,4,4,5,single-choice,spatial-relational,4|5,7,4/5,230359,4
6,1,23,360,1,1169,1,7,3,3,4,single-choice,spatial-relational,3|4,7,3/4,230360,3
6,1,23,361,1,832,1,3,1,1,2,single-choice,spatial-relational,1|2,7,1/2,230361,1
6,1,23,362,1,1179,1,11,5,5,6,single-choice,spatial-relational,5|6,7,5/6,230362,5
6,1,23,363,1,959,1,13,6,6,7,single-choice,spatial-relational,6|7,7,6/7,230363,6
6,1,23,364,1,1075,1,9,4,4,5,single-choice,spatial-relational,4|5,7,4/5,230364,4
6,1,23,365,1,780,1,5,2,2,3,single-choice,spatial-relational,2|3,7,2/3,230365,2
6,1,23,366,0,984,1,7,3,4,4,single-choice,spatial-relational,3|4,7,3/4,230366,3
6,1,23,367,1,1131,1,7,3,3,4,single-choice,spatial-relational,3|4,7,3/4,230367,3
6,1,23,368,1,1461,1,9,4,4,5,single-choice,spatial-relational,4|5,7,4/5,230368,4
6,1,23,369,1,900,1,5,2,2,3,single-choice,spatial-relational,2|3,7,2/3,230369,2
6,1,23,370,1,981,1,11,5,5,6,single-choice,spatial-relational,5|6,7,5/6,230370,5
6,1,23,371,0,710,1,3,1,2,2,single-choice,spatial-relational,1|2,7,1/2,230371,1
6,1,23,372,1,790,1,13,6,6,7,single-choice,spatial-relational,6|7,7,6/7,230372,6
6,1,23,373,0,765,1,9,4,5,5,single-choice,spatial-relational,4|5,7,4/5,230373,4
6,1,23,374,1,1438,1,7,3,3,4,single-choice,spatial-relational,3|4,7,3/4,230374,3
6,1,23,375,1,943,1,13,6,6,7,single-choice,spatial-relational,6|7,7,6/7,230375,6
6,1,23,376,1,983,1,3,1,1,2,single-choice,spatial-relational,1|2,7,1/2,230376,1
6,1,23,377,1,727,1,7,3,3,4,single-choice,spatial-relational,3|4,7,3/4,230377,3
6,1,23,378,1,886,1,5,2,2,3,single-choice,spatial-relational,2|3,7,2/3,230378,2
6,1,23,379,1,968,1,11,5,5,6,single-choice,spatial-relational,5|6,7,5/6,230379,5
6,1,23,380,1,994,1,11,5,5,6,single-choice,spatial-relational,5|6,7,5/6,230380,5
6,1,23,381,1,871,1,3,1,1,2,single-choice,spatial-relational,1|2,7,1/2,230381,1
6,1,23,382,1,770,1,13,6,6,7,single-choice,spatial-relational,6|7,7,6/7,230382,6
6,1,23,383,1,1077,1,9,4,4,5,single-choice,spatial-relational,4|5,7,4/5,230383,4
6,1,23,384,1,785,1,5,2,2,3,single-choice,spatial-relational,2|3,7,2/3,230384,2
6,1,23,385,1,973,1,11,5,5,6,single-choice,spatial-relational,5|6,7,5/6,230385,5
6,1,23,386,1,1070,1,13,6,6,7,single-choice,spatial-relational,6|7,7,6/7,230386,6
6,1,23,387,1,943,1,7,3,3,4,single-choice,spatial-relational,3|4,7,3/4,230387,3
6,1,23,388,1,802,1,13,6,6,7,single-choice,spatial-relational,6|7,7,6/7,230388,6
6,1,23,389,1,1129,1,7,3,3,4,single-choice,spatial-relational,3|4,7,3/4,230389,3
6,1,23,390,1,892,1,5,2,2,3,single-choice,spatial-relational,2|3,7,2/3,230390,2
6,1,23,391,1,1077,1,9,4,4,5,single-choice,spatial-relational,4|5,7,4/5,230391,4
6,1,23,392,1,1138,1,11,5,5,6,single-choice,spatial-relational,5|6,7,5/6,230392,5
6,1,23,393,1,871,1,3,1,1,2,single-choice,spatial-relational,1|2,7,1/2,230393,1
6,1,23,394,0,839,1,9,4,5,5,single-choice,spatial-relational,4|5,7,4/5,230394,4
6,1,23,395,0,686,1,3,1,2,2,single-choice,spatial-relational,1|2,7,1/2,230395,1
6,1,23,396,1,898,1,5,2,2,3,single-choice,spatial-relational,2|3,7,2/3,230396,2
6,1,23,397,1,930,1,9,4,4,5,single-choice,spatial-relational,4|5,7,4/5,230397,4
6,1,23,398,1,1319,1,7,3,3,4,single-choice,spatial-relational,3|4,7,3/4,230398,3
6,1,23,399,1,968,1,9,4,4,5,single-choice,spatial-relational,4|5,7,4/5,230399,4
6,1,23,400,1,1299,1,11,5,5,6,single-choice,spatial-relational,5|6,7,5/6,230400,5
6,1,23,401,1,979,1,13,6,6,7,single-choice,spatial-relational,6|7,7,6/7,230401,6
6,1,23,402,1,994,1,13,6,6,7,single-choice,spatial-relational,6|7,7,6/7,230402,6
6,1,23,403,1,693,1,5,2,2,3,single-choice,spatial-relational,2|3,7,2/3,230403,2
6,1,23,404,1,735,1,3,1,1,2,single-choice,spatial-relational,1|2,7,1/2,230404,1
6,1,23,405,1,879,1,5,2,2,3,single-choice,spatial-relational,2|3,7,2/3,230405,2
6,1,23,406,0,648,1,3,1,2,2,single-choice,spatial-relational,1|2,7,1/2,230406,1
6,1,23,407,1,1252,1,11,5,5,6,single-choice,spatial-relational,5|6,7,5/6,230407,5
6,1,23,408,0,1144,1,7,3,4,4,single-choice,spatial-relational,3|4,7,3/4,230408,3
6,1,23,409,1,1122,1,9,4,4,5,single-choice,spatial-relational,4|5,7,4/5,230409,4
6,1,23,410,1,1287,1,3,1,1,2,single-choice,spatial-relational,1|2,7,1/2,230410,1
6,1,23,411,0,853,1,9,4,5,5,single-choice,spatial-relational,4|5,7,4/5,230411,4
6,1,23,412,1,985,1,11,5,5,6,single-choice,spatial-relational,5|6,7,5/6,230412,5
6,1,23,413,1,1065,1,13,6,6,7,single-choice,spatial-relational,6|7,7,6/7,230413,6
6,1,23,414,0,1142,1,7,3,4,4,single-choice,spatial-relational,3|4,7,3/4,230414,3
6,1,23,415,1,788,1,13,6,6,7,single-choice,spatial-relational,6|7,7,6/7,230415,6
6,1,23,416,0,961,1,7,3,4,4,single-choice,spatial-relational,3|4,7,3/4,230416,3
6,1,23,417,1,812,1,5,2,2,3,single-choice,spatial-relational,2|3,7,2/3,230417,2
6,1,23,418,0,904,1,3,1,2,2,single-choice,spatial-relational,1|2,7,1/2,230418,1
6,1,23,419,1,991,1,5,2,2,3,single-choice,spatial-relational,2|3,7,2/3,230419,2
6,1,23,420,0,1469,1,11,5,6,6,single-choice,spatial-relational,5|6,7,5/6,230420,5
6,1,23,421,1,768,1,3,1,1,2,single-choice,spatial-relational,1|2,7,1/2,230421,1
6,1,23,422,1,1008,1,13,6,6,7,single-choice,spatial-relational,6|7,7,6/7,230422,6
6,1,23,423,1,1786,1,7,3,3,4,single-choice,spatial-relational,3|4,7,3/4,230423,3
6,1,23,424,1,868,1,5,2,2,3,single-choice,spatial-relational,2|3,7,2/3,230424,2
6,1,23,425,1,680,1,13,6,6,7,single-choice,spatial-relational,6|7,7,6/7,230425,6
6,1,23,426,1,1577,1,11,5,5,6,single-choice,spatial-relational,5|6,7,5/6,230426,5
6,1,23,427,1,1234,1,11,5,5,6,single-choice,spatial-relational,5|6,7,5/6,230427,5
6,1,23,428,1,732,1,7,3,3,4,single-choice,spatial-relational,3|4,7,3/4,230428,3
6,1,23,429,0,817,1,3,1,2,2,single-choice,spatial-relational,1|2,7,1/2,230429,1
6,1,23,430,1,1088,1,5,2,2,3,single-choice,spatial-relational,2|3,7,2/3,230430,2
6,1,23,431,1,902,1,9,4,4,5,single-choice,spatial-relational,4|5,7,4/5,230431,4
6,1,23,432,1,1033,1,9,4,4,5,single-choice,spatial-relational,4|5,7,4/5,230432,4
6,1,23,433,1,1178,1,11,5,5,6,single-choice,spatial-relational,5|6,7,5/6,230433,5
6,1,23,434,1,1049,1,5,2,2,3,single-choice,spatial-relational,2|3,7,2/3,230434,2
6,1,23,435,1,834,1,13,6,6,7,single-choice,spatial-relational,6|7,7,6/7,230435,6
6,1,23,436,1,1310,1,9,4,4,5,single-choice,spatial-relational,4|5,7,4/5,230436,4
6,1,23,437,1,903,1,11,5,5,6,single-choice,spatial-relational,5|6,7,5/6,230437,5
6,1,23,438,1,1032,1,3,1,1,2,single-choice,spatial-relational,1|2,7,1/2,230438,1
6,1,23,439,0,820,1,9,4,5,5,single-choice,spatial-relational,4|5,7,4/5,230439,4
6,1,23,440,0,1114,1,7,3,4,4,single-choice,spatial-relational,3|4,7,3/4,230440,3
6,1,23,441,1,890,1,7,3,3,4,single-choice,spatial-relational,3|4,7,3/4,230441,3
6,1,23,442,1,825,1,13,6,6,7,single-choice,spatial-relational,6|7,7,6/7,230442,6
6,1,23,443,0,856,1,3,1,2,2,single-choice,spatial-relational,1|2,7,1/2,230443,1
6,1,23,444,1,766,1,5,2,2,3,single-choice,spatial-relational,2|3,7,2/3,230444,2
6,1,23,445,1,1176,1,7,3,3,4,single-choice,spatial-relational,3|4,7,3/4,230445,3
6,1,23,446,1,1269,1,13,6,6,7,single-choice,spatial-relational,6|7,7,6/7,230446,6
6,1,23,447,1,1172,1,13,6,6,7,single-choice,spatial-relational,6|7,7,6/7,230447,6
6,1,23,448,1,1605,1,9,4,4,5,single-choice,spatial-relational,4|5,7,4/5,230448,4
6,1,23,449,1,808,1,3,1,1,2,single-choice,spatial-relational,1|2,7,1/2,230449,1
6,1,23,450,1,942,1,11,5,5,6,single-choice,spatial-relational,5|6,7,5/6,230450,5
6,1,23,451,0,1166,1,7,3,4,4,single-choice,spatial-relational,3|4,7,3/4,230451,3
6,1,23,452,0,1451,1,9,4,5,5,single-choice,spatial-relational,4|5,7,4/5,230452,4
6,1,23,453,1,962,1,3,1,1,2,single-choice,spatial-relational,1|2,7,1/2,230453,1
6,1,23,454,0,879,1,11,5,6,6,single-choice,spatial-relational,5|6,7,5/6,230454,5
6,1,23,455,1,1197,1,5,2,2,3,single-choice,spatial-relational,2|3,7,2/3,230455,2
6,1,23,456,1,789,1,5,2,2,3,single-choice,spatial-relational,2|3,7,2/3,230456,2
6,1,23,457,1,855,1,11,5,5,6,single-choice,spatial-relational,5|6,7,5/6,230457,5
6,1,23,458,1,775,1,11,5,5,6,single-choice,spatial-relational,5|6,7,5/6,230458,5
6,1,23,459,0,1261,1,7,3,4,4,single-choice,spatial-relational,3|4,7,3/4,230459,3
6,1,23,460,0,884,1,9,4,5,5,single-choice,spatial-relational,4|5,7,4/5,230460,4
6,1,23,461,1,981,1,13,6,6,7,single-choice,spatial-relational,6|7,7,6/7,230461,6
6,1,23,462,1,1071,1,5,2,2,3,single-choice,spatial-relational,2|3,7,2/3,230462,2
6,1,23,463,1,992,1,7,3,3,4,single-choice,spatial-relational,3|4,7,3/4,230463,3
6,1,23,464,1,815,1,13,6,6,7,single-choice,spatial-relational,6|7,7,6/7,230464,6
6,1,23,465,1,821,1,5,2,2,3,single-choice,spatial-relational,2|3,7,2/3,230465,2
6,1,23,466,1,780,1,3,1,1,2,single-choice,spatial-relational,1|2,7,1/2,230466,1
6,1,23,467,1,905,1,9,4,4,5,single-choice,spatial-relational,4|5,7,4/5,230467,4
6,1,23,468,0,879,1,3,1,2,2,single-choice,spatial-relational,1|2,7,1/2,230468,1
6,1,23,469,1,1117,1,13,6,6,7,single-choice,spatial-relational,6|7,7,6/7,230469,6
6,1,23,470,0,1102,1,9,4,5,5,single-choice,spatial-relational,4|5,7,4/5,230470,4
6,1,23,471,1,916,1,5,2,2,3,single-choice,spatial-relational,2|3,7,2/3,230471,2
6,1,23,472,1,1027,1,3,1,1,2,single-choice,spatial-relational,1|2,7,1/2,230472,1
6,1,23,473,1,1245,1,7,3,3,4,single-choice,spatial-relational,3|4,7,3/4,230473,3
6,1,23,474,1,937,1,11,5,5,6,single-choice,spatial-relational,5|6,7,5/6,230474,5
6,1,23,475,0,675,1,3,1,2,2,single-choice,spatial-relational,1|2,7,1/2,230475,1
6,1,23,476,1,1388,1,7,3,3,4,single-choice,spatial-relational,3|4,7,3/4,230476,3
6,1,23,477,1,823,1,13,6,6,7,single-choice,spatial-relational,6|7,7,6/7,230477,6
6,1,23,478,0,1376,1,11,5,6,6,single-choice,spatial-relational,5|6,7,5/6,230478,5
6,1,23,479,1,1077,1,5,2,2,3,single-choice,spatial-relational,2|3,7,2/3,230479,2
6,1,23,480,0,1225,1,9,4,5,5,single-choice,spatial-relational,4|5,7,4/5,230480,4
6,1,23,481,0,899,1,3,1,2,2,single-choice,spatial-relational,1|2,7,1/2,230481,1
6,1,23,482,0,1039,1,13,6,7,7,single-choice,spatial-relational,6|7,7,6/7,230482,6
6,1,23,483,1,973,1,9,4,4,5,single-choice,spatial-relational,4|5,7,4/5,230483,4
6,1,23,484,1,1149,1,9,4,4,5,single-choice,spatial-relational,4|5,7,4/5,230484,4
6,1,23,485,1,1001,1,11,5,5,6,single-choice,spatial-relational,5|6,7,5/6,230485,5
6,1,23,486,1,744,1,3,1,1,2,single-choice,spatial-relational,1|2,7,1/2,230486,1
6,1,23,487,1,1010,1,11,5,5,6,single-choice,spatial-relational,5|6,7,5/6,230487,5
6,1,23,488,1,1334,1,7,3,3,4,single-choice,spatial-relational,3|4,7,3/4,230488,3
6,1,23,489,1,720,1,5,2,2,3,single-choice,spatial-relational,2|3,7,2/3,230489,2
6,1,23,490,1,742,1,13,6,6,7,single-choice,spatial-relational,6|7,7,6/7,230490,6
6,1,23,491,1,754,1,7,3,3,4,single-choice,spatial-relational,3|4,7,3/4,230491,3
6,1,23,492,0,732,1,5,2,3,3,single-choice,spatial-relational,2|3,7,2/3,230492,2
6,1,23,493,1,827,1,5,2,2,3,single-choice,spatial-relational,2|3,7,2/3,230493,2
6,1,23,494,1,943,1,5,2,2,3,single-choice,spatial-relational,2|3,7,2/3,230494,2
6,1,23,495,1,988,1,13,6,6,7,single-choice,spatial-relational,6|7,7,6/7,230495,6
6,1,23,496,1,990,1,11,5,5,6,single-choice,spatial-relational,5|6,7,5/6,230496,5
6,1,23,497,1,860,1,11,5,5,6,single-choice,spatial-relational,5|6,7,5/6,230497,5
6,1,23,498,1,853,1,9,4,4,5,single-choice,spatial-relational,4|5,7,4/5,230498,4
6,1,23,499,1,981,1,9,4,4,5,single-choice,spatial-relational,4|5,7,4/5,230499,4
6,1,23,500,1,761,1,7,3,3,4,single-choice,spatial-relational,3|4,7,3/4,230500,3
6,1,23,501,0,1538,1,3,1,2,2,single-choice,spatial-relational,1|2,7,1/2,230501,1
6,1,23,502,1,1139,1,13,6,6,7,single-choice,spatial-relational,6|7,7,6/7,230502,6
6,1,23,503,1,909,1,7,3,3,4,single-choice,spatial-relational,3|4,7,3/4,230503,3
6,1,23,504,0,653,1,3,1,2,2,single-choice,spatial-relational,1|2,7,1/2,230504,1
6,1,23,505,0,864,1,9,4,5,5,single-choice,spatial-relational,4|5,7,4/5,230505,4
6,1,23,506,1,1096,1,13,6,6,7,single-choice,spatial-relational,6|7,7,6/7,230506,6
6,1,23,507,0,1570,1,9,4,5,5,single-choice,spatial-relational,4|5,7,4/5,230507,4
6,1,23,508,0,1178,1,7,3,4,4,single-choice,spatial-relational,3|4,7,3/4,230508,3
6,1,23,509,0,1049,1,11,5,6,6,single-choice,spatial-relational,5|6,7,5/6,230509,5
6,1,23,510,1,678,1,13,6,6,7,single-choice,spatial-relational,6|7,7,6/7,230510,6
6,1,23,511,1,900,1,5,2,2,3,single-choice,spatial-relational,2|3,7,2/3,230511,2
6,1,23,512,1,735,1,5,2,2,3,single-choice,spatial-relational,2|3,7,2/3,230512,2
6,1,23,513,1,869,1,3,1,1,2,single-choice,spatial-relational,1|2,7,1/2,230513,1
6,1,23,514,1,725,1,7,3,3,4,single-choice,spatial-relational,3|4,7,3/4,230514,3
6,1,23,515,1,1065,1,11,5,5,6,single-choice,spatial-relational,5|6,7,5/6,230515,5
6,1,23,516,0,694,1,3,1,2,2,single-choice,spatial-relational,1|2,7,1/2,230516,1
6,1,23,517,1,1079,1,5,2,2,3,single-choice,spatial-relational,2|3,7,2/3,230517,2
6,1,23,518,1,1093,1,13,6,6,7,single-choice,spatial-relational,6|7,7,6/7,230518,6
6,1,23,519,1,1599,1,7,3,3,4,single-choice,spatial-relational,3|4,7,3/4,230519,3
6,1,23,520,1,809,1,7,3,3,4,single-choice,spatial-relational,3|4,7,3/4,230520,3
6,1,23,521,1,1050,1,9,4,4,5,single-choice,spatial-relational,4|5,7,4/5,230521,4
6,1,23,522,1,1340,1,11,5,5,6,single-choice,spatial-relational,5|6,7,5/6,230522,5
6,1,23,523,0,907,1,3,1,2,2,single-choice,spatial-relational,1|2,7,1/2,230523,1
6,1,23,524,1,741,1,5,2,2,3,single-choice,spatial-relational,2|3,7,2/3,230524,2
6,1,23,525,1,1208,1,9,4,4,5,single-choice,spatial-relational,4|5,7,4/5,230525,4
6,1,23,526,1,917,1,3,1,1,2,single-choice,spatial-relational,1|2,7,1/2,230526,1
6,1,23,527,1,745,1,13,6,6,7,single-choice,spatial-relational,6|7,7,6/7,230527,6
6,1,23,528,1,1098,1,11,5,5,6,single-choice,spatial-relational,5|6,7,5/6,230528,5
6,1,23,529,1,1009,1,13,6,6,7,single-choice,spatial-relational,6|7,7,6/7,230529,6
6,1,23,530,1,707,1,3,1,1,2,single-choice,spatial-relational,1|2,7,1/2,230530,1
6,1,23,531,0,759,1,7,3,4,4,single-choice,spatial-relational,3|4,7,3/4,230531,3
6,1,23,532,1,1304,1,9,4,4,5,single-choice,spatial-relational,4|5,7,4/5,230532,4
6,1,23,533,1,1047,1,9,4,4,5,single-choice,spatial-relational,4|5,7,4/5,230533,4
6,1,23,534,0,700,1,3,1,2,2,single-choice,spatial-relational,1|2,7,1/2,230534,1
6,1,23,535,1,2136,1,13,6,6,7,single-choice,spatial-relational,6|7,7,6/7,230535,6
6,1,23,536,0,854,1,7,3,4,4,single-choice,spatial-relational,3|4,7,3/4,230536,3
6,1,23,537,1,884,1,5,2,2,3,single-choice,spatial-relational,2|3,7,2/3,230537,2
6,1,23,538,1,819,1,5,2,2,3,single-choice,spatial-relational,2|3,7,2/3,230538,2
6,1,23,539,1,1312,1,11,5,5,6,single-choice,spatial-relational,5|6,7,5/6,230539,5
6,1,23,540,1,1010,1,11,5,5,6,single-choice,spatial-relational,5|6,7,5/6,230540,5
6,1,23,541,1,777,1,9,4,4,5,single-choice,spatial-relational,4|5,7,4/5,230541,4
6,1,23,542,1,1148,1,9,4,4,5,single-choice,spatial-relational,4|5,7,4/5,230542,4
6,1,23,543,0,756,1,3,1,2,2,single-choice,spatial-relational,1|2,7,1/2,230543,1
6,1,23,544,1,764,1,5,2,2,3,single-choice,spatial-relational,2|3,7,2/3,230544,2
6,1,23,545,1,955,1,13,6,6,7,single-choice,spatial-relational,6|7,7,6/7,230545,6
6,1,23,546,1,1246,1,13,6,6,7,single-choice,spatial-relational,6|7,7,6/7,230546,6
6,1,23,547,1,1043,1,3,1,1,2,single-choice,spatial-relational,1|2,7,1/2,230547,1
6,1,23,548,1,1113,1,11,5,5,6,single-choice,spatial-relational,5|6,7,5/6,230548,5
6,1,23,549,1,1419,1,5,2,2,3,single-choice,spatial-relational,2|3,7,2/3,230549,2
6,1,23,550,0,1042,1,7,3,4,4,single-choice,spatial-relational,3|4,7,3/4,230550,3
6,1,23,551,0,1360,1,11,5,6,6,single-choice,spatial-relational,5|6,7,5/6,230551,5
6,1,23,552,1,1364,1,7,3,3,4,single-choice,spatial-relational,3|4,7,3/4,230552,3
6,1,23,553,1,1543,1,9,4,4,5,single-choice,spatial-relational,4|5,7,4/5,230553,4
6,1,23,554,1,701,1,5,2,2,3,single-choice,spatial-relational,2|3,7,2/3,230554,2
6,1,23,555,1,931,1,9,4,4,5,single-choice,spatial-relational,4|5,7,4/5,230555,4
6,1,23,556,1,1152,1,11,5,5,6,single-choice,spatial-relational,5|6,7,5/6,230556,5
6,1,23,557,1,873,1,7,3,3,4,single-choice,spatial-relational,3|4,7,3/4,230557,3
6,1,23,558,1,1238,1,5,2,2,3,single-choice,spatial-relational,2|3,7,2/3,230558,2
6,1,23,559,1,716,1,13,6,6,7,single-choice,spatial-relational,6|7,7,6/7,230559,6
6,1,23,560,1,1292,1,11,5,5,6,single-choice,spatial-relational,5|6,7,5/6,230560,5
6,1,23,561,1,702,1,3,1,1,2,single-choice,spatial-relational,1|2,7,1/2,230561,1
6,1,23,562,1,1054,1,13,6,6,7,single-choice,spatial-relational,6|7,7,6/7,230562,6
6,1,23,563,1,1406,1,7,3,3,4,single-choice,spatial-relational,3|4,7,3/4,230563,3
6,1,23,564,1,810,1,3,1,1,2,single-choice,spatial-relational,1|2,7,1/2,230564,1
6,1,23,565,0,72,1,9,4,5,5,single-choice,spatial-relational,4|5,7,4/5,230565,4
6,1,23,566,0,1878,1,11,5,6,6,single-choice,spatial-relational,5|6,7,5/6,230566,5
6,1,23,567,1,1073,1,5,2,2,3,single-choice,spatial-relational,2|3,7,2/3,230567,2
6,1,23,568,1,1283,1,13,6,6,7,single-choice,spatial-relational,6|7,7,6/7,230568,6
6,1,23,569,1,854,1,3,1,1,2,single-choice,spatial-relational,1|2,7,1/2,230569,1
6,1,23,570,1,1417,1,7,3,3,4,single-choice,spatial-relational,3|4,7,3/4,230570,3
6,1,23,571,1,916,1,9,4,4,5,single-choice,spatial-relational,4|5,7,4/5,230571,4
6,1,23,572,1,1197,1,5,2,2,3,single-choice,spatial-relational,2|3,7,2/3,230572,2
6,1,23,573,1,816,1,13,6,6,7,single-choice,spatial-relational,6|7,7,6/7,230573,6
6,1,23,574,1,1055,1,3,1,1,2,single-choice,spatial-relational,1|2,7,1/2,230574,1
6,1,23,575,1,1252,1,11,5,5,6,single-choice,spatial-relational,5|6,7,5/6,230575,5
6,1,23,576,1,898,1,7,3,3,4,single-choice,spatial-relational,3|4,7,3/4,230576,3
6,1,23,577,1,772,1,7,3,3,4,single-choice,spatial-relational,3|4,7,3/4,230577,3
6,1,23,578,1,1044,1,11,5,5,6,single-choice,spatial-relational,5|6,7,5/6,230578,5
6,1,23,579,1,791,1,5,2,2,3,single-choice,spatial-relational,2|3,7,2/3,230579,2
6,1,23,580,1,1069,1,11,5,5,6,single-choice,spatial-relational,5|6,7,5/6,230580,5
6,1,23,581,1,1163,1,9,4,4,5,single-choice,spatial-relational,4|5,7,4/5,230581,4
6,1,23,582,1,788,1,3,1,1,2,single-choice,spatial-relational,1|2,7,1/2,230582,1
6,1,23,583,1,788,1,13,6,6,7,single-choice,spatial-relational,6|7,7,6/7,230583,6
6,1,23,584,0,743,1,7,3,4,4,single-choice,spatial-relational,3|4,7,3/4,230584,3
6,1,23,585,1,877,1,13,6,6,7,single-choice,spatial-relational,6|7,7,6/7,230585,6
6,1,23,586,0,1254,1,5,2,3,3,single-choice,spatial-relational,2|3,7,2/3,230586,2
6,1,23,587,0,1267,1,9,4,5,5,single-choice,spatial-relational,4|5,7,4/5,230587,4
6,1,23,588,1,1045,1,3,1,1,2,single-choice,spatial-relational,1|2,7,1/2,230588,1
6,1,23,589,1,882,1,5,2,2,3,single-choice,spatial-relational,2|3,7,2/3,230589,2
6,1,23,590,1,1305,1,11,5,5,6,single-choice,spatial-relational,5|6,7,5/6,230590,5
6,1,23,591,1,1012,1,13,6,6,7,single-choice,spatial-relational,6|7,7,6/7,230591,6
6,1,23,592,1,1033,1,3,1,1,2,single-choice,spatial-relational,1|2,7,1/2,230592,1
6,1,23,593,0,903,1,7,3,4,4,single-choice,spatial-relational,3|4,7,3/4,230593,3
6,1,23,594,1,870,1,13,6,6,7,single-choice,spatial-relational,6|7,7,6/7,230594,6
6,1,23,595,1,1027,1,7,3,3,4,single-choice,spatial-relational,3|4,7,3/4,230595,3
6,1,23,596,1,716,1,3,1,1,2,single-choice,spatial-relational,1|2,7,1/2,230596,1
6,1,23,597,1,906,1,9,4,4,5,single-choice,spatial-relational,4|5,7,4/5,230597,4
6,1,23,598,0,1503,1,9,4,5,5,single-choice,spatial-relational,4|5,7,4/5,230598,4
6,1,23,599,1,939,1,5,2,2,3,single-choice,spatial-relational,2|3,7,2/3,230599,2
6,1,23,600,0,1428,1,11,5,6,6,single-choice,spatial-relational,5|6,7,5/6,230600,5
7,1,23,1,0,32,1,11,5,6,6,single-choice,spatial-relational,5|6,7,5/6,230001,5
7,1,23,2,0,738,1,3,1,2,2,single-choice,spatial-relational,1|2,7,1/2,230002,1
7,1,23,3,1,513,1,7,3,3,4,single-choice,spatial-relational,3|4,7,3/4,230003,3
7,1,23,4,1,587,1,3,1,1,2,single-choice,spatial-relational,1|2,7,1/2,230004,1
7,1,23,5,1,538,1,9,4,4,5,single-choice,spatial-relational,4|5,7,4/5,230005,4
7,1,23,6,1,5582,1,13,6,6,7,single-choice,spatial-relational,6|7,7,6/7,230006,6
7,1,23,7,0,553,1,7,3,4,4,single-choice,spatial-relational,3|4,7,3/4,230007,3
7,1,23,8,1,950,1,13,6,6,7,single-choice,spatial-relational,6|7,7,6/7,230008,6
7,1,23,9,1,120,1,5,2,2,3,single-choice,spatial-relational,2|3,7,2/3,230009,2
7,1,23,10,0,483,1,9,4,5,5,single-choice,spatial-relational,4|5,7,4/5,230010,4
7,1,23,11,1,613,1,11,5,5,6,single-choice,spatial-relational,5|6,7,5/6,230011,5
7,1,23,12,0,494,1,5,2,3,3,single-choice,spatial-relational,2|3,7,2/3,230012,2
7,1,23,13,1,565,1,5,2,2,3,single-choice,spatial-relational,2|3,7,2/3,230013,2
7,1,23,14,0,587,1,9,4,5,5,single-choice,spatial-relational,4|5,7,4/5,230014,4
7,1,23,15,1,116,1,13,6,6,7,single-choice,spatial-relational,6|7,7,6/7,230015,6
7,1,23,16,0,534,1,13,6,7,7,single-choice,spatial-relational,6|7,7,6/7,230016,6
7,1,23,17,0,575,1,3,1,2,2,single-choice,spatial-relational,1|2,7,1/2,230017,1
7,1,23,18,1,530,1,7,3,3,4,single-choice,spatial-relational,3|4,7,3/4,230018,3
7,1,23,19,1,697,1,11,5,5,6,single-choice,spatial-relational,5|6,7,5/6,230019,5
7,1,23,20,1,604,1,9,4,4,5,single-choice,spatial-relational,4|5,7,4/5,230020,4
7,1,23,21,0,508,1,7,3,4,4,single-choice,spatial-relational,3|4,7,3/4,230021,3
7,1,23,22,0,593,1,11,5,6,6,single-choice,spatial-relational,5|6,7,5/6,230022,5
7,1,23,23,0,726,1,5,2,3,3,single-choice,spatial-relational,2|3,7,2/3,230023,2
7,1,23,24,1,1270,1,13,6,6,7,single-choice,spatial-relational,6|7,7,6/7,230024,6
7,1,23,25,1,554,1,3,1,1,2,single-choice,spatial-relational,1|2,7,1/2,230025,1
7,1,23,26,0,450,1,9,4,5,5,single-choice,spatial-relational,4|5,7,4/5,230026,4
7,1,23,27,1,352,1,5,2,2,3,single-choice,spatial-relational,2|3,7,2/3,230027,2
7,1,23,28,1,713,1,3,1,1,2,single-choice,spatial-relational,1|2,7,1/2,230028,1
7,1,23,29,0,79,1,3,1,2,2,single-choice,spatial-relational,1|2,7,1/2,230029,1
7,1,23,30,1,633,1,9,4,4,5,single-choice,spatial-relational,4|5,7,4/5,230030,4
7,1,23,31,1,929,1,7,3,3,4,single-choice,spatial-relational,3|4,7,3/4,230031,3
7,1,23,32,0,44,1,11,5,6,6,single-choice,spatial-relational,5|6,7,5/6,230032,5
7,1,23,33,1,966,1,13,6,6,7,single-choice,spatial-relational,6|7,7,6/7,230033,6
7,1,23,34,0,628,1,9,4,5,5,single-choice,spatial-relational,4|5,7,4/5,230034,4
7,1,23,35,1,659,1,11,5,5,6,single-choice,spatial-relational,5|6,7,5/6,230035,5
7,1,23,36,0,693,1,5,2,3,3,single-choice,spatial-relational,2|3,7,2/3,230036,2
7,1,23,37,1,875,1,13,6,6,7,single-choice,spatial-relational,6|7,7,6/7,230037,6
7,1,23,38,1,782,1,5,2,2,3,single-choice,spatial-relational,2|3,7,2/3,230038,2
7,1,23,39,0,724,1,7,3,4,4,single-choice,spatial-relational,3|4,7,3/4,230039,3
7,1,23,40,0,807,1,11,5,6,6,single-choice,spatial-relational,5|6,7,5/6,230040,5
7,1,23,41,0,659,1,5,2,3,3,single-choice,spatial-relational,2|3,7,2/3,230041,2
7,1,23,42,1,905,1,13,6,6,7,single-choice,spatial-relational,6|7,7,6/7,230042,6
7,1,23,43,0,801,1,3,1,2,2,single-choice,spatial-relational,1|2,7,1/2,230043,1
7,1,23,44,1,979,1,9,4,4,5,single-choice,spatial-relational,4|5,7,4/5,230044,4
7,1,23,45,1,858,1,13,6,6,7,single-choice,spatial-relational,6|7,7,6/7,230045,6
7,1,23,46,1,912,1,5,2,2,3,single-choice,spatial-relational,2|3,7,2/3,230046,2
7,1,23,47,0,1265,1,11,5,6,6,single-choice,spatial-relational,5|6,7,5/6,230047,5
7,1,23,48,1,693,1,3,1,1,2,single-choice,spatial-relational,1|2,7,1/2,230048,1
7,1,23,49,1,924,1,7,3,3,4,single-choice,spatial-relational,3|4,7,3/4,230049,3
7,1,23,50,1,964,1,9,4,4,5,single-choice,spatial-relational,4|5,7,4/5,230050,4
7,1,23,51,1,1283,1,7,3,3,4,single-choice,spatial-relational,3|4,7,3/4,230051,3
7,1,23,52,1,678,1,5,2,2,3,single-choice,spatial-relational,2|3,7,2/3,230052,2
7,1,23,53,0,1056,1,11,5,6,6,single-choice,spatial-relational,5|6,7,5/6,230053,5
7,1,23,54,1,854,1,13,6,6,7,single-choice,spatial-relational,6|7,7,6/7,230054,6
7,1,23,55,1,872,1,5,2,2,3,single-choice,spatial-relational,2|3,7,2/3,230055,2
7,1,23,56,1,1037,1,9,4,4,5,single-choice,spatial-relational,4|5,7,4/5,230056,4
7,1,23,57,0,942,1,9,4,5,5,single-choice,spatial-relational,4|5,7,4/5,230057,4
7,1,23,58,1,1424,1,7,3,3,4,single-choice,spatial-relational,3|4,7,3/4,230058,3
7,1,23,59,1,1142,1,11,5,5,6,single-choice,spatial-relational,5|6,7,5/6,230059,5
7,1,23,60,0,941,1,13,6,7,7,single-choice,spatial-relational,6|7,7,6/7,230060,6
7,1,23,61,1,982,1,7,3,3,4,single-choice,spatial-relational,3|4,7,3/4,230061,3
7,1,23,62,1,747,1,3,1,1,2,single-choice,spatial-relational,1|2,7,1/2,230062,1
7,1,23,63,1,655,1,3,1,1,2,single-choice,spatial-relational,1|2,7,1/2,230063,1
7,1,23,64,1,892,1,5,2,2,3,single-choice,spatial-relational,2|3,7,2/3,230064,2
7,1,23,65,1,902,1,11,5,5,6,single-choice,spatial-relational,5|6,7,5/6,230065,5
7,1,23,66,1,1430,1,9,4,4,5,single-choice,spatial-relational,4|5,7,4/5,230066,4
7,1,23,67,1,862,1,7,3,3,4,single-choice,spatial-relational,3|4,7,3/4,230067,3
7,1,23,68,1,683,1,7,3,3,4,single-choice,spatial-relational,3|4,7,3/4,230068,3
7,1,23,69,0,1157,1,5,2,3,3,single-choice,spatial-relational,2|3,7,2/3,230069,2
7,1,23,70,1,970,1,13,6,6,7,single-choice,spatial-relational,6|7,7,6/7,230070,6
7,1,23,71,1,1279,1,13,6,6,7,single-choice,spatial-relational,6|7,7,6/7,230071,6
7,1,23,72,0,1119,1,9,4,5,5,single-choice,spatial-relational,4|5,7,4/5,230072,4
7,1,23,73,1,944,1,11,5,5,6,single-choice,spatial-relational,5|6,7,5/6,230073,5
7,1,23,74,1,936,1,3,1,1,2,single-choice,spatial-relational,1|2,7,1/2,230074,1
7,1,23,75,1,845,1,3,1,1,2,single-choice,spatial-relational,1|2,7,1/2,230075,1
7,1,23,76,0,678,1,3,1,2,2,single-choice,spatial-relational,1|2,7,1/2,230076,1
7,1,23,77,1,1071,1,11,5,5,6,single-choice,spatial-relational,5|6,7,5/6,230077,5
7,1,23,78,0,1493,1,9,4,5,5,single-choice,spatial-relational,4|5,7,4/5,230078,4
7,1,23,79,1,890,1,7,3,3,4,single-choice,spatial-relational,3|4,7,3/4,230079,3
7,1,23,80,0,1026,1,11,5,6,6,single-choice,spatial-relational,5|6,7,5/6,230080,5
7,1,23,81,1,998,1,7,3,3,4,single-choice,spatial-relational,3|4,7,3/4,230081,3
7,1,23,82,1,1145,1,13,6,6,7,single-choice,spatial-relational,6|7,7,6/7,230082,6
7,1,23,83,1,755,1,5,2,2,3,single-choice,spatial-relational,2|3,7,2/3,230083,2
7,1,23,84,0,832,1,5,2,3,3,single-choice,spatial-relational,2|3,7,2/3,230084,2
7,1,23,85,1,1159,1,13,6,6,7,single-choice,spatial-relational,6|7,7,6/7,230085,6
7,1,23,86,1,1017,1,3,1,1,2,single-choice,spatial-relational,1|2,7,1/2,230086,1
7,1,23,87,0,50,1,9,4,5,5,single-choice,spatial-relational,4|5,7,4/5,230087,4
7,1,23,88,0,1182,1,11,5,6,6,single-choice,spatial-relational,5|6,7,5/6,230088,5
7,1,23,89,0,868,1,13,6,7,7,single-choice,spatial-relational,6|7,7,6/7,230089,6
7,1,23,90,1,765,1,5,2,2,3,single-choice,spatial-relational,2|3,7,2/3,230090,2
7,1,23,91,1,693,1,5,2,2,3,single-choice,spatial-relational,2|3,7,2/3,230091,2
7,1,23,92,1,835,1,3,1,1,2,single-choice,spatial-relational,1|2,7,1/2,230092,1
7,1,23,93,1,866,1,9,4,4,5,single-choice,spatial-relational,4|5,7,4/5,230093,4
7,1,23,94,1,820,1,9,4,4,5,single-choice,spatial-relational,4|5,7,4/5,230094,4
7,1,23,95,1,1092,1,7,3,3,4,single-choice,spatial-relational,3|4,7,3/4,230095,3
7,1,23,96,1,847,1,3,1,1,2,single-choice,spatial-relational,1|2,7,1/2,230096,1
7,1,23,97,1,888,1,11,5,5,6,single-choice,spatial-relational,5|6,7,5/6,230097,5
7,1,23,98,1,1215,1,7,3,3,4,single-choice,spatial-relational,3|4,7,3/4,230098,3
7,1,23,99,0,1051,1,13,6,7,7,single-choice,spatial-relational,6|7,7,6/7,230099,6
7,1,23,100,0,940,1,9,4,5,5,single-choice,spatial-relational,4|5,7,4/5,230100,4
7,1,23,101,1,1271,1,11,5,5,6,single-choice,spatial-relational,5|6,7,5/6,230101,5
7,1,23,102,1,1059,1,11,5,5,6,single-choice,spatial-relational,5|6,7,5/6,230102,5
7,1,23,103,1,1227,1,5,2,2,3,single-choice,spatial-relational,2|3,7,2/3,230103,2
7,1,23,104,1,672,1,5,2,2,3,single-choice,spatial-relational,2|3,7,2/3,230104,2
7,1,23,105,1,823,1,13,6,6,7,single-choice,spatial-relational,6|7,7,6/7,230105,6
7,1,23,106,0,900,1,3,1,2,2,single-choice,spatial-relational,1|2,7,1/2,230106,1
7,1,23,107,1,936,1,7,3,3,4,single-choice,spatial-relational,3|4,7,3/4,230107,3
7,1,23,108,1,1253,1,9,4,4,5,single-choice,spatial-relational,4|5,7,4/5,230108,4
7,1,23,109,1,778,1,3,1,1,2,single-choice,spatial-relational,1|2,7,1/2,230109,1
7,1,23,110,0,32,1,7,3,4,4,single-choice,spatial-relational,3|4,7,3/4,230110,3
7,1,23,111,1,1001,1,13,6,6,7,single-choice,spatial-relational,6|7,7,6/7,230111,6
7,1,23,112,1,1410,1,11,5,5,6,single-choice,spatial-relational,5|6,7,5/6,230112,5
7,1,23,113,1,1185,1,9,4,4,5,single-choice,spatial-relational,4|5,7,4/5,230113,4
7,1,23,114,1,727,1,5,2,2,3,single-choice,spatial-relational,2|3,7,2/3,230114,2
7,1,23,115,1,787,1,13,6,6,7,single-choice,spatial-relational,6|7,7,6/7,230115,6
7,1,23,116,0,721,1,3,1,2,2,single-choice,spatial-relational,1|2,7,1/2,230116,1
7,1,23,117,1,1161,1,13,6,6,7,single-choice,spatial-relational,6|7,7,6/7,230117,6
7,1,23,118,1,1399,1,9,4,4,5,single-choice,spatial-relational,4|5,7,4/5,230118,4
7,1,23,119,0,1295,1,7,3,4,4,single-choice,spatial-relational,3|4,7,3/4,230119,3
7,1,23,120,1,769,1,5,2,2,3,single-choice,spatial-relational,2|3,7,2/3,230120,2
7,1,23,121,1,923,1,11,5,5,6,single-choice,spatial-relational,5|6,7,5/6,230121,5
7,1,23,122,1,736,1,7,3,3,4,single-choice,spatial-relational,3|4,7,3/4,230122,3
7,1,23,123,1,782,1,3,1,1,2,single-choice,spatial-relational,1|2,7,1/2,230123,1
7,1,23,124,0,99,1,7,3,4,4,single-choice,spatial-relational,3|4,7,3/4,230124,3
7,1,23,125,1,789,1,5,2,2,3,single-choice,spatial-relational,2|3,7,2/3,230125,2
7,1,23,126,1,715,1,5,2,2,3,single-choice,spatial-relational,2|3,7,2/3,230126,2
7,1,23,127,0,722,1,9,4,5,5,single-choice,spatial-relational,4|5,7,4/5,230127,4
7,1,23,128,1,2508,1,9,4,4,5,single-choice,spatial-relational,4|5,7,4/5,230128,4
7,1,23,129,1,1221,1,11,5,5,6,single-choice,spatial-relational,5|6,7,5/6,230129,5
7,1,23,130,1,1090,1,13,6,6,7,single-choice,spatial-relational,6|7,7,6/7,230130,6
7,1,23,131,1,1004,1,13,6,6,7,single-choice,spatial-relational,6|7,7,6/7,230131,6
7,1,23,132,0,1320,1,11,5,6,6,single-choice,spatial-relational,5|6,7,5/6,230132,5
7,1,23,133,1,820,1,3,1,1,2,single-choice,spatial-relational,1|2,7,1/2,230133,1
7,1,23,134,0,60,1,3,1,2,2,single-choice,spatial-relational,1|2,7,1/2,230134,1
7,1,23,135,1,1428,1,7,3,3,4,single-choice,spatial-relational,3|4,7,3/4,230135,3
7,1,23,136,1,869,1,3,1,1,2,single-choice,spatial-relational,1|2,7,1/2,230136,1
7,1,23,137,1,1046,1,7,3,3,4,single-choice,spatial-relational,3|4,7,3/4,230137,3
7,1,23,138,1,873,1,13,6,6,7,single-choice,spatial-relational,6|7,7,6/7,230138,6
7,1,23,139,1,1149,1,5,2,2,3,single-choice,spatial-relational,2|3,7,2/3,230139,2
7,1,23,140,1,736,1,5,2,2,3,single-choice,spatial-relational,2|3,7,2/3,230140,2
7,1,23,141,1,754,1,3,1,1,2,single-choice,spatial-relational,1|2,7,1/2,230141,1
7,1,23,142,1,1030,1,9,4,4,5,single-choice,spatial-relational,4|5,7,4/5,230142,4
7,1,23,143,1,755,1,13,6,6,7,single-choice,spatial-relational,6|7,7,6/7,230143,6
7,1,23,144,1,1180,1,11,5,5,6,single-choice,spatial-relational,5|6,7,5/6,230144,5
7,1,23,145,1,1201,1,7,3,3,4,single-choice,spatial-relational,3|4,7,3/4,230145,3
7,1,23,146,1,802,1,9,4,4,5,single-choice,spatial-relational,4|5,7,4/5,230146,4
7,1,23,147,1,1097,1,11,5,5,6,single-choice,spatial-relational,5|6,7,5/6,230147,5
7,1,23,148,1,978,1,13,6,6,7,single-choice,spatial-relational,6|7,7,6/7,230148,6
7,1,23,149,1,814,1,3,1,1,2,single-choice,spatial-relational,1|2,7,1/2,230149,1
7,1,23,150,0,647,1,5,2,3,3,single-choice,spatial-relational,2|3,7,2/3,230150,2
7,1,23,151,1,1159,1,13,6,6,7,single-choice,spatial-relational,6|7,7,6/7,230151,6
7,1,23,152,0,854,1,7,3,4,4,single-choice,spatial-relational,3|4,7,3/4,230152,3
7,1,23,153,1,777,1,7,3,3,4,single-choice,spatial-relational,3|4,7,3/4,230153,3
7,1,23,154,0,1074,1,3,1,2,2,single-choice,spatial-relational,1|2,7,1/2,230154,1
7,1,23,155,1,998,1,9,4,4,5,single-choice,spatial-relational,4|5,7,4/5,230155,4
7,1,23,156,1,1428,1,9,4,4,5,single-choice,spatial-relational,4|5,7,4/5,230156,4
7,1,23,157,1,1047,1,11,5,5,6,single-choice,spatial-relational,5|6,7,5/6,230157,5
7,1,23,158,1,813,1,5,2,2,3,single-choice,spatial-relational,2|3,7,2/3,230158,2
7,1,23,159,1,861,1,11,5,5,6,single-choice,spatial-relational,5|6,7,5/6,230159,5
7,1,23,160,0,729,1,3,1,2,2,single-choice,spatial-relational,1|2,7,1/2,230160,1
7,1,23,161,1,862,1,3,1,1,2,single-choice,spatial-relational,1|2,7,1/2,230161,1
7,1,23,162,1,1701,1,11,5,5,6,single-choice,spatial-relational,5|6,7,5/6,230162,5
7,1,23,163,1,959,1,11,5,5,6,single-choice,spatial-relational,5|6,7,5/6,230163,5
7,1,23,164,0,1400,1,9,4,5,5,single-choice,spatial-relational,4|5,7,4/5,230164,4
7,1,23,165,1,996,1,13,6,6,7,single-choice,spatial-relational,6|7,7,6/7,230165,6
7,1,23,166,1,1433,1,13,6,6,7,single-choice,spatial-relational,6|7,7,6/7,230166,6
7,1,23,167,1,815,1,5,2,2,3,single-choice,spatial-relational,2|3,7,2/3,230167,2
7,1,23,168,1,1090,1,9,4,4,5,single-choice,spatial-relational,4|5,7,4/5,230168,4
7,1,23,169,1,728,1,5,2,2,3,single-choice,spatial-relational,2|3,7,2/3,230169,2
7,1,23,170,0,1050,1,7,3,4,4,single-choice,spatial-relational,3|4,7,3/4,230170,3
7,1,23,171,0,1245,1,7,3,4,4,single-choice,spatial-relational,3|4,7,3/4,230171,3
7,1,23,172,1,1040,1,11,5,5,6,single-choice,spatial-relational,5|6,7,5/6,230172,5
7,1,23,173,1,1512,1,11,5,5,6,single-choice,spatial-relational,5|6,7,5/6,230173,5
7,1,23,174,1,855,1,3,1,1,2,single-choice,spatial-relational,1|2,7,1/2,230174,1
7,1,23,175,1,1123,1,13,6,6,7,single-choice,spatial-relational,6|7,7,6/7,230175,6
7,1,23,176,1,934,1,5,2,2,3,single-choice,spatial-relational,2|3,7,2/3,230176,2
7,1,23,177,1,652,1,5,2,2,3,single-choice,spatial-relational,2|3,7,2/3,230177,2
7,1,23,178,1,712,1,7,3,3,4,single-choice,spatial-relational,3|4,7,3/4,230178,3
7,1,23,179,1,801,1,3,1,1,2,single-choice,spatial-relational,1|2,7,1/2,230179,1
7,1,23,180,1,842,1,9,4,4,5,single-choice,spatial-relational,4|5,7,4/5,230180,4
7,1,23,181,1,1359,1,9,4,4,5,single-choice,spatial-relational,4|5,7,4/5,230181,4
7,1,23,182,1,1068,1,13,6,6,7,single-choice,spatial-relational,6|7,7,6/7,230182,6
7,1,23,183,1,963,1,7,3,3,4,single-choice,spatial-relational,3|4,7,3/4,230183,3
7,1,23,184,1,724,1,13,6,6,7,single-choice,spatial-relational,6|7,7,6/7,230184,6
7,1,23,185,1,1372,1,9,4,4,5,single-choice,spatial-relational,4|5,7,4/5,230185,4
7,1,23,186,0,865,1,3,1,2,2,single-choice,spatial-relational,1|2,7,1/2,230186,1
7,1,23,187,1,884,1,5,2,2,3,single-choice,spatial-relational,2|3,7,2/3,230187,2
7,1,23,188,1,935,1,11,5,5,6,single-choice,spatial-relational,5|6,7,5/6,230188,5
7,1,23,189,1,853,1,3,1,1,2,single-choice,spatial-relational,1|2,7,1/2,230189,1
7,1,23,190,1,1173,1,7,3,3,4,single-choice,spatial-relational,3|4,7,3/4,230190,3
7,1,23,191,1,1066,1,9,4,4,5,single-choice,spatial-relational,4|5,7,4/5,230191,4
7,1,23,192,1,1023,1,13,6,6,7,single-choice,spatial-relational,6|7,7,6/7,230192,6
7,1,23,193,1,1022,1,11,5,5,6,single-choice,spatial-relational,5|6,7,5/6,230193,5
7,1,23,194,1,1019,1,5,2,2,3,single-choice,spatial-relational,2|3,7,2/3,230194,2
7,1,23,195,1,814,1,7,3,3,4,single-choice,spatial-relational,3|4,7,3/4,230195,3
7,1,23,196,1,1228,1,7,3,3,4,single-choice,spatial-relational,3|4,7,3/4,230196,3
7,1,23,197,1,741,1,11,5,5,6,single-choice,spatial-relational,5|6,7,5/6,230197,5
7,1,23,198,1,996,1,3,1,1,2,single-choice,spatial-relational,1|2,7,1/2,230198,1
7,1,23,199,0,932,1,7,3,4,4,single-choice,spatial-relational,3|4,7,3/4,230199,3
7,1,23,200,1,890,1,9,4,4,5,single-choice,spatial-relational,4|5,7,4/5,230200,4
7,1,23,201,1,1111,1,13,6,6,7,single-choice,spatial-relational,6|7,7,6/7,230201,6
7,1,23,202,1,1023,1,5,2,2,3,single-choice,spatial-relational,2|3,7,2/3,230202,2
7,1,23,203,1,1196,1,9,4,4,5,single-choice,spatial-relational,4|5,7,4/5,230203,4
7,1,23,204,1,1308,1,11,5,5,6,single-choice,spatial-relational,5|6,7,5/6,230204,5
7,1,23,205,0,853,1,3,1,2,2,single-choice,spatial-relational,1|2,7,1/2,230205,1
7,1,23,206,1,767,1,5,2,2,3,single-choice,spatial-relational,2|3,7,2/3,230206,2
7,1,23,207,1,942,1,13,6,6,7,single-choice,spatial-relational,6|7,7,6/7,230207,6
7,1,23,208,1,1281,1,9,4,4,5,single-choice,spatial-relational,4|5,7,4/5,230208,4
7,1,23,209,1,833,1,3,1,1,2,single-choice,spatial-relational,1|2,7,1/2,230209,1
7,1,23,210,0,779,1,11,5,6,6,single-choice,spatial-relational,5|6,7,5/6,230210,5
7,1,23,211,1,804,1,3,1,1,2,single-choice,spatial-relational,1|2,7,1/2,230211,1
7,1,23,212,1,959,1,9,4,4,5,single-choice,spatial-relational,4|5,7,4/5,230212,4
7,1,23,213,1,1057,1,5,2,2,3,single-choice,spatial-relational,2|3,7,2/3,230213,2
7,1,23,214,1,702,1,7,3,3,4,single-choice,spatial-relational,3|4,7,3/4,230214,3
7,1,23,215,1,967,1,5,2,2,3,single-choice,spatial-relational,2|3,7,2/3,230215,2
7,1,23,216,1,904,1,13,6,6,7,single-choice,spatial-relational,6|7,7,6/7,230216,6
7,1,23,217,1,1178,1,13,6,6,7,single-choice,spatial-relational,6|7,7,6/7,230217,6
7,1,23,218,1,731,1,11,5,5,6,single-choice,spatial-relational,5|6,7,5/6,230218,5
7,1,23,219,1,836,1,7,3,3,4,single-choice,spatial-relational,3|4,7,3/4,230219,3
7,1,23,220,1,1166,1,13,6,6,7,single-choice,spatial-relational,6|7,7,6/7,230220,6
7,1,23,221,0,798,1,9,4,5,5,single-choice,spatial-relational,4|5,7,4/5,230221,4
7,1,23,222,1,1048,1,7,3,3,4,single-choice,spatial-relational,3|4,7,3/4,230222,3
7,1,23,223,1,878,1,13,6,6,7,single-choice,spatial-relational,6|7,7,6/7,230223,6
7,1,23,224,1,858,1,5,2,2,3,single-choice,spatial-relational,2|3,7,2/3,230224,2
7,1,23,225,0,1672,1,3,1,2,2,single-choice,spatial-relational,1|2,7,1/2,230225,1
7,1,23,226,1,1505,1,11,5,5,6,single-choice,spatial-relational,5|6,7,5/6,230226,5
7,1,23,227,1,778,1,3,1,1,2,single-choice,spatial-relational,1|2,7,1/2,230227,1
7,1,23,228,1,656,1,11,5,5,6,single-choice,spatial-relational,5|6,7,5/6,230228,5
7,1,23,229,1,956,1,5,2,2,3,single-choice,spatial-relational,2|3,7,2/3,230229,2
7,1,23,230,0,836,1,7,3,4,4,single-choice,spatial-relational,3|4,7,3/4,230230,3
7,1,23,231,0,1586,1,9,4,5,5,single-choice,spatial-relational,4|5,7,4/5,230231,4
7,1,23,232,0,956,1,5,2,3,3,single-choice,spatial-relational,2|3,7,2/3,230232,2
7,1,23,233,1,1280,1,7,3,3,4,single-choice,spatial-relational,3|4,7,3/4,230233,3
7,1,23,234,1,1208,1,9,4,4,5,single-choice,spatial-relational,4|5,7,4/5,230234,4
7,1,23,235,1,1055,1,13,6,6,7,single-choice,spatial-relational,6|7,7,6/7,230235,6
7,1,23,236,1,899,1,5,2,2,3,single-choice,spatial-relational,2|3,7,2/3,230236,2
7,1,23,237,1,1269,1,9,4,4,5,single-choice,spatial-relational,4|5,7,4/5,230237,4
7,1,23,238,1,1330,1,7,3,3,4,single-choice,spatial-relational,3|4,7,3/4,230238,3
7,1,23,239,1,702,1,3,1,1,2,single-choice,spatial-relational,1|2,7,1/2,230239,1
7,1,23,240,0,913,1,3,1,2,2,single-choice,spatial-relational,1|2,7,1/2,230240,1
7,1,23,241,1,1359,1,11,5,5,6,single-choice,spatial-relational,5|6,7,5/6,230241,5
7,1,23,242,1,1496,1,13,6,6,7,single-choice,spatial-relational,6|7,7,6/7,230242,6
7,1,23,243,1,908,1,11,5,5,6,single-choice,spatial-relational,5|6,7,5/6,230243,5
7,1,23,244,1,750,1,5,2,2,3,single-choice,spatial-relational,2|3,7,2/3,230244,2
7,1,23,245,0,878,1,3,1,2,2,single-choice,spatial-relational,1|2,7,1/2,230245,1
7,1,23,246,1,933,1,9,4,4,5,single-choice,spatial-relational,4|5,7,4/5,230246,4
7,1,23,247,1,1382,1,7,3,3,4,single-choice,spatial-relational,3|4,7,3/4,230247,3
7,1,23,248,1,918,1,3,1,1,2,single-choice,spatial-relational,1|2,7,1/2,230248,1
7,1,23,249,1,848,1,13,6,6,7,single-choice,spatial-relational,6|7,7,6/7,230249,6
7,1,23,250,1,825,1,5,2,2,3,single-choice,spatial-relational,2|3,7,2/3,230250,2
7,1,23,251,0,974,1,7,3,4,4,single-choice,spatial-relational,3|4,7,3/4,230251,3
7,1,23,252,1,1033,1,13,6,6,7,single-choice,spatial-relational,6|7,7,6/7,230252,6
7,1,23,253,1,1225,1,9,4,4,5,single-choice,spatial-relational,4|5,7,4/5,230253,4
7,1,23,254,1,1257,1,11,5,5,6,single-choice,spatial-relational,5|6,7,5/6,230254,5
7,1,23,255,1,1060,1,11,5,5,6,single-choice,spatial-relational,5|6,7,5/6,230255,5
7,1,23,256,1,1101,1,5,2,2,3,single-choice,spatial-relational,2|3,7,2/3,230256,2
7,1,23,257,1,689,1,3,1,1,2,single-choice,spatial-relational,1|2,7,1/2,230257,1
7,1,23,258,1,864,1,9,4,4,5,single-choice,spatial-relational,4|5,7,4/5,230258,4
7,1,23,259,1,791,1,5,2,2,3,single-choice,spatial-relational,2|3,7,2/3,230259,2
7,1,23,260,1,1173,1,9,4,4,5,single-choice,spatial-relational,4|5,7,4/5,230260,4
7,1,23,261,1,1177,1,7,3,3,4,single-choice,spatial-relational,3|4,7,3/4,230261,3
7,1,23,262,1,1258,1,11,5,5,6,single-choice,spatial-relational,5|6,7,5/6,230262,5
7,1,23,263,1,965,1,3,1,1,2,single-choice,spatial-relational,1|2,7,1/2,230263,1
7,1,23,264,1,974,1,7,3,3,4,single-choice,spatial-relational,3|4,7,3/4,230264,3
7,1,23,265,1,673,1,13,6,6,7,single-choice,spatial-relational,6|7,7,6/7,230265,6
7,1,23,266,1,1473,1,11,5,5,6,single-choice,spatial-relational,5|6,7,5/6,230266,5
7,1,23,267,1,1028,1,13,6,6,7,single-choice,spatial-relational,6|7,7,6/7,230267,6
7,1,23,268,1,771,1,11,5,5,6,single-choice,spatial-relational,5|6,7,5/6,230268,5
7,1,23,269,1,1074,1,13,6,6,7,single-choice,spatial-relational,6|7,7,6/7,230269,6
7,1,23,270,1,1081,1,7,3,3,4,single-choice,spatial-relational,3|4,7,3/4,230270,3
7,1,23,271,1,899,1,13,6,6,7,single-choice,spatial-relational,6|7,7,6/7,230271,6
7,1,23,272,1,1206,1,7,3,3,4,single-choice,spatial-relational,3|4,7,3/4,230272,3
7,1,23,273,0,914,1,11,5,6,6,single-choice,spatial-relational,5|6,7,5/6,230273,5
7,1,23,274,1,966,1,5,2,2,3,single-choice,spatial-relational,2|3,7,2/3,230274,2
7,1,23,275,1,703,1,5,2,2,3,single-choice,spatial-relational,2|3,7,2/3,230275,2
7,1,23,276,0,774,1,3,1,2,2,single-choice,spatial-relational,1|2,7,1/2,230276,1
7,1,23,277,0,860,1,9,4,5,5,single-choice,spatial-relational,4|5,7,4/5,230277,4
7,1,23,278,0,1081,1,9,4,5,5,single-choice,spatial-relational,4|5,7,4/5,230278,4
7,1,23,279,1,903,1,3,1,1,2,single-choice,spatial-relational,1|2,7,1/2,230279,1
7,1,23,280,0,117,1,9,4,5,5,single-choice,spatial-relational,4|5,7,4/5,230280,4
7,1,23,281,1,826,1,3,1,1,2,single-choice,spatial-relational,1|2,7,1/2,230281,1
7,1,23,282,1,1123,1,13,6,6,7,single-choice,spatial-relational,6|7,7,6/7,230282,6
7,1,23,283,1,953,1,5,2,2,3,single-choice,spatial-relational,2|3,7,2/3,230283,2
7,1,23,284,1,820,1,5,2,2,3,single-choice,spatial-relational,2|3,7,2/3,230284,2
7,1,23,285,1,999,1,9,4,4,5,single-choice,spatial-relational,4|5,7,4/5,230285,4
7,1,23,286,0,911,1,3,1,2,2,single-choice,spatial-relational,1|2,7,1/2,230286,1
7,1,23,287,1,1325,1,7,3,3,4,single-choice,spatial-relational,3|4,7,3/4,230287,3
7,1,23,288,1,1320,1,11,5,5,6,single-choice,spatial-relational,5|6,7,5/6,230288,5
7,1,23,289,1,1031,1,11,5,5,6,single-choice,spatial-relational,5|6,7,5/6,230289,5
7,1,23,290,1,1581,1,7,3,3,4,single-choice,spatial-relational,3|4,7,3/4,230290,3
7,1,23,291,1,964,1,13,6,6,7,single-choice,spatial-relational,6|7,7,6/7,230291,6
7,1,23,292,0,875,1,7,3,4,4,single-choice,spatial-relational,3|4,7,3/4,230292,3
7,1,23,293,0,2829,1,11,5,6,6,single-choice,spatial-relational,5|6,7,5/6,230293,5
7,1,23,294,0,1005,1,9,4,5,5,single-choice,spatial-relational,4|5,7,4/5,230294,4
7,1,23,295,1,874,1,3,1,1,2,single-choice,spatial-relational,1|2,7,1/2,230295,1
7,1,23,296,1,741,1,5,2,2,3,single-choice,spatial-relational,2|3,7,2/3,230296,2
7,1,23,297,1,1031,1,9,4,4,5,single-choice,spatial-relational,4|5,7,4/5,230297,4
7,1,23,298,0,1366,1,3,1,2,2,single-choice,spatial-relational,1|2,7,1/2,230298,1
7,1,23,299,1,1192,1,7,3,3,4,single-choice,spatial-relational,3|4,7,3/4,230299,3
7,1,23,300,1,946,1,13,6,6,7,single-choice,spatial-relational,6|7,7,6/7,230300,6
7,1,23,301,1,1371,1,13,6,6,7,single-choice,spatial-relational,6|7,7,6/7,230301,6
7,1,23,302,1,1088,1,11,5,5,6,single-choice,spatial-relational,5|6,7,5/6,230302,5
7,1,23,303,1,867,1,5,2,2,3,single-choice,spatial-relational,2|3,7,2/3,230303,2
7,1,23,304,1,1020,1,7,3,3,4,single-choice,spatial-relational,3|4,7,3/4,230304,3
7,1,23,305,1,910,1,7,3,3,4,single-choice,spatial-relational,3|4,7,3/4,230305,3
7,1,23,306,0,947,1,11,5,6,6,single-choice,spatial-relational,5|6,7,5/6,230306,5
7,1,23,307,1,829,1,5,2,2,3,single-choice,spatial-relational,2|3,7,2/3,230307,2
7,1,23,308,0,1199,1,9,4,5,5,single-choice,spatial-relational,4|5,7,4/5,230308,4
7,1,23,309,0,890,1,3,1,2,2,single-choice,spatial-relational,1|2,7,1/2,230309,1
7,1,23,310,1,822,1,3,1,1,2,single-choice,spatial-relational,1|2,7,1/2,230310,1
7,1,23,311,1,921,1,13,6,6,7,single-choice,spatial-relational,6|7,7,6/7,230311,6
7,1,23,312,1,1004,1,5,2,2,3,single-choice,spatial-relational,2|3,7,2/3,230312,2
7,1,23,313,1,1061,1,9,4,4,5,single-choice,spatial-relational,4|5,7,4/5,230313,4
7,1,23,314,0,1522,1,11,5,6,6,single-choice,spatial-relational,5|6,7,5/6,230314,5
7,1,23,315,1,1647,1,13,6,6,7,single-choice,spatial-relational,6|7,7,6/7,230315,6
7,1,23,316,0,1543,1,11,5,6,6,single-choice,spatial-relational,5|6,7,5/6,230316,5
7,1,23,317,1,1499,1,9,4,4,5,single-choice,spatial-relational,4|5,7,4/5,230317,4
7,1,23,318,1,1220,1,13,6,6,7,single-choice,spatial-relational,6|7,7,6/7,230318,6
7,1,23,319,1,1700,1,11,5,5,6,single-choice,spatial-relational,5|6,7,5/6,230319,5
7,1,23,320,1,737,1,5,2,2,3,single-choice,spatial-relational,2|3,7,2/3,230320,2
7,1,23,321,1,1081,1,7,3,3,4,single-choice,spatial-relational,3|4,7,3/4,230321,3
7,1,23,322,1,947,1,7,3,3,4,single-choice,spatial-relational,3|4,7,3/4,230322,3
7,1,23,323,1,859,1,5,2,2,3,single-choice,spatial-relational,2|3,7,2/3,230323,2
7,1,23,324,1,916,1,9,4,4,5,single-choice,spatial-relational,4|5,7,4/5,230324,4
7,1,23,325,1,864,1,3,1,1,2,single-choice,spatial-relational,1|2,7,1/2,230325,1
7,1,23,326,1,1002,1,13,6,6,7,single-choice,spatial-relational,6|7,7,6/7,230326,6
7,1,23,327,0,698,1,3,1,2,2,single-choice,spatial-relational,1|2,7,1/2,230327,1
7,1,23,328,1,1043,1,3,1,1,2,single-choice,spatial-relational,1|2,7,1/2,230328,1
7,1,23,329,1,856,1,5,2,2,3,single-choice,spatial-relational,2|3,7,2/3,230329,2
7,1,23,330,1,873,1,7,3,3,4,single-choice,spatial-relational,3|4,7,3/4,230330,3
7,1,23,331,1,822,1,13,6,6,7,single-choice,spatial-relational,6|7,7,6/7,230331,6
7,1,23,332,0,1374,1,9,4,5,5,single-choice,spatial-relational,4|5,7,4/5,230332,4
7,1,23,333,1,1169,1,7,3,3,4,single-choice,spatial-relational,3|4,7,3/4,230333,3
7,1,23,334,1,1403,1,5,2,2,3,single-choice,spatial-relational,2|3,7,2/3,230334,2
7,1,23,335,1,792,1,3,1,1,2,single-choice,spatial-relational,1|2,7,1/2,230335,1
7,1,23,336,1,1319,1,11,5,5,6,single-choice,spatial-relational,5|6,7,5/6,230336,5
7,1,23,337,1,789,1,13,6,6,7,single-choice,spatial-relational,6|7,7,6/7,230337,6
7,1,23,338,0,1334,1,11,5,6,6,single-choice,spatial-relational,5|6,7,5/6,230338,5
7,1,23,339,1,1410,1,9,4,4,5,single-choice,spatial-relational,4|5,7,4/5,230339,4
7,1,23,340,1,1106,1,13,6,6,7,single-choice,spatial-relational,6|7,7,6/7,230340,6
7,1,23,341,1,1510,1,11,5,5,6,single-choice,spatial-relational,5|6,7,5/6,230341,5
7,1,23,342,1,729,1,7,3,3,4,single-choice,spatial-relational,3|4,7,3/4,230342,3
7,1,23,343,1,777,1,5,2,2,3,single-choice,spatial-relational,2|3,7,2/3,230343,2
7,1,23,344,1,730,1,13,6,6,7,single-choice,spatial-relational,6|7,7,6/7,230344,6
7,1,23,345,1,885,1,3,1,1,2,single-choice,spatial-relational,1|2,7,1/2,230345,1
7,1,23,346,1,742,1,5,2,2,3,single-choice,spatial-relational,2|3,7,2/3,230346,2
7,1,23,347,1,722,1,3,1,1,2,single-choice,spatial-relational,1|2,7,1/2,230347,1
7,1,23,348,1,839,1,9,4,4,5,single-choice,spatial-relational,4|5,7,4/5,230348,4
7,1,23,349,1,1078,1,11,5,5,6,single-choice,spatial-relational,5|6,7,5/6,230349,5
7,1,23,350,1,1251,1,7,3,3,4,single-choice,spatial-relational,3|4,7,3/4,230350,3
7,1,23,351,1,824,1,9,4,4,5,single-choice,spatial-relational,4|5,7,4/5,230351,4
7,1,23,352,1,829,1,3,1,1,2,single-choice,spatial-relational,1|2,7,1/2,230352,1
7,1,23,353,1,761,1,5,2,2,3,single-choice,spatial-relational,2|3,7,2/3,230353,2
7,1,23,354,0,942,1,11,5,6,6,single-choice,spatial-relational,5|6,7,5/6,230354,5
7,1,23,355,1,974,1,11,5,5,6,single-choice,spatial-relational,5|6,7,5/6,230355,5
7,1,23,356,1,1678,1,9,4,4,5,single-choice,spatial-relational,4|5,7,4/5,230356,4
7,1,23,357,1,879,1,13,6,6,7,single-choice,spatial-relational,6|7,7,6/7,230357,6
7,1,23,358,1,972,1,13,6,6,7,single-choice,spatial-relational,6|7,7,6/7,230358,6
7,1,23,359,1,896,1,3,1,1,2,single-choice,spatial-relational,1|2,7,1/2,230359,1
7,1,23,360,0,1080,1,9,4,5,5,single-choice,spatial-relational,4|5,7,4/5,230360,4
7,1,23,361,1,804,1,5,2,2,3,single-choice,spatial-relational,2|3,7,2/3,230361,2
7,1,23,362,1,1015,1,7,3,3,4,single-choice,spatial-relational,3|4,7,3/4,230362,3
7,1,23,363,1,708,1,7,3,3,4,single-choice,spatial-relational,3|4,7,3/4,230363,3
7,1,23,364,1,779,1,5,2,2,3,single-choice,spatial-relational,2|3,7,2/3,230364,2
7,1,23,365,1,861,1,5,2,2,3,single-choice,spatial-relational,2|3,7,2/3,230365,2
7,1,23,366,0,987,1,7,3,4,4,single-choice,spatial-relational,3|4,7,3/4,230366,3
7,1,23,367,1,790,1,3,1,1,2,single-choice,spatial-relational,1|2,7,1/2,230367,1
7,1,23,368,1,823,1,3,1,1,2,single-choice,spatial-relational,1|2,7,1/2,230368,1
7,1,23,369,1,804,1,13,6,6,7,single-choice,spatial-relational,6|7,7,6/7,230369,6
7,1,23,370,1,948,1,9,4,4,5,single-choice,spatial-relational,4|5,7,4/5,230370,4
7,1,23,371,0,1166,1,7,3,4,4,single-choice,spatial-relational,3|4,7,3/4,230371,3
7,1,23,372,1,1070,1,9,4,4,5,single-choice,spatial-relational,4|5,7,4/5,230372,4
7,1,23,373,1,1349,1,11,5,5,6,single-choice,spatial-relational,5|6,7,5/6,230373,5
7,1,23,374,0,1362,1,11,5,6,6,single-choice,spatial-relational,5|6,7,5/6,230374,5
7,1,23,375,0,849,1,13,6,7,7,single-choice,spatial-relational,6|7,7,6/7,230375,6
7,1,23,376,1,1005,1,11,5,5,6,single-choice,spatial-relational,5|6,7,5/6,230376,5
7,1,23,377,1,831,1,3,1,1,2,single-choice,spatial-relational,1|2,7,1/2,230377,1
7,1,23,378,1,1736,1,9,4,4,5,single-choice,spatial-relational,4|5,7,4/5,230378,4
7,1,23,379,0,785,1,13,6,7,7,single-choice,spatial-relational,6|7,7,6/7,230379,6
7,1,23,380,1,2182,1,7,3,3,4,single-choice,spatial-relational,3|4,7,3/4,230380,3
7,1,23,381,0,830,1,3,1,2,2,single-choice,spatial-relational,1|2,7,1/2,230381,1
7,1,23,382,0,1320,1,11,5,6,6,single-choice,spatial-relational,5|6,7,5/6,230382,5
7,1,23,383,1,941,1,5,2,2,3,single-choice,spatial-relational,2|3,7,2/3,230383,2
7,1,23,384,1,979,1,7,3,3,4,single-choice,spatial-relational,3|4,7,3/4,230384,3
7,1,23,385,1,1041,1,9,4,4,5,single-choice,spatial-relational,4|5,7,4/5,230385,4
7,1,23,386,1,729,1,5,2,2,3,single-choice,spatial-relational,2|3,7,2/3,230386,2
7,1,23,387,1,926,1,13,6,6,7,single-choice,spatial-relational,6|7,7,6/7,230387,6
7,1,23,388,0,937,1,3,1,2,2,single-choice,spatial-relational,1|2,7,1/2,230388,1
7,1,23,389,1,825,1,11,5,5,6,single-choice,spatial-relational,5|6,7,5/6,230389,5
7,1,23,390,0,1019,1,3,1,2,2,single-choice,spatial-relational,1|2,7,1/2,230390,1
7,1,23,391,1,915,1,9,4,4,5,single-choice,spatial-relational,4|5,7,4/5,230391,4
7,1,23,392,1,1194,1,11,5,5,6,single-choice,spatial-relational,5|6,7,5/6,230392,5
7,1,23,393,1,808,1,5,2,2,3,single-choice,spatial-relational,2|3,7,2/3,230393,2
7,1,23,394,1,622,1,5,2,2,3,single-choice,spatial-relational,2|3,7,2/3,230394,2
7,1,23,395,1,1158,1,9,4,4,5,single-choice,spatial-relational,4|5,7,4/5,230395,4
7,1,23,396,1,1123,1,7,3,3,4,single-choice,spatial-relational,3|4,7,3/4,230396,3
7,1,23,397,1,1001,1,7,3,3,4,single-choice,spatial-relational,3|4,7,3/4,230397,3
7,1,23,398,1,801,1,13,6,6,7,single-choice,spatial-relational,6|7,7,6/7,230398,6
7,1,23,399,1,1417,1,13,6,6,7,single-choice,spatial-relational,6|7,7,6/7,230399,6
7,1,23,400,1,834,1,3,1,1,2,single-choice,spatial-relational,1|2,7,1/2,230400,1
7,1,23,401,1,849,1,3,1,1,2,single-choice,spatial-relational,1|2,7,1/2,230401,1
7,1,23,402,1,985,1,9,4,4,5,single-choice,spatial-relational,4|5,7,4/5,230402,4
7,1,23,403,1,831,1,5,2,2,3,single-choice,spatial-relational,2|3,7,2/3,230403,2
7,1,23,404,1,1341,1,9,4,4,5,single-choice,spatial-relational,4|5,7,4/5,230404,4
7,1,23,405,1,1000,1,7,3,3,4,single-choice,spatial-relational,3|4,7,3/4,230405,3
7,1,23,406,1,1054,1,11,5,5,6,single-choice,spatial-relational,5|6,7,5/6,230406,5
7,1,23,407,1,719,1,5,2,2,3,single-choice,spatial-relational,2|3,7,2/3,230407,2
7,1,23,408,1,1559,1,7,3,3,4,single-choice,spatial-relational,3|4,7,3/4,230408,3
7,1,23,409,1,912,1,13,6,6,7,single-choice,spatial-relational,6|7,7,6/7,230409,6
7,1,23,410,1,1230,1,13,6,6,7,single-choice,spatial-relational,6|7,7,6/7,230410,6
7,1,23,411,1,1653,1,11,5,5,6,single-choice,spatial-relational,5|6,7,5/6,230411,5
7,1,23,412,1,1245,1,13,6,6,7,single-choice,spatial-relational,6|7,7,6/7,230412,6
7,1,23,413,1,1064,1,13,6,6,7,single-choice,spatial-relational,6|7,7,6/7,230413,6
7,1,23,414,0,917,1,9,4,5,5,single-choice,spatial-relational,4|5,7,4/5,230414,4
7,1,23,415,1,896,1,3,1,1,2,single-choice,spatial-relational,1|2,7,1/2,230415,1
7,1,23,416,1,1558,1,11,5,5,6,single-choice,spatial-relational,5|6,7,5/6,230416,5
7,1,23,417,0,854,1,7,3,4,4,single-choice,spatial-relational,3|4,7,3/4,230417,3
7,1,23,418,1,835,1,3,1,1,2,single-choice,spatial-relational,1|2,7,1/2,230418,1
7,1,23,419,1,993,1,5,2,2,3,single-choice,spatial-relational,2|3,7,2/3,230419,2
7,1,23,420,1,40,1,11,5,5,6,single-choice,spatial-relational,5|6,7,5/6,230420,5
7,1,23,421,1,1041,1,5,2,2,3,single-choice,spatial-relational,2|3,7,2/3,230421,2
7,1,23,422,1,946,1,7,3,3,4,single-choice,spatial-relational,3|4,7,3/4,230422,3
7,1,23,423,1,66,1,9,4,4,5,single-choice,spatial-relational,4|5,7,4/5,230423,4
7,1,23,424,0,1143,1,9,4,5,5,single-choice,spatial-relational,4|5,7,4/5,230424,4
7,1,23,425,1,792,1,11,5,5,6,single-choice,spatial-relational,5|6,7,5/6,230425,5
7,1,23,426,1,1803,1,9,4,4,5,single-choice,spatial-relational,4|5,7,4/5,230426,4
7,1,23,427,1,1305,1,7,3,3,4,single-choice,spatial-relational,3|4,7,3/4,230427,3
7,1,23,428,0,1664,1,11,5,6,6,single-choice,spatial-relational,5|6,7,5/6,230428,5
7,1,23,429,1,32,1,7,3,3,4,single-choice,spatial-relational,3|4,7,3/4,230429,3
7,1,23,430,1,792,1,3,1,1,2,single-choice,spatial-relational,1|2,7,1/2,230430,1
7,1,23,431,1,743,1,5,2,2,3,single-choice,spatial-relational,2|3,7,2/3,230431,2
7,1,23,432,1,728,1,5,2,2,3,single-choice,spatial-relational,2|3,7,2/3,230432,2
7,1,23,433,1,834,1,13,6,6,7,single-choice,spatial-relational,6|7,7,6/7,230433,6
7,1,23,434,1,1015,1,3,1,1,2,single-choice,spatial-relational,1|2,7,1/2,230434,1
7,1,23,435,1,923,1,13,6,6,7,single-choice,spatial-relational,6|7,7,6/7,230435,6
7,1,23,436,1,997,1,11,5,5,6,single-choice,spatial-relational,5|6,7,5/6,230436,5
7,1,23,437,1,954,1,3,1,1,2,single-choice,spatial-relational,1|2,7,1/2,230437,1
7,1,23,438,1,1606,1,7,3,3,4,single-choice,spatial-relational,3|4,7,3/4,230438,3
7,1,23,439,1,714,1,13,6,6,7,single-choice,spatial-relational,6|7,7,6/7,230439,6
7,1,23,440,1,1346,1,11,5,5,6,single-choice,spatial-relational,5|6,7,5/6,230440,5
7,1,23,441,0,847,1,5,2,3,3,single-choice,spatial-relational,2|3,7,2/3,230441,2
7,1,23,442,1,851,1,3,1,1,2,single-choice,spatial-relational,1|2,7,1/2,230442,1
7,1,23,443,1,999,1,13,6,6,7,single-choice,spatial-relational,6|7,7,6/7,230443,6
7,1,23,444,1,803,1,5,2,2,3,single-choice,spatial-relational,2|3,7,2/3,230444,2
7,1,23,445,0,1397,1,9,4,5,5,single-choice,spatial-relational,4|5,7,4/5,230445,4
7,1,23,446,1,1583,1,9,4,4,5,single-choice,spatial-relational,4|5,7,4/5,230446,4
7,1,23,447,1,1072,1,7,3,3,4,single-choice,spatial-relational,3|4,7,3/4,230447,3
7,1,23,448,1,884,1,13,6,6,7,single-choice,spatial-relational,6|7,7,6/7,230448,6
7,1,23,449,1,1392,1,11,5,5,6,single-choice,spatial-relational,5|6,7,5/6,230449,5
7,1,23,450,0,969,1,7,3,4,4,single-choice,spatial-relational,3|4,7,3/4,230450,3
7,1,23,451,1,1564,1,11,5,5,6,single-choice,spatial-relational,5|6,7,5/6,230451,5
7,1,23,452,1,855,1,3,1,1,2,single-choice,spatial-relational,1|2,7,1/2,230452,1
7,1,23,453,1,1137,1,5,2,2,3,single-choice,spatial-relational,2|3,7,2/3,230453,2
7,1,23,454,1,727,1,5,2,2,3,single-choice,spatial-relational,2|3,7,2/3,230454,2
7,1,23,455,1,903,1,13,6,6,7,single-choice,spatial-relational,6|7,7,6/7,230455,6
7,1,23,456,0,1420,1,7,3,4,4,single-choice,spatial-relational,3|4,7,3/4,230456,3
7,1,23,457,1,979,1,9,4,4,5,single-choice,spatial-relational,4|5,7,4/5,230457,4
7,1,23,458,1,1166,1,9,4,4,5,single-choice,spatial-relational,4|5,7,4/5,230458,4
7,1,23,459,1,878,1,3,1,1,2,single-choice,spatial-relational,1|2,7,1/2,230459,1
7,1,23,460,1,782,1,9,4,4,5,single-choice,spatial-relational,4|5,7,4/5,230460,4
7,1,23,461,1,964,1,5,2,2,3,single-choice,spatial-relational,2|3,7,2/3,230461,2
7,1,23,462,1,752,1,13,6,6,7,single-choice,spatial-relational,6|7,7,6/7,230462,6
7,1,23,463,1,1231,1,7,3,3,4,single-choice,spatial-relational,3|4,7,3/4,230463,3
7,1,23,464,1,1295,1,9,4,4,5,single-choice,spatial-relational,4|5,7,4/5,230464,4
7,1,23,465,1,908,1,3,1,1,2,single-choice,spatial-relational,1|2,7,1/2,230465,1
7,1,23,466,0,87,1,3,1,2,2,single-choice,spatial-relational,1|2,7,1/2,230466,1
7,1,23,467,1,861,1,7,3,3,4,single-choice,spatial-relational,3|4,7,3/4,230467,3
7,1,23,468,1,1450,1,11,5,5,6,single-choice,spatial-relational,5|6,7,5/6,230468,5
7,1,23,469,1,860,1,5,2,2,3,single-choice,spatial-relational,2|3,7,2/3,230469,2
7,1,23,470,1,866,1,13,6,6,7,single-choice,spatial-relational,6|7,7,6/7,230470,6
7,1,23,471,1,1611,1,11,5,5,6,single-choice,spatial-relational,5|6,7,5/6,230471,5
7,1,23,472,1,1121,1,9,4,4,5,single-choice,spatial-relational,4|5,7,4/5,230472,4
7,1,23,473,1,1098,1,7,3,3,4,single-choice,spatial-relational,3|4,7,3/4,230473,3
7,1,23,474,1,877,1,5,2,2,3,single-choice,spatial-relational,2|3,7,2/3,230474,2
7,1,23,475,1,1103,1,7,3,3,4,single-choice,spatial-relational,3|4,7,3/4,230475,3
7,1,23,476,1,1293,1,11,5,5,6,single-choice,spatial-relational,5|6,7,5/6,230476,5
7,1,23,477,1,1028,1,13,6,6,7,single-choice,spatial-relational,6|7,7,6/7,230477,6
7,1,23,478,1,1066,1,11,5,5,6,single-choice,spatial-relational,5|6,7,5/6,230478,5
7,1,23,479,1,1023,1,13,6,6,7,single-choice,spatial-relational,6|7,7,6/7,230479,6
7,1,23,480,1,902,1,3,1,1,2,single-choice,spatial-relational,1|2,7,1/2,230480,1
7,1,23,481,1,804,1,5,2,2,3,single-choice,spatial-relational,2|3,7,2/3,230481,2
7,1,23,482,1,1341,1,9,4,4,5,single-choice,spatial-relational,4|5,7,4/5,230482,4
7,1,23,483,0,746,1,3,1,2,2,single-choice,spatial-relational,1|2,7,1/2,230483,1
7,1,23,484,1,1005,1,13,6,6,7,single-choice,spatial-relational,6|7,7,6/7,230484,6
7,1,23,485,1,904,1,7,3,3,4,single-choice,spatial-relational,3|4,7,3/4,230485,3
7,1,23,486,0,686,1,3,1,2,2,single-choice,spatial-relational,1|2,7,1/2,230486,1
7,1,23,487,0,1054,1,11,5,6,6,single-choice,spatial-relational,5|6,7,5/6,230487,5
7,1,23,488,0,1428,1,9,4,5,5,single-choice,spatial-relational,4|5,7,4/5,230488,4
7,1,23,489,1,833,1,3,1,1,2,single-choice,spatial-relational,1|2,7,1/2,230489,1
7,1,23,490,1,1074,1,5,2,2,3,single-choice,spatial-relational,2|3,7,2/3,230490,2
7,1,23,491,1,1841,1,7,3,3,4,single-choice,spatial-relational,3|4,7,3/4,230491,3
7,1,23,492,0,976,1,9,4,5,5,single-choice,spatial-relational,4|5,7,4/5,230492,4
7,1,23,493,0,881,1,13,6,7,7,single-choice,spatial-relational,6|7,7,6/7,230493,6
7,1,23,494,0,908,1,5,2,3,3,single-choice,spatial-relational,2|3,7,2/3,230494,2
7,1,23,495,1,1005,1,11,5,5,6,single-choice,spatial-relational,5|6,7,5/6,230495,5
7,1,23,496,1,883,1,5,2,2,3,single-choice,spatial-relational,2|3,7,2/3,230496,2
7,1,23,497,1,1095,1,11,5,5,6,single-choice,spatial-relational,5|6,7,5/6,230497,5
7,1,23,498,1,1116,1,7,3,3,4,single-choice,spatial-relational,3|4,7,3/4,230498,3
7,1,23,499,0,597,1,13,6,7,7,single-choice,spatial-relational,6|7,7,6/7,230499,6
7,1,23,500,0,734,1,9,4,5,5,single-choice,spatial-relational,4|5,7,4/5,230500,4
7,1,23,501,1,1152,1,5,2,2,3,single-choice,spatial-relational,2|3,7,2/3,230501,2
7,1,23,502,1,1144,1,11,5,5,6,single-choice,spatial-relational,5|6,7,5/6,230502,5
7,1,23,503,1,872,1,3,1,1,2,single-choice,spatial-relational,1|2,7,1/2,230503,1
7,1,23,504,1,882,1,13,6,6,7,single-choice,spatial-relational,6|7,7,6/7,230504,6
7,1,23,505,1,970,1,7,3,3,4,single-choice,spatial-relational,3|4,7,3/4,230505,3
7,1,23,506,1,829,1,3,1,1,2,single-choice,spatial-relational,1|2,7,1/2,230506,1
7,1,23,507,1,1619,1,9,4,4,5,single-choice,spatial-relational,4|5,7,4/5,230507,4
7,1,23,508,1,956,1,13,6,6,7,single-choice,spatial-relational,6|7,7,6/7,230508,6
7,1,23,509,0,853,1,7,3,4,4,single-choice,spatial-relational,3|4,7,3/4,230509,3
7,1,23,510,0,1234,1,11,5,6,6,single-choice,spatial-relational,5|6,7,5/6,230510,5
7,1,23,511,0,36,1,9,4,5,5,single-choice,spatial-relational,4|5,7,4/5,230511,4
7,1,23,512,0,1232,1,13,6,7,7,single-choice,spatial-relational,6|7,7,6/7,230512,6
7,1,23,513,1,864,1,5,2,2,3,single-choice,spatial-relational,2|3,7,2/3,230513,2
7,1,23,514,0,759,1,3,1,2,2,single-choice,spatial-relational,1|2,7,1/2,230514,1
7,1,23,515,1,58,1,11,5,5,6,single-choice,spatial-relational,5|6,7,5/6,230515,5
7,1,23,516,1,1308,1,7,3,3,4,single-choice,spatial-relational,3|4,7,3/4,230516,3
7,1,23,517,1,868,1,3,1,1,2,single-choice,spatial-relational,1|2,7,1/2,230517,1
7,1,23,518,1,123,1,5,2,2,3,single-choice,spatial-relational,2|3,7,2/3,230518,2
7,1,23,519,1,1077,1,9,4,4,5,single-choice,spatial-relational,4|5,7,4/5,230519,4
7,1,23,520,1,957,1,13,6,6,7,single-choice,spatial-relational,6|7,7,6/7,230520,6
7,1,23,521,1,668,1,5,2,2,3,single-choice,spatial-relational,2|3,7,2/3,230521,2
7,1,23,522,1,734,1,5,2,2,3,single-choice,spatial-relational,2|3,7,2/3,230522,2
7,1,23,523,0,19180,1,7,3,4,4,single-choice,spatial-relational,3|4,7,3/4,230523,3
7,1,23,524,1,699,1,3,1,1,2,single-choice,spatial-relational,1|2,7,1/2,230524,1
7,1,23,525,1,1001,1,13,6,6,7,single-choice,spatial-relational,6|7,7,6/7,230525,6
7,1,23,526,1,1304,1,9,4,4,5,single-choice,spatial-relational,4|5,7,4/5,230526,4
7,1,23,527,1,1057,1,11,5,5,6,single-choice,spatial-relational,5|6,7,5/6,230527,5
7,1,23,528,1,927,1,9,4,4,5,single-choice,spatial-relational,4|5,7,4/5,230528,4
7,1,23,529,0,956,1,7,3,4,4,single-choice,spatial-relational,3|4,7,3/4,230529,3
7,1,23,530,1,831,1,3,1,1,2,single-choice,spatial-relational,1|2,7,1/2,230530,1
7,1,23,531,0,939,1,11,5,6,6,single-choice,spatial-relational,5|6,7,5/6,230531,5
7,1,23,532,1,906,1,5,2,2,3,single-choice,spatial-relational,2|3,7,2/3,230532,2
7,1,23,533,1,873,1,7,3,3,4,single-choice,spatial-relational,3|4,7,3/4,230533,3
7,1,23,534,1,1161,1,7,3,3,4,single-choice,spatial-relational,3|4,7,3/4,230534,3
7,1,23,535,1,892,1,13,6,6,7,single-choice,spatial-relational,6|7,7,6/7,230535,6
7,1,23,536,1,973,1,3,1,1,2,single-choice,spatial-relational,1|2,7,1/2,230536,1
7,1,23,537,1,1015,1,11,5,5,6,single-choice,spatial-relational,5|6,7,5/6,230537,5
7,1,23,538,1,775,1,5,2,2,3,single-choice,spatial-relational,2|3,7,2/3,230538,2
7,1,23,539,1,987,1,13,6,6,7,single-choice,spatial-relational,6|7,7,6/7,230539,6
7,1,23,540,1,905,1,3,1,1,2,single-choice,spatial-relational,1|2,7,1/2,230540,1
7,1,23,541,1,78,1,9,4,4,5,single-choice,spatial-relational,4|5,7,4/5,230541,4
7,1,23,542,1,1130,1,9,4,4,5,single-choice,spatial-relational,4|5,7,4/5,230542,4
7,1,23,543,1,1333,1,11,5,5,6,single-choice,spatial-relational,5|6,7,5/6,230543,5
7,1,23,544,1,1026,1,9,4,4,5,single-choice,spatial-relational,4|5,7,4/5,230544,4
7,1,23,545,1,773,1,3,1,1,2,single-choice,spatial-relational,1|2,7,1/2,230545,1
7,1,23,546,1,1055,1,11,5,5,6,single-choice,spatial-relational,5|6,7,5/6,230546,5
7,1,23,547,1,1280,1,7,3,3,4,single-choice,spatial-relational,3|4,7,3/4,230547,3
7,1,23,548,1,1527,1,11,5,5,6,single-choice,spatial-relational,5|6,7,5/6,230548,5
7,1,23,549,1,902,1,7,3,3,4,single-choice,spatial-relational,3|4,7,3/4,230549,3
7,1,23,550,0,676,1,9,4,5,5,single-choice,spatial-relational,4|5,7,4/5,230550,4
7,1,23,551,1,787,1,3,1,1,2,single-choice,spatial-relational,1|2,7,1/2,230551,1
7,1,23,552,1,915,1,5,2,2,3,single-choice,spatial-relational,2|3,7,2/3,230552,2
7,1,23,553,1,912,1,13,6,6,7,single-choice,spatial-relational,6|7,7,6/7,230553,6
7,1,23,554,1,821,1,5,2,2,3,single-choice,spatial-relational,2|3,7,2/3,230554,2
7,1,23,555,1,936,1,13,6,6,7,single-choice,spatial-relational,6|7,7,6/7,230555,6
7,1,23,556,0,815,1,3,1,2,2,single-choice,spatial-relational,1|2,7,1/2,230556,1
7,1,23,557,0,483,1,5,2,3,3,single-choice,spatial-relational,2|3,7,2/3,230557,2
7,1,23,558,1,2231,1,7,3,3,4,single-choice,spatial-relational,3|4,7,3/4,230558,3
7,1,23,559,1,1147,1,11,5,5,6,single-choice,spatial-relational,5|6,7,5/6,230559,5
7,1,23,560,1,1055,1,3,1,1,2,single-choice,spatial-relational,1|2,7,1/2,230560,1
7,1,23,561,1,1242,1,9,4,4,5,single-choice,spatial-relational,4|5,7,4/5,230561,4
7,1,23,562,1,1071,1,13,6,6,7,single-choice,spatial-relational,6|7,7,6/7,230562,6
7,1,23,563,1,763,1,13,6,6,7,single-choice,spatial-relational,6|7,7,6/7,230563,6
7,1,23,564,1,869,1,5,2,2,3,single-choice,spatial-relational,2|3,7,2/3,230564,2
7,1,23,565,1,68,1,7,3,3,4,single-choice,spatial-relational,3|4,7,3/4,230565,3
7,1,23,566,0,1616,1,11,5,6,6,single-choice,spatial-relational,5|6,7,5/6,230566,5
7,1,23,567,1,865,1,9,4,4,5,single-choice,spatial-relational,4|5,7,4/5,230567,4
7,1,23,568,1,1146,1,9,4,4,5,single-choice,spatial-relational,4|5,7,4/5,230568,4
7,1,23,569,1,1161,1,7,3,3,4,single-choice,spatial-relational,3|4,7,3/4,230569,3
7,1,23,570,1,733,1,3,1,1,2,single-choice,spatial-relational,1|2,7,1/2,230570,1
7,1,23,571,1,987,1,11,5,5,6,single-choice,spatial-relational,5|6,7,5/6,230571,5
7,1,23,572,1,1084,1,7,3,3,4,single-choice,spatial-relational,3|4,7,3/4,230572,3
7,1,23,573,1,915,1,13,6,6,7,single-choice,spatial-relational,6|7,7,6/7,230573,6
7,1,23,574,1,1128,1,9,4,4,5,single-choice,spatial-relational,4|5,7,4/5,230574,4
7,1,23,575,1,806,1,3,1,1,2,single-choice,spatial-relational,1|2,7,1/2,230575,1
7,1,23,576,0,952,1,5,2,3,3,single-choice,spatial-relational,2|3,7,2/3,230576,2
7,1,23,577,1,1065,1,13,6,6,7,single-choice,spatial-relational,6|7,7,6/7,230577,6
7,1,23,578,1,1424,1,11,5,5,6,single-choice,spatial-relational,5|6,7,5/6,230578,5
7,1,23,579,1,1258,1,5,2,2,3,single-choice,spatial-relational,2|3,7,2/3,230579,2
7,1,23,580,0,731,1,3,1,2,2,single-choice,spatial-relational,1|2,7,1/2,230580,1
7,1,23,581,1,1540,1,5,2,2,3,single-choice,spatial-relational,2|3,7,2/3,230581,2
7,1,23,582,1,1399,1,11,5,5,6,single-choice,spatial-relational,5|6,7,5/6,230582,5
7,1,23,583,0,1093,1,9,4,5,5,single-choice,spatial-relational,4|5,7,4/5,230583,4
7,1,23,584,1,848,1,7,3,3,4,single-choice,spatial-relational,3|4,7,3/4,230584,3
7,1,23,585,1,901,1,13,6,6,7,single-choice,spatial-relational,6|7,7,6/7,230585,6
7,1,23,586,1,1289,1,9,4,4,5,single-choice,spatial-relational,4|5,7,4/5,230586,4
7,1,23,587,1,1072,1,13,6,6,7,single-choice,spatial-relational,6|7,7,6/7,230587,6
7,1,23,588,1,950,1,5,2,2,3,single-choice,spatial-relational,2|3,7,2/3,230588,2
7,1,23,589,1,887,1,7,3,3,4,single-choice,spatial-relational,3|4,7,3/4,230589,3
7,1,23,590,1,914,1,11,5,5,6,single-choice,spatial-relational,5|6,7,5/6,230590,5
7,1,23,591,1,1292,1,3,1,1,2,single-choice,spatial-relational,1|2,7,1/2,230591,1
7,1,23,592,0,728,1,3,1,2,2,single-choice,spatial-relational,1|2,7,1/2,230592,1
7,1,23,593,1,801,1,5,2,2,3,single-choice,spatial-relational,2|3,7,2/3,230593,2
7,1,23,594,1,918,1,13,6,6,7,single-choice,spatial-relational,6|7,7,6/7,230594,6
7,1,23,595,1,1013,1,3,1,1,2,single-choice,spatial-relational,1|2,7,1/2,230595,1
7,1,23,596,1,980,1,7,3,3,4,single-choice,spatial-relational,3|4,7,3/4,230596,3
7,1,23,597,1,1128,1,11,5,5,6,single-choice,spatial-relational,5|6,7,5/6,230597,5
7,1,23,598,1,1160,1,11,5,5,6,single-choice,spatial-relational,5|6,7,5/6,230598,5
7,1,23,599,1,1387,1,9,4,4,5,single-choice,spatial-relational,4|5,7,4/5,230599,4
7,1,23,600,1,1565,1,7,3,3,4,single-choice,spatial-relational,3|4,7,3/4,230600,3
7,1,23,601,1,815,1,13,6,6,7,single-choice,spatial-relational,6|7,7,6/7,230601,6
7,1,23,602,0,1123,1,5,2,3,3,single-choice,spatial-relational,2|3,7,2/3,230602,2
7,1,23,603,1,1328,1,9,4,4,5,single-choice,spatial-relational,4|5,7,4/5,230603,4
7,1,23,604,0,1054,1,3,1,2,2,single-choice,spatial-relational,1|2,7,1/2,230604,1
7,1,23,605,1,1034,1,7,3,3,4,single-choice,spatial-relational,3|4,7,3/4,230605,3
7,1,23,606,1,977,1,13,6,6,7,single-choice,spatial-relational,6|7,7,6/7,230606,6
7,1,23,607,1,1412,1,9,4,4,5,single-choice,spatial-relational,4|5,7,4/5,230607,4
7,1,23,608,1,1240,1,7,3,3,4,single-choice,spatial-relational,3|4,7,3/4,230608,3
7,1,23,609,1,803,1,5,2,2,3,single-choice,spatial-relational,2|3,7,2/3,230609,2
7,1,23,610,1,1320,1,11,5,5,6,single-choice,spatial-relational,5|6,7,5/6,230610,5
7,1,23,611,1,930,1,5,2,2,3,single-choice,spatial-relational,2|3,7,2/3,230611,2
7,1,23,612,1,857,1,3,1,1,2,single-choice,spatial-relational,1|2,7,1/2,230612,1
7,1,23,613,1,1151,1,9,4,4,5,single-choice,spatial-relational,4|5,7,4/5,230613,4
7,1,23,614,1,1073,1,11,5,5,6,single-choice,spatial-relational,5|6,7,5/6,230614,5
7,1,23,615,1,1088,1,13,6,6,7,single-choice,spatial-relational,6|7,7,6/7,230615,6
1,1,24,1,1,28,1,11,5,5,6,single-choice,spatial-relational,5|6,7,5/6,240001,5
1,1,24,2,0,540,2,10,4,6,6,single-choice,spatial-relational,4|6,7,4/6,240002,4
1,1,24,3,1,44,1,3,1,1,2,single-choice,spatial-relational,1|2,7,1/2,240003,1
1,1,24,4,0,599,5,7,1,6,6,single-choice,spatial-relational,1|6,7,1/6,240004,1
1,1,24,5,0,522,4,6,1,5,5,single-choice,spatial-relational,1|5,7,1/5,240005,1
1,1,24,6,0,565,3,9,3,6,6,single-choice,spatial-relational,3|6,7,3/6,240006,3
1,1,24,7,1,616,4,8,2,2,6,single-choice,spatial-relational,2|6,7,2/6,240007,2
1,1,24,8,0,436,4,8,2,6,6,single-choice,spatial-relational,2|6,7,2/6,240008,2
1,1,24,9,1,413,1,13,6,6,7,single-choice,spatial-relational,6|7,7,6/7,240009,6
1,1,24,10,1,373,3,7,2,2,5,single-choice,spatial-relational,2|5,7,2/5,240010,2
1,1,24,11,0,402,5,9,2,7,7,single-choice,spatial-relational,2|7,7,2/7,240011,2
1,1,24,12,0,425,3,11,4,7,7,single-choice,spatial-relational,4|7,7,4/7,240012,4
1,1,24,13,0,513,1,9,4,5,5,single-choice,spatial-relational,4|5,7,4/5,240013,4
1,1,24,14,0,350,2,12,5,7,7,single-choice,spatial-relational,5|7,7,5/7,240014,5
1,1,24,15,1,518,2,10,4,4,6,single-choice,spatial-relational,4|6,7,4/6,240015,4
1,1,24,16,0,415,2,4,1,3,3,single-choice,spatial-relational,1|3,7,1/3,240016,1
1,1,24,17,1,501,1,7,3,3,4,single-choice,spatial-relational,3|4,7,3/4,240017,3
1,1,24,18,0,424,3,5,1,4,4,single-choice,spatial-relational,1|4,7,1/4,240018,1
1,1,24,19,1,633,2,12,5,5,7,single-choice,spatial-relational,5|7,7,5/7,240019,5
1,1,24,20,0,472,6,8,1,7,7,single-choice,spatial-relational,1|7,7,1/7,240020,1
1,1,24,21,1,456,2,4,1,1,3,single-choice,spatial-relational,1|3,7,1/3,240021,1
1,1,24,22,0,481,6,8,1,7,7,single-choice,spatial-relational,1|7,7,1/7,240022,1
1,1,24,23,1,459,1,5,2,2,3,single-choice,spatial-relational,2|3,7,2/3,240023,2
1,1,24,24,0,596,2,8,3,5,5,single-choice,spatial-relational,3|5,7,3/5,240024,3
1,1,24,25,1,669,3,7,2,2,5,single-choice,spatial-relational,2|5,7,2/5,240025,2
1,1,24,26,1,843,1,9,4,4,5,single-choice,spatial-relational,4|5,7,4/5,240026,4
1,1,24,27,1,760,2,8,3,3,5,single-choice,spatial-relational,3|5,7,3/5,240027,3
1,1,24,28,0,521,1,3,1,2,2,single-choice,spatial-relational,1|2,7,1/2,240028,1
1,1,24,29,1,764,3,11,4,4,7,single-choice,spatial-relational,4|7,7,4/7,240029,4
1,1,24,30,0,593,3,5,1,4,4,single-choice,spatial-relational,1|4,7,1/4,240030,1
1,1,24,31,1,772,4,10,3,3,7,single-choice,spatial-relational,3|7,7,3/7,240031,3
1,1,24,32,1,788,2,6,2,2,4,single-choice,spatial-relational,2|4,7,2/4,240032,2
1,1,24,33,1,862,1,11,5,5,6,single-choice,spatial-relational,5|6,7,5/6,240033,5
1,1,24,34,0,714,2,6,2,4,4,single-choice,spatial-relational,2|4,7,2/4,240034,2
1,1,24,35,0,523,1,5,2,3,3,single-choice,spatial-relational,2|3,7,2/3,240035,2
1,1,24,36,1,275,4,6,1,1,5,single-choice,spatial-relational,1|5,7,1/5,240036,1
1,1,24,37,1,549,3,9,3,3,6,single-choice,spatial-relational,3|6,7,3/6,240037,3
1,1,24,38,0,486,4,10,3,7,7,single-choice,spatial-relational,3|7,7,3/7,240038,3
1,1,24,39,0,485,5,7,1,6,6,single-choice,spatial-relational,1|6,7,1/6,240039,1
1,1,24,40,0,611,1,13,6,7,7,single-choice,spatial-relational,6|7,7,6/7,240040,6
1,1,24,41,0,1174,1,7,3,4,4,single-choice,spatial-relational,3|4,7,3/4,240041,3
1,1,24,42,1,569,5,9,2,2,7,single-choice,spatial-relational,2|7,7,2/7,240042,2
1,1,24,43,1,645,5,7,1,1,6,single-choice,spatial-relational,1|6,7,1/6,240043,1
1,1,24,44,1,612,2,10,4,4,6,single-choice,spatial-relational,4|6,7,4/6,240044,4
1,1,24,45,0,503,2,4,1,3,3,single-choice,spatial-relational,1|3,7,1/3,240045,1
1,1,24,46,1,686,3,9,3,3,6,single-choice,spatial-relational,3|6,7,3/6,240046,3
1,1,24,47,0,616,3,9,3,6,6,single-choice,spatial-relational,3|6,7,3/6,240047,3
1,1,24,48,1,935,1,9,4,4,5,single-choice,spatial-relational,4|5,7,4/5,240048,4
1,1,24,49,0,56,2,10,4,6,6,single-choice,spatial-relational,4|6,7,4/6,240049,4
1,1,24,50,0,670,4,8,2,6,6,single-choice,spatial-relational,2|6,7,2/6,240050,2
1,1,24,51,1,633,2,4,1,1,3,single-choice,spatial-relational,1|3,7,1/3,240051,1
1,1,24,52,1,816,3,7,2,2,5,single-choice,spatial-relational,2|5,7,2/5,240052,2
1,1,24,53,1,83,1,3,1,1,2,single-choice,spatial-relational,1|2,7,1/2,240053,1
1,1,24,54,0,489,5,9,2,7,7,single-choice,spatial-relational,2|7,7,2/7,240054,2
1,1,24,55,0,782,2,8,3,5,5,single-choice,spatial-relational,3|5,7,3/5,240055,3
1,1,24,56,1,923,1,7,3,3,4,single-choice,spatial-relational,3|4,7,3/4,240056,3
1,1,24,57,1,541,6,8,1,1,7,single-choice,spatial-relational,1|7,7,1/7,240057,1
1,1,24,58,0,1207,1,3,1,2,2,single-choice,spatial-relational,1|2,7,1/2,240058,1
1,1,24,59,0,32,5,7,1,6,6,single-choice,spatial-relational,1|6,7,1/6,240059,1
1,1,24,60,1,48,2,6,2,2,4,single-choice,spatial-relational,2|4,7,2/4,240060,2
1,1,24,61,1,455,3,11,4,4,7,single-choice,spatial-relational,4|7,7,4/7,240061,4
1,1,24,62,0,433,3,7,2,5,5,single-choice,spatial-relational,2|5,7,2/5,240062,2
1,1,24,63,1,561,1,7,3,3,4,single-choice,spatial-relational,3|4,7,3/4,240063,3
1,1,24,64,0,52,2,12,5,7,7,single-choice,spatial-relational,5|7,7,5/7,240064,5
1,1,24,65,0,507,1,5,2,3,3,single-choice,spatial-relational,2|3,7,2/3,240065,2
1,1,24,66,1,650,3,5,1,1,4,single-choice,spatial-relational,1|4,7,1/4,240066,1
1,1,24,67,0,565,2,6,2,4,4,single-choice,spatial-relational,2|4,7,2/4,240067,2
1,1,24,68,1,881,2,8,3,3,5,single-choice,spatial-relational,3|5,7,3/5,240068,3
1,1,24,69,0,527,3,5,1,4,4,single-choice,spatial-relational,1|4,7,1/4,240069,1
1,1,24,70,1,930,5,9,2,2,7,single-choice,spatial-relational,2|7,7,2/7,240070,2
1,1,24,71,0,787,6,8,1,7,7,single-choice,spatial-relational,1|7,7,1/7,240071,1
1,1,24,72,0,884,3,11,4,7,7,single-choice,spatial-relational,4|7,7,4/7,240072,4
1,1,24,73,1,44,2,12,5,5,7,single-choice,spatial-relational,5|7,7,5/7,240073,5
1,1,24,74,1,1007,1,13,6,6,7,single-choice,spatial-relational,6|7,7,6/7,240074,6
1,1,24,75,1,951,4,10,3,3,7,single-choice,spatial-relational,3|7,7,3/7,240075,3
1,1,24,76,0,935,4,8,2,6,6,single-choice,spatial-relational,2|6,7,2/6,240076,2
1,1,24,77,1,1168,1,11,5,5,6,single-choice,spatial-relational,5|6,7,5/6,240077,5
1,1,24,78,1,1276,4,6,1,1,5,single-choice,spatial-relational,1|5,7,1/5,240078,1
1,1,24,79,0,1025,4,10,3,7,7,single-choice,spatial-relational,3|7,7,3/7,240079,3
1,1,24,80,1,848,4,6,1,1,5,single-choice,spatial-relational,1|5,7,1/5,240080,1
1,1,24,81,1,861,1,11,5,5,6,single-choice,spatial-relational,5|6,7,5/6,240081,5
1,1,24,82,0,1841,1,5,2,3,3,single-choice,spatial-relational,2|3,7,2/3,240082,2
1,1,24,83,1,920,1,13,6,6,7,single-choice,spatial-relational,6|7,7,6/7,240083,6
1,1,24,84,0,931,1,9,4,5,5,single-choice,spatial-relational,4|5,7,4/5,240084,4
1,1,24,85,1,770,5,7,1,1,6,single-choice,spatial-relational,1|6,7,1/6,240085,1
1,1,24,86,1,704,3,7,2,2,5,single-choice,spatial-relational,2|5,7,2/5,240086,2
1,1,24,87,1,787,3,11,4,4,7,single-choice,spatial-relational,4|7,7,4/7,240087,4
1,1,24,88,0,1216,1,5,2,3,3,single-choice,spatial-relational,2|3,7,2/3,240088,2
1,1,24,89,1,924,3,5,1,1,4,single-choice,spatial-relational,1|4,7,1/4,240089,1
1,1,24,90,1,724,1,3,1,1,2,single-choice,spatial-relational,1|2,7,1/2,240090,1
1,1,24,91,1,127,5,9,2,2,7,single-choice,spatial-relational,2|7,7,2/7,240091,2
1,1,24,92,1,715,2,4,1,1,3,single-choice,spatial-relational,1|3,7,1/3,240092,1
1,1,24,93,1,821,3,9,3,3,6,single-choice,spatial-relational,3|6,7,3/6,240093,3
1,1,24,94,1,914,1,5,2,2,3,single-choice,spatial-relational,2|3,7,2/3,240094,2
1,1,24,95,1,860,4,10,3,3,7,single-choice,spatial-relational,3|7,7,3/7,240095,3
1,1,24,96,1,967,1,7,3,3,4,single-choice,spatial-relational,3|4,7,3/4,240096,3
1,1,24,97,0,933,1,9,4,5,5,single-choice,spatial-relational,4|5,7,4/5,240097,4
1,1,24,98,1,1019,1,11,5,5,6,single-choice,spatial-relational,5|6,7,5/6,240098,5
1,1,24,99,1,1060,4,6,1,1,5,single-choice,spatial-relational,1|5,7,1/5,240099,1
1,1,24,100,1,693,4,8,2,2,6,single-choice,spatial-relational,2|6,7,2/6,240100,2
1,1,24,101,1,1113,1,9,4,4,5,single-choice,spatial-relational,4|5,7,4/5,240101,4
1,1,24,102,1,964,2,6,2,2,4,single-choice,spatial-relational,2|4,7,2/4,240102,2
1,1,24,103,1,866,2,8,3,3,5,single-choice,spatial-relational,3|5,7,3/5,240103,3
1,1,24,104,1,884,3,5,1,1,4,single-choice,spatial-relational,1|4,7,1/4,240104,1
1,1,24,105,1,687,2,4,1,1,3,single-choice,spatial-relational,1|3,7,1/3,240105,1
1,1,24,106,1,789,2,12,5,5,7,single-choice,spatial-relational,5|7,7,5/7,240106,5
1,1,24,107,1,1028,1,11,5,5,6,single-choice,spatial-relational,5|6,7,5/6,240107,5
1,1,24,108,1,1807,2,8,3,3,5,single-choice,spatial-relational,3|5,7,3/5,240108,3
1,1,24,109,1,814,1,3,1,1,2,single-choice,spatial-relational,1|2,7,1/2,240109,1
1,1,24,110,1,882,6,8,1,1,7,single-choice,spatial-relational,1|7,7,1/7,240110,1
1,1,24,111,1,677,4,6,1,1,5,single-choice,spatial-relational,1|5,7,1/5,240111,1
1,1,24,112,1,824,2,12,5,5,7,single-choice,spatial-relational,5|7,7,5/7,240112,5
1,1,24,113,0,740,2,6,2,4,4,single-choice,spatial-relational,2|4,7,2/4,240113,2
1,1,24,114,0,939,1,7,3,4,4,single-choice,spatial-relational,3|4,7,3/4,240114,3
1,1,24,115,1,850,3,7,2,2,5,single-choice,spatial-relational,2|5,7,2/5,240115,2
1,1,24,116,1,803,5,7,1,1,6,single-choice,spatial-relational,1|6,7,1/6,240116,1
1,1,24,117,1,593,4,10,3,3,7,single-choice,spatial-relational,3|7,7,3/7,240117,3
1,1,24,118,0,894,4,8,2,6,6,single-choice,spatial-relational,2|6,7,2/6,240118,2
1,1,24,119,1,1160,6,8,1,1,7,single-choice,spatial-relational,1|7,7,1/7,240119,1
1,1,24,120,0,32,3,11,4,7,7,single-choice,spatial-relational,4|7,7,4/7,240120,4
1,1,24,121,1,1147,3,9,3,3,6,single-choice,spatial-relational,3|6,7,3/6,240121,3
1,1,24,122,1,853,5,9,2,2,7,single-choice,spatial-relational,2|7,7,2/7,240122,2
1,1,24,123,1,974,1,13,6,6,7,single-choice,spatial-relational,6|7,7,6/7,240123,6
1,1,24,124,0,989,2,10,4,6,6,single-choice,spatial-relational,4|6,7,4/6,240124,4
1,1,24,125,1,1130,2,10,4,4,6,single-choice,spatial-relational,4|6,7,4/6,240125,4
1,1,24,126,1,986,1,13,6,6,7,single-choice,spatial-relational,6|7,7,6/7,240126,6
1,1,24,127,1,1399,1,7,3,3,4,single-choice,spatial-relational,3|4,7,3/4,240127,3
1,1,24,128,0,725,1,5,2,3,3,single-choice,spatial-relational,2|3,7,2/3,240128,2
1,1,24,129,1,48,5,9,2,2,7,single-choice,spatial-relational,2|7,7,2/7,240129,2
1,1,24,130,1,672,1,5,2,2,3,single-choice,spatial-relational,2|3,7,2/3,240130,2
1,1,24,131,1,1123,3,11,4,4,7,single-choice,spatial-relational,4|7,7,4/7,240131,4
1,1,24,132,1,810,1,3,1,1,2,single-choice,spatial-relational,1|2,7,1/2,240132,1
1,1,24,133,1,708,4,6,1,1,5,single-choice,spatial-relational,1|5,7,1/5,240133,1
1,1,24,134,1,787,2,4,1,1,3,single-choice,spatial-relational,1|3,7,1/3,240134,1
1,1,24,135,0,52,1,3,1,2,2,single-choice,spatial-relational,1|2,7,1/2,240135,1
1,1,24,136,1,821,4,8,2,2,6,single-choice,spatial-relational,2|6,7,2/6,240136,2
1,1,24,137,1,790,4,10,3,3,7,single-choice,spatial-relational,3|7,7,3/7,240137,3
1,1,24,138,1,1782,2,10,4,4,6,single-choice,spatial-relational,4|6,7,4/6,240138,4
1,1,24,139,1,1326,6,8,1,1,7,single-choice,spatial-relational,1|7,7,1/7,240139,1
1,1,24,140,1,669,5,7,1,1,6,single-choice,spatial-relational,1|6,7,1/6,240140,1
1,1,24,141,1,676,2,6,2,2,4,single-choice,spatial-relational,2|4,7,2/4,240141,2
1,1,24,142,1,1002,2,10,4,4,6,single-choice,spatial-relational,4|6,7,4/6,240142,4
1,1,24,143,1,704,4,8,2,2,6,single-choice,spatial-relational,2|6,7,2/6,240143,2
1,1,24,144,1,862,1,11,5,5,6,single-choice,spatial-relational,5|6,7,5/6,240144,5
1,1,24,145,1,1042,6,8,1,1,7,single-choice,spatial-relational,1|7,7,1/7,240145,1
1,1,24,146,1,670,2,12,5,5,7,single-choice,spatial-relational,5|7,7,5/7,240146,5
1,1,24,147,1,1437,1,9,4,4,5,single-choice,spatial-relational,4|5,7,4/5,240147,4
1,1,24,148,1,824,3,5,1,1,4,single-choice,spatial-relational,1|4,7,1/4,240148,1
1,1,24,149,0,832,1,7,3,4,4,single-choice,spatial-relational,3|4,7,3/4,240149,3
1,1,24,150,1,961,3,11,4,4,7,single-choice,spatial-relational,4|7,7,4/7,240150,4
1,1,24,151,1,781,2,6,2,2,4,single-choice,spatial-relational,2|4,7,2/4,240151,2
1,1,24,152,1,877,5,7,1,1,6,single-choice,spatial-relational,1|6,7,1/6,240152,1
1,1,24,153,0,1337,3,7,2,5,5,single-choice,spatial-relational,2|5,7,2/5,240153,2
1,1,24,154,1,32,3,5,1,1,4,single-choice,spatial-relational,1|4,7,1/4,240154,1
1,1,24,155,1,804,1,13,6,6,7,single-choice,spatial-relational,6|7,7,6/7,240155,6
1,1,24,156,1,1046,1,9,4,4,5,single-choice,spatial-relational,4|5,7,4/5,240156,4
1,1,24,157,1,987,1,13,6,6,7,single-choice,spatial-relational,6|7,7,6/7,240157,6
1,1,24,158,1,971,2,8,3,3,5,single-choice,spatial-relational,3|5,7,3/5,240158,3
1,1,24,159,1,1652,3,7,2,2,5,single-choice,spatial-relational,2|5,7,2/5,240159,2
1,1,24,160,1,776,4,10,3,3,7,single-choice,spatial-relational,3|7,7,3/7,240160,3
1,1,24,161,1,787,4,6,1,1,5,single-choice,spatial-relational,1|5,7,1/5,240161,1
1,1,24,162,1,817,5,9,2,2,7,single-choice,spatial-relational,2|7,7,2/7,240162,2
1,1,24,163,1,919,3,9,3,3,6,single-choice,spatial-relational,3|6,7,3/6,240163,3
1,1,24,164,0,896,2,8,3,5,5,single-choice,spatial-relational,3|5,7,3/5,240164,3
1,1,24,165,1,808,2,4,1,1,3,single-choice,spatial-relational,1|3,7,1/3,240165,1
1,1,24,166,1,826,3,9,3,3,6,single-choice,spatial-relational,3|6,7,3/6,240166,3
1,1,24,167,1,891,2,12,5,5,7,single-choice,spatial-relational,5|7,7,5/7,240167,5
1,1,24,168,0,792,1,11,5,6,6,single-choice,spatial-relational,5|6,7,5/6,240168,5
1,1,24,169,1,824,2,4,1,1,3,single-choice,spatial-relational,1|3,7,1/3,240169,1
1,1,24,170,1,851,3,7,2,2,5,single-choice,spatial-relational,2|5,7,2/5,240170,2
1,1,24,171,0,620,1,3,1,2,2,single-choice,spatial-relational,1|2,7,1/2,240171,1
1,1,24,172,1,971,2,10,4,4,6,single-choice,spatial-relational,4|6,7,4/6,240172,4
1,1,24,173,1,1253,2,12,5,5,7,single-choice,spatial-relational,5|7,7,5/7,240173,5
1,1,24,174,0,988,3,9,3,6,6,single-choice,spatial-relational,3|6,7,3/6,240174,3
1,1,24,175,0,899,3,11,4,7,7,single-choice,spatial-relational,4|7,7,4/7,240175,4
1,1,24,176,1,910,6,8,1,1,7,single-choice,spatial-relational,1|7,7,1/7,240176,1
1,1,24,177,1,669,2,6,2,2,4,single-choice,spatial-relational,2|4,7,2/4,240177,2
1,1,24,178,1,805,2,12,5,5,7,single-choice,spatial-relational,5|7,7,5/7,240178,5
1,1,24,179,1,775,4,6,1,1,5,single-choice,spatial-relational,1|5,7,1/5,240179,1
1,1,24,180,1,961,2,4,1,1,3,single-choice,spatial-relational,1|3,7,1/3,240180,1
1,1,24,181,1,607,1,3,1,1,2,single-choice,spatial-relational,1|2,7,1/2,240181,1
1,1,24,182,1,895,4,8,2,2,6,single-choice,spatial-relational,2|6,7,2/6,240182,2
1,1,24,183,1,723,5,7,1,1,6,single-choice,spatial-relational,1|6,7,1/6,240183,1
1,1,24,184,1,761,2,8,3,3,5,single-choice,spatial-relational,3|5,7,3/5,240184,3
1,1,24,185,1,1260,4,6,1,1,5,single-choice,spatial-relational,1|5,7,1/5,240185,1
1,1,24,186,1,844,1,11,5,5,6,single-choice,spatial-relational,5|6,7,5/6,240186,5
1,1,24,187,1,882,3,7,2,2,5,single-choice,spatial-relational,2|5,7,2/5,240187,2
1,1,24,188,1,1127,4,10,3,3,7,single-choice,spatial-relational,3|7,7,3/7,240188,3
1,1,24,189,1,876,1,5,2,2,3,single-choice,spatial-relational,2|3,7,2/3,240189,2
1,1,24,190,0,1490,1,7,3,4,4,single-choice,spatial-relational,3|4,7,3/4,240190,3
1,1,24,191,0,1332,2,10,4,6,6,single-choice,spatial-relational,4|6,7,4/6,240191,4
1,1,24,192,1,920,1,13,6,6,7,single-choice,spatial-relational,6|7,7,6/7,240192,6
1,1,24,193,1,1415,3,9,3,3,6,single-choice,spatial-relational,3|6,7,3/6,240193,3
1,1,24,194,1,1104,3,5,1,1,4,single-choice,spatial-relational,1|4,7,1/4,240194,1
1,1,24,195,1,882,2,6,2,2,4,single-choice,spatial-relational,2|4,7,2/4,240195,2
1,1,24,196,0,860,1,9,4,5,5,single-choice,spatial-relational,4|5,7,4/5,240196,4
1,1,24,197,1,722,1,13,6,6,7,single-choice,spatial-relational,6|7,7,6/7,240197,6
1,1,24,198,0,1015,4,8,2,6,6,single-choice,spatial-relational,2|6,7,2/6,240198,2
1,1,24,199,1,42,4,10,3,3,7,single-choice,spatial-relational,3|7,7,3/7,240199,3
1,1,24,200,1,791,3,5,1,1,4,single-choice,spatial-relational,1|4,7,1/4,240200,1
1,1,24,201,1,1060,6,8,1,1,7,single-choice,spatial-relational,1|7,7,1/7,240201,1
1,1,24,202,1,905,1,9,4,4,5,single-choice,spatial-relational,4|5,7,4/5,240202,4
1,1,24,203,1,735,1,5,2,2,3,single-choice,spatial-relational,2|3,7,2/3,240203,2
1,1,24,204,1,1350,5,9,2,2,7,single-choice,spatial-relational,2|7,7,2/7,240204,2
1,1,24,205,1,897,2,8,3,3,5,single-choice,spatial-relational,3|5,7,3/5,240205,3
1,1,24,206,1,911,3,11,4,4,7,single-choice,spatial-relational,4|7,7,4/7,240206,4
1,1,24,207,1,1128,1,11,5,5,6,single-choice,spatial-relational,5|6,7,5/6,240207,5
1,1,24,208,1,1447,5,9,2,2,7,single-choice,spatial-relational,2|7,7,2/7,240208,2
1,1,24,209,0,694,1,7,3,4,4,single-choice,spatial-relational,3|4,7,3/4,240209,3
1,1,24,210,1,873,5,7,1,1,6,single-choice,spatial-relational,1|6,7,1/6,240210,1
1,1,24,211,1,728,4,10,3,3,7,single-choice,spatial-relational,3|7,7,3/7,240211,3
1,1,24,212,1,986,1,11,5,5,6,single-choice,spatial-relational,5|6,7,5/6,240212,5
1,1,24,213,1,1200,5,9,2,2,7,single-choice,spatial-relational,2|7,7,2/7,240213,2
1,1,24,214,1,832,3,11,4,4,7,single-choice,spatial-relational,4|7,7,4/7,240214,4
1,1,24,215,1,1329,3,9,3,3,6,single-choice,spatial-relational,3|6,7,3/6,240215,3
1,1,24,216,0,1345,2,10,4,6,6,single-choice,spatial-relational,4|6,7,4/6,240216,4
1,1,24,217,1,1062,3,9,3,3,6,single-choice,spatial-relational,3|6,7,3/6,240217,3
1,1,24,218,1,700,3,5,1,1,4,single-choice,spatial-relational,1|4,7,1/4,240218,1
1,1,24,219,1,925,5,7,1,1,6,single-choice,spatial-relational,1|6,7,1/6,240219,1
1,1,24,220,1,823,4,8,2,2,6,single-choice,spatial-relational,2|6,7,2/6,240220,2
1,1,24,221,1,625,2,6,2,2,4,single-choice,spatial-relational,2|4,7,2/4,240221,2
1,1,24,222,0,1188,1,5,2,3,3,single-choice,spatial-relational,2|3,7,2/3,240222,2
1,1,24,223,1,1240,3,11,4,4,7,single-choice,spatial-relational,4|7,7,4/7,240223,4
1,1,24,224,1,773,4,6,1,1,5,single-choice,spatial-relational,1|5,7,1/5,240224,1
1,1,24,225,0,1107,2,10,4,6,6,single-choice,spatial-relational,4|6,7,4/6,240225,4
1,1,24,226,1,1019,1,13,6,6,7,single-choice,spatial-relational,6|7,7,6/7,240226,6
1,1,24,227,1,961,2,12,5,5,7,single-choice,spatial-relational,5|7,7,5/7,240227,5
1,1,24,228,1,799,2,4,1,1,3,single-choice,spatial-relational,1|3,7,1/3,240228,1
1,1,24,229,1,983,4,6,1,1,5,single-choice,spatial-relational,1|5,7,1/5,240229,1
1,1,24,230,1,884,3,5,1,1,4,single-choice,spatial-relational,1|4,7,1/4,240230,1
1,1,24,231,1,1055,1,7,3,3,4,single-choice,spatial-relational,3|4,7,3/4,240231,3
1,1,24,232,0,911,1,9,4,5,5,single-choice,spatial-relational,4|5,7,4/5,240232,4
1,1,24,233,1,1634,1,11,5,5,6,single-choice,spatial-relational,5|6,7,5/6,240233,5
1,1,24,234,1,1317,1,7,3,3,4,single-choice,spatial-relational,3|4,7,3/4,240234,3
1,1,24,235,1,1293,2,8,3,3,5,single-choice,spatial-relational,3|5,7,3/5,240235,3
1,1,24,236,1,868,1,3,1,1,2,single-choice,spatial-relational,1|2,7,1/2,240236,1
1,1,24,237,1,664,5,7,1,1,6,single-choice,spatial-relational,1|6,7,1/6,240237,1
1,1,24,238,1,849,2,8,3,3,5,single-choice,spatial-relational,3|5,7,3/5,240238,3
1,1,24,239,1,863,1,13,6,6,7,single-choice,spatial-relational,6|7,7,6/7,240239,6
1,1,24,240,1,928,1,5,2,2,3,single-choice,spatial-relational,2|3,7,2/3,240240,2
1,1,24,241,0,814,1,9,4,5,5,single-choice,spatial-relational,4|5,7,4/5,240241,4
1,1,24,242,1,1287,2,6,2,2,4,single-choice,spatial-relational,2|4,7,2/4,240242,2
1,1,24,243,1,1393,5,9,2,2,7,single-choice,spatial-relational,2|7,7,2/7,240243,2
1,1,24,244,1,954,3,7,2,2,5,single-choice,spatial-relational,2|5,7,2/5,240244,2
1,1,24,245,1,774,4,10,3,3,7,single-choice,spatial-relational,3|7,7,3/7,240245,3
1,1,24,246,1,859,2,12,5,5,7,single-choice,spatial-relational,5|7,7,5/7,240246,5
1,1,24,247,1,932,1,3,1,1,2,single-choice,spatial-relational,1|2,7,1/2,240247,1
1,1,24,248,1,973,6,8,1,1,7,single-choice,spatial-relational,1|7,7,1/7,240248,1
1,1,24,249,1,878,6,8,1,1,7,single-choice,spatial-relational,1|7,7,1/7,240249,1
1,1,24,250,1,752,2,4,1,1,3,single-choice,spatial-relational,1|3,7,1/3,240250,1
1,1,24,251,0,44,3,7,2,5,5,single-choice,spatial-relational,2|5,7,2/5,240251,2
1,1,24,252,1,825,4,8,2,2,6,single-choice,spatial-relational,2|6,7,2/6,240252,2
1,1,24,253,1,1057,2,8,3,3,5,single-choice,spatial-relational,3|5,7,3/5,240253,3
1,1,24,254,1,1044,1,7,3,3,4,single-choice,spatial-relational,3|4,7,3/4,240254,3
1,1,24,255,1,851,3,9,3,3,6,single-choice,spatial-relational,3|6,7,3/6,240255,3
1,1,24,256,1,706,2,4,1,1,3,single-choice,spatial-relational,1|3,7,1/3,240256,1
1,1,24,257,1,567,3,7,2,2,5,single-choice,spatial-relational,2|5,7,2/5,240257,2
1,1,24,258,1,1038,3,5,1,1,4,single-choice,spatial-relational,1|4,7,1/4,240258,1
1,1,24,259,0,695,4,8,2,6,6,single-choice,spatial-relational,2|6,7,2/6,240259,2
1,1,24,260,1,1104,1,11,5,5,6,single-choice,spatial-relational,5|6,7,5/6,240260,5
1,1,24,261,1,1190,2,6,2,2,4,single-choice,spatial-relational,2|4,7,2/4,240261,2
1,1,24,262,1,748,3,9,3,3,6,single-choice,spatial-relational,3|6,7,3/6,240262,3
1,1,24,263,1,911,1,11,5,5,6,single-choice,spatial-relational,5|6,7,5/6,240263,5
1,1,24,264,1,834,4,10,3,3,7,single-choice,spatial-relational,3|7,7,3/7,240264,3
1,1,24,265,1,1083,1,5,2,2,3,single-choice,spatial-relational,2|3,7,2/3,240265,2
1,1,24,266,1,714,3,5,1,1,4,single-choice,spatial-relational,1|4,7,1/4,240266,1
1,1,24,267,1,1309,1,9,4,4,5,single-choice,spatial-relational,4|5,7,4/5,240267,4
1,1,24,268,0,1275,2,10,4,6,6,single-choice,spatial-relational,4|6,7,4/6,240268,4
1,1,24,269,1,774,1,5,2,2,3,single-choice,spatial-relational,2|3,7,2/3,240269,2
1,1,24,270,1,1014,3,7,2,2,5,single-choice,spatial-relational,2|5,7,2/5,240270,2
1,1,24,271,1,756,1,13,6,6,7,single-choice,spatial-relational,6|7,7,6/7,240271,6
1,1,24,272,1,1419,6,8,1,1,7,single-choice,spatial-relational,1|7,7,1/7,240272,1
1,1,24,273,1,1076,2,6,2,2,4,single-choice,spatial-relational,2|4,7,2/4,240273,2
1,1,24,274,1,705,4,6,1,1,5,single-choice,spatial-relational,1|5,7,1/5,240274,1
1,1,24,275,1,832,2,12,5,5,7,single-choice,spatial-relational,5|7,7,5/7,240275,5
1,1,24,276,1,890,1,3,1,1,2,single-choice,spatial-relational,1|2,7,1/2,240276,1
1,1,24,277,1,612,5,9,2,2,7,single-choice,spatial-relational,2|7,7,2/7,240277,2
1,1,24,278,1,682,5,7,1,1,6,single-choice,spatial-relational,1|6,7,1/6,240278,1
1,1,24,279,1,758,1,7,3,3,4,single-choice,spatial-relational,3|4,7,3/4,240279,3
1,1,24,280,0,650,2,4,1,3,3,single-choice,spatial-relational,1|3,7,1/3,240280,1
1,1,24,281,1,974,3,11,4,4,7,single-choice,spatial-relational,4|7,7,4/7,240281,4
1,1,24,282,0,886,2,10,4,6,6,single-choice,spatial-relational,4|6,7,4/6,240282,4
1,1,24,283,1,865,2,12,5,5,7,single-choice,spatial-relational,5|7,7,5/7,240283,5
1,1,24,284,1,775,1,3,1,1,2,single-choice,spatial-relational,1|2,7,1/2,240284,1
1,1,24,285,1,1042,3,11,4,4,7,single-choice,spatial-relational,4|7,7,4/7,240285,4
1,1,24,286,0,1148,1,9,4,5,5,single-choice,spatial-relational,4|5,7,4/5,240286,4
1,1,24,287,1,1115,2,8,3,3,5,single-choice,spatial-relational,3|5,7,3/5,240287,3
1,1,24,288,1,843,4,8,2,2,6,single-choice,spatial-relational,2|6,7,2/6,240288,2
1,1,24,289,1,861,4,10,3,3,7,single-choice,spatial-relational,3|7,7,3/7,240289,3
1,1,24,290,1,934,4,6,1,1,5,single-choice,spatial-relational,1|5,7,1/5,240290,1
1,1,24,291,1,959,6,8,1,1,7,single-choice,spatial-relational,1|7,7,1/7,240291,1
1,1,24,292,1,1133,5,9,2,2,7,single-choice,spatial-relational,2|7,7,2/7,240292,2
1,1,24,293,1,809,1,13,6,6,7,single-choice,spatial-relational,6|7,7,6/7,240293,6
1,1,24,294,0,1161,5,7,1,6,6,single-choice,spatial-relational,1|6,7,1/6,240294,1
1,1,24,295,1,1155,2,6,2,2,4,single-choice,spatial-relational,2|4,7,2/4,240295,2
1,1,24,296,1,655,5,7,1,1,6,single-choice,spatial-relational,1|6,7,1/6,240296,1
1,1,24,297,0,1009,1,7,3,4,4,single-choice,spatial-relational,3|4,7,3/4,240297,3
1,1,24,298,1,886,1,5,2,2,3,single-choice,spatial-relational,2|3,7,2/3,240298,2
1,1,24,299,1,1110,4,8,2,2,6,single-choice,spatial-relational,2|6,7,2/6,240299,2
1,1,24,300,1,875,2,12,5,5,7,single-choice,spatial-relational,5|7,7,5/7,240300,5
1,1,24,301,1,1313,5,7,1,1,6,single-choice,spatial-relational,1|6,7,1/6,240301,1
1,1,24,302,1,743,1,13,6,6,7,single-choice,spatial-relational,6|7,7,6/7,240302,6
1,1,24,303,1,1104,4,6,1,1,5,single-choice,spatial-relational,1|5,7,1/5,240303,1
1,1,24,304,1,836,1,11,5,5,6,single-choice,spatial-relational,5|6,7,5/6,240304,5
1,1,24,305,0,1593,2,10,4,6,6,single-choice,spatial-relational,4|6,7,4/6,240305,4
1,1,24,306,1,40,1,3,1,1,2,single-choice,spatial-relational,1|2,7,1/2,240306,1
1,1,24,307,0,67,1,7,3,4,4,single-choice,spatial-relational,3|4,7,3/4,240307,3
1,1,24,308,0,478,3,5,1,4,4,single-choice,spatial-relational,1|4,7,1/4,240308,1
1,1,24,309,1,773,2,4,1,1,3,single-choice,spatial-relational,1|3,7,1/3,240309,1
1,1,24,310,1,832,1,13,6,6,7,single-choice,spatial-relational,6|7,7,6/7,240310,6
1,1,24,311,0,1446,1,9,4,5,5,single-choice,spatial-relational,4|5,7,4/5,240311,4
1,1,24,312,1,897,3,7,2,2,5,single-choice,spatial-relational,2|5,7,2/5,240312,2
1,1,24,313,1,1021,6,8,1,1,7,single-choice,spatial-relational,1|7,7,1/7,240313,1
1,1,24,314,1,788,2,12,5,5,7,single-choice,spatial-relational,5|7,7,5/7,240314,5
1,1,24,315,1,803,4,6,1,1,5,single-choice,spatial-relational,1|5,7,1/5,240315,1
1,1,24,316,1,740,2,4,1,1,3,single-choice,spatial-relational,1|3,7,1/3,240316,1
1,1,24,317,1,1211,2,6,2,2,4,single-choice,spatial-relational,2|4,7,2/4,240317,2
1,1,24,318,1,961,6,8,1,1,7,single-choice,spatial-relational,1|7,7,1/7,240318,1
1,1,24,319,1,587,4,10,3,3,7,single-choice,spatial-relational,3|7,7,3/7,240319,3
1,1,24,320,0,858,2,10,4,6,6,single-choice,spatial-relational,4|6,7,4/6,240320,4
1,1,24,321,1,1187,3,9,3,3,6,single-choice,spatial-relational,3|6,7,3/6,240321,3
1,1,24,322,1,787,4,10,3,3,7,single-choice,spatial-relational,3|7,7,3/7,240322,3
1,1,24,323,1,658,5,9,2,2,7,single-choice,spatial-relational,2|7,7,2/7,240323,2
1,1,24,324,1,855,3,11,4,4,7,single-choice,spatial-relational,4|7,7,4/7,240324,4
1,1,24,325,1,687,1,3,1,1,2,single-choice,spatial-relational,1|2,7,1/2,240325,1
1,1,24,326,0,1228,1,5,2,3,3,single-choice,spatial-relational,2|3,7,2/3,240326,2
1,1,24,327,1,768,3,5,1,1,4,single-choice,spatial-relational,1|4,7,1/4,240327,1
1,1,24,328,0,1233,1,9,4,5,5,single-choice,spatial-relational,4|5,7,4/5,240328,4
1,1,24,329,1,787,3,11,4,4,7,single-choice,spatial-relational,4|7,7,4/7,240329,4
1,1,24,330,1,1076,3,7,2,2,5,single-choice,spatial-relational,2|5,7,2/5,240330,2
1,1,24,331,1,1003,4,8,2,2,6,single-choice,spatial-relational,2|6,7,2/6,240331,2
1,1,24,332,1,1122,2,8,3,3,5,single-choice,spatial-relational,3|5,7,3/5,240332,3
1,1,24,333,1,1101,3,9,3,3,6,single-choice,spatial-relational,3|6,7,3/6,240333,3
1,1,24,334,1,760,2,8,3,3,5,single-choice,spatial-relational,3|5,7,3/5,240334,3
1,1,24,335,1,1056,1,11,5,5,6,single-choice,spatial-relational,5|6,7,5/6,240335,5
1,1,24,336,1,1068,5,9,2,2,7,single-choice,spatial-relational,2|7,7,2/7,240336,2
1,1,24,337,1,629,2,12,5,5,7,single-choice,spatial-relational,5|7,7,5/7,240337,5
1,1,24,338,1,1388,4,8,2,2,6,single-choice,spatial-relational,2|6,7,2/6,240338,2
1,1,24,339,1,960,5,7,1,1,6,single-choice,spatial-relational,1|6,7,1/6,240339,1
1,1,24,340,1,48,4,6,1,1,5,single-choice,spatial-relational,1|5,7,1/5,240340,1
1,1,24,341,1,853,4,10,3,3,7,single-choice,spatial-relational,3|7,7,3/7,240341,3
1,1,24,342,1,1487,2,4,1,1,3,single-choice,spatial-relational,1|3,7,1/3,240342,1
1,1,24,343,1,698,2,6,2,2,4,single-choice,spatial-relational,2|4,7,2/4,240343,2
1,1,24,344,1,793,3,7,2,2,5,single-choice,spatial-relational,2|5,7,2/5,240344,2
1,1,24,345,1,910,1,13,6,6,7,single-choice,spatial-relational,6|7,7,6/7,240345,6
1,1,24,346,1,1956,1,9,4,4,5,single-choice,spatial-relational,4|5,7,4/5,240346,4
1,1,24,347,1,738,4,8,2,2,6,single-choice,spatial-relational,2|6,7,2/6,240347,2
1,1,24,348,1,905,2,6,2,2,4,single-choice,spatial-relational,2|4,7,2/4,240348,2
1,1,24,349,1,1027,6,8,1,1,7,single-choice,spatial-relational,1|7,7,1/7,240349,1
1,1,24,350,1,887,3,5,1,1,4,single-choice,spatial-relational,1|4,7,1/4,240350,1
1,1,24,351,1,1230,1,7,3,3,4,single-choice,spatial-relational,3|4,7,3/4,240351,3
1,1,24,352,1,715,2,12,5,5,7,single-choice,spatial-relational,5|7,7,5/7,240352,5
1,1,24,353,1,842,1,9,4,4,5,single-choice,spatial-relational,4|5,7,4/5,240353,4
1,1,24,354,0,1378,3,7,2,5,5,single-choice,spatial-relational,2|5,7,2/5,240354,2
1,1,24,355,1,926,4,10,3,3,7,single-choice,spatial-relational,3|7,7,3/7,240355,3
1,1,24,356,1,686,2,8,3,3,5,single-choice,spatial-relational,3|5,7,3/5,240356,3
1,1,24,357,1,837,1,3,1,1,2,single-choice,spatial-relational,1|2,7,1/2,240357,1
1,1,24,358,1,741,1,3,1,1,2,single-choice,spatial-relational,1|2,7,1/2,240358,1
1,1,24,359,1,903,1,7,3,3,4,single-choice,spatial-relational,3|4,7,3/4,240359,3
1,1,24,360,1,1276,2,8,3,3,5,single-choice,spatial-relational,3|5,7,3/5,240360,3
1,1,24,361,1,904,3,11,4,4,7,single-choice,spatial-relational,4|7,7,4/7,240361,4
1,1,24,362,0,991,3,9,3,6,6,single-choice,spatial-relational,3|6,7,3/6,240362,3
1,1,24,363,1,1149,1,13,6,6,7,single-choice,spatial-relational,6|7,7,6/7,240363,6
1,1,24,364,1,851,2,4,1,1,3,single-choice,spatial-relational,1|3,7,1/3,240364,1
1,1,24,365,0,1024,1,5,2,3,3,single-choice,spatial-relational,2|3,7,2/3,240365,2
1,1,24,366,0,64,5,7,1,6,6,single-choice,spatial-relational,1|6,7,1/6,240366,1
1,1,24,367,1,894,3,11,4,4,7,single-choice,spatial-relational,4|7,7,4/7,240367,4
1,1,24,368,0,1069,2,10,4,6,6,single-choice,spatial-relational,4|6,7,4/6,240368,4
1,1,24,369,0,1133,1,11,5,6,6,single-choice,spatial-relational,5|6,7,5/6,240369,5
1,1,24,370,1,727,1,5,2,2,3,single-choice,spatial-relational,2|3,7,2/3,240370,2
1,1,24,371,1,880,4,6,1,1,5,single-choice,spatial-relational,1|5,7,1/5,240371,1
1,1,24,372,1,1019,1,11,5,5,6,single-choice,spatial-relational,5|6,7,5/6,240372,5
1,1,24,373,1,736,5,9,2,2,7,single-choice,spatial-relational,2|7,7,2/7,240373,2
1,1,24,374,1,766,6,8,1,1,7,single-choice,spatial-relational,1|7,7,1/7,240374,1
1,1,24,375,1,807,5,9,2,2,7,single-choice,spatial-relational,2|7,7,2/7,240375,2
1,1,24,376,1,797,3,5,1,1,4,single-choice,spatial-relational,1|4,7,1/4,240376,1
1,1,24,377,1,944,2,10,4,4,6,single-choice,spatial-relational,4|6,7,4/6,240377,4
1,1,24,378,1,1352,3,9,3,3,6,single-choice,spatial-relational,3|6,7,3/6,240378,3
1,1,24,379,1,1061,3,5,1,1,4,single-choice,spatial-relational,1|4,7,1/4,240379,1
1,1,24,380,1,980,4,6,1,1,5,single-choice,spatial-relational,1|5,7,1/5,240380,1
1,1,24,381,1,1079,2,8,3,3,5,single-choice,spatial-relational,3|5,7,3/5,240381,3
1,1,24,382,0,1058,2,10,4,6,6,single-choice,spatial-relational,4|6,7,4/6,240382,4
1,1,24,383,0,51,1,9,4,5,5,single-choice,spatial-relational,4|5,7,4/5,240383,4
1,1,24,384,1,798,3,7,2,2,5,single-choice,spatial-relational,2|5,7,2/5,240384,2
1,1,24,385,1,1142,2,6,2,2,4,single-choice,spatial-relational,2|4,7,2/4,240385,2
1,1,24,386,0,957,5,9,2,7,7,single-choice,spatial-relational,2|7,7,2/7,240386,2
1,1,24,387,1,825,1,13,6,6,7,single-choice,spatial-relational,6|7,7,6/7,240387,6
1,1,24,388,1,1136,5,9,2,2,7,single-choice,spatial-relational,2|7,7,2/7,240388,2
1,1,24,389,1,743,3,5,1,1,4,single-choice,spatial-relational,1|4,7,1/4,240389,1
1,1,24,390,1,866,3,7,2,2,5,single-choice,spatial-relational,2|5,7,2/5,240390,2
1,1,24,391,1,1181,3,9,3,3,6,single-choice,spatial-relational,3|6,7,3/6,240391,3
1,1,24,392,1,906,2,4,1,1,3,single-choice,spatial-relational,1|3,7,1/3,240392,1
1,1,24,393,1,958,1,11,5,5,6,single-choice,spatial-relational,5|6,7,5/6,240393,5
1,1,24,394,1,763,2,8,3,3,5,single-choice,spatial-relational,3|5,7,3/5,240394,3
1,1,24,395,1,1297,3,11,4,4,7,single-choice,spatial-relational,4|7,7,4/7,240395,4
1,1,24,396,1,823,2,12,5,5,7,single-choice,spatial-relational,5|7,7,5/7,240396,5
1,1,24,397,1,997,5,7,1,1,6,single-choice,spatial-relational,1|6,7,1/6,240397,1
1,1,24,398,1,1035,1,7,3,3,4,single-choice,spatial-relational,3|4,7,3/4,240398,3
1,1,24,399,1,833,4,10,3,3,7,single-choice,spatial-relational,3|7,7,3/7,240399,3
1,1,24,400,1,1080,1,9,4,4,5,single-choice,spatial-relational,4|5,7,4/5,240400,4
1,1,24,401,1,758,4,8,2,2,6,single-choice,spatial-relational,2|6,7,2/6,240401,2
1,1,24,402,1,1005,4,6,1,1,5,single-choice,spatial-relational,1|5,7,1/5,240402,1
1,1,24,403,1,1065,2,6,2,2,4,single-choice,spatial-relational,2|4,7,2/4,240403,2
1,1,24,404,1,890,3,9,3,3,6,single-choice,spatial-relational,3|6,7,3/6,240404,3
1,1,24,405,0,1251,2,10,4,6,6,single-choice,spatial-relational,4|6,7,4/6,240405,4
1,1,24,406,1,1327,1,7,3,3,4,single-choice,spatial-relational,3|4,7,3/4,240406,3
1,1,24,407,1,835,2,12,5,5,7,single-choice,spatial-relational,5|7,7,5/7,240407,5
1,1,24,408,1,938,2,4,1,1,3,single-choice,spatial-relational,1|3,7,1/3,240408,1
1,1,24,409,1,921,4,8,2,2,6,single-choice,spatial-relational,2|6,7,2/6,240409,2
1,1,24,410,1,1354,4,10,3,3,7,single-choice,spatial-relational,3|7,7,3/7,240410,3
1,1,24,411,1,952,1,11,5,5,6,single-choice,spatial-relational,5|6,7,5/6,240411,5
1,1,24,412,1,978,3,11,4,4,7,single-choice,spatial-relational,4|7,7,4/7,240412,4
1,1,24,413,1,1282,6,8,1,1,7,single-choice,spatial-relational,1|7,7,1/7,240413,1
1,1,24,414,1,44,1,3,1,1,2,single-choice,spatial-relational,1|2,7,1/2,240414,1
1,1,24,415,0,748,1,5,2,3,3,single-choice,spatial-relational,2|3,7,2/3,240415,2
1,1,24,416,1,740,1,3,1,1,2,single-choice,spatial-relational,1|2,7,1/2,240416,1
1,1,24,417,1,842,1,13,6,6,7,single-choice,spatial-relational,6|7,7,6/7,240417,6
1,1,24,418,1,1103,5,7,1,1,6,single-choice,spatial-relational,1|6,7,1/6,240418,1
1,1,24,419,1,927,6,8,1,1,7,single-choice,spatial-relational,1|7,7,1/7,240419,1
1,1,24,420,0,99,1,5,2,3,3,single-choice,spatial-relational,2|3,7,2/3,240420,2
1,1,24,421,1,1525,1,11,5,5,6,single-choice,spatial-relational,5|6,7,5/6,240421,5
1,1,24,422,1,963,5,7,1,1,6,single-choice,spatial-relational,1|6,7,1/6,240422,1
1,1,24,423,1,859,5,9,2,2,7,single-choice,spatial-relational,2|7,7,2/7,240423,2
1,1,24,424,1,797,3,7,2,2,5,single-choice,spatial-relational,2|5,7,2/5,240424,2
1,1,24,425,1,846,2,6,2,2,4,single-choice,spatial-relational,2|4,7,2/4,240425,2
1,1,24,426,1,804,4,10,3,3,7,single-choice,spatial-relational,3|7,7,3/7,240426,3
1,1,24,427,1,654,3,11,4,4,7,single-choice,spatial-relational,4|7,7,4/7,240427,4
1,1,24,428,1,878,1,13,6,6,7,single-choice,spatial-relational,6|7,7,6/7,240428,6
1,1,24,429,0,1002,1,9,4,5,5,single-choice,spatial-relational,4|5,7,4/5,240429,4
1,1,24,430,1,1349,1,7,3,3,4,single-choice,spatial-relational,3|4,7,3/4,240430,3
1,1,24,431,1,932,3,5,1,1,4,single-choice,spatial-relational,1|4,7,1/4,240431,1
1,1,24,432,1,724,2,12,5,5,7,single-choice,spatial-relational,5|7,7,5/7,240432,5
1,1,24,433,1,945,5,7,1,1,6,single-choice,spatial-relational,1|6,7,1/6,240433,1
1,1,24,434,1,1036,4,8,2,2,6,single-choice,spatial-relational,2|6,7,2/6,240434,2
1,1,24,435,1,916,2,6,2,2,4,single-choice,spatial-relational,2|4,7,2/4,240435,2
1,1,24,436,1,667,2,4,1,1,3,single-choice,spatial-relational,1|3,7,1/3,240436,1
1,1,24,437,1,883,5,9,2,2,7,single-choice,spatial-relational,2|7,7,2/7,240437,2
1,1,24,438,1,687,2,12,5,5,7,single-choice,spatial-relational,5|7,7,5/7,240438,5
1,1,24,439,1,1163,6,8,1,1,7,single-choice,spatial-relational,1|7,7,1/7,240439,1
1,1,24,440,1,562,1,3,1,1,2,single-choice,spatial-relational,1|2,7,1/2,240440,1
1,1,24,441,1,1059,1,7,3,3,4,single-choice,spatial-relational,3|4,7,3/4,240441,3
1,1,24,442,1,683,4,10,3,3,7,single-choice,spatial-relational,3|7,7,3/7,240442,3
1,1,24,443,1,1250,4,6,1,1,5,single-choice,spatial-relational,1|5,7,1/5,240443,1
1,1,24,444,1,966,1,11,5,5,6,single-choice,spatial-relational,5|6,7,5/6,240444,5
1,1,24,445,1,705,2,8,3,3,5,single-choice,spatial-relational,3|5,7,3/5,240445,3
1,1,24,446,1,8072,2,4,1,1,3,single-choice,spatial-relational,1|3,7,1/3,240446,1
1,1,24,447,1,908,2,8,3,3,5,single-choice,spatial-relational,3|5,7,3/5,240447,3
1,1,24,448,1,802,3,5,1,1,4,single-choice,spatial-relational,1|4,7,1/4,240448,1
1,1,24,449,1,889,2,10,4,4,6,single-choice,spatial-relational,4|6,7,4/6,240449,4
1,1,24,450,0,1102,6,8,1,7,7,single-choice,spatial-relational,1|7,7,1/7,240450,1
1,1,24,451,1,789,4,6,1,1,5,single-choice,spatial-relational,1|5,7,1/5,240451,1
1,1,24,452,1,1115,3,7,2,2,5,single-choice,spatial-relational,2|5,7,2/5,240452,2
1,1,24,453,1,686,1,5,2,2,3,single-choice,spatial-relational,2|3,7,2/3,240453,2
1,1,24,454,1,911,3,9,3,3,6,single-choice,spatial-relational,3|6,7,3/6,240454,3
1,1,24,455,0,617,1,3,1,2,2,single-choice,spatial-relational,1|2,7,1/2,240455,1
1,1,24,456,1,889,4,8,2,2,6,single-choice,spatial-relational,2|6,7,2/6,240456,2
1,1,24,457,1,945,1,9,4,4,5,single-choice,spatial-relational,4|5,7,4/5,240457,4
1,1,24,458,1,931,1,13,6,6,7,single-choice,spatial-relational,6|7,7,6/7,240458,6
1,1,24,459,1,1701,3,11,4,4,7,single-choice,spatial-relational,4|7,7,4/7,240459,4
1,1,24,460,1,880,1,5,2,2,3,single-choice,spatial-relational,2|3,7,2/3,240460,2
1,1,24,461,1,985,3,9,3,3,6,single-choice,spatial-relational,3|6,7,3/6,240461,3
1,1,24,462,0,1068,2,10,4,6,6,single-choice,spatial-relational,4|6,7,4/6,240462,4
1,1,24,463,1,974,2,8,3,3,5,single-choice,spatial-relational,3|5,7,3/5,240463,3
1,1,24,464,1,916,4,6,1,1,5,single-choice,spatial-relational,1|5,7,1/5,240464,1
1,1,24,465,1,1437,6,8,1,1,7,single-choice,spatial-relational,1|7,7,1/7,240465,1
1,1,24,466,1,1427,3,11,4,4,7,single-choice,spatial-relational,4|7,7,4/7,240466,4
1,1,24,467,1,955,3,5,1,1,4,single-choice,spatial-relational,1|4,7,1/4,240467,1
1,1,24,468,1,770,2,4,1,1,3,single-choice,spatial-relational,1|3,7,1/3,240468,1
1,1,24,469,1,911,5,7,1,1,6,single-choice,spatial-relational,1|6,7,1/6,240469,1
1,1,24,470,1,890,2,4,1,1,3,single-choice,spatial-relational,1|3,7,1/3,240470,1
1,1,24,471,1,848,1,5,2,2,3,single-choice,spatial-relational,2|3,7,2/3,240471,2
1,1,24,472,1,791,1,3,1,1,2,single-choice,spatial-relational,1|2,7,1/2,240472,1
1,1,24,473,1,707,3,9,3,3,6,single-choice,spatial-relational,3|6,7,3/6,240473,3
1,1,24,474,1,679,1,3,1,1,2,single-choice,spatial-relational,1|2,7,1/2,240474,1
1,1,24,475,1,846,5,9,2,2,7,single-choice,spatial-relational,2|7,7,2/7,240475,2
1,1,24,476,0,700,4,6,1,5,5,single-choice,spatial-relational,1|5,7,1/5,240476,1
1,1,24,477,1,829,5,7,1,1,6,single-choice,spatial-relational,1|6,7,1/6,240477,1
1,1,24,478,1,979,2,10,4,4,6,single-choice,spatial-relational,4|6,7,4/6,240478,4
1,1,24,479,1,1129,2,6,2,2,4,single-choice,spatial-relational,2|4,7,2/4,240479,2
1,1,24,480,0,1401,1,9,4,5,5,single-choice,spatial-relational,4|5,7,4/5,240480,4
1,1,24,481,1,950,4,10,3,3,7,single-choice,spatial-relational,3|7,7,3/7,240481,3
1,1,24,482,1,806,4,10,3,3,7,single-choice,spatial-relational,3|7,7,3/7,240482,3
1,1,24,483,1,904,2,12,5,5,7,single-choice,spatial-relational,5|7,7,5/7,240483,5
1,1,24,484,1,1882,1,11,5,5,6,single-choice,spatial-relational,5|6,7,5/6,240484,5
1,1,24,485,1,898,1,5,2,2,3,single-choice,spatial-relational,2|3,7,2/3,240485,2
1,1,24,486,1,825,6,8,1,1,7,single-choice,spatial-relational,1|7,7,1/7,240486,1
1,1,24,487,1,902,5,9,2,2,7,single-choice,spatial-relational,2|7,7,2/7,240487,2
1,1,24,488,1,962,1,7,3,3,4,single-choice,spatial-relational,3|4,7,3/4,240488,3
1,1,24,489,1,674,4,8,2,2,6,single-choice,spatial-relational,2|6,7,2/6,240489,2
1,1,24,490,1,775,3,5,1,1,4,single-choice,spatial-relational,1|4,7,1/4,240490,1
1,1,24,491,1,845,1,13,6,6,7,single-choice,spatial-relational,6|7,7,6/7,240491,6
1,1,24,492,1,696,2,6,2,2,4,single-choice,spatial-relational,2|4,7,2/4,240492,2
1,1,24,493,1,1639,2,10,4,4,6,single-choice,spatial-relational,4|6,7,4/6,240493,4
1,1,24,494,1,1288,1,9,4,4,5,single-choice,spatial-relational,4|5,7,4/5,240494,4
1,1,24,495,1,664,1,13,6,6,7,single-choice,spatial-relational,6|7,7,6/7,240495,6
1,1,24,496,1,796,2,12,5,5,7,single-choice,spatial-relational,5|7,7,5/7,240496,5
1,1,24,497,0,724,4,8,2,6,6,single-choice,spatial-relational,2|6,7,2/6,240497,2
1,1,24,498,1,902,1,7,3,3,4,single-choice,spatial-relational,3|4,7,3/4,240498,3
1,1,24,499,1,1736,1,11,5,5,6,single-choice,spatial-relational,5|6,7,5/6,240499,5
1,1,24,500,1,1018,3,11,4,4,7,single-choice,spatial-relational,4|7,7,4/7,240500,4
1,1,24,501,1,817,3,7,2,2,5,single-choice,spatial-relational,2|5,7,2/5,240501,2
1,1,24,502,1,904,3,7,2,2,5,single-choice,spatial-relational,2|5,7,2/5,240502,2
1,1,24,503,1,913,3,9,3,3,6,single-choice,spatial-relational,3|6,7,3/6,240503,3
1,1,24,504,1,1019,2,8,3,3,5,single-choice,spatial-relational,3|5,7,3/5,240504,3
1,1,24,505,1,907,3,11,4,4,7,single-choice,spatial-relational,4|7,7,4/7,240505,4
1,1,24,506,1,1206,2,8,3,3,5,single-choice,spatial-relational,3|5,7,3/5,240506,3
1,1,24,507,1,1449,4,8,2,2,6,single-choice,spatial-relational,2|6,7,2/6,240507,2
1,1,24,508,1,876,2,12,5,5,7,single-choice,spatial-relational,5|7,7,5/7,240508,5
1,1,24,509,1,1050,6,8,1,1,7,single-choice,spatial-relational,1|7,7,1/7,240509,1
1,1,24,510,0,1266,2,10,4,6,6,single-choice,spatial-relational,4|6,7,4/6,240510,4
1,1,24,511,1,1217,2,10,4,4,6,single-choice,spatial-relational,4|6,7,4/6,240511,4
1,1,24,512,1,1067,4,10,3,3,7,single-choice,spatial-relational,3|7,7,3/7,240512,3
1,1,24,513,1,952,4,10,3,3,7,single-choice,spatial-relational,3|7,7,3/7,240513,3
1,1,24,514,1,927,3,7,2,2,5,single-choice,spatial-relational,2|5,7,2/5,240514,2
1,1,24,515,1,943,2,6,2,2,4,single-choice,spatial-relational,2|4,7,2/4,240515,2
1,1,24,516,1,969,3,5,1,1,4,single-choice,spatial-relational,1|4,7,1/4,240516,1
1,1,24,517,1,684,2,4,1,1,3,single-choice,spatial-relational,1|3,7,1/3,240517,1
1,1,24,518,1,1047,1,11,5,5,6,single-choice,spatial-relational,5|6,7,5/6,240518,5
1,1,24,519,1,1127,3,7,2,2,5,single-choice,spatial-relational,2|5,7,2/5,240519,2
1,1,24,520,1,698,3,5,1,1,4,single-choice,spatial-relational,1|4,7,1/4,240520,1
1,1,24,521,1,979,3,9,3,3,6,single-choice,spatial-relational,3|6,7,3/6,240521,3
1,1,24,522,1,1727,1,7,3,3,4,single-choice,spatial-relational,3|4,7,3/4,240522,3
1,1,24,523,1,817,4,6,1,1,5,single-choice,spatial-relational,1|5,7,1/5,240523,1
1,1,24,524,1,1510,2,6,2,2,4,single-choice,spatial-relational,2|4,7,2/4,240524,2
1,1,24,525,1,873,4,8,2,2,6,single-choice,spatial-relational,2|6,7,2/6,240525,2
1,1,24,526,0,85,5,7,1,6,6,single-choice,spatial-relational,1|6,7,1/6,240526,1
1,1,24,527,1,847,3,9,3,3,6,single-choice,spatial-relational,3|6,7,3/6,240527,3
1,1,24,528,1,827,3,11,4,4,7,single-choice,spatial-relational,4|7,7,4/7,240528,4
1,1,24,529,1,1361,5,9,2,2,7,single-choice,spatial-relational,2|7,7,2/7,240529,2
1,1,24,530,1,862,1,13,6,6,7,single-choice,spatial-relational,6|7,7,6/7,240530,6
1,1,24,531,1,923,5,9,2,2,7,single-choice,spatial-relational,2|7,7,2/7,240531,2
1,1,24,532,1,1261,6,8,1,1,7,single-choice,spatial-relational,1|7,7,1/7,240532,1
1,1,24,533,1,1039,4,6,1,1,5,single-choice,spatial-relational,1|5,7,1/5,240533,1
1,1,24,534,1,761,1,13,6,6,7,single-choice,spatial-relational,6|7,7,6/7,240534,6
1,1,24,535,1,768,2,12,5,5,7,single-choice,spatial-relational,5|7,7,5/7,240535,5
1,1,24,536,1,786,1,5,2,2,3,single-choice,spatial-relational,2|3,7,2/3,240536,2
1,1,24,537,1,752,1,3,1,1,2,single-choice,spatial-relational,1|2,7,1/2,240537,1
1,1,24,538,1,916,1,5,2,2,3,single-choice,spatial-relational,2|3,7,2/3,240538,2
1,1,24,539,1,855,1,3,1,1,2,single-choice,spatial-relational,1|2,7,1/2,240539,1
1,1,24,540,0,803,2,4,1,3,3,single-choice,spatial-relational,1|3,7,1/3,240540,1
1,1,24,541,1,1120,1,11,5,5,6,single-choice,spatial-relational,5|6,7,5/6,240541,5
1,1,24,542,1,1317,1,7,3,3,4,single-choice,spatial-relational,3|4,7,3/4,240542,3
1,1,24,543,1,971,5,7,1,1,6,single-choice,spatial-relational,1|6,7,1/6,240543,1
1,1,24,544,1,848,2,8,3,3,5,single-choice,spatial-relational,3|5,7,3/5,240544,3
1,1,24,545,1,1408,1,9,4,4,5,single-choice,spatial-relational,4|5,7,4/5,240545,4
1,1,24,546,1,1348,1,9,4,4,5,single-choice,spatial-relational,4|5,7,4/5,240546,4
1,1,24,547,1,962,2,12,5,5,7,single-choice,spatial-relational,5|7,7,5/7,240547,5
1,1,24,548,1,769,3,7,2,2,5,single-choice,spatial-relational,2|5,7,2/5,240548,2
1,1,24,549,1,856,5,7,1,1,6,single-choice,spatial-relational,1|6,7,1/6,240549,1
1,1,24,550,1,964,3,9,3,3,6,single-choice,spatial-relational,3|6,7,3/6,240550,3
1,1,24,551,1,932,1,11,5,5,6,single-choice,spatial-relational,5|6,7,5/6,240551,5
1,1,24,552,1,1103,1,9,4,4,5,single-choice,spatial-relational,4|5,7,4/5,240552,4
1,1,24,553,1,994,2,6,2,2,4,single-choice,spatial-relational,2|4,7,2/4,240553,2
1,1,24,554,1,961,4,6,1,1,5,single-choice,spatial-relational,1|5,7,1/5,240554,1
1,1,24,555,1,1311,5,9,2,2,7,single-choice,spatial-relational,2|7,7,2/7,240555,2
1,1,24,556,1,1437,5,9,2,2,7,single-choice,spatial-relational,2|7,7,2/7,240556,2
1,1,24,557,1,1063,2,6,2,2,4,single-choice,spatial-relational,2|4,7,2/4,240557,2
1,1,24,558,1,740,1,3,1,1,2,single-choice,spatial-relational,1|2,7,1/2,240558,1
1,1,24,559,1,779,3,5,1,1,4,single-choice,spatial-relational,1|4,7,1/4,240559,1
1,1,24,560,1,763,2,10,4,4,6,single-choice,spatial-relational,4|6,7,4/6,240560,4
1,1,24,561,1,942,4,10,3,3,7,single-choice,spatial-relational,3|7,7,3/7,240561,3
1,1,24,562,1,666,2,4,1,1,3,single-choice,spatial-relational,1|3,7,1/3,240562,1
1,1,24,563,0,1264,2,8,3,5,5,single-choice,spatial-relational,3|5,7,3/5,240563,3
1,1,24,564,0,963,1,7,3,4,4,single-choice,spatial-relational,3|4,7,3/4,240564,3
1,1,24,565,1,1103,3,11,4,4,7,single-choice,spatial-relational,4|7,7,4/7,240565,4
1,1,24,566,1,1194,1,11,5,5,6,single-choice,spatial-relational,5|6,7,5/6,240566,5
1,1,24,567,1,1529,3,9,3,3,6,single-choice,spatial-relational,3|6,7,3/6,240567,3
1,1,24,568,1,984,5,7,1,1,6,single-choice,spatial-relational,1|6,7,1/6,240568,1
1,1,24,569,1,814,4,8,2,2,6,single-choice,spatial-relational,2|6,7,2/6,240569,2
1,1,24,570,1,981,2,8,3,3,5,single-choice,spatial-relational,3|5,7,3/5,240570,3
1,1,24,571,1,950,1,3,1,1,2,single-choice,spatial-relational,1|2,7,1/2,240571,1
1,1,24,572,1,1021,3,5,1,1,4,single-choice,spatial-relational,1|4,7,1/4,240572,1
1,1,24,573,1,1252,4,8,2,2,6,single-choice,spatial-relational,2|6,7,2/6,240573,2
1,1,24,574,1,843,4,6,1,1,5,single-choice,spatial-relational,1|5,7,1/5,240574,1
1,1,24,575,1,810,3,11,4,4,7,single-choice,spatial-relational,4|7,7,4/7,240575,4
1,1,24,576,0,822,6,8,1,7,7,single-choice,spatial-relational,1|7,7,1/7,240576,1
1,1,24,577,1,856,2,4,1,1,3,single-choice,spatial-relational,1|3,7,1/3,240577,1
1,1,24,578,1,1184,3,7,2,2,5,single-choice,spatial-relational,2|5,7,2/5,240578,2
1,1,24,579,1,754,6,8,1,1,7,single-choice,spatial-relational,1|7,7,1/7,240579,1
1,1,24,580,1,698,1,5,2,2,3,single-choice,spatial-relational,2|3,7,2/3,240580,2
1,1,24,581,1,837,4,10,3,3,7,single-choice,spatial-relational,3|7,7,3/7,240581,3
1,1,24,582,1,1114,1,5,2,2,3,single-choice,spatial-relational,2|3,7,2/3,240582,2
1,1,24,583,1,950,2,10,4,4,6,single-choice,spatial-relational,4|6,7,4/6,240583,4
1,1,24,584,1,786,1,13,6,6,7,single-choice,spatial-relational,6|7,7,6/7,240584,6
1,1,24,585,1,936,2,12,5,5,7,single-choice,spatial-relational,5|7,7,5/7,240585,5
1,1,24,586,1,1175,1,7,3,3,4,single-choice,spatial-relational,3|4,7,3/4,240586,3
1,1,24,587,1,1678,1,9,4,4,5,single-choice,spatial-relational,4|5,7,4/5,240587,4
1,1,24,588,1,830,1,13,6,6,7,single-choice,spatial-relational,6|7,7,6/7,240588,6
1,1,24,589,1,903,1,5,2,2,3,single-choice,spatial-relational,2|3,7,2/3,240589,2
1,1,24,590,1,1007,3,11,4,4,7,single-choice,spatial-relational,4|7,7,4/7,240590,4
1,1,24,591,1,893,1,3,1,1,2,single-choice,spatial-relational,1|2,7,1/2,240591,1
1,1,24,592,1,942,5,7,1,1,6,single-choice,spatial-relational,1|6,7,1/6,240592,1
1,1,24,593,1,699,4,10,3,3,7,single-choice,spatial-relational,3|7,7,3/7,240593,3
1,1,24,594,1,951,4,8,2,2,6,single-choice,spatial-relational,2|6,7,2/6,240594,2
1,1,24,595,1,1086,1,11,5,5,6,single-choice,spatial-relational,5|6,7,5/6,240595,5
1,1,24,596,0,1108,5,9,2,7,7,single-choice,spatial-relational,2|7,7,2/7,240596,2
1,1,24,597,1,36,1,11,5,5,6,single-choice,spatial-relational,5|6,7,5/6,240597,5
1,1,24,598,1,1038,1,13,6,6,7,single-choice,spatial-relational,6|7,7,6/7,240598,6
1,1,24,599,1,1223,4,6,1,1,5,single-choice,spatial-relational,1|5,7,1/5,240599,1
1,1,24,600,1,812,3,9,3,3,6,single-choice,spatial-relational,3|6,7,3/6,240600,3
2,1,24,1,0,4,3,7,2,5,5,single-choice,spatial-relational,2|5,7,2/5,240001,2
2,1,24,2,1,542,1,9,4,4,5,single-choice,spatial-relational,4|5,7,4/5,240002,4
2,1,24,3,0,32,3,11,4,7,7,single-choice,spatial-relational,4|7,7,4/7,240003,4
2,1,24,4,1,621,1,7,3,3,4,single-choice,spatial-relational,3|4,7,3/4,240004,3
2,1,24,5,0,656,6,8,1,7,7,single-choice,spatial-relational,1|7,7,1/7,240005,1
2,1,24,6,1,791,4,6,1,1,5,single-choice,spatial-relational,1|5,7,1/5,240006,1
2,1,24,7,0,584,2,10,4,6,6,single-choice,spatial-relational,4|6,7,4/6,240007,4
2,1,24,8,1,907,1,13,6,6,7,single-choice,spatial-relational,6|7,7,6/7,240008,6
2,1,24,9,0,463,6,8,1,7,7,single-choice,spatial-relational,1|7,7,1/7,240009,1
2,1,24,10,1,738,3,7,2,2,5,single-choice,spatial-relational,2|5,7,2/5,240010,2
2,1,24,11,0,82,4,8,2,6,6,single-choice,spatial-relational,2|6,7,2/6,240011,2
2,1,24,12,0,490,1,7,3,4,4,single-choice,spatial-relational,3|4,7,3/4,240012,3
2,1,24,13,0,541,5,7,1,6,6,single-choice,spatial-relational,1|6,7,1/6,240013,1
2,1,24,14,1,624,4,10,3,3,7,single-choice,spatial-relational,3|7,7,3/7,240014,3
2,1,24,15,1,36,1,11,5,5,6,single-choice,spatial-relational,5|6,7,5/6,240015,5
2,1,24,16,0,792,4,8,2,6,6,single-choice,spatial-relational,2|6,7,2/6,240016,2
2,1,24,17,0,477,1,3,1,2,2,single-choice,spatial-relational,1|2,7,1/2,240017,1
2,1,24,18,1,598,2,4,1,1,3,single-choice,spatial-relational,1|3,7,1/3,240018,1
2,1,24,19,0,704,1,5,2,3,3,single-choice,spatial-relational,2|3,7,2/3,240019,2
2,1,24,20,1,817,2,12,5,5,7,single-choice,spatial-relational,5|7,7,5/7,240020,5
2,1,24,21,0,49,2,8,3,5,5,single-choice,spatial-relational,3|5,7,3/5,240021,3
2,1,24,22,1,892,2,6,2,2,4,single-choice,spatial-relational,2|4,7,2/4,240022,2
2,1,24,23,1,1158,4,6,1,1,5,single-choice,spatial-relational,1|5,7,1/5,240023,1
2,1,24,24,0,937,1,9,4,5,5,single-choice,spatial-relational,4|5,7,4/5,240024,4
2,1,24,25,1,1256,1,11,5,5,6,single-choice,spatial-relational,5|6,7,5/6,240025,5
2,1,24,26,1,864,2,12,5,5,7,single-choice,spatial-relational,5|7,7,5/7,240026,5
2,1,24,27,1,977,3,9,3,3,6,single-choice,spatial-relational,3|6,7,3/6,240027,3
2,1,24,28,1,836,3,11,4,4,7,single-choice,spatial-relational,4|7,7,4/7,240028,4
2,1,24,29,1,994,1,5,2,2,3,single-choice,spatial-relational,2|3,7,2/3,240029,2
2,1,24,30,0,1001,2,6,2,4,4,single-choice,spatial-relational,2|4,7,2/4,240030,2
2,1,24,31,0,617,2,4,1,3,3,single-choice,spatial-relational,1|3,7,1/3,240031,1
2,1,24,32,1,1062,5,9,2,2,7,single-choice,spatial-relational,2|7,7,2/7,240032,2
2,1,24,33,1,1398,2,10,4,4,6,single-choice,spatial-relational,4|6,7,4/6,240033,4
2,1,24,34,1,1044,5,9,2,2,7,single-choice,spatial-relational,2|7,7,2/7,240034,2
2,1,24,35,1,836,1,3,1,1,2,single-choice,spatial-relational,1|2,7,1/2,240035,1
2,1,24,36,1,1451,1,13,6,6,7,single-choice,spatial-relational,6|7,7,6/7,240036,6
2,1,24,37,1,1032,3,5,1,1,4,single-choice,spatial-relational,1|4,7,1/4,240037,1
2,1,24,38,1,788,4,10,3,3,7,single-choice,spatial-relational,3|7,7,3/7,240038,3
2,1,24,39,1,1098,3,9,3,3,6,single-choice,spatial-relational,3|6,7,3/6,240039,3
2,1,24,40,1,880,5,7,1,1,6,single-choice,spatial-relational,1|6,7,1/6,240040,1
2,1,24,41,1,1673,2,8,3,3,5,single-choice,spatial-relational,3|5,7,3/5,240041,3
2,1,24,42,1,982,3,5,1,1,4,single-choice,spatial-relational,1|4,7,1/4,240042,1
2,1,24,43,1,714,2,6,2,2,4,single-choice,spatial-relational,2|4,7,2/4,240043,2
2,1,24,44,1,754,1,3,1,1,2,single-choice,spatial-relational,1|2,7,1/2,240044,1
2,1,24,45,1,949,2,8,3,3,5,single-choice,spatial-relational,3|5,7,3/5,240045,3
2,1,24,46,1,893,1,5,2,2,3,single-choice,spatial-relational,2|3,7,2/3,240046,2
2,1,24,47,1,775,1,13,6,6,7,single-choice,spatial-relational,6|7,7,6/7,240047,6
2,1,24,48,1,773,4,8,2,2,6,single-choice,spatial-relational,2|6,7,2/6,240048,2
2,1,24,49,0,531,4,6,1,5,5,single-choice,spatial-relational,1|5,7,1/5,240049,1
2,1,24,50,1,770,3,5,1,1,4,single-choice,spatial-relational,1|4,7,1/4,240050,1
2,1,24,51,1,758,6,8,1,1,7,single-choice,spatial-relational,1|7,7,1/7,240051,1
2,1,24,52,1,1076,3,7,2,2,5,single-choice,spatial-relational,2|5,7,2/5,240052,2
2,1,24,53,0,1012,3,11,4,7,7,single-choice,spatial-relational,4|7,7,4/7,240053,4
2,1,24,54,1,897,1,5,2,2,3,single-choice,spatial-relational,2|3,7,2/3,240054,2
2,1,24,55,1,1015,1,11,5,5,6,single-choice,spatial-relational,5|6,7,5/6,240055,5
2,1,24,56,1,1122,3,9,3,3,6,single-choice,spatial-relational,3|6,7,3/6,240056,3
2,1,24,57,0,815,1,7,3,4,4,single-choice,spatial-relational,3|4,7,3/4,240057,3
2,1,24,58,1,842,4,10,3,3,7,single-choice,spatial-relational,3|7,7,3/7,240058,3
2,1,24,59,1,779,2,4,1,1,3,single-choice,spatial-relational,1|3,7,1/3,240059,1
2,1,24,60,1,1750,4,8,2,2,6,single-choice,spatial-relational,2|6,7,2/6,240060,2
2,1,24,61,0,805,2,10,4,6,6,single-choice,spatial-relational,4|6,7,4/6,240061,4
2,1,24,62,1,752,2,8,3,3,5,single-choice,spatial-relational,3|5,7,3/5,240062,3
2,1,24,63,1,932,1,13,6,6,7,single-choice,spatial-relational,6|7,7,6/7,240063,6
2,1,24,64,1,748,1,11,5,5,6,single-choice,spatial-relational,5|6,7,5/6,240064,5
2,1,24,65,1,781,2,12,5,5,7,single-choice,spatial-relational,5|7,7,5/7,240065,5
2,1,24,66,0,160,4,10,3,7,7,single-choice,spatial-relational,3|7,7,3/7,240066,3
2,1,24,67,0,1392,1,9,4,5,5,single-choice,spatial-relational,4|5,7,4/5,240067,4
2,1,24,68,1,1019,5,9,2,2,7,single-choice,spatial-relational,2|7,7,2/7,240068,2
2,1,24,69,1,923,6,8,1,1,7,single-choice,spatial-relational,1|7,7,1/7,240069,1
2,1,24,70,1,690,2,6,2,2,4,single-choice,spatial-relational,2|4,7,2/4,240070,2
2,1,24,71,0,811,2,4,1,3,3,single-choice,spatial-relational,1|3,7,1/3,240071,1
2,1,24,72,0,1104,1,9,4,5,5,single-choice,spatial-relational,4|5,7,4/5,240072,4
2,1,24,73,1,1263,3,5,1,1,4,single-choice,spatial-relational,1|4,7,1/4,240073,1
2,1,24,74,1,1711,3,7,2,2,5,single-choice,spatial-relational,2|5,7,2/5,240074,2
2,1,24,75,1,944,4,6,1,1,5,single-choice,spatial-relational,1|5,7,1/5,240075,1
2,1,24,76,1,865,2,10,4,4,6,single-choice,spatial-relational,4|6,7,4/6,240076,4
2,1,24,77,1,1082,2,12,5,5,7,single-choice,spatial-relational,5|7,7,5/7,240077,5
2,1,24,78,1,895,3,11,4,4,7,single-choice,spatial-relational,4|7,7,4/7,240078,4
2,1,24,79,1,744,5,9,2,2,7,single-choice,spatial-relational,2|7,7,2/7,240079,2
2,1,24,80,1,824,5,7,1,1,6,single-choice,spatial-relational,1|6,7,1/6,240080,1
2,1,24,81,1,1088,3,9,3,3,6,single-choice,spatial-relational,3|6,7,3/6,240081,3
2,1,24,82,1,902,1,3,1,1,2,single-choice,spatial-relational,1|2,7,1/2,240082,1
2,1,24,83,1,1091,1,7,3,3,4,single-choice,spatial-relational,3|4,7,3/4,240083,3
2,1,24,84,1,861,5,7,1,1,6,single-choice,spatial-relational,1|6,7,1/6,240084,1
2,1,24,85,0,724,4,8,2,6,6,single-choice,spatial-relational,2|6,7,2/6,240085,2
2,1,24,86,1,1401,2,10,4,4,6,single-choice,spatial-relational,4|6,7,4/6,240086,4
2,1,24,87,1,1534,2,8,3,3,5,single-choice,spatial-relational,3|5,7,3/5,240087,3
2,1,24,88,1,983,1,13,6,6,7,single-choice,spatial-relational,6|7,7,6/7,240088,6
2,1,24,89,1,992,2,4,1,1,3,single-choice,spatial-relational,1|3,7,1/3,240089,1
2,1,24,90,1,972,6,8,1,1,7,single-choice,spatial-relational,1|7,7,1/7,240090,1
2,1,24,91,1,1134,3,7,2,2,5,single-choice,spatial-relational,2|5,7,2/5,240091,2
2,1,24,92,1,850,2,10,4,4,6,single-choice,spatial-relational,4|6,7,4/6,240092,4
2,1,24,93,1,1351,3,9,3,3,6,single-choice,spatial-relational,3|6,7,3/6,240093,3
2,1,24,94,1,784,1,3,1,1,2,single-choice,spatial-relational,1|2,7,1/2,240094,1
2,1,24,95,1,1199,4,8,2,2,6,single-choice,spatial-relational,2|6,7,2/6,240095,2
2,1,24,96,1,809,2,8,3,3,5,single-choice,spatial-relational,3|5,7,3/5,240096,3
2,1,24,97,1,721,4,6,1,1,5,single-choice,spatial-relational,1|5,7,1/5,240097,1
2,1,24,98,0,968,1,9,4,5,5,single-choice,spatial-relational,4|5,7,4/5,240098,4
2,1,24,99,1,648,4,10,3,3,7,single-choice,spatial-relational,3|7,7,3/7,240099,3
2,1,24,100,1,741,1,13,6,6,7,single-choice,spatial-relational,6|7,7,6/7,240100,6
2,1,24,101,1,1308,1,11,5,5,6,single-choice,spatial-relational,5|6,7,5/6,240101,5
2,1,24,102,1,1130,1,7,3,3,4,single-choice,spatial-relational,3|4,7,3/4,240102,3
2,1,24,103,1,814,5,9,2,2,7,single-choice,spatial-relational,2|7,7,2/7,240103,2
2,1,24,104,1,806,2,6,2,2,4,single-choice,spatial-relational,2|4,7,2/4,240104,2
2,1,24,105,1,705,3,11,4,4,7,single-choice,spatial-relational,4|7,7,4/7,240105,4
2,1,24,106,1,1023,1,11,5,5,6,single-choice,spatial-relational,5|6,7,5/6,240106,5
2,1,24,107,1,1037,6,8,1,1,7,single-choice,spatial-relational,1|7,7,1/7,240107,1
2,1,24,108,1,624,5,7,1,1,6,single-choice,spatial-relational,1|6,7,1/6,240108,1
2,1,24,109,1,723,1,3,1,1,2,single-choice,spatial-relational,1|2,7,1/2,240109,1
2,1,24,110,1,814,2,12,5,5,7,single-choice,spatial-relational,5|7,7,5/7,240110,5
2,1,24,111,1,708,2,12,5,5,7,single-choice,spatial-relational,5|7,7,5/7,240111,5
2,1,24,112,1,937,1,5,2,2,3,single-choice,spatial-relational,2|3,7,2/3,240112,2
2,1,24,113,0,643,1,9,4,5,5,single-choice,spatial-relational,4|5,7,4/5,240113,4
2,1,24,114,1,780,3,9,3,3,6,single-choice,spatial-relational,3|6,7,3/6,240114,3
2,1,24,115,1,849,5,7,1,1,6,single-choice,spatial-relational,1|6,7,1/6,240115,1
2,1,24,116,1,732,3,5,1,1,4,single-choice,spatial-relational,1|4,7,1/4,240116,1
2,1,24,117,1,748,4,6,1,1,5,single-choice,spatial-relational,1|5,7,1/5,240117,1
2,1,24,118,1,1433,1,7,3,3,4,single-choice,spatial-relational,3|4,7,3/4,240118,3
2,1,24,119,1,881,3,11,4,4,7,single-choice,spatial-relational,4|7,7,4/7,240119,4
2,1,24,120,1,903,2,6,2,2,4,single-choice,spatial-relational,2|4,7,2/4,240120,2
2,1,24,121,1,743,4,10,3,3,7,single-choice,spatial-relational,3|7,7,3/7,240121,3
2,1,24,122,1,672,1,5,2,2,3,single-choice,spatial-relational,2|3,7,2/3,240122,2
2,1,24,123,1,629,5,9,2,2,7,single-choice,spatial-relational,2|7,7,2/7,240123,2
2,1,24,124,0,1260,2,4,1,3,3,single-choice,spatial-relational,1|3,7,1/3,240124,1
2,1,24,125,1,793,3,7,2,2,5,single-choice,spatial-relational,2|5,7,2/5,240125,2
2,1,24,126,1,866,3,5,1,1,4,single-choice,spatial-relational,1|4,7,1/4,240126,1
2,1,24,127,0,88,1,7,3,4,4,single-choice,spatial-relational,3|4,7,3/4,240127,3
2,1,24,128,1,32,1,11,5,5,6,single-choice,spatial-relational,5|6,7,5/6,240128,5
2,1,24,129,1,832,1,3,1,1,2,single-choice,spatial-relational,1|2,7,1/2,240129,1
2,1,24,130,1,636,2,12,5,5,7,single-choice,spatial-relational,5|7,7,5/7,240130,5
2,1,24,131,1,969,4,8,2,2,6,single-choice,spatial-relational,2|6,7,2/6,240131,2
2,1,24,132,1,679,5,9,2,2,7,single-choice,spatial-relational,2|7,7,2/7,240132,2
2,1,24,133,1,827,3,9,3,3,6,single-choice,spatial-relational,3|6,7,3/6,240133,3
2,1,24,134,1,841,4,10,3,3,7,single-choice,spatial-relational,3|7,7,3/7,240134,3
2,1,24,135,1,1021,5,9,2,2,7,single-choice,spatial-relational,2|7,7,2/7,240135,2
2,1,24,136,1,810,5,7,1,1,6,single-choice,spatial-relational,1|6,7,1/6,240136,1
2,1,24,137,1,824,2,6,2,2,4,single-choice,spatial-relational,2|4,7,2/4,240137,2
2,1,24,138,1,701,1,13,6,6,7,single-choice,spatial-relational,6|7,7,6/7,240138,6
2,1,24,139,1,1104,4,8,2,2,6,single-choice,spatial-relational,2|6,7,2/6,240139,2
2,1,24,140,1,794,4,6,1,1,5,single-choice,spatial-relational,1|5,7,1/5,240140,1
2,1,24,141,1,624,2,12,5,5,7,single-choice,spatial-relational,5|7,7,5/7,240141,5
2,1,24,142,1,1450,1,9,4,4,5,single-choice,spatial-relational,4|5,7,4/5,240142,4
2,1,24,143,1,908,3,7,2,2,5,single-choice,spatial-relational,2|5,7,2/5,240143,2
2,1,24,144,1,640,1,9,4,4,5,single-choice,spatial-relational,4|5,7,4/5,240144,4
2,1,24,145,1,851,4,6,1,1,5,single-choice,spatial-relational,1|5,7,1/5,240145,1
2,1,24,146,1,579,1,13,6,6,7,single-choice,spatial-relational,6|7,7,6/7,240146,6
2,1,24,147,1,1057,2,8,3,3,5,single-choice,spatial-relational,3|5,7,3/5,240147,3
2,1,24,148,0,1330,2,4,1,3,3,single-choice,spatial-relational,1|3,7,1/3,240148,1
2,1,24,149,1,729,1,3,1,1,2,single-choice,spatial-relational,1|2,7,1/2,240149,1
2,1,24,150,1,808,2,8,3,3,5,single-choice,spatial-relational,3|5,7,3/5,240150,3
2,1,24,151,1,811,2,4,1,1,3,single-choice,spatial-relational,1|3,7,1/3,240151,1
2,1,24,152,1,786,2,10,4,4,6,single-choice,spatial-relational,4|6,7,4/6,240152,4
2,1,24,153,1,819,5,7,1,1,6,single-choice,spatial-relational,1|6,7,1/6,240153,1
2,1,24,154,1,942,6,8,1,1,7,single-choice,spatial-relational,1|7,7,1/7,240154,1
2,1,24,155,1,1101,3,9,3,3,6,single-choice,spatial-relational,3|6,7,3/6,240155,3
2,1,24,156,1,1009,3,11,4,4,7,single-choice,spatial-relational,4|7,7,4/7,240156,4
2,1,24,157,1,824,1,5,2,2,3,single-choice,spatial-relational,2|3,7,2/3,240157,2
2,1,24,158,1,667,3,11,4,4,7,single-choice,spatial-relational,4|7,7,4/7,240158,4
2,1,24,159,1,962,1,11,5,5,6,single-choice,spatial-relational,5|6,7,5/6,240159,5
2,1,24,160,1,1142,1,7,3,3,4,single-choice,spatial-relational,3|4,7,3/4,240160,3
2,1,24,161,1,802,3,5,1,1,4,single-choice,spatial-relational,1|4,7,1/4,240161,1
2,1,24,162,1,644,2,6,2,2,4,single-choice,spatial-relational,2|4,7,2/4,240162,2
2,1,24,163,0,752,6,8,1,7,7,single-choice,spatial-relational,1|7,7,1/7,240163,1
2,1,24,164,1,694,4,10,3,3,7,single-choice,spatial-relational,3|7,7,3/7,240164,3
2,1,24,165,0,1132,2,10,4,6,6,single-choice,spatial-relational,4|6,7,4/6,240165,4
2,1,24,166,1,742,3,7,2,2,5,single-choice,spatial-relational,2|5,7,2/5,240166,2
2,1,24,167,1,691,3,5,1,1,4,single-choice,spatial-relational,1|4,7,1/4,240167,1
2,1,24,168,0,1096,1,5,2,3,3,single-choice,spatial-relational,2|3,7,2/3,240168,2
2,1,24,169,1,716,1,3,1,1,2,single-choice,spatial-relational,1|2,7,1/2,240169,1
2,1,24,170,1,839,4,6,1,1,5,single-choice,spatial-relational,1|5,7,1/5,240170,1
2,1,24,171,1,850,3,7,2,2,5,single-choice,spatial-relational,2|5,7,2/5,240171,2
2,1,24,172,0,1195,2,10,4,6,6,single-choice,spatial-relational,4|6,7,4/6,240172,4
2,1,24,173,1,1000,3,11,4,4,7,single-choice,spatial-relational,4|7,7,4/7,240173,4
2,1,24,174,1,962,4,6,1,1,5,single-choice,spatial-relational,1|5,7,1/5,240174,1
2,1,24,175,1,873,5,7,1,1,6,single-choice,spatial-relational,1|6,7,1/6,240175,1
2,1,24,176,1,764,3,5,1,1,4,single-choice,spatial-relational,1|4,7,1/4,240176,1
2,1,24,177,1,968,2,8,3,3,5,single-choice,spatial-relational,3|5,7,3/5,240177,3
2,1,24,178,1,854,5,9,2,2,7,single-choice,spatial-relational,2|7,7,2/7,240178,2
2,1,24,179,1,905,2,4,1,1,3,single-choice,spatial-relational,1|3,7,1/3,240179,1
2,1,24,180,0,871,6,8,1,7,7,single-choice,spatial-relational,1|7,7,1/7,240180,1
2,1,24,181,1,753,3,9,3,3,6,single-choice,spatial-relational,3|6,7,3/6,240181,3
2,1,24,182,1,924,1,9,4,4,5,single-choice,spatial-relational,4|5,7,4/5,240182,4
2,1,24,183,1,1203,2,10,4,4,6,single-choice,spatial-relational,4|6,7,4/6,240183,4
2,1,24,184,1,827,2,12,5,5,7,single-choice,spatial-relational,5|7,7,5/7,240184,5
2,1,24,185,1,1110,1,7,3,3,4,single-choice,spatial-relational,3|4,7,3/4,240185,3
2,1,24,186,1,791,2,12,5,5,7,single-choice,spatial-relational,5|7,7,5/7,240186,5
2,1,24,187,1,722,2,4,1,1,3,single-choice,spatial-relational,1|3,7,1/3,240187,1
2,1,24,188,1,621,2,6,2,2,4,single-choice,spatial-relational,2|4,7,2/4,240188,2
2,1,24,189,1,983,2,6,2,2,4,single-choice,spatial-relational,2|4,7,2/4,240189,2
2,1,24,190,0,671,6,8,1,7,7,single-choice,spatial-relational,1|7,7,1/7,240190,1
2,1,24,191,1,714,3,5,1,1,4,single-choice,spatial-relational,1|4,7,1/4,240191,1
2,1,24,192,1,792,5,9,2,2,7,single-choice,spatial-relational,2|7,7,2/7,240192,2
2,1,24,193,1,811,1,13,6,6,7,single-choice,spatial-relational,6|7,7,6/7,240193,6
2,1,24,194,0,1348,1,7,3,4,4,single-choice,spatial-relational,3|4,7,3/4,240194,3
2,1,24,195,1,897,2,8,3,3,5,single-choice,spatial-relational,3|5,7,3/5,240195,3
2,1,24,196,1,1089,1,9,4,4,5,single-choice,spatial-relational,4|5,7,4/5,240196,4
2,1,24,197,1,940,4,10,3,3,7,single-choice,spatial-relational,3|7,7,3/7,240197,3
2,1,24,198,0,773,1,5,2,3,3,single-choice,spatial-relational,2|3,7,2/3,240198,2
2,1,24,199,1,1014,1,11,5,5,6,single-choice,spatial-relational,5|6,7,5/6,240199,5
2,1,24,200,1,1394,4,8,2,2,6,single-choice,spatial-relational,2|6,7,2/6,240200,2
2,1,24,201,1,849,1,11,5,5,6,single-choice,spatial-relational,5|6,7,5/6,240201,5
2,1,24,202,1,777,4,10,3,3,7,single-choice,spatial-relational,3|7,7,3/7,240202,3
2,1,24,203,1,744,5,7,1,1,6,single-choice,spatial-relational,1|6,7,1/6,240203,1
2,1,24,204,1,723,3,11,4,4,7,single-choice,spatial-relational,4|7,7,4/7,240204,4
2,1,24,205,1,925,4,8,2,2,6,single-choice,spatial-relational,2|6,7,2/6,240205,2
2,1,24,206,1,650,1,3,1,1,2,single-choice,spatial-relational,1|2,7,1/2,240206,1
2,1,24,207,1,692,3,7,2,2,5,single-choice,spatial-relational,2|5,7,2/5,240207,2
2,1,24,208,1,933,3,9,3,3,6,single-choice,spatial-relational,3|6,7,3/6,240208,3
2,1,24,209,1,630,1,5,2,2,3,single-choice,spatial-relational,2|3,7,2/3,240209,2
2,1,24,210,1,704,1,13,6,6,7,single-choice,spatial-relational,6|7,7,6/7,240210,6
2,1,24,211,1,1035,1,11,5,5,6,single-choice,spatial-relational,5|6,7,5/6,240211,5
2,1,24,212,1,823,3,11,4,4,7,single-choice,spatial-relational,4|7,7,4/7,240212,4
2,1,24,213,1,888,4,6,1,1,5,single-choice,spatial-relational,1|5,7,1/5,240213,1
2,1,24,214,1,636,2,4,1,1,3,single-choice,spatial-relational,1|3,7,1/3,240214,1
2,1,24,215,1,969,3,9,3,3,6,single-choice,spatial-relational,3|6,7,3/6,240215,3
2,1,24,216,1,830,5,7,1,1,6,single-choice,spatial-relational,1|6,7,1/6,240216,1
2,1,24,217,0,611,1,3,1,2,2,single-choice,spatial-relational,1|2,7,1/2,240217,1
2,1,24,218,1,641,6,8,1,1,7,single-choice,spatial-relational,1|7,7,1/7,240218,1
2,1,24,219,1,1053,2,10,4,4,6,single-choice,spatial-relational,4|6,7,4/6,240219,4
2,1,24,220,0,1004,1,7,3,4,4,single-choice,spatial-relational,3|4,7,3/4,240220,3
2,1,24,221,1,643,5,7,1,1,6,single-choice,spatial-relational,1|6,7,1/6,240221,1
2,1,24,222,0,127,4,10,3,7,7,single-choice,spatial-relational,3|7,7,3/7,240222,3
2,1,24,223,1,723,1,5,2,2,3,single-choice,spatial-relational,2|3,7,2/3,240223,2
2,1,24,224,1,716,3,7,2,2,5,single-choice,spatial-relational,2|5,7,2/5,240224,2
2,1,24,225,1,681,4,6,1,1,5,single-choice,spatial-relational,1|5,7,1/5,240225,1
2,1,24,226,1,823,1,9,4,4,5,single-choice,spatial-relational,4|5,7,4/5,240226,4
2,1,24,227,1,842,2,4,1,1,3,single-choice,spatial-relational,1|3,7,1/3,240227,1
2,1,24,228,1,614,2,6,2,2,4,single-choice,spatial-relational,2|4,7,2/4,240228,2
2,1,24,229,1,716,5,9,2,2,7,single-choice,spatial-relational,2|7,7,2/7,240229,2
2,1,24,230,1,700,1,11,5,5,6,single-choice,spatial-relational,5|6,7,5/6,240230,5
2,1,24,231,1,716,1,13,6,6,7,single-choice,spatial-relational,6|7,7,6/7,240231,6
2,1,24,232,1,1358,1,9,4,4,5,single-choice,spatial-relational,4|5,7,4/5,240232,4
2,1,24,233,1,1028,1,13,6,6,7,single-choice,spatial-relational,6|7,7,6/7,240233,6
2,1,24,234,1,797,3,11,4,4,7,single-choice,spatial-relational,4|7,7,4/7,240234,4
2,1,24,235,1,856,3,7,2,2,5,single-choice,spatial-relational,2|5,7,2/5,240235,2
2,1,24,236,1,824,2,12,5,5,7,single-choice,spatial-relational,5|7,7,5/7,240236,5
2,1,24,237,1,888,1,5,2,2,3,single-choice,spatial-relational,2|3,7,2/3,240237,2
2,1,24,238,1,944,5,9,2,2,7,single-choice,spatial-relational,2|7,7,2/7,240238,2
2,1,24,239,1,1026,4,8,2,2,6,single-choice,spatial-relational,2|6,7,2/6,240239,2
2,1,24,240,1,705,1,3,1,1,2,single-choice,spatial-relational,1|2,7,1/2,240240,1
2,1,24,241,1,36,4,10,3,3,7,single-choice,spatial-relational,3|7,7,3/7,240241,3
2,1,24,242,1,862,3,9,3,3,6,single-choice,spatial-relational,3|6,7,3/6,240242,3
2,1,24,243,1,752,2,8,3,3,5,single-choice,spatial-relational,3|5,7,3/5,240243,3
2,1,24,244,1,1161,2,10,4,4,6,single-choice,spatial-relational,4|6,7,4/6,240244,4
2,1,24,245,1,801,2,6,2,2,4,single-choice,spatial-relational,2|4,7,2/4,240245,2
2,1,24,246,1,632,3,5,1,1,4,single-choice,spatial-relational,1|4,7,1/4,240246,1
2,1,24,247,1,922,3,5,1,1,4,single-choice,spatial-relational,1|4,7,1/4,240247,1
2,1,24,248,1,788,2,8,3,3,5,single-choice,spatial-relational,3|5,7,3/5,240248,3
2,1,24,249,1,1022,1,7,3,3,4,single-choice,spatial-relational,3|4,7,3/4,240249,3
2,1,24,250,1,958,4,8,2,2,6,single-choice,spatial-relational,2|6,7,2/6,240250,2
2,1,24,251,0,743,6,8,1,7,7,single-choice,spatial-relational,1|7,7,1/7,240251,1
2,1,24,252,1,892,2,12,5,5,7,single-choice,spatial-relational,5|7,7,5/7,240252,5
2,1,24,253,1,935,3,11,4,4,7,single-choice,spatial-relational,4|7,7,4/7,240253,4
2,1,24,254,1,855,2,6,2,2,4,single-choice,spatial-relational,2|4,7,2/4,240254,2
2,1,24,255,1,1332,2,8,3,3,5,single-choice,spatial-relational,3|5,7,3/5,240255,3
2,1,24,256,1,863,5,9,2,2,7,single-choice,spatial-relational,2|7,7,2/7,240256,2
2,1,24,257,1,800,5,7,1,1,6,single-choice,spatial-relational,1|6,7,1/6,240257,1
2,1,24,258,0,713,1,3,1,2,2,single-choice,spatial-relational,1|2,7,1/2,240258,1
2,1,24,259,1,713,1,3,1,1,2,single-choice,spatial-relational,1|2,7,1/2,240259,1
2,1,24,260,1,794,2,10,4,4,6,single-choice,spatial-relational,4|6,7,4/6,240260,4
2,1,24,261,1,728,4,10,3,3,7,single-choice,spatial-relational,3|7,7,3/7,240261,3
2,1,24,262,1,818,4,10,3,3,7,single-choice,spatial-relational,3|7,7,3/7,240262,3
2,1,24,263,1,901,1,11,5,5,6,single-choice,spatial-relational,5|6,7,5/6,240263,5
2,1,24,264,0,789,4,6,1,5,5,single-choice,spatial-relational,1|5,7,1/5,240264,1
2,1,24,265,1,1151,1,13,6,6,7,single-choice,spatial-relational,6|7,7,6/7,240265,6
2,1,24,266,1,1132,6,8,1,1,7,single-choice,spatial-relational,1|7,7,1/7,240266,1
2,1,24,267,1,792,1,5,2,2,3,single-choice,spatial-relational,2|3,7,2/3,240267,2
2,1,24,268,1,843,4,6,1,1,5,single-choice,spatial-relational,1|5,7,1/5,240268,1
2,1,24,269,1,1002,1,7,3,3,4,single-choice,spatial-relational,3|4,7,3/4,240269,3
2,1,24,270,1,864,1,13,6,6,7,single-choice,spatial-relational,6|7,7,6/7,240270,6
2,1,24,271,0,841,2,10,4,6,6,single-choice,spatial-relational,4|6,7,4/6,240271,4
2,1,24,272,1,809,6,8,1,1,7,single-choice,spatial-relational,1|7,7,1/7,240272,1
2,1,24,273,1,728,4,8,2,2,6,single-choice,spatial-relational,2|6,7,2/6,240273,2
2,1,24,274,1,701,2,12,5,5,7,single-choice,spatial-relational,5|7,7,5/7,240274,5
2,1,24,275,1,919,1,7,3,3,4,single-choice,spatial-relational,3|4,7,3/4,240275,3
2,1,24,276,1,992,1,9,4,4,5,single-choice,spatial-relational,4|5,7,4/5,240276,4
2,1,24,277,1,732,2,4,1,1,3,single-choice,spatial-relational,1|3,7,1/3,240277,1
2,1,24,278,1,611,3,5,1,1,4,single-choice,spatial-relational,1|4,7,1/4,240278,1
2,1,24,279,1,935,3,9,3,3,6,single-choice,spatial-relational,3|6,7,3/6,240279,3
2,1,24,280,1,1010,3,11,4,4,7,single-choice,spatial-relational,4|7,7,4/7,240280,4
2,1,24,281,1,1111,5,9,2,2,7,single-choice,spatial-relational,2|7,7,2/7,240281,2
2,1,24,282,0,1299,5,7,1,6,6,single-choice,spatial-relational,1|6,7,1/6,240282,1
2,1,24,283,1,626,3,7,2,2,5,single-choice,spatial-relational,2|5,7,2/5,240283,2
2,1,24,284,1,739,3,9,3,3,6,single-choice,spatial-relational,3|6,7,3/6,240284,3
2,1,24,285,1,795,2,12,5,5,7,single-choice,spatial-relational,5|7,7,5/7,240285,5
2,1,24,286,1,684,2,8,3,3,5,single-choice,spatial-relational,3|5,7,3/5,240286,3
2,1,24,287,1,808,2,6,2,2,4,single-choice,spatial-relational,2|4,7,2/4,240287,2
2,1,24,288,1,564,4,8,2,2,6,single-choice,spatial-relational,2|6,7,2/6,240288,2
2,1,24,289,1,620,2,4,1,1,3,single-choice,spatial-relational,1|3,7,1/3,240289,1
2,1,24,290,1,607,1,5,2,2,3,single-choice,spatial-relational,2|3,7,2/3,240290,2
2,1,24,291,1,750,3,7,2,2,5,single-choice,spatial-relational,2|5,7,2/5,240291,2
2,1,24,292,1,868,1,11,5,5,6,single-choice,spatial-relational,5|6,7,5/6,240292,5
2,1,24,293,0,930,1,9,4,5,5,single-choice,spatial-relational,4|5,7,4/5,240293,4
2,1,24,294,1,840,3,5,1,1,4,single-choice,spatial-relational,1|4,7,1/4,240294,1
2,1,24,295,1,111,2,10,4,4,6,single-choice,spatial-relational,4|6,7,4/6,240295,4
2,1,24,296,1,801,3,11,4,4,7,single-choice,spatial-relational,4|7,7,4/7,240296,4
2,1,24,297,1,724,5,9,2,2,7,single-choice,spatial-relational,2|7,7,2/7,240297,2
2,1,24,298,1,975,2,6,2,2,4,single-choice,spatial-relational,2|4,7,2/4,240298,2
2,1,24,299,1,1114,1,9,4,4,5,single-choice,spatial-relational,4|5,7,4/5,240299,4
2,1,24,300,1,1064,4,10,3,3,7,single-choice,spatial-relational,3|7,7,3/7,240300,3
2,1,24,301,1,846,1,5,2,2,3,single-choice,spatial-relational,2|3,7,2/3,240301,2
2,1,24,302,1,733,2,12,5,5,7,single-choice,spatial-relational,5|7,7,5/7,240302,5
2,1,24,303,1,1175,1,11,5,5,6,single-choice,spatial-relational,5|6,7,5/6,240303,5
2,1,24,304,1,939,2,6,2,2,4,single-choice,spatial-relational,2|4,7,2/4,240304,2
2,1,24,305,1,594,1,7,3,3,4,single-choice,spatial-relational,3|4,7,3/4,240305,3
2,1,24,306,1,851,1,13,6,6,7,single-choice,spatial-relational,6|7,7,6/7,240306,6
2,1,24,307,1,1024,3,5,1,1,4,single-choice,spatial-relational,1|4,7,1/4,240307,1
2,1,24,308,1,610,3,7,2,2,5,single-choice,spatial-relational,2|5,7,2/5,240308,2
2,1,24,309,1,932,6,8,1,1,7,single-choice,spatial-relational,1|7,7,1/7,240309,1
2,1,24,310,1,854,2,8,3,3,5,single-choice,spatial-relational,3|5,7,3/5,240310,3
2,1,24,311,1,625,1,13,6,6,7,single-choice,spatial-relational,6|7,7,6/7,240311,6
2,1,24,312,1,795,3,5,1,1,4,single-choice,spatial-relational,1|4,7,1/4,240312,1
2,1,24,313,1,913,1,9,4,4,5,single-choice,spatial-relational,4|5,7,4/5,240313,4
2,1,24,314,1,833,3,9,3,3,6,single-choice,spatial-relational,3|6,7,3/6,240314,3
2,1,24,315,1,790,5,9,2,2,7,single-choice,spatial-relational,2|7,7,2/7,240315,2
2,1,24,316,1,614,6,8,1,1,7,single-choice,spatial-relational,1|7,7,1/7,240316,1
2,1,24,317,1,919,4,8,2,2,6,single-choice,spatial-relational,2|6,7,2/6,240317,2
2,1,24,318,1,857,4,8,2,2,6,single-choice,spatial-relational,2|6,7,2/6,240318,2
2,1,24,319,0,1219,3,7,2,5,5,single-choice,spatial-relational,2|5,7,2/5,240319,2
2,1,24,320,1,713,1,3,1,1,2,single-choice,spatial-relational,1|2,7,1/2,240320,1
2,1,24,321,1,964,1,7,3,3,4,single-choice,spatial-relational,3|4,7,3/4,240321,3
2,1,24,322,1,793,2,4,1,1,3,single-choice,spatial-relational,1|3,7,1/3,240322,1
2,1,24,323,1,723,4,6,1,1,5,single-choice,spatial-relational,1|5,7,1/5,240323,1
2,1,24,324,1,989,3,11,4,4,7,single-choice,spatial-relational,4|7,7,4/7,240324,4
2,1,24,325,1,1035,5,7,1,1,6,single-choice,spatial-relational,1|6,7,1/6,240325,1
2,1,24,326,1,714,4,10,3,3,7,single-choice,spatial-relational,3|7,7,3/7,240326,3
2,1,24,327,1,685,2,4,1,1,3,single-choice,spatial-relational,1|3,7,1/3,240327,1
2,1,24,328,1,723,2,12,5,5,7,single-choice,spatial-relational,5|7,7,5/7,240328,5
2,1,24,329,0,1317,2,10,4,6,6,single-choice,spatial-relational,4|6,7,4/6,240329,4
2,1,24,330,1,1223,3,9,3,3,6,single-choice,spatial-relational,3|6,7,3/6,240330,3
2,1,24,331,1,658,1,5,2,2,3,single-choice,spatial-relational,2|3,7,2/3,240331,2
2,1,24,332,1,867,5,7,1,1,6,single-choice,spatial-relational,1|6,7,1/6,240332,1
2,1,24,333,1,672,2,8,3,3,5,single-choice,spatial-relational,3|5,7,3/5,240333,3
2,1,24,334,1,923,4,6,1,1,5,single-choice,spatial-relational,1|5,7,1/5,240334,1
2,1,24,335,1,645,1,3,1,1,2,single-choice,spatial-relational,1|2,7,1/2,240335,1
2,1,24,336,1,837,1,11,5,5,6,single-choice,spatial-relational,5|6,7,5/6,240336,5
2,1,24,337,1,831,3,11,4,4,7,single-choice,spatial-relational,4|7,7,4/7,240337,4
2,1,24,338,1,830,4,8,2,2,6,single-choice,spatial-relational,2|6,7,2/6,240338,2
2,1,24,339,1,719,5,9,2,2,7,single-choice,spatial-relational,2|7,7,2/7,240339,2
2,1,24,340,1,705,1,3,1,1,2,single-choice,spatial-relational,1|2,7,1/2,240340,1
2,1,24,341,1,694,3,5,1,1,4,single-choice,spatial-relational,1|4,7,1/4,240341,1
2,1,24,342,1,694,4,10,3,3,7,single-choice,spatial-relational,3|7,7,3/7,240342,3
2,1,24,343,0,859,6,8,1,7,7,single-choice,spatial-relational,1|7,7,1/7,240343,1
2,1,24,344,1,705,1,7,3,3,4,single-choice,spatial-relational,3|4,7,3/4,240344,3
2,1,24,345,1,713,1,7,3,3,4,single-choice,spatial-relational,3|4,7,3/4,240345,3
2,1,24,346,1,812,2,4,1,1,3,single-choice,spatial-relational,1|3,7,1/3,240346,1
2,1,24,347,1,926,3,5,1,1,4,single-choice,spatial-relational,1|4,7,1/4,240347,1
2,1,24,348,1,873,2,6,2,2,4,single-choice,spatial-relational,2|4,7,2/4,240348,2
2,1,24,349,1,622,5,7,1,1,6,single-choice,spatial-relational,1|6,7,1/6,240349,1
2,1,24,350,1,676,6,8,1,1,7,single-choice,spatial-relational,1|7,7,1/7,240350,1
2,1,24,351,1,791,5,7,1,1,6,single-choice,spatial-relational,1|6,7,1/6,240351,1
2,1,24,352,1,712,1,13,6,6,7,single-choice,spatial-relational,6|7,7,6/7,240352,6
2,1,24,353,1,1120,3,11,4,4,7,single-choice,spatial-relational,4|7,7,4/7,240353,4
2,1,24,354,1,954,3,7,2,2,5,single-choice,spatial-relational,2|5,7,2/5,240354,2
2,1,24,355,1,916,1,5,2,2,3,single-choice,spatial-relational,2|3,7,2/3,240355,2
2,1,24,356,1,971,2,10,4,4,6,single-choice,spatial-relational,4|6,7,4/6,240356,4
2,1,24,357,1,942,1,3,1,1,2,single-choice,spatial-relational,1|2,7,1/2,240357,1
2,1,24,358,1,48,3,7,2,2,5,single-choice,spatial-relational,2|5,7,2/5,240358,2
2,1,24,359,1,659,2,12,5,5,7,single-choice,spatial-relational,5|7,7,5/7,240359,5
2,1,24,360,1,931,1,5,2,2,3,single-choice,spatial-relational,2|3,7,2/3,240360,2
2,1,24,361,1,789,2,6,2,2,4,single-choice,spatial-relational,2|4,7,2/4,240361,2
2,1,24,362,1,848,3,9,3,3,6,single-choice,spatial-relational,3|6,7,3/6,240362,3
2,1,24,363,0,2023,4,6,1,5,5,single-choice,spatial-relational,1|5,7,1/5,240363,1
2,1,24,364,1,1084,2,10,4,4,6,single-choice,spatial-relational,4|6,7,4/6,240364,4
2,1,24,365,1,1062,1,11,5,5,6,single-choice,spatial-relational,5|6,7,5/6,240365,5
2,1,24,366,1,773,2,4,1,1,3,single-choice,spatial-relational,1|3,7,1/3,240366,1
2,1,24,367,1,882,2,12,5,5,7,single-choice,spatial-relational,5|7,7,5/7,240367,5
2,1,24,368,1,1005,1,13,6,6,7,single-choice,spatial-relational,6|7,7,6/7,240368,6
2,1,24,369,1,1188,1,9,4,4,5,single-choice,spatial-relational,4|5,7,4/5,240369,4
2,1,24,370,1,1048,2,8,3,3,5,single-choice,spatial-relational,3|5,7,3/5,240370,3
2,1,24,371,1,1752,1,9,4,4,5,single-choice,spatial-relational,4|5,7,4/5,240371,4
2,1,24,372,1,1024,5,9,2,2,7,single-choice,spatial-relational,2|7,7,2/7,240372,2
2,1,24,373,1,925,4,10,3,3,7,single-choice,spatial-relational,3|7,7,3/7,240373,3
2,1,24,374,1,843,4,6,1,1,5,single-choice,spatial-relational,1|5,7,1/5,240374,1
2,1,24,375,0,84,2,8,3,5,5,single-choice,spatial-relational,3|5,7,3/5,240375,3
2,1,24,376,1,783,4,8,2,2,6,single-choice,spatial-relational,2|6,7,2/6,240376,2
2,1,24,377,1,1103,3,9,3,3,6,single-choice,spatial-relational,3|6,7,3/6,240377,3
2,1,24,378,1,802,1,11,5,5,6,single-choice,spatial-relational,5|6,7,5/6,240378,5
2,1,24,379,1,966,4,8,2,2,6,single-choice,spatial-relational,2|6,7,2/6,240379,2
2,1,24,380,1,854,5,7,1,1,6,single-choice,spatial-relational,1|6,7,1/6,240380,1
2,1,24,381,1,600,2,4,1,1,3,single-choice,spatial-relational,1|3,7,1/3,240381,1
2,1,24,382,0,102,5,7,1,6,6,single-choice,spatial-relational,1|6,7,1/6,240382,1
2,1,24,383,1,664,5,9,2,2,7,single-choice,spatial-relational,2|7,7,2/7,240383,2
2,1,24,384,1,921,2,8,3,3,5,single-choice,spatial-relational,3|5,7,3/5,240384,3
2,1,24,385,1,1084,3,9,3,3,6,single-choice,spatial-relational,3|6,7,3/6,240385,3
2,1,24,386,1,923,1,9,4,4,5,single-choice,spatial-relational,4|5,7,4/5,240386,4
2,1,24,387,1,1035,1,9,4,4,5,single-choice,spatial-relational,4|5,7,4/5,240387,4
2,1,24,388,1,1018,3,9,3,3,6,single-choice,spatial-relational,3|6,7,3/6,240388,3
2,1,24,389,1,926,3,7,2,2,5,single-choice,spatial-relational,2|5,7,2/5,240389,2
2,1,24,390,0,959,1,7,3,4,4,single-choice,spatial-relational,3|4,7,3/4,240390,3
2,1,24,391,1,972,2,12,5,5,7,single-choice,spatial-relational,5|7,7,5/7,240391,5
2,1,24,392,1,1200,6,8,1,1,7,single-choice,spatial-relational,1|7,7,1/7,240392,1
2,1,24,393,1,81,4,6,1,1,5,single-choice,spatial-relational,1|5,7,1/5,240393,1
2,1,24,394,1,1040,3,7,2,2,5,single-choice,spatial-relational,2|5,7,2/5,240394,2
2,1,24,395,1,744,1,3,1,1,2,single-choice,spatial-relational,1|2,7,1/2,240395,1
2,1,24,396,1,759,1,13,6,6,7,single-choice,spatial-relational,6|7,7,6/7,240396,6
2,1,24,397,1,753,3,5,1,1,4,single-choice,spatial-relational,1|4,7,1/4,240397,1
2,1,24,398,1,721,4,10,3,3,7,single-choice,spatial-relational,3|7,7,3/7,240398,3
2,1,24,399,1,756,1,5,2,2,3,single-choice,spatial-relational,2|3,7,2/3,240399,2
2,1,24,400,1,714,1,5,2,2,3,single-choice,spatial-relational,2|3,7,2/3,240400,2
2,1,24,401,1,860,1,7,3,3,4,single-choice,spatial-relational,3|4,7,3/4,240401,3
2,1,24,402,1,1302,2,10,4,4,6,single-choice,spatial-relational,4|6,7,4/6,240402,4
2,1,24,403,1,856,3,11,4,4,7,single-choice,spatial-relational,4|7,7,4/7,240403,4
2,1,24,404,1,1032,1,11,5,5,6,single-choice,spatial-relational,5|6,7,5/6,240404,5
2,1,24,405,1,905,4,8,2,2,6,single-choice,spatial-relational,2|6,7,2/6,240405,2
2,1,24,406,1,699,4,10,3,3,7,single-choice,spatial-relational,3|7,7,3/7,240406,3
2,1,24,407,1,802,6,8,1,1,7,single-choice,spatial-relational,1|7,7,1/7,240407,1
2,1,24,408,1,755,2,6,2,2,4,single-choice,spatial-relational,2|4,7,2/4,240408,2
2,1,24,409,1,810,1,11,5,5,6,single-choice,spatial-relational,5|6,7,5/6,240409,5
2,1,24,410,1,927,5,9,2,2,7,single-choice,spatial-relational,2|7,7,2/7,240410,2
2,1,24,411,0,12612,2,4,1,3,3,single-choice,spatial-relational,1|3,7,1/3,240411,1
2,1,24,412,1,916,1,13,6,6,7,single-choice,spatial-relational,6|7,7,6/7,240412,6
2,1,24,413,1,883,1,3,1,1,2,single-choice,spatial-relational,1|2,7,1/2,240413,1
2,1,24,414,1,828,2,8,3,3,5,single-choice,spatial-relational,3|5,7,3/5,240414,3
2,1,24,415,1,803,2,10,4,4,6,single-choice,spatial-relational,4|6,7,4/6,240415,4
2,1,24,416,1,806,3,5,1,1,4,single-choice,spatial-relational,1|4,7,1/4,240416,1
2,1,24,417,1,638,3,11,4,4,7,single-choice,spatial-relational,4|7,7,4/7,240417,4
2,1,24,418,1,882,2,6,2,2,4,single-choice,spatial-relational,2|4,7,2/4,240418,2
2,1,24,419,1,896,4,6,1,1,5,single-choice,spatial-relational,1|5,7,1/5,240419,1
2,1,24,420,1,869,2,12,5,5,7,single-choice,spatial-relational,5|7,7,5/7,240420,5
2,1,24,421,1,744,1,7,3,3,4,single-choice,spatial-relational,3|4,7,3/4,240421,3
2,1,24,422,1,753,4,6,1,1,5,single-choice,spatial-relational,1|5,7,1/5,240422,1
2,1,24,423,1,1628,5,7,1,1,6,single-choice,spatial-relational,1|6,7,1/6,240423,1
2,1,24,424,1,825,6,8,1,1,7,single-choice,spatial-relational,1|7,7,1/7,240424,1
2,1,24,425,1,624,2,6,2,2,4,single-choice,spatial-relational,2|4,7,2/4,240425,2
2,1,24,426,1,1041,1,9,4,4,5,single-choice,spatial-relational,4|5,7,4/5,240426,4
2,1,24,427,1,860,2,12,5,5,7,single-choice,spatial-relational,5|7,7,5/7,240427,5
2,1,24,428,1,1220,3,5,1,1,4,single-choice,spatial-relational,1|4,7,1/4,240428,1
2,1,24,429,1,666,4,8,2,2,6,single-choice,spatial-relational,2|6,7,2/6,240429,2
2,1,24,430,1,658,3,11,4,4,7,single-choice,spatial-relational,4|7,7,4/7,240430,4
2,1,24,431,1,948,2,4,1,1,3,single-choice,spatial-relational,1|3,7,1/3,240431,1
2,1,24,432,1,720,3,11,4,4,7,single-choice,spatial-relational,4|7,7,4/7,240432,4
2,1,24,433,1,885,1,5,2,2,3,single-choice,spatial-relational,2|3,7,2/3,240433,2
2,1,24,434,1,973,4,10,3,3,7,single-choice,spatial-relational,3|7,7,3/7,240434,3
2,1,24,435,1,1322,2,10,4,4,6,single-choice,spatial-relational,4|6,7,4/6,240435,4
2,1,24,436,1,905,1,3,1,1,2,single-choice,spatial-relational,1|2,7,1/2,240436,1
2,1,24,437,1,993,4,6,1,1,5,single-choice,spatial-relational,1|5,7,1/5,240437,1
2,1,24,438,1,961,3,9,3,3,6,single-choice,spatial-relational,3|6,7,3/6,240438,3
2,1,24,439,1,800,2,6,2,2,4,single-choice,spatial-relational,2|4,7,2/4,240439,2
2,1,24,440,1,912,3,9,3,3,6,single-choice,spatial-relational,3|6,7,3/6,240440,3
2,1,24,441,1,902,2,10,4,4,6,single-choice,spatial-relational,4|6,7,4/6,240441,4
2,1,24,442,1,968,1,5,2,2,3,single-choice,spatial-relational,2|3,7,2/3,240442,2
2,1,24,443,1,644,5,9,2,2,7,single-choice,spatial-relational,2|7,7,2/7,240443,2
2,1,24,444,1,782,2,8,3,3,5,single-choice,spatial-relational,3|5,7,3/5,240444,3
2,1,24,445,0,822,2,8,3,5,5,single-choice,spatial-relational,3|5,7,3/5,240445,3
2,1,24,446,1,948,1,11,5,5,6,single-choice,spatial-relational,5|6,7,5/6,240446,5
2,1,24,447,1,978,1,13,6,6,7,single-choice,spatial-relational,6|7,7,6/7,240447,6
2,1,24,448,1,1019,1,11,5,5,6,single-choice,spatial-relational,5|6,7,5/6,240448,5
2,1,24,449,1,896,5,7,1,1,6,single-choice,spatial-relational,1|6,7,1/6,240449,1
2,1,24,450,1,1254,6,8,1,1,7,single-choice,spatial-relational,1|7,7,1/7,240450,1
2,1,24,451,1,902,1,7,3,3,4,single-choice,spatial-relational,3|4,7,3/4,240451,3
2,1,24,452,1,836,2,12,5,5,7,single-choice,spatial-relational,5|7,7,5/7,240452,5
2,1,24,453,1,769,3,7,2,2,5,single-choice,spatial-relational,2|5,7,2/5,240453,2
2,1,24,454,1,811,5,9,2,2,7,single-choice,spatial-relational,2|7,7,2/7,240454,2
2,1,24,455,0,723,2,4,1,3,3,single-choice,spatial-relational,1|3,7,1/3,240455,1
2,1,24,456,1,784,3,7,2,2,5,single-choice,spatial-relational,2|5,7,2/5,240456,2
2,1,24,457,1,873,1,13,6,6,7,single-choice,spatial-relational,6|7,7,6/7,240457,6
2,1,24,458,1,925,4,10,3,3,7,single-choice,spatial-relational,3|7,7,3/7,240458,3
2,1,24,459,1,1004,1,9,4,4,5,single-choice,spatial-relational,4|5,7,4/5,240459,4
2,1,24,460,1,701,1,3,1,1,2,single-choice,spatial-relational,1|2,7,1/2,240460,1
2,1,24,461,1,984,3,5,1,1,4,single-choice,spatial-relational,1|4,7,1/4,240461,1
2,1,24,462,1,884,4,8,2,2,6,single-choice,spatial-relational,2|6,7,2/6,240462,2
2,1,24,463,1,752,1,9,4,4,5,single-choice,spatial-relational,4|5,7,4/5,240463,4
2,1,24,464,1,1033,3,7,2,2,5,single-choice,spatial-relational,2|5,7,2/5,240464,2
2,1,24,465,1,752,4,6,1,1,5,single-choice,spatial-relational,1|5,7,1/5,240465,1
2,1,24,466,1,972,4,10,3,3,7,single-choice,spatial-relational,3|7,7,3/7,240466,3
2,1,24,467,1,1061,5,7,1,1,6,single-choice,spatial-relational,1|6,7,1/6,240467,1
2,1,24,468,1,767,4,10,3,3,7,single-choice,spatial-relational,3|7,7,3/7,240468,3
2,1,24,469,1,812,1,5,2,2,3,single-choice,spatial-relational,2|3,7,2/3,240469,2
2,1,24,470,1,628,1,3,1,1,2,single-choice,spatial-relational,1|2,7,1/2,240470,1
2,1,24,471,1,1011,6,8,1,1,7,single-choice,spatial-relational,1|7,7,1/7,240471,1
2,1,24,472,1,821,5,9,2,2,7,single-choice,spatial-relational,2|7,7,2/7,240472,2
2,1,24,473,1,797,1,13,6,6,7,single-choice,spatial-relational,6|7,7,6/7,240473,6
2,1,24,474,1,898,2,10,4,4,6,single-choice,spatial-relational,4|6,7,4/6,240474,4
2,1,24,475,1,932,4,8,2,2,6,single-choice,spatial-relational,2|6,7,2/6,240475,2
2,1,24,476,1,650,3,11,4,4,7,single-choice,spatial-relational,4|7,7,4/7,240476,4
2,1,24,477,1,743,3,5,1,1,4,single-choice,spatial-relational,1|4,7,1/4,240477,1
2,1,24,478,1,764,1,3,1,1,2,single-choice,spatial-relational,1|2,7,1/2,240478,1
2,1,24,479,1,695,3,11,4,4,7,single-choice,spatial-relational,4|7,7,4/7,240479,4
2,1,24,480,1,668,1,13,6,6,7,single-choice,spatial-relational,6|7,7,6/7,240480,6
2,1,24,481,1,1466,3,7,2,2,5,single-choice,spatial-relational,2|5,7,2/5,240481,2
2,1,24,482,1,691,6,8,1,1,7,single-choice,spatial-relational,1|7,7,1/7,240482,1
2,1,24,483,1,899,2,10,4,4,6,single-choice,spatial-relational,4|6,7,4/6,240483,4
2,1,24,484,1,1097,1,11,5,5,6,single-choice,spatial-relational,5|6,7,5/6,240484,5
2,1,24,485,1,855,2,12,5,5,7,single-choice,spatial-relational,5|7,7,5/7,240485,5
2,1,24,486,1,951,4,6,1,1,5,single-choice,spatial-relational,1|5,7,1/5,240486,1
2,1,24,487,1,987,5,9,2,2,7,single-choice,spatial-relational,2|7,7,2/7,240487,2
2,1,24,488,1,793,2,8,3,3,5,single-choice,spatial-relational,3|5,7,3/5,240488,3
2,1,24,489,1,834,2,8,3,3,5,single-choice,spatial-relational,3|5,7,3/5,240489,3
2,1,24,490,1,779,2,12,5,5,7,single-choice,spatial-relational,5|7,7,5/7,240490,5
2,1,24,491,1,872,2,6,2,2,4,single-choice,spatial-relational,2|4,7,2/4,240491,2
2,1,24,492,1,1074,3,9,3,3,6,single-choice,spatial-relational,3|6,7,3/6,240492,3
2,1,24,493,1,805,2,4,1,1,3,single-choice,spatial-relational,1|3,7,1/3,240493,1
2,1,24,494,1,801,4,8,2,2,6,single-choice,spatial-relational,2|6,7,2/6,240494,2
2,1,24,495,1,791,1,9,4,4,5,single-choice,spatial-relational,4|5,7,4/5,240495,4
2,1,24,496,1,914,3,5,1,1,4,single-choice,spatial-relational,1|4,7,1/4,240496,1
2,1,24,497,0,650,1,7,3,4,4,single-choice,spatial-relational,3|4,7,3/4,240497,3
2,1,24,498,1,1209,3,9,3,3,6,single-choice,spatial-relational,3|6,7,3/6,240498,3
2,1,24,499,1,910,2,6,2,2,4,single-choice,spatial-relational,2|4,7,2/4,240499,2
2,1,24,500,1,710,1,5,2,2,3,single-choice,spatial-relational,2|3,7,2/3,240500,2
2,1,24,501,1,922,1,11,5,5,6,single-choice,spatial-relational,5|6,7,5/6,240501,5
2,1,24,502,1,769,1,7,3,3,4,single-choice,spatial-relational,3|4,7,3/4,240502,3
2,1,24,503,1,738,5,7,1,1,6,single-choice,spatial-relational,1|6,7,1/6,240503,1
2,1,24,504,1,688,2,4,1,1,3,single-choice,spatial-relational,1|3,7,1/3,240504,1
2,1,24,505,1,1333,3,7,2,2,5,single-choice,spatial-relational,2|5,7,2/5,240505,2
2,1,24,506,1,660,3,11,4,4,7,single-choice,spatial-relational,4|7,7,4/7,240506,4
2,1,24,507,1,735,1,3,1,1,2,single-choice,spatial-relational,1|2,7,1/2,240507,1
2,1,24,508,1,789,3,5,1,1,4,single-choice,spatial-relational,1|4,7,1/4,240508,1
2,1,24,509,1,935,2,12,5,5,7,single-choice,spatial-relational,5|7,7,5/7,240509,5
2,1,24,510,1,1346,2,8,3,3,5,single-choice,spatial-relational,3|5,7,3/5,240510,3
2,1,24,511,1,741,4,6,1,1,5,single-choice,spatial-relational,1|5,7,1/5,240511,1
2,1,24,512,1,859,3,7,2,2,5,single-choice,spatial-relational,2|5,7,2/5,240512,2
2,1,24,513,0,142,1,9,4,5,5,single-choice,spatial-relational,4|5,7,4/5,240513,4
2,1,24,514,1,809,2,12,5,5,7,single-choice,spatial-relational,5|7,7,5/7,240514,5
2,1,24,515,1,1629,1,11,5,5,6,single-choice,spatial-relational,5|6,7,5/6,240515,5
2,1,24,516,1,873,1,5,2,2,3,single-choice,spatial-relational,2|3,7,2/3,240516,2
2,1,24,517,1,1117,2,10,4,4,6,single-choice,spatial-relational,4|6,7,4/6,240517,4
2,1,24,518,1,939,5,9,2,2,7,single-choice,spatial-relational,2|7,7,2/7,240518,2
2,1,24,519,0,684,1,3,1,2,2,single-choice,spatial-relational,1|2,7,1/2,240519,1
2,1,24,520,1,928,2,6,2,2,4,single-choice,spatial-relational,2|4,7,2/4,240520,2
2,1,24,521,1,1015,6,8,1,1,7,single-choice,spatial-relational,1|7,7,1/7,240521,1
2,1,24,522,1,914,4,10,3,3,7,single-choice,spatial-relational,3|7,7,3/7,240522,3
2,1,24,523,1,847,2,10,4,4,6,single-choice,spatial-relational,4|6,7,4/6,240523,4
2,1,24,524,1,905,5,7,1,1,6,single-choice,spatial-relational,1|6,7,1/6,240524,1
2,1,24,525,1,925,1,11,5,5,6,single-choice,spatial-relational,5|6,7,5/6,240525,5
2,1,24,526,1,880,1,13,6,6,7,single-choice,spatial-relational,6|7,7,6/7,240526,6
2,1,24,527,1,1048,3,9,3,3,6,single-choice,spatial-relational,3|6,7,3/6,240527,3
2,1,24,528,1,788,5,9,2,2,7,single-choice,spatial-relational,2|7,7,2/7,240528,2
2,1,24,529,1,814,1,5,2,2,3,single-choice,spatial-relational,2|3,7,2/3,240529,2
2,1,24,530,1,873,1,7,3,3,4,single-choice,spatial-relational,3|4,7,3/4,240530,3
2,1,24,531,1,820,2,4,1,1,3,single-choice,spatial-relational,1|3,7,1/3,240531,1
2,1,24,532,1,735,1,7,3,3,4,single-choice,spatial-relational,3|4,7,3/4,240532,3
2,1,24,533,1,957,2,8,3,3,5,single-choice,spatial-relational,3|5,7,3/5,240533,3
2,1,24,534,1,744,3,11,4,4,7,single-choice,spatial-relational,4|7,7,4/7,240534,4
2,1,24,535,1,1087,3,5,1,1,4,single-choice,spatial-relational,1|4,7,1/4,240535,1
2,1,24,536,1,752,2,6,2,2,4,single-choice,spatial-relational,2|4,7,2/4,240536,2
2,1,24,537,1,743,1,13,6,6,7,single-choice,spatial-relational,6|7,7,6/7,240537,6
2,1,24,538,1,1053,1,9,4,4,5,single-choice,spatial-relational,4|5,7,4/5,240538,4
2,1,24,539,1,732,4,8,2,2,6,single-choice,spatial-relational,2|6,7,2/6,240539,2
2,1,24,540,1,709,2,4,1,1,3,single-choice,spatial-relational,1|3,7,1/3,240540,1
2,1,24,541,1,932,5,7,1,1,6,single-choice,spatial-relational,1|6,7,1/6,240541,1
2,1,24,542,1,895,4,8,2,2,6,single-choice,spatial-relational,2|6,7,2/6,240542,2
2,1,24,543,1,961,6,8,1,1,7,single-choice,spatial-relational,1|7,7,1/7,240543,1
2,1,24,544,1,936,3,9,3,3,6,single-choice,spatial-relational,3|6,7,3/6,240544,3
2,1,24,545,1,858,4,10,3,3,7,single-choice,spatial-relational,3|7,7,3/7,240545,3
2,1,24,546,1,1100,4,6,1,1,5,single-choice,spatial-relational,1|5,7,1/5,240546,1
2,1,24,547,1,772,5,9,2,2,7,single-choice,spatial-relational,2|7,7,2/7,240547,2
2,1,24,548,1,612,2,12,5,5,7,single-choice,spatial-relational,5|7,7,5/7,240548,5
2,1,24,549,1,910,3,5,1,1,4,single-choice,spatial-relational,1|4,7,1/4,240549,1
2,1,24,550,1,781,1,3,1,1,2,single-choice,spatial-relational,1|2,7,1/2,240550,1
2,1,24,551,1,1039,3,11,4,4,7,single-choice,spatial-relational,4|7,7,4/7,240551,4
2,1,24,552,1,907,1,7,3,3,4,single-choice,spatial-relational,3|4,7,3/4,240552,3
2,1,24,553,1,927,2,10,4,4,6,single-choice,spatial-relational,4|6,7,4/6,240553,4
2,1,24,554,1,859,5,7,1,1,6,single-choice,spatial-relational,1|6,7,1/6,240554,1
2,1,24,555,1,921,1,11,5,5,6,single-choice,spatial-relational,5|6,7,5/6,240555,5
2,1,24,556,0,1345,6,8,1,7,7,single-choice,spatial-relational,1|7,7,1/7,240556,1
2,1,24,557,1,851,2,12,5,5,7,single-choice,spatial-relational,5|7,7,5/7,240557,5
2,1,24,558,1,927,2,4,1,1,3,single-choice,spatial-relational,1|3,7,1/3,240558,1
2,1,24,559,1,815,3,11,4,4,7,single-choice,spatial-relational,4|7,7,4/7,240559,4
2,1,24,560,1,929,4,8,2,2,6,single-choice,spatial-relational,2|6,7,2/6,240560,2
2,1,24,561,1,816,2,6,2,2,4,single-choice,spatial-relational,2|4,7,2/4,240561,2
2,1,24,562,1,852,3,9,3,3,6,single-choice,spatial-relational,3|6,7,3/6,240562,3
2,1,24,563,1,877,4,10,3,3,7,single-choice,spatial-relational,3|7,7,3/7,240563,3
2,1,24,564,1,893,5,7,1,1,6,single-choice,spatial-relational,1|6,7,1/6,240564,1
2,1,24,565,1,1411,1,7,3,3,4,single-choice,spatial-relational,3|4,7,3/4,240565,3
2,1,24,566,1,1050,3,7,2,2,5,single-choice,spatial-relational,2|5,7,2/5,240566,2
2,1,24,567,1,858,1,9,4,4,5,single-choice,spatial-relational,4|5,7,4/5,240567,4
2,1,24,568,0,811,1,3,1,2,2,single-choice,spatial-relational,1|2,7,1/2,240568,1
2,1,24,569,1,1140,1,11,5,5,6,single-choice,spatial-relational,5|6,7,5/6,240569,5
2,1,24,570,1,1061,4,6,1,1,5,single-choice,spatial-relational,1|5,7,1/5,240570,1
2,1,24,571,1,1003,1,5,2,2,3,single-choice,spatial-relational,2|3,7,2/3,240571,2
2,1,24,572,1,869,2,4,1,1,3,single-choice,spatial-relational,1|3,7,1/3,240572,1
2,1,24,573,1,983,5,9,2,2,7,single-choice,spatial-relational,2|7,7,2/7,240573,2
2,1,24,574,0,1116,2,10,4,6,6,single-choice,spatial-relational,4|6,7,4/6,240574,4
2,1,24,575,1,694,3,7,2,2,5,single-choice,spatial-relational,2|5,7,2/5,240575,2
2,1,24,576,1,917,1,13,6,6,7,single-choice,spatial-relational,6|7,7,6/7,240576,6
2,1,24,577,1,1056,4,10,3,3,7,single-choice,spatial-relational,3|7,7,3/7,240577,3
2,1,24,578,1,1203,3,5,1,1,4,single-choice,spatial-relational,1|4,7,1/4,240578,1
2,1,24,579,1,766,1,5,2,2,3,single-choice,spatial-relational,2|3,7,2/3,240579,2
2,1,24,580,1,828,2,6,2,2,4,single-choice,spatial-relational,2|4,7,2/4,240580,2
2,1,24,581,1,681,2,8,3,3,5,single-choice,spatial-relational,3|5,7,3/5,240581,3
2,1,24,582,1,995,3,9,3,3,6,single-choice,spatial-relational,3|6,7,3/6,240582,3
2,1,24,583,1,785,1,13,6,6,7,single-choice,spatial-relational,6|7,7,6/7,240583,6
2,1,24,584,1,1139,4,6,1,1,5,single-choice,spatial-relational,1|5,7,1/5,240584,1
2,1,24,585,1,942,2,8,3,3,5,single-choice,spatial-relational,3|5,7,3/5,240585,3
2,1,24,586,0,861,6,8,1,7,7,single-choice,spatial-relational,1|7,7,1/7,240586,1
2,1,24,587,1,1112,1,9,4,4,5,single-choice,spatial-relational,4|5,7,4/5,240587,4
2,1,24,588,1,704,4,8,2,2,6,single-choice,spatial-relational,2|6,7,2/6,240588,2
2,1,24,589,1,813,4,10,3,3,7,single-choice,spatial-relational,3|7,7,3/7,240589,3
2,1,24,590,1,783,1,11,5,5,6,single-choice,spatial-relational,5|6,7,5/6,240590,5
2,1,24,591,1,1374,2,10,4,4,6,single-choice,spatial-relational,4|6,7,4/6,240591,4
2,1,24,592,1,916,4,8,2,2,6,single-choice,spatial-relational,2|6,7,2/6,240592,2
2,1,24,593,1,843,3,7,2,2,5,single-choice,spatial-relational,2|5,7,2/5,240593,2
2,1,24,594,1,742,1,13,6,6,7,single-choice,spatial-relational,6|7,7,6/7,240594,6
2,1,24,595,1,773,2,12,5,5,7,single-choice,spatial-relational,5|7,7,5/7,240595,5
2,1,24,596,1,691,5,9,2,2,7,single-choice,spatial-relational,2|7,7,2/7,240596,2
2,1,24,597,1,10230,1,5,2,2,3,single-choice,spatial-relational,2|3,7,2/3,240597,2
2,1,24,598,1,731,6,8,1,1,7,single-choice,spatial-relational,1|7,7,1/7,240598,1
2,1,24,599,1,959,4,8,2,2,6,single-choice,spatial-relational,2|6,7,2/6,240599,2
2,1,24,600,1,815,3,7,2,2,5,single-choice,spatial-relational,2|5,7,2/5,240600,2
3,1,24,1,0,1200,3,9,3,6,6,single-choice,spatial-relational,3|6,7,3/6,240001,3
3,1,24,2,0,40,2,4,1,3,3,single-choice,spatial-relational,1|3,7,1/3,240002,1
3,1,24,3,0,596,4,10,3,7,7,single-choice,spatial-relational,3|7,7,3/7,240003,3
3,1,24,4,0,711,3,5,1,4,4,single-choice,spatial-relational,1|4,7,1/4,240004,1
3,1,24,5,0,605,3,7,2,5,5,single-choice,spatial-relational,2|5,7,2/5,240005,2
3,1,24,6,0,600,2,10,4,6,6,single-choice,spatial-relational,4|6,7,4/6,240006,4
3,1,24,7,0,512,1,5,2,3,3,single-choice,spatial-relational,2|3,7,2/3,240007,2
3,1,24,8,0,682,1,9,4,5,5,single-choice,spatial-relational,4|5,7,4/5,240008,4
3,1,24,9,1,802,1,5,2,2,3,single-choice,spatial-relational,2|3,7,2/3,240009,2
3,1,24,10,0,761,4,8,2,6,6,single-choice,spatial-relational,2|6,7,2/6,240010,2
3,1,24,11,0,495,2,6,2,4,4,single-choice,spatial-relational,2|4,7,2/4,240011,2
3,1,24,12,1,852,2,12,5,5,7,single-choice,spatial-relational,5|7,7,5/7,240012,5
3,1,24,13,1,854,5,9,2,2,7,single-choice,spatial-relational,2|7,7,2/7,240013,2
3,1,24,14,1,710,1,7,3,3,4,single-choice,spatial-relational,3|4,7,3/4,240014,3
3,1,24,15,1,784,4,6,1,1,5,single-choice,spatial-relational,1|5,7,1/5,240015,1
3,1,24,16,0,957,4,6,1,5,5,single-choice,spatial-relational,1|5,7,1/5,240016,1
3,1,24,17,1,741,4,10,3,3,7,single-choice,spatial-relational,3|7,7,3/7,240017,3
3,1,24,18,0,912,2,10,4,6,6,single-choice,spatial-relational,4|6,7,4/6,240018,4
3,1,24,19,1,762,2,8,3,3,5,single-choice,spatial-relational,3|5,7,3/5,240019,3
3,1,24,20,1,806,2,4,1,1,3,single-choice,spatial-relational,1|3,7,1/3,240020,1
3,1,24,21,0,32,1,3,1,2,2,single-choice,spatial-relational,1|2,7,1/2,240021,1
3,1,24,22,1,788,1,3,1,1,2,single-choice,spatial-relational,1|2,7,1/2,240022,1
3,1,24,23,1,795,2,12,5,5,7,single-choice,spatial-relational,5|7,7,5/7,240023,5
3,1,24,24,1,836,4,8,2,2,6,single-choice,spatial-relational,2|6,7,2/6,240024,2
3,1,24,25,0,638,6,8,1,7,7,single-choice,spatial-relational,1|7,7,1/7,240025,1
3,1,24,26,1,838,1,13,6,6,7,single-choice,spatial-relational,6|7,7,6/7,240026,6
3,1,24,27,0,823,1,7,3,4,4,single-choice,spatial-relational,3|4,7,3/4,240027,3
3,1,24,28,1,662,2,6,2,2,4,single-choice,spatial-relational,2|4,7,2/4,240028,2
3,1,24,29,1,925,1,11,5,5,6,single-choice,spatial-relational,5|6,7,5/6,240029,5
3,1,24,30,1,902,3,7,2,2,5,single-choice,spatial-relational,2|5,7,2/5,240030,2
3,1,24,31,1,824,1,11,5,5,6,single-choice,spatial-relational,5|6,7,5/6,240031,5
3,1,24,32,1,978,2,8,3,3,5,single-choice,spatial-relational,3|5,7,3/5,240032,3
3,1,24,33,1,808,1,13,6,6,7,single-choice,spatial-relational,6|7,7,6/7,240033,6
3,1,24,34,0,640,6,8,1,7,7,single-choice,spatial-relational,1|7,7,1/7,240034,1
3,1,24,35,1,750,3,11,4,4,7,single-choice,spatial-relational,4|7,7,4/7,240035,4
3,1,24,36,1,877,5,7,1,1,6,single-choice,spatial-relational,1|6,7,1/6,240036,1
3,1,24,37,1,764,3,9,3,3,6,single-choice,spatial-relational,3|6,7,3/6,240037,3
3,1,24,38,1,1121,1,9,4,4,5,single-choice,spatial-relational,4|5,7,4/5,240038,4
3,1,24,39,1,785,5,7,1,1,6,single-choice,spatial-relational,1|6,7,1/6,240039,1
3,1,24,40,1,923,3,11,4,4,7,single-choice,spatial-relational,4|7,7,4/7,240040,4
3,1,24,41,0,711,3,5,1,4,4,single-choice,spatial-relational,1|4,7,1/4,240041,1
3,1,24,42,1,927,5,9,2,2,7,single-choice,spatial-relational,2|7,7,2/7,240042,2
3,1,24,43,0,48,2,6,2,4,4,single-choice,spatial-relational,2|4,7,2/4,240043,2
3,1,24,44,1,764,2,6,2,2,4,single-choice,spatial-relational,2|4,7,2/4,240044,2
3,1,24,45,0,713,6,8,1,7,7,single-choice,spatial-relational,1|7,7,1/7,240045,1
3,1,24,46,1,946,1,11,5,5,6,single-choice,spatial-relational,5|6,7,5/6,240046,5
3,1,24,47,1,1122,3,7,2,2,5,single-choice,spatial-relational,2|5,7,2/5,240047,2
3,1,24,48,1,725,4,10,3,3,7,single-choice,spatial-relational,3|7,7,3/7,240048,3
3,1,24,49,1,847,1,5,2,2,3,single-choice,spatial-relational,2|3,7,2/3,240049,2
3,1,24,50,0,1069,1,9,4,5,5,single-choice,spatial-relational,4|5,7,4/5,240050,4
3,1,24,51,1,661,4,8,2,2,6,single-choice,spatial-relational,2|6,7,2/6,240051,2
3,1,24,52,1,843,1,9,4,4,5,single-choice,spatial-relational,4|5,7,4/5,240052,4
3,1,24,53,1,1004,2,12,5,5,7,single-choice,spatial-relational,5|7,7,5/7,240053,5
3,1,24,54,1,839,3,7,2,2,5,single-choice,spatial-relational,2|5,7,2/5,240054,2
3,1,24,55,1,861,1,7,3,3,4,single-choice,spatial-relational,3|4,7,3/4,240055,3
3,1,24,56,1,885,5,7,1,1,6,single-choice,spatial-relational,1|6,7,1/6,240056,1
3,1,24,57,1,609,1,3,1,1,2,single-choice,spatial-relational,1|2,7,1/2,240057,1
3,1,24,58,1,703,2,10,4,4,6,single-choice,spatial-relational,4|6,7,4/6,240058,4
3,1,24,59,1,743,2,4,1,1,3,single-choice,spatial-relational,1|3,7,1/3,240059,1
3,1,24,60,1,616,5,9,2,2,7,single-choice,spatial-relational,2|7,7,2/7,240060,2
3,1,24,61,1,800,1,13,6,6,7,single-choice,spatial-relational,6|7,7,6/7,240061,6
3,1,24,62,0,1771,4,8,2,6,6,single-choice,spatial-relational,2|6,7,2/6,240062,2
3,1,24,63,0,825,1,5,2,3,3,single-choice,spatial-relational,2|3,7,2/3,240063,2
3,1,24,64,1,856,2,12,5,5,7,single-choice,spatial-relational,5|7,7,5/7,240064,5
3,1,24,65,1,835,3,9,3,3,6,single-choice,spatial-relational,3|6,7,3/6,240065,3
3,1,24,66,1,897,1,11,5,5,6,single-choice,spatial-relational,5|6,7,5/6,240066,5
3,1,24,67,1,1051,2,4,1,1,3,single-choice,spatial-relational,1|3,7,1/3,240067,1
3,1,24,68,1,627,2,8,3,3,5,single-choice,spatial-relational,3|5,7,3/5,240068,3
3,1,24,69,0,750,2,10,4,6,6,single-choice,spatial-relational,4|6,7,4/6,240069,4
3,1,24,70,1,648,3,5,1,1,4,single-choice,spatial-relational,1|4,7,1/4,240070,1
3,1,24,71,1,725,1,3,1,1,2,single-choice,spatial-relational,1|2,7,1/2,240071,1
3,1,24,72,1,751,2,8,3,3,5,single-choice,spatial-relational,3|5,7,3/5,240072,3
3,1,24,73,1,789,4,6,1,1,5,single-choice,spatial-relational,1|5,7,1/5,240073,1
3,1,24,74,1,644,3,9,3,3,6,single-choice,spatial-relational,3|6,7,3/6,240074,3
3,1,24,75,1,829,4,6,1,1,5,single-choice,spatial-relational,1|5,7,1/5,240075,1
3,1,24,76,1,881,3,5,1,1,4,single-choice,spatial-relational,1|4,7,1/4,240076,1
3,1,24,77,1,784,5,9,2,2,7,single-choice,spatial-relational,2|7,7,2/7,240077,2
3,1,24,78,1,685,3,11,4,4,7,single-choice,spatial-relational,4|7,7,4/7,240078,4
3,1,24,79,1,640,4,10,3,3,7,single-choice,spatial-relational,3|7,7,3/7,240079,3
3,1,24,80,1,994,3,11,4,4,7,single-choice,spatial-relational,4|7,7,4/7,240080,4
3,1,24,81,1,869,1,13,6,6,7,single-choice,spatial-relational,6|7,7,6/7,240081,6
3,1,24,82,1,764,1,7,3,3,4,single-choice,spatial-relational,3|4,7,3/4,240082,3
3,1,24,83,1,642,5,7,1,1,6,single-choice,spatial-relational,1|6,7,1/6,240083,1
3,1,24,84,1,617,6,8,1,1,7,single-choice,spatial-relational,1|7,7,1/7,240084,1
3,1,24,85,1,760,1,5,2,2,3,single-choice,spatial-relational,2|3,7,2/3,240085,2
3,1,24,86,1,866,1,7,3,3,4,single-choice,spatial-relational,3|4,7,3/4,240086,3
3,1,24,87,1,1331,3,9,3,3,6,single-choice,spatial-relational,3|6,7,3/6,240087,3
3,1,24,88,1,805,3,11,4,4,7,single-choice,spatial-relational,4|7,7,4/7,240088,4
3,1,24,89,1,774,3,5,1,1,4,single-choice,spatial-relational,1|4,7,1/4,240089,1
3,1,24,90,1,729,4,8,2,2,6,single-choice,spatial-relational,2|6,7,2/6,240090,2
3,1,24,91,1,774,2,6,2,2,4,single-choice,spatial-relational,2|4,7,2/4,240091,2
3,1,24,92,1,812,2,4,1,1,3,single-choice,spatial-relational,1|3,7,1/3,240092,1
3,1,24,93,1,867,1,11,5,5,6,single-choice,spatial-relational,5|6,7,5/6,240093,5
3,1,24,94,1,1201,2,8,3,3,5,single-choice,spatial-relational,3|5,7,3/5,240094,3
3,1,24,95,1,839,1,3,1,1,2,single-choice,spatial-relational,1|2,7,1/2,240095,1
3,1,24,96,1,896,2,6,2,2,4,single-choice,spatial-relational,2|4,7,2/4,240096,2
3,1,24,97,1,674,4,10,3,3,7,single-choice,spatial-relational,3|7,7,3/7,240097,3
3,1,24,98,1,764,6,8,1,1,7,single-choice,spatial-relational,1|7,7,1/7,240098,1
3,1,24,99,1,865,3,9,3,3,6,single-choice,spatial-relational,3|6,7,3/6,240099,3
3,1,24,100,1,694,1,3,1,1,2,single-choice,spatial-relational,1|2,7,1/2,240100,1
3,1,24,101,1,610,2,4,1,1,3,single-choice,spatial-relational,1|3,7,1/3,240101,1
3,1,24,102,0,882,2,10,4,6,6,single-choice,spatial-relational,4|6,7,4/6,240102,4
3,1,24,103,1,616,5,7,1,1,6,single-choice,spatial-relational,1|6,7,1/6,240103,1
3,1,24,104,1,35,4,8,2,2,6,single-choice,spatial-relational,2|6,7,2/6,240104,2
3,1,24,105,1,802,3,5,1,1,4,single-choice,spatial-relational,1|4,7,1/4,240105,1
3,1,24,106,0,694,3,7,2,5,5,single-choice,spatial-relational,2|5,7,2/5,240106,2
3,1,24,107,1,701,6,8,1,1,7,single-choice,spatial-relational,1|7,7,1/7,240107,1
3,1,24,108,1,685,3,11,4,4,7,single-choice,spatial-relational,4|7,7,4/7,240108,4
3,1,24,109,1,1322,3,7,2,2,5,single-choice,spatial-relational,2|5,7,2/5,240109,2
3,1,24,110,1,1082,1,11,5,5,6,single-choice,spatial-relational,5|6,7,5/6,240110,5
3,1,24,111,1,838,1,9,4,4,5,single-choice,spatial-relational,4|5,7,4/5,240111,4
3,1,24,112,1,883,2,12,5,5,7,single-choice,spatial-relational,5|7,7,5/7,240112,5
3,1,24,113,1,1106,2,10,4,4,6,single-choice,spatial-relational,4|6,7,4/6,240113,4
3,1,24,114,1,874,5,7,1,1,6,single-choice,spatial-relational,1|6,7,1/6,240114,1
3,1,24,115,1,721,1,13,6,6,7,single-choice,spatial-relational,6|7,7,6/7,240115,6
3,1,24,116,1,1874,1,9,4,4,5,single-choice,spatial-relational,4|5,7,4/5,240116,4
3,1,24,117,1,1057,1,7,3,3,4,single-choice,spatial-relational,3|4,7,3/4,240117,3
3,1,24,118,1,725,4,6,1,1,5,single-choice,spatial-relational,1|5,7,1/5,240118,1
3,1,24,119,1,902,4,10,3,3,7,single-choice,spatial-relational,3|7,7,3/7,240119,3
3,1,24,120,1,825,5,9,2,2,7,single-choice,spatial-relational,2|7,7,2/7,240120,2
3,1,24,121,1,815,2,12,5,5,7,single-choice,spatial-relational,5|7,7,5/7,240121,5
3,1,24,122,1,1157,5,9,2,2,7,single-choice,spatial-relational,2|7,7,2/7,240122,2
3,1,24,123,1,1280,1,13,6,6,7,single-choice,spatial-relational,6|7,7,6/7,240123,6
3,1,24,124,1,1499,2,8,3,3,5,single-choice,spatial-relational,3|5,7,3/5,240124,3
3,1,24,125,1,857,1,5,2,2,3,single-choice,spatial-relational,2|3,7,2/3,240125,2
3,1,24,126,1,854,4,6,1,1,5,single-choice,spatial-relational,1|5,7,1/5,240126,1
3,1,24,127,1,698,1,5,2,2,3,single-choice,spatial-relational,2|3,7,2/3,240127,2
3,1,24,128,1,733,2,12,5,5,7,single-choice,spatial-relational,5|7,7,5/7,240128,5
3,1,24,129,1,847,5,9,2,2,7,single-choice,spatial-relational,2|7,7,2/7,240129,2
3,1,24,130,1,880,1,7,3,3,4,single-choice,spatial-relational,3|4,7,3/4,240130,3
3,1,24,131,1,820,1,13,6,6,7,single-choice,spatial-relational,6|7,7,6/7,240131,6
3,1,24,132,1,1845,3,9,3,3,6,single-choice,spatial-relational,3|6,7,3/6,240132,3
3,1,24,133,1,817,4,10,3,3,7,single-choice,spatial-relational,3|7,7,3/7,240133,3
3,1,24,134,1,943,4,8,2,2,6,single-choice,spatial-relational,2|6,7,2/6,240134,2
3,1,24,135,1,860,1,11,5,5,6,single-choice,spatial-relational,5|6,7,5/6,240135,5
3,1,24,136,1,1298,2,6,2,2,4,single-choice,spatial-relational,2|4,7,2/4,240136,2
3,1,24,137,1,675,1,3,1,1,2,single-choice,spatial-relational,1|2,7,1/2,240137,1
3,1,24,138,1,751,1,9,4,4,5,single-choice,spatial-relational,4|5,7,4/5,240138,4
3,1,24,139,1,823,6,8,1,1,7,single-choice,spatial-relational,1|7,7,1/7,240139,1
3,1,24,140,0,1303,2,4,1,3,3,single-choice,spatial-relational,1|3,7,1/3,240140,1
3,1,24,141,1,737,2,6,2,2,4,single-choice,spatial-relational,2|4,7,2/4,240141,2
3,1,24,142,1,631,5,7,1,1,6,single-choice,spatial-relational,1|6,7,1/6,240142,1
3,1,24,143,1,1046,5,9,2,2,7,single-choice,spatial-relational,2|7,7,2/7,240143,2
3,1,24,144,1,803,3,5,1,1,4,single-choice,spatial-relational,1|4,7,1/4,240144,1
3,1,24,145,1,1251,4,10,3,3,7,single-choice,spatial-relational,3|7,7,3/7,240145,3
3,1,24,146,1,812,2,10,4,4,6,single-choice,spatial-relational,4|6,7,4/6,240146,4
3,1,24,147,1,894,1,7,3,3,4,single-choice,spatial-relational,3|4,7,3/4,240147,3
3,1,24,148,1,957,1,11,5,5,6,single-choice,spatial-relational,5|6,7,5/6,240148,5
3,1,24,149,1,890,6,8,1,1,7,single-choice,spatial-relational,1|7,7,1/7,240149,1
3,1,24,150,0,627,1,3,1,2,2,single-choice,spatial-relational,1|2,7,1/2,240150,1
3,1,24,151,1,721,1,5,2,2,3,single-choice,spatial-relational,2|3,7,2/3,240151,2
3,1,24,152,1,689,4,8,2,2,6,single-choice,spatial-relational,2|6,7,2/6,240152,2
3,1,24,153,1,719,4,6,1,1,5,single-choice,spatial-relational,1|5,7,1/5,240153,1
3,1,24,154,1,1011,3,7,2,2,5,single-choice,spatial-relational,2|5,7,2/5,240154,2
3,1,24,155,1,724,1,13,6,6,7,single-choice,spatial-relational,6|7,7,6/7,240155,6
3,1,24,156,1,947,3,11,4,4,7,single-choice,spatial-relational,4|7,7,4/7,240156,4
3,1,24,157,1,1105,1,9,4,4,5,single-choice,spatial-relational,4|5,7,4/5,240157,4
3,1,24,158,1,915,2,8,3,3,5,single-choice,spatial-relational,3|5,7,3/5,240158,3
3,1,24,159,1,689,2,8,3,3,5,single-choice,spatial-relational,3|5,7,3/5,240159,3
3,1,24,160,1,942,2,12,5,5,7,single-choice,spatial-relational,5|7,7,5/7,240160,5
3,1,24,161,1,1119,2,10,4,4,6,single-choice,spatial-relational,4|6,7,4/6,240161,4
3,1,24,162,1,821,3,7,2,2,5,single-choice,spatial-relational,2|5,7,2/5,240162,2
3,1,24,163,1,735,2,4,1,1,3,single-choice,spatial-relational,1|3,7,1/3,240163,1
3,1,24,164,1,120,3,9,3,3,6,single-choice,spatial-relational,3|6,7,3/6,240164,3
3,1,24,165,1,900,3,11,4,4,7,single-choice,spatial-relational,4|7,7,4/7,240165,4
3,1,24,166,1,789,4,6,1,1,5,single-choice,spatial-relational,1|5,7,1/5,240166,1
3,1,24,167,1,820,5,7,1,1,6,single-choice,spatial-relational,1|6,7,1/6,240167,1
3,1,24,168,1,753,3,5,1,1,4,single-choice,spatial-relational,1|4,7,1/4,240168,1
3,1,24,169,1,821,4,6,1,1,5,single-choice,spatial-relational,1|5,7,1/5,240169,1
3,1,24,170,1,585,1,5,2,2,3,single-choice,spatial-relational,2|3,7,2/3,240170,2
3,1,24,171,1,654,4,6,1,1,5,single-choice,spatial-relational,1|5,7,1/5,240171,1
3,1,24,172,1,975,2,10,4,4,6,single-choice,spatial-relational,4|6,7,4/6,240172,4
3,1,24,173,1,1268,6,8,1,1,7,single-choice,spatial-relational,1|7,7,1/7,240173,1
3,1,24,174,1,672,6,8,1,1,7,single-choice,spatial-relational,1|7,7,1/7,240174,1
3,1,24,175,1,715,2,8,3,3,5,single-choice,spatial-relational,3|5,7,3/5,240175,3
3,1,24,176,1,840,1,11,5,5,6,single-choice,spatial-relational,5|6,7,5/6,240176,5
3,1,24,177,1,846,3,7,2,2,5,single-choice,spatial-relational,2|5,7,2/5,240177,2
3,1,24,178,1,698,1,7,3,3,4,single-choice,spatial-relational,3|4,7,3/4,240178,3
3,1,24,179,1,1206,4,8,2,2,6,single-choice,spatial-relational,2|6,7,2/6,240179,2
3,1,24,180,1,815,1,13,6,6,7,single-choice,spatial-relational,6|7,7,6/7,240180,6
3,1,24,181,1,1083,4,10,3,3,7,single-choice,spatial-relational,3|7,7,3/7,240181,3
3,1,24,182,0,731,2,4,1,3,3,single-choice,spatial-relational,1|3,7,1/3,240182,1
3,1,24,183,1,763,2,6,2,2,4,single-choice,spatial-relational,2|4,7,2/4,240183,2
3,1,24,184,1,779,2,6,2,2,4,single-choice,spatial-relational,2|4,7,2/4,240184,2
3,1,24,185,1,696,3,5,1,1,4,single-choice,spatial-relational,1|4,7,1/4,240185,1
3,1,24,186,1,1018,3,9,3,3,6,single-choice,spatial-relational,3|6,7,3/6,240186,3
3,1,24,187,1,719,4,10,3,3,7,single-choice,spatial-relational,3|7,7,3/7,240187,3
3,1,24,188,1,762,4,8,2,2,6,single-choice,spatial-relational,2|6,7,2/6,240188,2
3,1,24,189,1,815,2,4,1,1,3,single-choice,spatial-relational,1|3,7,1/3,240189,1
3,1,24,190,1,903,1,5,2,2,3,single-choice,spatial-relational,2|3,7,2/3,240190,2
3,1,24,191,1,1692,1,9,4,4,5,single-choice,spatial-relational,4|5,7,4/5,240191,4
3,1,24,192,1,814,5,7,1,1,6,single-choice,spatial-relational,1|6,7,1/6,240192,1
3,1,24,193,1,927,3,9,3,3,6,single-choice,spatial-relational,3|6,7,3/6,240193,3
3,1,24,194,1,910,2,12,5,5,7,single-choice,spatial-relational,5|7,7,5/7,240194,5
3,1,24,195,1,906,1,7,3,3,4,single-choice,spatial-relational,3|4,7,3/4,240195,3
3,1,24,196,1,1110,1,9,4,4,5,single-choice,spatial-relational,4|5,7,4/5,240196,4
3,1,24,197,1,710,3,5,1,1,4,single-choice,spatial-relational,1|4,7,1/4,240197,1
3,1,24,198,1,638,3,11,4,4,7,single-choice,spatial-relational,4|7,7,4/7,240198,4
3,1,24,199,1,701,5,9,2,2,7,single-choice,spatial-relational,2|7,7,2/7,240199,2
3,1,24,200,1,711,2,12,5,5,7,single-choice,spatial-relational,5|7,7,5/7,240200,5
3,1,24,201,1,901,5,7,1,1,6,single-choice,spatial-relational,1|6,7,1/6,240201,1
3,1,24,202,1,706,3,11,4,4,7,single-choice,spatial-relational,4|7,7,4/7,240202,4
3,1,24,203,0,1235,1,11,5,6,6,single-choice,spatial-relational,5|6,7,5/6,240203,5
3,1,24,204,1,749,1,3,1,1,2,single-choice,spatial-relational,1|2,7,1/2,240204,1
3,1,24,205,1,590,3,7,2,2,5,single-choice,spatial-relational,2|5,7,2/5,240205,2
3,1,24,206,1,712,1,3,1,1,2,single-choice,spatial-relational,1|2,7,1/2,240206,1
3,1,24,207,1,804,1,13,6,6,7,single-choice,spatial-relational,6|7,7,6/7,240207,6
3,1,24,208,1,937,5,9,2,2,7,single-choice,spatial-relational,2|7,7,2/7,240208,2
3,1,24,209,1,932,2,8,3,3,5,single-choice,spatial-relational,3|5,7,3/5,240209,3
3,1,24,210,1,858,2,10,4,4,6,single-choice,spatial-relational,4|6,7,4/6,240210,4
3,1,24,211,1,965,1,9,4,4,5,single-choice,spatial-relational,4|5,7,4/5,240211,4
3,1,24,212,1,902,4,10,3,3,7,single-choice,spatial-relational,3|7,7,3/7,240212,3
3,1,24,213,1,936,1,7,3,3,4,single-choice,spatial-relational,3|4,7,3/4,240213,3
3,1,24,214,1,705,1,7,3,3,4,single-choice,spatial-relational,3|4,7,3/4,240214,3
3,1,24,215,1,683,3,5,1,1,4,single-choice,spatial-relational,1|4,7,1/4,240215,1
3,1,24,216,1,993,1,11,5,5,6,single-choice,spatial-relational,5|6,7,5/6,240216,5
3,1,24,217,1,688,2,12,5,5,7,single-choice,spatial-relational,5|7,7,5/7,240217,5
3,1,24,218,1,730,4,10,3,3,7,single-choice,spatial-relational,3|7,7,3/7,240218,3
3,1,24,219,1,932,6,8,1,1,7,single-choice,spatial-relational,1|7,7,1/7,240219,1
3,1,24,220,1,892,1,11,5,5,6,single-choice,spatial-relational,5|6,7,5/6,240220,5
3,1,24,221,1,837,1,3,1,1,2,single-choice,spatial-relational,1|2,7,1/2,240221,1
3,1,24,222,1,606,3,7,2,2,5,single-choice,spatial-relational,2|5,7,2/5,240222,2
3,1,24,223,1,763,3,11,4,4,7,single-choice,spatial-relational,4|7,7,4/7,240223,4
3,1,24,224,1,917,5,7,1,1,6,single-choice,spatial-relational,1|6,7,1/6,240224,1
3,1,24,225,1,852,1,5,2,2,3,single-choice,spatial-relational,2|3,7,2/3,240225,2
3,1,24,226,1,863,2,8,3,3,5,single-choice,spatial-relational,3|5,7,3/5,240226,3
3,1,24,227,1,775,4,6,1,1,5,single-choice,spatial-relational,1|5,7,1/5,240227,1
3,1,24,228,1,970,1,9,4,4,5,single-choice,spatial-relational,4|5,7,4/5,240228,4
3,1,24,229,1,728,2,4,1,1,3,single-choice,spatial-relational,1|3,7,1/3,240229,1
3,1,24,230,1,827,2,10,4,4,6,single-choice,spatial-relational,4|6,7,4/6,240230,4
3,1,24,231,1,657,1,3,1,1,2,single-choice,spatial-relational,1|2,7,1/2,240231,1
3,1,24,232,1,783,3,7,2,2,5,single-choice,spatial-relational,2|5,7,2/5,240232,2
3,1,24,233,1,635,2,4,1,1,3,single-choice,spatial-relational,1|3,7,1/3,240233,1
3,1,24,234,1,638,3,11,4,4,7,single-choice,spatial-relational,4|7,7,4/7,240234,4
3,1,24,235,1,659,4,8,2,2,6,single-choice,spatial-relational,2|6,7,2/6,240235,2
3,1,24,236,1,832,1,5,2,2,3,single-choice,spatial-relational,2|3,7,2/3,240236,2
3,1,24,237,1,1006,3,9,3,3,6,single-choice,spatial-relational,3|6,7,3/6,240237,3
3,1,24,238,1,718,6,8,1,1,7,single-choice,spatial-relational,1|7,7,1/7,240238,1
3,1,24,239,1,732,3,5,1,1,4,single-choice,spatial-relational,1|4,7,1/4,240239,1
3,1,24,240,1,631,2,12,5,5,7,single-choice,spatial-relational,5|7,7,5/7,240240,5
3,1,24,241,1,1437,2,10,4,4,6,single-choice,spatial-relational,4|6,7,4/6,240241,4
3,1,24,242,1,1253,4,8,2,2,6,single-choice,spatial-relational,2|6,7,2/6,240242,2
3,1,24,243,1,760,3,9,3,3,6,single-choice,spatial-relational,3|6,7,3/6,240243,3
3,1,24,244,1,908,1,13,6,6,7,single-choice,spatial-relational,6|7,7,6/7,240244,6
3,1,24,245,1,837,5,7,1,1,6,single-choice,spatial-relational,1|6,7,1/6,240245,1
3,1,24,246,1,697,2,6,2,2,4,single-choice,spatial-relational,2|4,7,2/4,240246,2
3,1,24,247,1,730,1,13,6,6,7,single-choice,spatial-relational,6|7,7,6/7,240247,6
3,1,24,248,1,748,5,9,2,2,7,single-choice,spatial-relational,2|7,7,2/7,240248,2
3,1,24,249,1,690,2,6,2,2,4,single-choice,spatial-relational,2|4,7,2/4,240249,2
3,1,24,250,1,825,5,9,2,2,7,single-choice,spatial-relational,2|7,7,2/7,240250,2
3,1,24,251,1,837,2,8,3,3,5,single-choice,spatial-relational,3|5,7,3/5,240251,3
3,1,24,252,1,804,4,6,1,1,5,single-choice,spatial-relational,1|5,7,1/5,240252,1
3,1,24,253,1,708,6,8,1,1,7,single-choice,spatial-relational,1|7,7,1/7,240253,1
3,1,24,254,1,855,2,8,3,3,5,single-choice,spatial-relational,3|5,7,3/5,240254,3
3,1,24,255,1,916,6,8,1,1,7,single-choice,spatial-relational,1|7,7,1/7,240255,1
3,1,24,256,1,40,1,13,6,6,7,single-choice,spatial-relational,6|7,7,6/7,240256,6
3,1,24,257,1,1041,1,11,5,5,6,single-choice,spatial-relational,5|6,7,5/6,240257,5
3,1,24,258,1,1350,2,10,4,4,6,single-choice,spatial-relational,4|6,7,4/6,240258,4
3,1,24,259,1,702,2,10,4,4,6,single-choice,spatial-relational,4|6,7,4/6,240259,4
3,1,24,260,1,632,4,10,3,3,7,single-choice,spatial-relational,3|7,7,3/7,240260,3
3,1,24,261,1,1341,1,9,4,4,5,single-choice,spatial-relational,4|5,7,4/5,240261,4
3,1,24,262,1,1076,1,11,5,5,6,single-choice,spatial-relational,5|6,7,5/6,240262,5
3,1,24,263,1,701,1,3,1,1,2,single-choice,spatial-relational,1|2,7,1/2,240263,1
3,1,24,264,1,772,1,13,6,6,7,single-choice,spatial-relational,6|7,7,6/7,240264,6
3,1,24,265,1,818,4,8,2,2,6,single-choice,spatial-relational,2|6,7,2/6,240265,2
3,1,24,266,1,931,1,7,3,3,4,single-choice,spatial-relational,3|4,7,3/4,240266,3
3,1,24,267,0,918,1,5,2,3,3,single-choice,spatial-relational,2|3,7,2/3,240267,2
3,1,24,268,1,742,3,11,4,4,7,single-choice,spatial-relational,4|7,7,4/7,240268,4
3,1,24,269,1,1092,2,8,3,3,5,single-choice,spatial-relational,3|5,7,3/5,240269,3
3,1,24,270,1,772,3,5,1,1,4,single-choice,spatial-relational,1|4,7,1/4,240270,1
3,1,24,271,1,615,4,6,1,1,5,single-choice,spatial-relational,1|5,7,1/5,240271,1
3,1,24,272,1,749,3,7,2,2,5,single-choice,spatial-relational,2|5,7,2/5,240272,2
3,1,24,273,1,598,2,6,2,2,4,single-choice,spatial-relational,2|4,7,2/4,240273,2
3,1,24,274,1,706,4,6,1,1,5,single-choice,spatial-relational,1|5,7,1/5,240274,1
3,1,24,275,1,644,5,9,2,2,7,single-choice,spatial-relational,2|7,7,2/7,240275,2
3,1,24,276,1,694,2,6,2,2,4,single-choice,spatial-relational,2|4,7,2/4,240276,2
3,1,24,277,1,614,2,4,1,1,3,single-choice,spatial-relational,1|3,7,1/3,240277,1
3,1,24,278,1,810,2,12,5,5,7,single-choice,spatial-relational,5|7,7,5/7,240278,5
3,1,24,279,1,1301,3,9,3,3,6,single-choice,spatial-relational,3|6,7,3/6,240279,3
3,1,24,280,1,1144,4,8,2,2,6,single-choice,spatial-relational,2|6,7,2/6,240280,2
3,1,24,281,1,893,5,9,2,2,7,single-choice,spatial-relational,2|7,7,2/7,240281,2
3,1,24,282,1,690,3,5,1,1,4,single-choice,spatial-relational,1|4,7,1/4,240282,1
3,1,24,283,1,840,2,4,1,1,3,single-choice,spatial-relational,1|3,7,1/3,240283,1
3,1,24,284,1,821,1,9,4,4,5,single-choice,spatial-relational,4|5,7,4/5,240284,4
3,1,24,285,1,980,3,9,3,3,6,single-choice,spatial-relational,3|6,7,3/6,240285,3
3,1,24,286,1,783,3,7,2,2,5,single-choice,spatial-relational,2|5,7,2/5,240286,2
3,1,24,287,1,718,4,10,3,3,7,single-choice,spatial-relational,3|7,7,3/7,240287,3
3,1,24,288,1,702,2,12,5,5,7,single-choice,spatial-relational,5|7,7,5/7,240288,5
3,1,24,289,1,731,3,11,4,4,7,single-choice,spatial-relational,4|7,7,4/7,240289,4
3,1,24,290,1,783,1,5,2,2,3,single-choice,spatial-relational,2|3,7,2/3,240290,2
3,1,24,291,1,663,1,3,1,1,2,single-choice,spatial-relational,1|2,7,1/2,240291,1
3,1,24,292,1,972,5,7,1,1,6,single-choice,spatial-relational,1|6,7,1/6,240292,1
3,1,24,293,1,954,1,7,3,3,4,single-choice,spatial-relational,3|4,7,3/4,240293,3
3,1,24,294,1,615,5,7,1,1,6,single-choice,spatial-relational,1|6,7,1/6,240294,1
3,1,24,295,1,782,2,6,2,2,4,single-choice,spatial-relational,2|4,7,2/4,240295,2
3,1,24,296,1,709,1,9,4,4,5,single-choice,spatial-relational,4|5,7,4/5,240296,4
3,1,24,297,1,762,2,12,5,5,7,single-choice,spatial-relational,5|7,7,5/7,240297,5
3,1,24,298,1,788,3,5,1,1,4,single-choice,spatial-relational,1|4,7,1/4,240298,1
3,1,24,299,1,726,6,8,1,1,7,single-choice,spatial-relational,1|7,7,1/7,240299,1
3,1,24,300,0,605,1,3,1,2,2,single-choice,spatial-relational,1|2,7,1/2,240300,1
3,1,24,301,1,670,2,4,1,1,3,single-choice,spatial-relational,1|3,7,1/3,240301,1
3,1,24,302,1,711,4,6,1,1,5,single-choice,spatial-relational,1|5,7,1/5,240302,1
3,1,24,303,1,692,1,13,6,6,7,single-choice,spatial-relational,6|7,7,6/7,240303,6
3,1,24,304,1,1462,2,8,3,3,5,single-choice,spatial-relational,3|5,7,3/5,240304,3
3,1,24,305,0,990,1,5,2,3,3,single-choice,spatial-relational,2|3,7,2/3,240305,2
3,1,24,306,1,895,1,7,3,3,4,single-choice,spatial-relational,3|4,7,3/4,240306,3
3,1,24,307,0,773,4,8,2,6,6,single-choice,spatial-relational,2|6,7,2/6,240307,2
3,1,24,308,1,88,5,7,1,1,6,single-choice,spatial-relational,1|6,7,1/6,240308,1
3,1,24,309,1,669,4,10,3,3,7,single-choice,spatial-relational,3|7,7,3/7,240309,3
3,1,24,310,1,965,3,11,4,4,7,single-choice,spatial-relational,4|7,7,4/7,240310,4
3,1,24,311,1,807,3,7,2,2,5,single-choice,spatial-relational,2|5,7,2/5,240311,2
3,1,24,312,1,696,3,5,1,1,4,single-choice,spatial-relational,1|4,7,1/4,240312,1
3,1,24,313,1,698,5,7,1,1,6,single-choice,spatial-relational,1|6,7,1/6,240313,1
3,1,24,314,1,939,1,11,5,5,6,single-choice,spatial-relational,5|6,7,5/6,240314,5
3,1,24,315,1,1092,3,7,2,2,5,single-choice,spatial-relational,2|5,7,2/5,240315,2
3,1,24,316,1,599,3,11,4,4,7,single-choice,spatial-relational,4|7,7,4/7,240316,4
3,1,24,317,1,707,3,9,3,3,6,single-choice,spatial-relational,3|6,7,3/6,240317,3
3,1,24,318,1,833,1,7,3,3,4,single-choice,spatial-relational,3|4,7,3/4,240318,3
3,1,24,319,1,1209,1,9,4,4,5,single-choice,spatial-relational,4|5,7,4/5,240319,4
3,1,24,320,1,956,4,10,3,3,7,single-choice,spatial-relational,3|7,7,3/7,240320,3
3,1,24,321,1,746,1,3,1,1,2,single-choice,spatial-relational,1|2,7,1/2,240321,1
3,1,24,322,1,715,2,10,4,4,6,single-choice,spatial-relational,4|6,7,4/6,240322,4
3,1,24,323,1,881,1,13,6,6,7,single-choice,spatial-relational,6|7,7,6/7,240323,6
3,1,24,324,1,808,4,6,1,1,5,single-choice,spatial-relational,1|5,7,1/5,240324,1
3,1,24,325,0,104,6,8,1,7,7,single-choice,spatial-relational,1|7,7,1/7,240325,1
3,1,24,326,1,694,4,8,2,2,6,single-choice,spatial-relational,2|6,7,2/6,240326,2
3,1,24,327,1,733,2,6,2,2,4,single-choice,spatial-relational,2|4,7,2/4,240327,2
3,1,24,328,1,712,5,9,2,2,7,single-choice,spatial-relational,2|7,7,2/7,240328,2
3,1,24,329,1,813,2,4,1,1,3,single-choice,spatial-relational,1|3,7,1/3,240329,1
3,1,24,330,1,850,3,9,3,3,6,single-choice,spatial-relational,3|6,7,3/6,240330,3
3,1,24,331,1,704,5,9,2,2,7,single-choice,spatial-relational,2|7,7,2/7,240331,2
3,1,24,332,0,671,2,10,4,6,6,single-choice,spatial-relational,4|6,7,4/6,240332,4
3,1,24,333,1,995,1,11,5,5,6,single-choice,spatial-relational,5|6,7,5/6,240333,5
3,1,24,334,1,875,1,5,2,2,3,single-choice,spatial-relational,2|3,7,2/3,240334,2
3,1,24,335,1,870,2,12,5,5,7,single-choice,spatial-relational,5|7,7,5/7,240335,5
3,1,24,336,1,977,2,8,3,3,5,single-choice,spatial-relational,3|5,7,3/5,240336,3
3,1,24,337,1,1015,2,10,4,4,6,single-choice,spatial-relational,4|6,7,4/6,240337,4
3,1,24,338,1,884,1,7,3,3,4,single-choice,spatial-relational,3|4,7,3/4,240338,3
3,1,24,339,1,844,5,9,2,2,7,single-choice,spatial-relational,2|7,7,2/7,240339,2
3,1,24,340,1,681,2,6,2,2,4,single-choice,spatial-relational,2|4,7,2/4,240340,2
3,1,24,341,1,788,4,8,2,2,6,single-choice,spatial-relational,2|6,7,2/6,240341,2
3,1,24,342,1,863,5,7,1,1,6,single-choice,spatial-relational,1|6,7,1/6,240342,1
3,1,24,343,0,126,3,7,2,5,5,single-choice,spatial-relational,2|5,7,2/5,240343,2
3,1,24,344,1,691,1,3,1,1,2,single-choice,spatial-relational,1|2,7,1/2,240344,1
3,1,24,345,1,746,2,6,2,2,4,single-choice,spatial-relational,2|4,7,2/4,240345,2
3,1,24,346,0,834,1,7,3,4,4,single-choice,spatial-relational,3|4,7,3/4,240346,3
3,1,24,347,1,612,4,10,3,3,7,single-choice,spatial-relational,3|7,7,3/7,240347,3
3,1,24,348,1,916,1,13,6,6,7,single-choice,spatial-relational,6|7,7,6/7,240348,6
3,1,24,349,1,840,5,7,1,1,6,single-choice,spatial-relational,1|6,7,1/6,240349,1
3,1,24,350,1,683,4,6,1,1,5,single-choice,spatial-relational,1|5,7,1/5,240350,1
3,1,24,351,1,761,3,9,3,3,6,single-choice,spatial-relational,3|6,7,3/6,240351,3
3,1,24,352,1,791,5,9,2,2,7,single-choice,spatial-relational,2|7,7,2/7,240352,2
3,1,24,353,1,788,6,8,1,1,7,single-choice,spatial-relational,1|7,7,1/7,240353,1
3,1,24,354,1,792,1,9,4,4,5,single-choice,spatial-relational,4|5,7,4/5,240354,4
3,1,24,355,1,797,4,8,2,2,6,single-choice,spatial-relational,2|6,7,2/6,240355,2
3,1,24,356,1,698,3,11,4,4,7,single-choice,spatial-relational,4|7,7,4/7,240356,4
3,1,24,357,1,921,2,10,4,4,6,single-choice,spatial-relational,4|6,7,4/6,240357,4
3,1,24,358,1,661,2,4,1,1,3,single-choice,spatial-relational,1|3,7,1/3,240358,1
3,1,24,359,1,971,4,6,1,1,5,single-choice,spatial-relational,1|5,7,1/5,240359,1
3,1,24,360,0,1190,1,9,4,5,5,single-choice,spatial-relational,4|5,7,4/5,240360,4
3,1,24,361,1,721,3,7,2,2,5,single-choice,spatial-relational,2|5,7,2/5,240361,2
3,1,24,362,1,1322,1,11,5,5,6,single-choice,spatial-relational,5|6,7,5/6,240362,5
3,1,24,363,1,739,3,5,1,1,4,single-choice,spatial-relational,1|4,7,1/4,240363,1
3,1,24,364,1,733,3,5,1,1,4,single-choice,spatial-relational,1|4,7,1/4,240364,1
3,1,24,365,0,791,2,4,1,3,3,single-choice,spatial-relational,1|3,7,1/3,240365,1
3,1,24,366,1,704,6,8,1,1,7,single-choice,spatial-relational,1|7,7,1/7,240366,1
3,1,24,367,1,734,2,8,3,3,5,single-choice,spatial-relational,3|5,7,3/5,240367,3
3,1,24,368,1,829,2,8,3,3,5,single-choice,spatial-relational,3|5,7,3/5,240368,3
3,1,24,369,1,898,2,12,5,5,7,single-choice,spatial-relational,5|7,7,5/7,240369,5
3,1,24,370,1,729,4,10,3,3,7,single-choice,spatial-relational,3|7,7,3/7,240370,3
3,1,24,371,1,637,1,3,1,1,2,single-choice,spatial-relational,1|2,7,1/2,240371,1
3,1,24,372,1,672,3,11,4,4,7,single-choice,spatial-relational,4|7,7,4/7,240372,4
3,1,24,373,1,906,3,9,3,3,6,single-choice,spatial-relational,3|6,7,3/6,240373,3
3,1,24,374,1,685,1,13,6,6,7,single-choice,spatial-relational,6|7,7,6/7,240374,6
3,1,24,375,1,752,2,12,5,5,7,single-choice,spatial-relational,5|7,7,5/7,240375,5
3,1,24,376,1,769,1,5,2,2,3,single-choice,spatial-relational,2|3,7,2/3,240376,2
3,1,24,377,1,632,1,5,2,2,3,single-choice,spatial-relational,2|3,7,2/3,240377,2
3,1,24,378,1,862,1,11,5,5,6,single-choice,spatial-relational,5|6,7,5/6,240378,5
3,1,24,379,1,804,4,6,1,1,5,single-choice,spatial-relational,1|5,7,1/5,240379,1
3,1,24,380,1,984,1,7,3,3,4,single-choice,spatial-relational,3|4,7,3/4,240380,3
3,1,24,381,1,967,2,8,3,3,5,single-choice,spatial-relational,3|5,7,3/5,240381,3
3,1,24,382,1,721,1,3,1,1,2,single-choice,spatial-relational,1|2,7,1/2,240382,1
3,1,24,383,1,674,3,5,1,1,4,single-choice,spatial-relational,1|4,7,1/4,240383,1
3,1,24,384,1,811,1,5,2,2,3,single-choice,spatial-relational,2|3,7,2/3,240384,2
3,1,24,385,1,742,1,13,6,6,7,single-choice,spatial-relational,6|7,7,6/7,240385,6
3,1,24,386,1,663,2,6,2,2,4,single-choice,spatial-relational,2|4,7,2/4,240386,2
3,1,24,387,1,860,5,7,1,1,6,single-choice,spatial-relational,1|6,7,1/6,240387,1
3,1,24,388,1,1323,5,9,2,2,7,single-choice,spatial-relational,2|7,7,2/7,240388,2
3,1,24,389,1,920,3,11,4,4,7,single-choice,spatial-relational,4|7,7,4/7,240389,4
3,1,24,390,1,792,2,4,1,1,3,single-choice,spatial-relational,1|3,7,1/3,240390,1
3,1,24,391,1,802,3,7,2,2,5,single-choice,spatial-relational,2|5,7,2/5,240391,2
3,1,24,392,1,631,5,9,2,2,7,single-choice,spatial-relational,2|7,7,2/7,240392,2
3,1,24,393,1,981,1,7,3,3,4,single-choice,spatial-relational,3|4,7,3/4,240393,3
3,1,24,394,1,862,2,10,4,4,6,single-choice,spatial-relational,4|6,7,4/6,240394,4
3,1,24,395,1,847,1,9,4,4,5,single-choice,spatial-relational,4|5,7,4/5,240395,4
3,1,24,396,1,958,1,13,6,6,7,single-choice,spatial-relational,6|7,7,6/7,240396,6
3,1,24,397,1,929,4,10,3,3,7,single-choice,spatial-relational,3|7,7,3/7,240397,3
3,1,24,398,1,735,1,9,4,4,5,single-choice,spatial-relational,4|5,7,4/5,240398,4
3,1,24,399,1,880,6,8,1,1,7,single-choice,spatial-relational,1|7,7,1/7,240399,1
3,1,24,400,1,855,6,8,1,1,7,single-choice,spatial-relational,1|7,7,1/7,240400,1
3,1,24,401,1,687,2,4,1,1,3,single-choice,spatial-relational,1|3,7,1/3,240401,1
3,1,24,402,1,564,1,5,2,2,3,single-choice,spatial-relational,2|3,7,2/3,240402,2
3,1,24,403,0,1035,1,11,5,6,6,single-choice,spatial-relational,5|6,7,5/6,240403,5
3,1,24,404,1,795,2,12,5,5,7,single-choice,spatial-relational,5|7,7,5/7,240404,5
3,1,24,405,1,944,2,8,3,3,5,single-choice,spatial-relational,3|5,7,3/5,240405,3
3,1,24,406,1,866,1,3,1,1,2,single-choice,spatial-relational,1|2,7,1/2,240406,1
3,1,24,407,1,703,2,12,5,5,7,single-choice,spatial-relational,5|7,7,5/7,240407,5
3,1,24,408,1,977,3,9,3,3,6,single-choice,spatial-relational,3|6,7,3/6,240408,3
3,1,24,409,1,682,4,10,3,3,7,single-choice,spatial-relational,3|7,7,3/7,240409,3
3,1,24,410,1,1231,3,9,3,3,6,single-choice,spatial-relational,3|6,7,3/6,240410,3
3,1,24,411,1,839,1,11,5,5,6,single-choice,spatial-relational,5|6,7,5/6,240411,5
3,1,24,412,1,1031,4,6,1,1,5,single-choice,spatial-relational,1|5,7,1/5,240412,1
3,1,24,413,1,941,2,10,4,4,6,single-choice,spatial-relational,4|6,7,4/6,240413,4
3,1,24,414,1,843,5,7,1,1,6,single-choice,spatial-relational,1|6,7,1/6,240414,1
3,1,24,415,1,742,2,6,2,2,4,single-choice,spatial-relational,2|4,7,2/4,240415,2
3,1,24,416,1,673,3,11,4,4,7,single-choice,spatial-relational,4|7,7,4/7,240416,4
3,1,24,417,1,994,3,5,1,1,4,single-choice,spatial-relational,1|4,7,1/4,240417,1
3,1,24,418,1,620,3,7,2,2,5,single-choice,spatial-relational,2|5,7,2/5,240418,2
3,1,24,419,1,799,4,8,2,2,6,single-choice,spatial-relational,2|6,7,2/6,240419,2
3,1,24,420,1,637,4,8,2,2,6,single-choice,spatial-relational,2|6,7,2/6,240420,2
3,1,24,421,1,674,1,13,6,6,7,single-choice,spatial-relational,6|7,7,6/7,240421,6
3,1,24,422,1,1007,3,11,4,4,7,single-choice,spatial-relational,4|7,7,4/7,240422,4
3,1,24,423,1,714,1,3,1,1,2,single-choice,spatial-relational,1|2,7,1/2,240423,1
3,1,24,424,1,610,1,13,6,6,7,single-choice,spatial-relational,6|7,7,6/7,240424,6
3,1,24,425,1,1180,2,8,3,3,5,single-choice,spatial-relational,3|5,7,3/5,240425,3
3,1,24,426,1,814,1,5,2,2,3,single-choice,spatial-relational,2|3,7,2/3,240426,2
3,1,24,427,1,783,4,8,2,2,6,single-choice,spatial-relational,2|6,7,2/6,240427,2
3,1,24,428,0,663,6,8,1,7,7,single-choice,spatial-relational,1|7,7,1/7,240428,1
3,1,24,429,1,773,4,10,3,3,7,single-choice,spatial-relational,3|7,7,3/7,240429,3
3,1,24,430,1,664,2,12,5,5,7,single-choice,spatial-relational,5|7,7,5/7,240430,5
3,1,24,431,1,872,3,9,3,3,6,single-choice,spatial-relational,3|6,7,3/6,240431,3
3,1,24,432,1,633,5,7,1,1,6,single-choice,spatial-relational,1|6,7,1/6,240432,1
3,1,24,433,1,1068,1,7,3,3,4,single-choice,spatial-relational,3|4,7,3/4,240433,3
3,1,24,434,1,871,5,9,2,2,7,single-choice,spatial-relational,2|7,7,2/7,240434,2
3,1,24,435,1,802,3,9,3,3,6,single-choice,spatial-relational,3|6,7,3/6,240435,3
3,1,24,436,1,910,1,11,5,5,6,single-choice,spatial-relational,5|6,7,5/6,240436,5
3,1,24,437,1,871,3,5,1,1,4,single-choice,spatial-relational,1|4,7,1/4,240437,1
3,1,24,438,1,943,4,6,1,1,5,single-choice,spatial-relational,1|5,7,1/5,240438,1
3,1,24,439,1,746,2,12,5,5,7,single-choice,spatial-relational,5|7,7,5/7,240439,5
3,1,24,440,0,844,5,7,1,6,6,single-choice,spatial-relational,1|6,7,1/6,240440,1
3,1,24,441,1,836,4,8,2,2,6,single-choice,spatial-relational,2|6,7,2/6,240441,2
3,1,24,442,1,886,1,9,4,4,5,single-choice,spatial-relational,4|5,7,4/5,240442,4
3,1,24,443,1,1536,2,6,2,2,4,single-choice,spatial-relational,2|4,7,2/4,240443,2
3,1,24,444,1,760,2,4,1,1,3,single-choice,spatial-relational,1|3,7,1/3,240444,1
3,1,24,445,1,756,2,6,2,2,4,single-choice,spatial-relational,2|4,7,2/4,240445,2
3,1,24,446,1,728,2,4,1,1,3,single-choice,spatial-relational,1|3,7,1/3,240446,1
3,1,24,447,1,921,6,8,1,1,7,single-choice,spatial-relational,1|7,7,1/7,240447,1
3,1,24,448,0,77,1,3,1,2,2,single-choice,spatial-relational,1|2,7,1/2,240448,1
3,1,24,449,1,761,4,10,3,3,7,single-choice,spatial-relational,3|7,7,3/7,240449,3
3,1,24,450,1,862,1,11,5,5,6,single-choice,spatial-relational,5|6,7,5/6,240450,5
3,1,24,451,1,841,2,8,3,3,5,single-choice,spatial-relational,3|5,7,3/5,240451,3
3,1,24,452,1,741,3,5,1,1,4,single-choice,spatial-relational,1|4,7,1/4,240452,1
3,1,24,453,1,1147,1,7,3,3,4,single-choice,spatial-relational,3|4,7,3/4,240453,3
3,1,24,454,1,785,2,10,4,4,6,single-choice,spatial-relational,4|6,7,4/6,240454,4
3,1,24,455,1,641,4,6,1,1,5,single-choice,spatial-relational,1|5,7,1/5,240455,1
3,1,24,456,1,644,5,9,2,2,7,single-choice,spatial-relational,2|7,7,2/7,240456,2
3,1,24,457,1,666,1,5,2,2,3,single-choice,spatial-relational,2|3,7,2/3,240457,2
3,1,24,458,1,913,2,10,4,4,6,single-choice,spatial-relational,4|6,7,4/6,240458,4
3,1,24,459,1,968,3,7,2,2,5,single-choice,spatial-relational,2|5,7,2/5,240459,2
3,1,24,460,1,807,1,9,4,4,5,single-choice,spatial-relational,4|5,7,4/5,240460,4
3,1,24,461,1,823,3,11,4,4,7,single-choice,spatial-relational,4|7,7,4/7,240461,4
3,1,24,462,0,895,3,7,2,5,5,single-choice,spatial-relational,2|5,7,2/5,240462,2
3,1,24,463,1,1096,2,12,5,5,7,single-choice,spatial-relational,5|7,7,5/7,240463,5
3,1,24,464,1,1029,4,8,2,2,6,single-choice,spatial-relational,2|6,7,2/6,240464,2
3,1,24,465,1,1236,2,8,3,3,5,single-choice,spatial-relational,3|5,7,3/5,240465,3
3,1,24,466,1,862,3,9,3,3,6,single-choice,spatial-relational,3|6,7,3/6,240466,3
3,1,24,467,0,1010,6,8,1,7,7,single-choice,spatial-relational,1|7,7,1/7,240467,1
3,1,24,468,1,831,5,7,1,1,6,single-choice,spatial-relational,1|6,7,1/6,240468,1
3,1,24,469,1,930,2,10,4,4,6,single-choice,spatial-relational,4|6,7,4/6,240469,4
3,1,24,470,1,865,2,6,2,2,4,single-choice,spatial-relational,2|4,7,2/4,240470,2
3,1,24,471,1,814,2,6,2,2,4,single-choice,spatial-relational,2|4,7,2/4,240471,2
3,1,24,472,1,604,1,13,6,6,7,single-choice,spatial-relational,6|7,7,6/7,240472,6
3,1,24,473,1,796,1,5,2,2,3,single-choice,spatial-relational,2|3,7,2/3,240473,2
3,1,24,474,1,720,1,9,4,4,5,single-choice,spatial-relational,4|5,7,4/5,240474,4
3,1,24,475,1,966,6,8,1,1,7,single-choice,spatial-relational,1|7,7,1/7,240475,1
3,1,24,476,1,849,3,5,1,1,4,single-choice,spatial-relational,1|4,7,1/4,240476,1
3,1,24,477,0,36,1,3,1,2,2,single-choice,spatial-relational,1|2,7,1/2,240477,1
3,1,24,478,1,1207,4,10,3,3,7,single-choice,spatial-relational,3|7,7,3/7,240478,3
3,1,24,479,1,816,2,4,1,1,3,single-choice,spatial-relational,1|3,7,1/3,240479,1
3,1,24,480,1,911,4,6,1,1,5,single-choice,spatial-relational,1|5,7,1/5,240480,1
3,1,24,481,1,1293,2,8,3,3,5,single-choice,spatial-relational,3|5,7,3/5,240481,3
3,1,24,482,1,987,1,7,3,3,4,single-choice,spatial-relational,3|4,7,3/4,240482,3
3,1,24,483,1,808,4,8,2,2,6,single-choice,spatial-relational,2|6,7,2/6,240483,2
3,1,24,484,1,723,4,10,3,3,7,single-choice,spatial-relational,3|7,7,3/7,240484,3
3,1,24,485,1,755,4,6,1,1,5,single-choice,spatial-relational,1|5,7,1/5,240485,1
3,1,24,486,1,884,5,9,2,2,7,single-choice,spatial-relational,2|7,7,2/7,240486,2
3,1,24,487,1,683,1,13,6,6,7,single-choice,spatial-relational,6|7,7,6/7,240487,6
3,1,24,488,1,766,1,3,1,1,2,single-choice,spatial-relational,1|2,7,1/2,240488,1
3,1,24,489,1,623,2,4,1,1,3,single-choice,spatial-relational,1|3,7,1/3,240489,1
3,1,24,490,1,848,5,7,1,1,6,single-choice,spatial-relational,1|6,7,1/6,240490,1
3,1,24,491,1,1270,3,11,4,4,7,single-choice,spatial-relational,4|7,7,4/7,240491,4
3,1,24,492,0,792,1,5,2,3,3,single-choice,spatial-relational,2|3,7,2/3,240492,2
3,1,24,493,1,1482,1,11,5,5,6,single-choice,spatial-relational,5|6,7,5/6,240493,5
3,1,24,494,1,910,1,9,4,4,5,single-choice,spatial-relational,4|5,7,4/5,240494,4
3,1,24,495,1,857,2,12,5,5,7,single-choice,spatial-relational,5|7,7,5/7,240495,5
3,1,24,496,1,830,3,7,2,2,5,single-choice,spatial-relational,2|5,7,2/5,240496,2
3,1,24,497,1,702,3,11,4,4,7,single-choice,spatial-relational,4|7,7,4/7,240497,4
3,1,24,498,1,1352,1,11,5,5,6,single-choice,spatial-relational,5|6,7,5/6,240498,5
3,1,24,499,1,987,1,7,3,3,4,single-choice,spatial-relational,3|4,7,3/4,240499,3
3,1,24,500,1,1576,2,10,4,4,6,single-choice,spatial-relational,4|6,7,4/6,240500,4
3,1,24,501,1,741,3,7,2,2,5,single-choice,spatial-relational,2|5,7,2/5,240501,2
3,1,24,502,1,957,5,9,2,2,7,single-choice,spatial-relational,2|7,7,2/7,240502,2
3,1,24,503,1,893,3,5,1,1,4,single-choice,spatial-relational,1|4,7,1/4,240503,1
3,1,24,504,1,666,3,9,3,3,6,single-choice,spatial-relational,3|6,7,3/6,240504,3
3,1,24,505,1,990,4,8,2,2,6,single-choice,spatial-relational,2|6,7,2/6,240505,2
3,1,24,506,0,80,2,4,1,3,3,single-choice,spatial-relational,1|3,7,1/3,240506,1
3,1,24,507,1,849,4,6,1,1,5,single-choice,spatial-relational,1|5,7,1/5,240507,1
3,1,24,508,1,1105,3,11,4,4,7,single-choice,spatial-relational,4|7,7,4/7,240508,4
3,1,24,509,1,834,3,5,1,1,4,single-choice,spatial-relational,1|4,7,1/4,240509,1
3,1,24,510,1,77,1,7,3,3,4,single-choice,spatial-relational,3|4,7,3/4,240510,3
3,1,24,511,1,709,2,8,3,3,5,single-choice,spatial-relational,3|5,7,3/5,240511,3
3,1,24,512,1,831,2,8,3,3,5,single-choice,spatial-relational,3|5,7,3/5,240512,3
3,1,24,513,1,865,2,6,2,2,4,single-choice,spatial-relational,2|4,7,2/4,240513,2
3,1,24,514,1,1113,1,7,3,3,4,single-choice,spatial-relational,3|4,7,3/4,240514,3
3,1,24,515,1,652,4,6,1,1,5,single-choice,spatial-relational,1|5,7,1/5,240515,1
3,1,24,516,1,866,4,8,2,2,6,single-choice,spatial-relational,2|6,7,2/6,240516,2
3,1,24,517,1,1025,5,7,1,1,6,single-choice,spatial-relational,1|6,7,1/6,240517,1
3,1,24,518,1,54,6,8,1,1,7,single-choice,spatial-relational,1|7,7,1/7,240518,1
3,1,24,519,1,658,1,3,1,1,2,single-choice,spatial-relational,1|2,7,1/2,240519,1
3,1,24,520,1,793,3,5,1,1,4,single-choice,spatial-relational,1|4,7,1/4,240520,1
3,1,24,521,1,804,1,13,6,6,7,single-choice,spatial-relational,6|7,7,6/7,240521,6
3,1,24,522,1,994,4,10,3,3,7,single-choice,spatial-relational,3|7,7,3/7,240522,3
3,1,24,523,1,746,5,9,2,2,7,single-choice,spatial-relational,2|7,7,2/7,240523,2
3,1,24,524,0,955,1,9,4,5,5,single-choice,spatial-relational,4|5,7,4/5,240524,4
3,1,24,525,0,1558,3,9,3,6,6,single-choice,spatial-relational,3|6,7,3/6,240525,3
3,1,24,526,1,880,2,4,1,1,3,single-choice,spatial-relational,1|3,7,1/3,240526,1
3,1,24,527,1,1061,1,13,6,6,7,single-choice,spatial-relational,6|7,7,6/7,240527,6
3,1,24,528,1,731,5,7,1,1,6,single-choice,spatial-relational,1|6,7,1/6,240528,1
3,1,24,529,1,790,1,3,1,1,2,single-choice,spatial-relational,1|2,7,1/2,240529,1
3,1,24,530,1,691,5,9,2,2,7,single-choice,spatial-relational,2|7,7,2/7,240530,2
3,1,24,531,1,44,2,12,5,5,7,single-choice,spatial-relational,5|7,7,5/7,240531,5
3,1,24,532,1,916,2,10,4,4,6,single-choice,spatial-relational,4|6,7,4/6,240532,4
3,1,24,533,1,904,3,9,3,3,6,single-choice,spatial-relational,3|6,7,3/6,240533,3
3,1,24,534,1,755,1,5,2,2,3,single-choice,spatial-relational,2|3,7,2/3,240534,2
3,1,24,535,1,767,3,11,4,4,7,single-choice,spatial-relational,4|7,7,4/7,240535,4
3,1,24,536,1,752,4,10,3,3,7,single-choice,spatial-relational,3|7,7,3/7,240536,3
3,1,24,537,1,1241,1,11,5,5,6,single-choice,spatial-relational,5|6,7,5/6,240537,5
3,1,24,538,0,758,6,8,1,7,7,single-choice,spatial-relational,1|7,7,1/7,240538,1
3,1,24,539,1,802,3,7,2,2,5,single-choice,spatial-relational,2|5,7,2/5,240539,2
3,1,24,540,1,1143,2,12,5,5,7,single-choice,spatial-relational,5|7,7,5/7,240540,5
3,1,24,541,1,793,1,11,5,5,6,single-choice,spatial-relational,5|6,7,5/6,240541,5
3,1,24,542,1,719,3,7,2,2,5,single-choice,spatial-relational,2|5,7,2/5,240542,2
3,1,24,543,1,917,1,5,2,2,3,single-choice,spatial-relational,2|3,7,2/3,240543,2
3,1,24,544,1,870,2,6,2,2,4,single-choice,spatial-relational,2|4,7,2/4,240544,2
3,1,24,545,1,855,1,9,4,4,5,single-choice,spatial-relational,4|5,7,4/5,240545,4
3,1,24,546,0,930,2,10,4,6,6,single-choice,spatial-relational,4|6,7,4/6,240546,4
3,1,24,547,1,1142,3,11,4,4,7,single-choice,spatial-relational,4|7,7,4/7,240547,4
3,1,24,548,1,890,4,8,2,2,6,single-choice,spatial-relational,2|6,7,2/6,240548,2
3,1,24,549,1,954,5,9,2,2,7,single-choice,spatial-relational,2|7,7,2/7,240549,2
3,1,24,550,1,636,3,5,1,1,4,single-choice,spatial-relational,1|4,7,1/4,240550,1
3,1,24,551,0,638,2,4,1,3,3,single-choice,spatial-relational,1|3,7,1/3,240551,1
3,1,24,552,1,598,5,7,1,1,6,single-choice,spatial-relational,1|6,7,1/6,240552,1
3,1,24,553,1,990,1,7,3,3,4,single-choice,spatial-relational,3|4,7,3/4,240553,3
3,1,24,554,1,707,2,8,3,3,5,single-choice,spatial-relational,3|5,7,3/5,240554,3
3,1,24,555,1,714,3,7,2,2,5,single-choice,spatial-relational,2|5,7,2/5,240555,2
3,1,24,556,1,697,4,8,2,2,6,single-choice,spatial-relational,2|6,7,2/6,240556,2
3,1,24,557,1,1002,2,10,4,4,6,single-choice,spatial-relational,4|6,7,4/6,240557,4
3,1,24,558,1,700,1,3,1,1,2,single-choice,spatial-relational,1|2,7,1/2,240558,1
3,1,24,559,1,119,2,12,5,5,7,single-choice,spatial-relational,5|7,7,5/7,240559,5
3,1,24,560,1,817,4,6,1,1,5,single-choice,spatial-relational,1|5,7,1/5,240560,1
3,1,24,561,0,662,1,3,1,2,2,single-choice,spatial-relational,1|2,7,1/2,240561,1
3,1,24,562,0,740,5,9,2,7,7,single-choice,spatial-relational,2|7,7,2/7,240562,2
3,1,24,563,1,1230,1,13,6,6,7,single-choice,spatial-relational,6|7,7,6/7,240563,6
3,1,24,564,0,1301,1,11,5,6,6,single-choice,spatial-relational,5|6,7,5/6,240564,5
3,1,24,565,1,815,6,8,1,1,7,single-choice,spatial-relational,1|7,7,1/7,240565,1
3,1,24,566,0,44,2,4,1,3,3,single-choice,spatial-relational,1|3,7,1/3,240566,1
3,1,24,567,1,826,5,7,1,1,6,single-choice,spatial-relational,1|6,7,1/6,240567,1
3,1,24,568,1,683,3,9,3,3,6,single-choice,spatial-relational,3|6,7,3/6,240568,3
3,1,24,569,1,709,1,5,2,2,3,single-choice,spatial-relational,2|3,7,2/3,240569,2
3,1,24,570,0,826,6,8,1,7,7,single-choice,spatial-relational,1|7,7,1/7,240570,1
3,1,24,571,1,992,4,10,3,3,7,single-choice,spatial-relational,3|7,7,3/7,240571,3
3,1,24,572,1,1904,1,11,5,5,6,single-choice,spatial-relational,5|6,7,5/6,240572,5
3,1,24,573,1,2013,4,10,3,3,7,single-choice,spatial-relational,3|7,7,3/7,240573,3
3,1,24,574,1,754,1,7,3,3,4,single-choice,spatial-relational,3|4,7,3/4,240574,3
3,1,24,575,1,1050,3,9,3,3,6,single-choice,spatial-relational,3|6,7,3/6,240575,3
3,1,24,576,1,981,2,10,4,4,6,single-choice,spatial-relational,4|6,7,4/6,240576,4
3,1,24,577,1,909,2,8,3,3,5,single-choice,spatial-relational,3|5,7,3/5,240577,3
3,1,24,578,1,792,2,12,5,5,7,single-choice,spatial-relational,5|7,7,5/7,240578,5
3,1,24,579,0,540,4,6,1,5,5,single-choice,spatial-relational,1|5,7,1/5,240579,1
3,1,24,580,1,833,3,5,1,1,4,single-choice,spatial-relational,1|4,7,1/4,240580,1
3,1,24,581,1,882,1,13,6,6,7,single-choice,spatial-relational,6|7,7,6/7,240581,6
3,1,24,582,1,1102,1,9,4,4,5,single-choice,spatial-relational,4|5,7,4/5,240582,4
3,1,24,583,1,685,1,5,2,2,3,single-choice,spatial-relational,2|3,7,2/3,240583,2
3,1,24,584,1,840,3,7,2,2,5,single-choice,spatial-relational,2|5,7,2/5,240584,2
3,1,24,585,1,654,2,6,2,2,4,single-choice,spatial-relational,2|4,7,2/4,240585,2
3,1,24,586,1,784,2,6,2,2,4,single-choice,spatial-relational,2|4,7,2/4,240586,2
3,1,24,587,1,770,1,9,4,4,5,single-choice,spatial-relational,4|5,7,4/5,240587,4
3,1,24,588,1,704,3,11,4,4,7,single-choice,spatial-relational,4|7,7,4/7,240588,4
3,1,24,589,1,804,2,4,1,1,3,single-choice,spatial-relational,1|3,7,1/3,240589,1
3,1,24,590,1,711,5,7,1,1,6,single-choice,spatial-relational,1|6,7,1/6,240590,1
3,1,24,591,1,630,4,6,1,1,5,single-choice,spatial-relational,1|5,7,1/5,240591,1
3,1,24,592,0,621,1,3,1,2,2,single-choice,spatial-relational,1|2,7,1/2,240592,1
3,1,24,593,0,859,2,4,1,3,3,single-choice,spatial-relational,1|3,7,1/3,240593,1
3,1,24,594,0,1301,2,12,5,7,7,single-choice,spatial-relational,5|7,7,5/7,240594,5
3,1,24,595,1,732,5,7,1,1,6,single-choice,spatial-relational,1|6,7,1/6,240595,1
3,1,24,596,1,1227,2,12,5,5,7,single-choice,spatial-relational,5|7,7,5/7,240596,5
3,1,24,597,1,788,3,5,1,1,4,single-choice,spatial-relational,1|4,7,1/4,240597,1
3,1,24,598,1,841,4,6,1,1,5,single-choice,spatial-relational,1|5,7,1/5,240598,1
3,1,24,599,1,759,3,5,1,1,4,single-choice,spatial-relational,1|4,7,1/4,240599,1
3,1,24,600,1,989,5,9,2,2,7,single-choice,spatial-relational,2|7,7,2/7,240600,2
1,2,21,1,0,1514,1,11,5,6,6,single-choice,spatial-relational,5|6,7,5/6,210001,5
1,2,21,2,0,1357,1,9,4,5,5,single-choice,spatial-relational,4|5,7,4/5,210002,4
1,2,21,3,0,613,1,5,2,3,3,single-choice,spatial-relational,2|3,7,2/3,210003,2
1,2,21,4,1,947,1,13,6,6,7,single-choice,spatial-relational,6|7,7,6/7,210004,6
1,2,21,5,1,860,1,13,6,6,7,single-choice,spatial-relational,6|7,7,6/7,210005,6
1,2,21,6,1,3613,1,9,4,4,5,single-choice,spatial-relational,4|5,7,4/5,210006,4
1,2,21,7,0,1391,1,3,1,2,2,single-choice,spatial-relational,1|2,7,1/2,210007,1
1,2,21,8,0,798,1,7,3,4,4,single-choice,spatial-relational,3|4,7,3/4,210008,3
1,2,21,9,1,723,1,3,1,1,2,single-choice,spatial-relational,1|2,7,1/2,210009,1
1,2,21,10,1,1149,1,7,3,3,4,single-choice,spatial-relational,3|4,7,3/4,210010,3
1,2,21,11,1,1191,1,5,2,2,3,single-choice,spatial-relational,2|3,7,2/3,210011,2
1,2,21,12,0,703,1,11,5,6,6,single-choice,spatial-relational,5|6,7,5/6,210012,5
1,2,21,13,1,618,1,13,6,6,7,single-choice,spatial-relational,6|7,7,6/7,210013,6
1,2,21,14,1,2254,1,9,4,4,5,single-choice,spatial-relational,4|5,7,4/5,210014,4
1,2,21,15,1,1083,1,11,5,5,6,single-choice,spatial-relational,5|6,7,5/6,210015,5
1,2,21,16,1,698,1,7,3,3,4,single-choice,spatial-relational,3|4,7,3/4,210016,3
1,2,21,17,1,865,1,5,2,2,3,single-choice,spatial-relational,2|3,7,2/3,210017,2
1,2,21,18,0,1062,1,5,2,3,3,single-choice,spatial-relational,2|3,7,2/3,210018,2
1,2,21,19,1,732,1,9,4,4,5,single-choice,spatial-relational,4|5,7,4/5,210019,4
1,2,21,20,0,875,1,3,1,2,2,single-choice,spatial-relational,1|2,7,1/2,210020,1
1,2,21,21,0,1086,1,7,3,4,4,single-choice,spatial-relational,3|4,7,3/4,210021,3
1,2,21,22,0,723,1,11,5,6,6,single-choice,spatial-relational,5|6,7,5/6,210022,5
1,2,21,23,1,531,1,13,6,6,7,single-choice,spatial-relational,6|7,7,6/7,210023,6
1,2,21,24,0,1318,1,3,1,2,2,single-choice,spatial-relational,1|2,7,1/2,210024,1
1,2,21,25,1,1107,1,9,4,4,5,single-choice,spatial-relational,4|5,7,4/5,210025,4
1,2,21,26,1,1087,1,13,6,6,7,single-choice,spatial-relational,6|7,7,6/7,210026,6
1,2,21,27,1,862,1,11,5,5,6,single-choice,spatial-relational,5|6,7,5/6,210027,5
1,2,21,28,0,1041,1,7,3,4,4,single-choice,spatial-relational,3|4,7,3/4,210028,3
1,2,21,29,1,1110,1,13,6,6,7,single-choice,spatial-relational,6|7,7,6/7,210029,6
1,2,21,30,0,847,1,5,2,3,3,single-choice,spatial-relational,2|3,7,2/3,210030,2
1,2,21,31,1,1267,1,3,1,1,2,single-choice,spatial-relational,1|2,7,1/2,210031,1
1,2,21,32,0,1048,1,7,3,4,4,single-choice,spatial-relational,3|4,7,3/4,210032,3
1,2,21,33,1,693,1,3,1,1,2,single-choice,spatial-relational,1|2,7,1/2,210033,1
1,2,21,34,1,793,1,5,2,2,3,single-choice,spatial-relational,2|3,7,2/3,210034,2
1,2,21,35,0,1639,1,11,5,6,6,single-choice,spatial-relational,5|6,7,5/6,210035,5
1,2,21,36,0,686,1,9,4,5,5,single-choice,spatial-relational,4|5,7,4/5,210036,4
1,2,21,37,1,1116,1,5,2,2,3,single-choice,spatial-relational,2|3,7,2/3,210037,2
1,2,21,38,1,845,1,11,5,5,6,single-choice,spatial-relational,5|6,7,5/6,210038,5
1,2,21,39,0,1831,1,7,3,4,4,single-choice,spatial-relational,3|4,7,3/4,210039,3
1,2,21,40,1,837,1,13,6,6,7,single-choice,spatial-relational,6|7,7,6/7,210040,6
1,2,21,41,1,903,1,9,4,4,5,single-choice,spatial-relational,4|5,7,4/5,210041,4
1,2,21,42,0,1975,1,3,1,2,2,single-choice,spatial-relational,1|2,7,1/2,210042,1
1,2,21,43,1,703,1,9,4,4,5,single-choice,spatial-relational,4|5,7,4/5,210043,4
1,2,21,44,0,788,1,11,5,6,6,single-choice,spatial-relational,5|6,7,5/6,210044,5
1,2,21,45,1,640,1,13,6,6,7,single-choice,spatial-relational,6|7,7,6/7,210045,6
1,2,21,46,0,1714,1,7,3,4,4,single-choice,spatial-relational,3|4,7,3/4,210046,3
1,2,21,47,1,995,1,3,1,1,2,single-choice,spatial-relational,1|2,7,1/2,210047,1
1,2,21,48,1,814,1,5,2,2,3,single-choice,spatial-relational,2|3,7,2/3,210048,2
1,2,21,49,1,2009,1,7,3,3,4,single-choice,spatial-relational,3|4,7,3/4,210049,3
1,2,21,50,0,1757,1,7,3,4,4,single-choice,spatial-relational,3|4,7,3/4,210050,3
1,2,21,51,1,945,1,5,2,2,3,single-choice,spatial-relational,2|3,7,2/3,210051,2
1,2,21,52,0,967,1,3,1,2,2,single-choice,spatial-relational,1|2,7,1/2,210052,1
1,2,21,53,0,1130,1,5,2,3,3,single-choice,spatial-relational,2|3,7,2/3,210053,2
1,2,21,54,1,501,1,13,6,6,7,single-choice,spatial-relational,6|7,7,6/7,210054,6
1,2,21,55,0,1226,1,11,5,6,6,single-choice,spatial-relational,5|6,7,5/6,210055,5
1,2,21,56,1,913,1,3,1,1,2,single-choice,spatial-relational,1|2,7,1/2,210056,1
1,2,21,57,0,757,1,9,4,5,5,single-choice,spatial-relational,4|5,7,4/5,210057,4
1,2,21,58,0,1267,1,11,5,6,6,single-choice,spatial-relational,5|6,7,5/6,210058,5
1,2,21,59,1,573,1,13,6,6,7,single-choice,spatial-relational,6|7,7,6/7,210059,6
1,2,21,60,1,1269,1,9,4,4,5,single-choice,spatial-relational,4|5,7,4/5,210060,4
1,2,21,61,1,2584,1,3,1,1,2,single-choice,spatial-relational,1|2,7,1/2,210061,1
1,2,21,62,0,1429,1,11,5,6,6,single-choice,spatial-relational,5|6,7,5/6,210062,5
1,2,21,63,0,852,1,9,4,5,5,single-choice,spatial-relational,4|5,7,4/5,210063,4
1,2,21,64,1,785,1,11,5,5,6,single-choice,spatial-relational,5|6,7,5/6,210064,5
1,2,21,65,0,810,1,3,1,2,2,single-choice,spatial-relational,1|2,7,1/2,210065,1
1,2,21,66,0,788,1,7,3,4,4,single-choice,spatial-relational,3|4,7,3/4,210066,3
1,2,21,67,0,933,1,5,2,3,3,single-choice,spatial-relational,2|3,7,2/3,210067,2
1,2,21,68,0,1150,1,7,3,4,4,single-choice,spatial-relational,3|4,7,3/4,210068,3
1,2,21,69,1,1022,1,5,2,2,3,single-choice,spatial-relational,2|3,7,2/3,210069,2
1,2,21,70,1,992,1,13,6,6,7,single-choice,spatial-relational,6|7,7,6/7,210070,6
1,2,21,71,1,2369,1,13,6,6,7,single-choice,spatial-relational,6|7,7,6/7,210071,6
1,2,21,72,0,1859,1,9,4,5,5,single-choice,spatial-relational,4|5,7,4/5,210072,4
1,2,21,73,1,738,1,5,2,2,3,single-choice,spatial-relational,2|3,7,2/3,210073,2
1,2,21,74,0,1023,1,11,5,6,6,single-choice,spatial-relational,5|6,7,5/6,210074,5
1,2,21,75,0,941,1,7,3,4,4,single-choice,spatial-relational,3|4,7,3/4,210075,3
1,2,21,76,1,1866,1,9,4,4,5,single-choice,spatial-relational,4|5,7,4/5,210076,4
1,2,21,77,0,1097,1,3,1,2,2,single-choice,spatial-relational,1|2,7,1/2,210077,1
1,2,21,78,1,645,1,3,1,1,2,single-choice,spatial-relational,1|2,7,1/2,210078,1
1,2,21,79,1,1536,1,9,4,4,5,single-choice,spatial-relational,4|5,7,4/5,210079,4
1,2,21,80,0,1708,1,5,2,3,3,single-choice,spatial-relational,2|3,7,2/3,210080,2
1,2,21,81,1,593,1,13,6,6,7,single-choice,spatial-relational,6|7,7,6/7,210081,6
1,2,21,82,0,979,1,11,5,6,6,single-choice,spatial-relational,5|6,7,5/6,210082,5
1,2,21,83,0,782,1,7,3,4,4,single-choice,spatial-relational,3|4,7,3/4,210083,3
1,2,21,84,1,761,1,13,6,6,7,single-choice,spatial-relational,6|7,7,6/7,210084,6
1,2,21,85,1,1011,1,5,2,2,3,single-choice,spatial-relational,2|3,7,2/3,210085,2
1,2,21,86,0,795,1,11,5,6,6,single-choice,spatial-relational,5|6,7,5/6,210086,5
1,2,21,87,0,1136,1,9,4,5,5,single-choice,spatial-relational,4|5,7,4/5,210087,4
1,2,21,88,1,582,1,13,6,6,7,single-choice,spatial-relational,6|7,7,6/7,210088,6
1,2,21,89,1,1320,1,3,1,1,2,single-choice,spatial-relational,1|2,7,1/2,210089,1
1,2,21,90,0,990,1,11,5,6,6,single-choice,spatial-relational,5|6,7,5/6,210090,5
1,2,21,91,1,1015,1,7,3,3,4,single-choice,spatial-relational,3|4,7,3/4,210091,3
1,2,21,92,0,1980,1,7,3,4,4,single-choice,spatial-relational,3|4,7,3/4,210092,3
1,2,21,93,1,528,1,13,6,6,7,single-choice,spatial-relational,6|7,7,6/7,210093,6
1,2,21,94,0,889,1,3,1,2,2,single-choice,spatial-relational,1|2,7,1/2,210094,1
1,2,21,95,1,836,1,5,2,2,3,single-choice,spatial-relational,2|3,7,2/3,210095,2
1,2,21,96,1,2741,1,9,4,4,5,single-choice,spatial-relational,4|5,7,4/5,210096,4
1,2,21,97,1,1124,1,9,4,4,5,single-choice,spatial-relational,4|5,7,4/5,210097,4
1,2,21,98,1,1575,1,5,2,2,3,single-choice,spatial-relational,2|3,7,2/3,210098,2
1,2,21,99,1,853,1,5,2,2,3,single-choice,spatial-relational,2|3,7,2/3,210099,2
1,2,21,100,1,1273,1,9,4,4,5,single-choice,spatial-relational,4|5,7,4/5,210100,4
1,2,21,101,1,3913,1,7,3,3,4,single-choice,spatial-relational,3|4,7,3/4,210101,3
1,2,21,102,0,832,1,3,1,2,2,single-choice,spatial-relational,1|2,7,1/2,210102,1
1,2,21,103,1,814,1,3,1,1,2,single-choice,spatial-relational,1|2,7,1/2,210103,1
1,2,21,104,1,901,1,13,6,6,7,single-choice,spatial-relational,6|7,7,6/7,210104,6
1,2,21,105,1,1051,1,7,3,3,4,single-choice,spatial-relational,3|4,7,3/4,210105,3
1,2,21,106,0,766,1,11,5,6,6,single-choice,spatial-relational,5|6,7,5/6,210106,5
1,2,21,107,0,518,1,11,5,6,6,single-choice,spatial-relational,5|6,7,5/6,210107,5
1,2,21,108,0,52,1,13,6,7,7,single-choice,spatial-relational,6|7,7,6/7,210108,6
1,2,21,109,1,546,1,3,1,1,2,single-choice,spatial-relational,1|2,7,1/2,210109,1
1,2,21,110,1,703,1,13,6,6,7,single-choice,spatial-relational,6|7,7,6/7,210110,6
1,2,21,111,0,1637,1,11,5,6,6,single-choice,spatial-relational,5|6,7,5/6,210111,5
1,2,21,112,0,475,1,11,5,6,6,single-choice,spatial-relational,5|6,7,5/6,210112,5
1,2,21,113,1,1647,1,5,2,2,3,single-choice,spatial-relational,2|3,7,2/3,210113,2
1,2,21,114,1,1048,1,9,4,4,5,single-choice,spatial-relational,4|5,7,4/5,210114,4
1,2,21,115,0,1318,1,5,2,3,3,single-choice,spatial-relational,2|3,7,2/3,210115,2
1,2,21,116,1,1078,1,9,4,4,5,single-choice,spatial-relational,4|5,7,4/5,210116,4
1,2,21,117,0,1031,1,7,3,4,4,single-choice,spatial-relational,3|4,7,3/4,210117,3
1,2,21,118,1,679,1,13,6,6,7,single-choice,spatial-relational,6|7,7,6/7,210118,6
1,2,21,119,1,996,1,3,1,1,2,single-choice,spatial-relational,1|2,7,1/2,210119,1
1,2,21,120,0,2151,1,7,3,4,4,single-choice,spatial-relational,3|4,7,3/4,210120,3
1,2,21,121,1,735,1,5,2,2,3,single-choice,spatial-relational,2|3,7,2/3,210121,2
1,2,21,122,1,1197,1,9,4,4,5,single-choice,spatial-relational,4|5,7,4/5,210122,4
1,2,21,123,1,1205,1,3,1,1,2,single-choice,spatial-relational,1|2,7,1/2,210123,1
1,2,21,124,1,785,1,13,6,6,7,single-choice,spatial-relational,6|7,7,6/7,210124,6
1,2,21,125,1,1210,1,9,4,4,5,single-choice,spatial-relational,4|5,7,4/5,210125,4
1,2,21,126,0,973,1,7,3,4,4,single-choice,spatial-relational,3|4,7,3/4,210126,3
1,2,21,127,1,631,1,5,2,2,3,single-choice,spatial-relational,2|3,7,2/3,210127,2
1,2,21,128,1,1177,1,3,1,1,2,single-choice,spatial-relational,1|2,7,1/2,210128,1
1,2,21,129,1,1710,1,13,6,6,7,single-choice,spatial-relational,6|7,7,6/7,210129,6
1,2,21,130,0,1830,1,7,3,4,4,single-choice,spatial-relational,3|4,7,3/4,210130,3
1,2,21,131,0,862,1,11,5,6,6,single-choice,spatial-relational,5|6,7,5/6,210131,5
1,2,21,132,0,901,1,11,5,6,6,single-choice,spatial-relational,5|6,7,5/6,210132,5
1,2,21,133,1,693,1,5,2,2,3,single-choice,spatial-relational,2|3,7,2/3,210133,2
1,2,21,134,1,924,1,11,5,5,6,single-choice,spatial-relational,5|6,7,5/6,210134,5
1,2,21,135,1,2885,1,9,4,4,5,single-choice,spatial-relational,4|5,7,4/5,210135,4
1,2,21,136,1,1666,1,9,4,4,5,single-choice,spatial-relational,4|5,7,4/5,210136,4
1,2,21,137,0,933,1,7,3,4,4,single-choice,spatial-relational,3|4,7,3/4,210137,3
1,2,21,138,1,1134,1,3,1,1,2,single-choice,spatial-relational,1|2,7,1/2,210138,1
1,2,21,139,1,635,1,13,6,6,7,single-choice,spatial-relational,6|7,7,6/7,210139,6
1,2,21,140,1,1326,1,5,2,2,3,single-choice,spatial-relational,2|3,7,2/3,210140,2
1,2,21,141,1,1245,1,11,5,5,6,single-choice,spatial-relational,5|6,7,5/6,210141,5
1,2,21,142,1,1216,1,3,1,1,2,single-choice,spatial-relational,1|2,7,1/2,210142,1
1,2,21,143,1,1438,1,13,6,6,7,single-choice,spatial-relational,6|7,7,6/7,210143,6
1,2,21,144,0,1723,1,7,3,4,4,single-choice,spatial-relational,3|4,7,3/4,210144,3
1,2,21,145,1,631,1,5,2,2,3,single-choice,spatial-relational,2|3,7,2/3,210145,2
1,2,21,146,1,1178,1,3,1,1,2,single-choice,spatial-relational,1|2,7,1/2,210146,1
1,2,21,147,1,1762,1,7,3,3,4,single-choice,spatial-relational,3|4,7,3/4,210147,3
1,2,21,148,0,718,1,3,1,2,2,single-choice,spatial-relational,1|2,7,1/2,210148,1
1,2,21,149,0,499,1,11,5,6,6,single-choice,spatial-relational,5|6,7,5/6,210149,5
1,2,21,150,0,1053,1,11,5,6,6,single-choice,spatial-relational,5|6,7,5/6,210150,5
1,2,21,151,1,1101,1,13,6,6,7,single-choice,spatial-relational,6|7,7,6/7,210151,6
1,2,21,152,1,767,1,5,2,2,3,single-choice,spatial-relational,2|3,7,2/3,210152,2
1,2,21,153,1,661,1,13,6,6,7,single-choice,spatial-relational,6|7,7,6/7,210153,6
1,2,21,154,0,1379,1,9,4,5,5,single-choice,spatial-relational,4|5,7,4/5,210154,4
1,2,21,155,0,723,1,7,3,4,4,single-choice,spatial-relational,3|4,7,3/4,210155,3
1,2,21,156,1,1102,1,9,4,4,5,single-choice,spatial-relational,4|5,7,4/5,210156,4
1,2,21,157,0,1783,1,11,5,6,6,single-choice,spatial-relational,5|6,7,5/6,210157,5
1,2,21,158,0,1188,1,11,5,6,6,single-choice,spatial-relational,5|6,7,5/6,210158,5
1,2,21,159,1,1341,1,13,6,6,7,single-choice,spatial-relational,6|7,7,6/7,210159,6
1,2,21,160,1,3603,1,13,6,6,7,single-choice,spatial-relational,6|7,7,6/7,210160,6
1,2,21,161,1,2079,1,7,3,3,4,single-choice,spatial-relational,3|4,7,3/4,210161,3
1,2,21,162,0,1507,1,7,3,4,4,single-choice,spatial-relational,3|4,7,3/4,210162,3
1,2,21,163,1,850,1,9,4,4,5,single-choice,spatial-relational,4|5,7,4/5,210163,4
1,2,21,164,1,1379,1,3,1,1,2,single-choice,spatial-relational,1|2,7,1/2,210164,1
1,2,21,165,1,784,1,5,2,2,3,single-choice,spatial-relational,2|3,7,2/3,210165,2
1,2,21,166,1,1690,1,9,4,4,5,single-choice,spatial-relational,4|5,7,4/5,210166,4
1,2,21,167,0,725,1,3,1,2,2,single-choice,spatial-relational,1|2,7,1/2,210167,1
1,2,21,168,1,599,1,5,2,2,3,single-choice,spatial-relational,2|3,7,2/3,210168,2
1,2,21,169,1,733,1,5,2,2,3,single-choice,spatial-relational,2|3,7,2/3,210169,2
1,2,21,170,0,1645,1,9,4,5,5,single-choice,spatial-relational,4|5,7,4/5,210170,4
1,2,21,171,1,902,1,3,1,1,2,single-choice,spatial-relational,1|2,7,1/2,210171,1
1,2,21,172,1,997,1,7,3,3,4,single-choice,spatial-relational,3|4,7,3/4,210172,3
1,2,21,173,0,1288,1,13,6,7,7,single-choice,spatial-relational,6|7,7,6/7,210173,6
1,2,21,174,0,830,1,11,5,6,6,single-choice,spatial-relational,5|6,7,5/6,210174,5
1,2,21,175,1,138,1,9,4,4,5,single-choice,spatial-relational,4|5,7,4/5,210175,4
1,2,21,176,1,1422,1,13,6,6,7,single-choice,spatial-relational,6|7,7,6/7,210176,6
1,2,21,177,1,1131,1,11,5,5,6,single-choice,spatial-relational,5|6,7,5/6,210177,5
1,2,21,178,1,1350,1,5,2,2,3,single-choice,spatial-relational,2|3,7,2/3,210178,2
1,2,21,179,1,932,1,3,1,1,2,single-choice,spatial-relational,1|2,7,1/2,210179,1
1,2,21,180,1,2049,1,7,3,3,4,single-choice,spatial-relational,3|4,7,3/4,210180,3
1,2,21,181,0,1076,1,13,6,7,7,single-choice,spatial-relational,6|7,7,6/7,210181,6
1,2,21,182,0,1103,1,11,5,6,6,single-choice,spatial-relational,5|6,7,5/6,210182,5
1,2,21,183,1,948,1,3,1,1,2,single-choice,spatial-relational,1|2,7,1/2,210183,1
1,2,21,184,1,1556,1,9,4,4,5,single-choice,spatial-relational,4|5,7,4/5,210184,4
1,2,21,185,1,1658,1,13,6,6,7,single-choice,spatial-relational,6|7,7,6/7,210185,6
1,2,21,186,0,1655,1,9,4,5,5,single-choice,spatial-relational,4|5,7,4/5,210186,4
1,2,21,187,1,1065,1,11,5,5,6,single-choice,spatial-relational,5|6,7,5/6,210187,5
1,2,21,188,1,780,1,5,2,2,3,single-choice,spatial-relational,2|3,7,2/3,210188,2
1,2,21,189,1,1148,1,7,3,3,4,single-choice,spatial-relational,3|4,7,3/4,210189,3
1,2,21,190,1,1939,1,5,2,2,3,single-choice,spatial-relational,2|3,7,2/3,210190,2
1,2,21,191,0,2008,1,7,3,4,4,single-choice,spatial-relational,3|4,7,3/4,210191,3
1,2,21,192,1,657,1,3,1,1,2,single-choice,spatial-relational,1|2,7,1/2,210192,1
1,2,21,193,1,1121,1,7,3,3,4,single-choice,spatial-relational,3|4,7,3/4,210193,3
1,2,21,194,1,843,1,3,1,1,2,single-choice,spatial-relational,1|2,7,1/2,210194,1
1,2,21,195,0,1394,1,11,5,6,6,single-choice,spatial-relational,5|6,7,5/6,210195,5
1,2,21,196,1,625,1,13,6,6,7,single-choice,spatial-relational,6|7,7,6/7,210196,6
1,2,21,197,1,2607,1,9,4,4,5,single-choice,spatial-relational,4|5,7,4/5,210197,4
1,2,21,198,1,732,1,5,2,2,3,single-choice,spatial-relational,2|3,7,2/3,210198,2
1,2,21,199,1,620,1,5,2,2,3,single-choice,spatial-relational,2|3,7,2/3,210199,2
1,2,21,200,1,1103,1,11,5,5,6,single-choice,spatial-relational,5|6,7,5/6,210200,5
1,2,21,201,0,724,1,3,1,2,2,single-choice,spatial-relational,1|2,7,1/2,210201,1
1,2,21,202,1,1168,1,13,6,6,7,single-choice,spatial-relational,6|7,7,6/7,210202,6
1,2,21,203,1,1090,1,9,4,4,5,single-choice,spatial-relational,4|5,7,4/5,210203,4
1,2,21,204,1,917,1,7,3,3,4,single-choice,spatial-relational,3|4,7,3/4,210204,3
1,2,21,205,1,1209,1,7,3,3,4,single-choice,spatial-relational,3|4,7,3/4,210205,3
1,2,21,206,0,1290,1,9,4,5,5,single-choice,spatial-relational,4|5,7,4/5,210206,4
1,2,21,207,1,671,1,5,2,2,3,single-choice,spatial-relational,2|3,7,2/3,210207,2
1,2,21,208,1,1026,1,7,3,3,4,single-choice,spatial-relational,3|4,7,3/4,210208,3
1,2,21,209,1,695,1,13,6,6,7,single-choice,spatial-relational,6|7,7,6/7,210209,6
1,2,21,210,0,739,1,3,1,2,2,single-choice,spatial-relational,1|2,7,1/2,210210,1
1,2,21,211,1,1092,1,13,6,6,7,single-choice,spatial-relational,6|7,7,6/7,210211,6
1,2,21,212,1,983,1,11,5,5,6,single-choice,spatial-relational,5|6,7,5/6,210212,5
1,2,21,213,1,1240,1,11,5,5,6,single-choice,spatial-relational,5|6,7,5/6,210213,5
1,2,21,214,1,1040,1,9,4,4,5,single-choice,spatial-relational,4|5,7,4/5,210214,4
1,2,21,215,1,1161,1,3,1,1,2,single-choice,spatial-relational,1|2,7,1/2,210215,1
1,2,21,216,1,706,1,5,2,2,3,single-choice,spatial-relational,2|3,7,2/3,210216,2
1,2,21,217,1,1307,1,9,4,4,5,single-choice,spatial-relational,4|5,7,4/5,210217,4
1,2,21,218,1,2273,1,7,3,3,4,single-choice,spatial-relational,3|4,7,3/4,210218,3
1,2,21,219,1,857,1,7,3,3,4,single-choice,spatial-relational,3|4,7,3/4,210219,3
1,2,21,220,0,865,1,11,5,6,6,single-choice,spatial-relational,5|6,7,5/6,210220,5
1,2,21,221,1,579,1,5,2,2,3,single-choice,spatial-relational,2|3,7,2/3,210221,2
1,2,21,222,0,916,1,3,1,2,2,single-choice,spatial-relational,1|2,7,1/2,210222,1
1,2,21,223,1,524,1,13,6,6,7,single-choice,spatial-relational,6|7,7,6/7,210223,6
1,2,21,224,1,711,1,5,2,2,3,single-choice,spatial-relational,2|3,7,2/3,210224,2
1,2,21,225,0,1987,1,9,4,5,5,single-choice,spatial-relational,4|5,7,4/5,210225,4
1,2,21,226,1,684,1,3,1,1,2,single-choice,spatial-relational,1|2,7,1/2,210226,1
1,2,21,227,0,951,1,11,5,6,6,single-choice,spatial-relational,5|6,7,5/6,210227,5
1,2,21,228,1,697,1,13,6,6,7,single-choice,spatial-relational,6|7,7,6/7,210228,6
1,2,21,229,0,1580,1,11,5,6,6,single-choice,spatial-relational,5|6,7,5/6,210229,5
1,2,21,230,1,533,1,13,6,6,7,single-choice,spatial-relational,6|7,7,6/7,210230,6
1,2,21,231,1,788,1,5,2,2,3,single-choice,spatial-relational,2|3,7,2/3,210231,2
1,2,21,232,1,2255,1,9,4,4,5,single-choice,spatial-relational,4|5,7,4/5,210232,4
1,2,21,233,0,1356,1,11,5,6,6,single-choice,spatial-relational,5|6,7,5/6,210233,5
1,2,21,234,1,981,1,5,2,2,3,single-choice,spatial-relational,2|3,7,2/3,210234,2
1,2,21,235,1,1302,1,7,3,3,4,single-choice,spatial-relational,3|4,7,3/4,210235,3
1,2,21,236,1,1142,1,3,1,1,2,single-choice,spatial-relational,1|2,7,1/2,210236,1
1,2,21,237,0,670,1,3,1,2,2,single-choice,spatial-relational,1|2,7,1/2,210237,1
1,2,21,238,0,946,1,7,3,4,4,single-choice,spatial-relational,3|4,7,3/4,210238,3
1,2,21,239,1,571,1,9,4,4,5,single-choice,spatial-relational,4|5,7,4/5,210239,4
1,2,21,240,1,1277,1,13,6,6,7,single-choice,spatial-relational,6|7,7,6/7,210240,6
1,2,21,241,1,1167,1,3,1,1,2,single-choice,spatial-relational,1|2,7,1/2,210241,1
1,2,21,242,1,1024,1,3,1,1,2,single-choice,spatial-relational,1|2,7,1/2,210242,1
1,2,21,243,1,1785,1,11,5,5,6,single-choice,spatial-relational,5|6,7,5/6,210243,5
1,2,21,244,0,1053,1,5,2,3,3,single-choice,spatial-relational,2|3,7,2/3,210244,2
1,2,21,245,1,657,1,5,2,2,3,single-choice,spatial-relational,2|3,7,2/3,210245,2
1,2,21,246,0,882,1,7,3,4,4,single-choice,spatial-relational,3|4,7,3/4,210246,3
1,2,21,247,0,696,1,7,3,4,4,single-choice,spatial-relational,3|4,7,3/4,210247,3
1,2,21,248,0,1293,1,9,4,5,5,single-choice,spatial-relational,4|5,7,4/5,210248,4
1,2,21,249,1,1183,1,9,4,4,5,single-choice,spatial-relational,4|5,7,4/5,210249,4
1,2,21,250,0,1319,1,11,5,6,6,single-choice,spatial-relational,5|6,7,5/6,210250,5
1,2,21,251,1,788,1,13,6,6,7,single-choice,spatial-relational,6|7,7,6/7,210251,6
1,2,21,252,1,1395,1,13,6,6,7,single-choice,spatial-relational,6|7,7,6/7,210252,6
1,2,21,253,1,2153,1,9,4,4,5,single-choice,spatial-relational,4|5,7,4/5,210253,4
1,2,21,254,0,1021,1,7,3,4,4,single-choice,spatial-relational,3|4,7,3/4,210254,3
1,2,21,255,1,657,1,3,1,1,2,single-choice,spatial-relational,1|2,7,1/2,210255,1
1,2,21,256,0,796,1,11,5,6,6,single-choice,spatial-relational,5|6,7,5/6,210256,5
1,2,21,257,0,523,1,11,5,6,6,single-choice,spatial-relational,5|6,7,5/6,210257,5
1,2,21,258,0,162,1,13,6,7,7,single-choice,spatial-relational,6|7,7,6/7,210258,6
1,2,21,259,1,638,1,3,1,1,2,single-choice,spatial-relational,1|2,7,1/2,210259,1
1,2,21,260,1,601,1,13,6,6,7,single-choice,spatial-relational,6|7,7,6/7,210260,6
1,2,21,261,0,1177,1,5,2,3,3,single-choice,spatial-relational,2|3,7,2/3,210261,2
1,2,21,262,1,665,1,5,2,2,3,single-choice,spatial-relational,2|3,7,2/3,210262,2
1,2,21,263,1,1415,1,7,3,3,4,single-choice,spatial-relational,3|4,7,3/4,210263,3
1,2,21,264,0,917,1,9,4,5,5,single-choice,spatial-relational,4|5,7,4/5,210264,4
1,2,21,265,0,1375,1,7,3,4,4,single-choice,spatial-relational,3|4,7,3/4,210265,3
1,2,21,266,1,484,1,5,2,2,3,single-choice,spatial-relational,2|3,7,2/3,210266,2
1,2,21,267,1,932,1,9,4,4,5,single-choice,spatial-relational,4|5,7,4/5,210267,4
1,2,21,268,0,1194,1,13,6,7,7,single-choice,spatial-relational,6|7,7,6/7,210268,6
1,2,21,269,0,495,1,11,5,6,6,single-choice,spatial-relational,5|6,7,5/6,210269,5
1,2,21,270,1,561,1,13,6,6,7,single-choice,spatial-relational,6|7,7,6/7,210270,6
1,2,21,271,0,1531,1,11,5,6,6,single-choice,spatial-relational,5|6,7,5/6,210271,5
1,2,21,272,1,690,1,5,2,2,3,single-choice,spatial-relational,2|3,7,2/3,210272,2
1,2,21,273,1,822,1,3,1,1,2,single-choice,spatial-relational,1|2,7,1/2,210273,1
1,2,21,274,1,1073,1,3,1,1,2,single-choice,spatial-relational,1|2,7,1/2,210274,1
1,2,21,275,1,1367,1,7,3,3,4,single-choice,spatial-relational,3|4,7,3/4,210275,3
1,2,21,276,1,3163,1,9,4,4,5,single-choice,spatial-relational,4|5,7,4/5,210276,4
1,2,21,277,0,790,1,11,5,6,6,single-choice,spatial-relational,5|6,7,5/6,210277,5
1,2,21,278,0,645,1,7,3,4,4,single-choice,spatial-relational,3|4,7,3/4,210278,3
1,2,21,279,0,1014,1,11,5,6,6,single-choice,spatial-relational,5|6,7,5/6,210279,5
1,2,21,280,0,767,1,3,1,2,2,single-choice,spatial-relational,1|2,7,1/2,210280,1
1,2,21,281,1,744,1,3,1,1,2,single-choice,spatial-relational,1|2,7,1/2,210281,1
1,2,21,282,0,1330,1,13,6,7,7,single-choice,spatial-relational,6|7,7,6/7,210282,6
1,2,21,283,1,641,1,5,2,2,3,single-choice,spatial-relational,2|3,7,2/3,210283,2
1,2,21,284,1,887,1,7,3,3,4,single-choice,spatial-relational,3|4,7,3/4,210284,3
1,2,21,285,0,1140,1,5,2,3,3,single-choice,spatial-relational,2|3,7,2/3,210285,2
1,2,21,286,1,659,1,9,4,4,5,single-choice,spatial-relational,4|5,7,4/5,210286,4
1,2,21,287,1,1529,1,9,4,4,5,single-choice,spatial-relational,4|5,7,4/5,210287,4
1,2,21,288,1,1659,1,13,6,6,7,single-choice,spatial-relational,6|7,7,6/7,210288,6
1,2,21,289,1,1495,1,13,6,6,7,single-choice,spatial-relational,6|7,7,6/7,210289,6
1,2,21,290,0,932,1,7,3,4,4,single-choice,spatial-relational,3|4,7,3/4,210290,3
1,2,21,291,0,1069,1,9,4,5,5,single-choice,spatial-relational,4|5,7,4/5,210291,4
1,2,21,292,1,824,1,3,1,1,2,single-choice,spatial-relational,1|2,7,1/2,210292,1
1,2,21,293,1,2070,1,7,3,3,4,single-choice,spatial-relational,3|4,7,3/4,210293,3
1,2,21,294,1,800,1,5,2,2,3,single-choice,spatial-relational,2|3,7,2/3,210294,2
1,2,21,295,1,2038,1,11,5,5,6,single-choice,spatial-relational,5|6,7,5/6,210295,5
1,2,21,296,0,1085,1,11,5,6,6,single-choice,spatial-relational,5|6,7,5/6,210296,5
1,2,21,297,1,798,1,5,2,2,3,single-choice,spatial-relational,2|3,7,2/3,210297,2
1,2,21,298,1,934,1,3,1,1,2,single-choice,spatial-relational,1|2,7,1/2,210298,1
1,2,21,299,1,1085,1,9,4,4,5,single-choice,spatial-relational,4|5,7,4/5,210299,4
1,2,21,300,1,1364,1,13,6,6,7,single-choice,spatial-relational,6|7,7,6/7,210300,6
1,2,21,301,1,1884,1,11,5,5,6,single-choice,spatial-relational,5|6,7,5/6,210301,5
1,2,21,302,1,1963,1,9,4,4,5,single-choice,spatial-relational,4|5,7,4/5,210302,4
1,2,21,303,0,1115,1,5,2,3,3,single-choice,spatial-relational,2|3,7,2/3,210303,2
1,2,21,304,1,785,1,9,4,4,5,single-choice,spatial-relational,4|5,7,4/5,210304,4
1,2,21,305,1,883,1,3,1,1,2,single-choice,spatial-relational,1|2,7,1/2,210305,1
1,2,21,306,0,776,1,7,3,4,4,single-choice,spatial-relational,3|4,7,3/4,210306,3
1,2,21,307,1,574,1,13,6,6,7,single-choice,spatial-relational,6|7,7,6/7,210307,6
1,2,21,308,1,928,1,3,1,1,2,single-choice,spatial-relational,1|2,7,1/2,210308,1
1,2,21,309,0,1676,1,5,2,3,3,single-choice,spatial-relational,2|3,7,2/3,210309,2
1,2,21,310,1,481,1,13,6,6,7,single-choice,spatial-relational,6|7,7,6/7,210310,6
1,2,21,311,0,1019,1,7,3,4,4,single-choice,spatial-relational,3|4,7,3/4,210311,3
1,2,21,312,0,474,1,11,5,6,6,single-choice,spatial-relational,5|6,7,5/6,210312,5
1,2,21,313,0,841,1,7,3,4,4,single-choice,spatial-relational,3|4,7,3/4,210313,3
1,2,21,314,1,617,1,5,2,2,3,single-choice,spatial-relational,2|3,7,2/3,210314,2
1,2,21,315,1,853,1,3,1,1,2,single-choice,spatial-relational,1|2,7,1/2,210315,1
1,2,21,316,1,2016,1,13,6,6,7,single-choice,spatial-relational,6|7,7,6/7,210316,6
1,2,21,317,0,804,1,9,4,5,5,single-choice,spatial-relational,4|5,7,4/5,210317,4
1,2,21,318,1,616,1,9,4,4,5,single-choice,spatial-relational,4|5,7,4/5,210318,4
1,2,21,319,0,1647,1,7,3,4,4,single-choice,spatial-relational,3|4,7,3/4,210319,3
1,2,21,320,0,513,1,11,5,6,6,single-choice,spatial-relational,5|6,7,5/6,210320,5
1,2,21,321,1,1177,1,13,6,6,7,single-choice,spatial-relational,6|7,7,6/7,210321,6
1,2,21,322,1,1705,1,5,2,2,3,single-choice,spatial-relational,2|3,7,2/3,210322,2
1,2,21,323,1,1135,1,3,1,1,2,single-choice,spatial-relational,1|2,7,1/2,210323,1
1,2,21,324,1,1526,1,11,5,5,6,single-choice,spatial-relational,5|6,7,5/6,210324,5
1,2,21,325,1,1177,1,5,2,2,3,single-choice,spatial-relational,2|3,7,2/3,210325,2
1,2,21,326,1,1319,1,11,5,5,6,single-choice,spatial-relational,5|6,7,5/6,210326,5
1,2,21,327,1,1556,1,5,2,2,3,single-choice,spatial-relational,2|3,7,2/3,210327,2
1,2,21,328,1,782,1,13,6,6,7,single-choice,spatial-relational,6|7,7,6/7,210328,6
1,2,21,329,1,835,1,9,4,4,5,single-choice,spatial-relational,4|5,7,4/5,210329,4
1,2,21,330,0,1357,1,9,4,5,5,single-choice,spatial-relational,4|5,7,4/5,210330,4
1,2,21,331,1,718,1,3,1,1,2,single-choice,spatial-relational,1|2,7,1/2,210331,1
1,2,21,332,1,833,1,7,3,3,4,single-choice,spatial-relational,3|4,7,3/4,210332,3
1,2,21,333,1,2698,1,13,6,6,7,single-choice,spatial-relational,6|7,7,6/7,210333,6
1,2,21,334,1,1025,1,3,1,1,2,single-choice,spatial-relational,1|2,7,1/2,210334,1
1,2,21,335,0,1495,1,7,3,4,4,single-choice,spatial-relational,3|4,7,3/4,210335,3
1,2,21,336,0,514,1,11,5,6,6,single-choice,spatial-relational,5|6,7,5/6,210336,5
1,2,21,337,1,677,1,9,4,4,5,single-choice,spatial-relational,4|5,7,4/5,210337,4
1,2,21,338,1,684,1,13,6,6,7,single-choice,spatial-relational,6|7,7,6/7,210338,6
1,2,21,339,1,2077,1,5,2,2,3,single-choice,spatial-relational,2|3,7,2/3,210339,2
1,2,21,340,0,1136,1,11,5,6,6,single-choice,spatial-relational,5|6,7,5/6,210340,5
1,2,21,341,0,520,1,11,5,6,6,single-choice,spatial-relational,5|6,7,5/6,210341,5
1,2,21,342,0,685,1,7,3,4,4,single-choice,spatial-relational,3|4,7,3/4,210342,3
1,2,21,343,1,626,1,13,6,6,7,single-choice,spatial-relational,6|7,7,6/7,210343,6
1,2,21,344,0,784,1,3,1,2,2,single-choice,spatial-relational,1|2,7,1/2,210344,1
1,2,21,345,0,562,1,7,3,4,4,single-choice,spatial-relational,3|4,7,3/4,210345,3
1,2,21,346,1,667,1,3,1,1,2,single-choice,spatial-relational,1|2,7,1/2,210346,1
1,2,21,347,1,957,1,9,4,4,5,single-choice,spatial-relational,4|5,7,4/5,210347,4
1,2,21,348,1,1127,1,5,2,2,3,single-choice,spatial-relational,2|3,7,2/3,210348,2
1,2,21,349,0,1746,1,3,1,2,2,single-choice,spatial-relational,1|2,7,1/2,210349,1
1,2,21,350,1,586,1,5,2,2,3,single-choice,spatial-relational,2|3,7,2/3,210350,2
1,2,21,351,0,1532,1,5,2,3,3,single-choice,spatial-relational,2|3,7,2/3,210351,2
1,2,21,352,0,953,1,7,3,4,4,single-choice,spatial-relational,3|4,7,3/4,210352,3
1,2,21,353,1,2068,1,9,4,4,5,single-choice,spatial-relational,4|5,7,4/5,210353,4
1,2,21,354,1,1079,1,13,6,6,7,single-choice,spatial-relational,6|7,7,6/7,210354,6
1,2,21,355,0,1749,1,11,5,6,6,single-choice,spatial-relational,5|6,7,5/6,210355,5
1,2,21,356,1,1319,1,9,4,4,5,single-choice,spatial-relational,4|5,7,4/5,210356,4
1,2,21,357,0,1139,1,7,3,4,4,single-choice,spatial-relational,3|4,7,3/4,210357,3
1,2,21,358,0,529,1,11,5,6,6,single-choice,spatial-relational,5|6,7,5/6,210358,5
1,2,21,359,1,1193,1,3,1,1,2,single-choice,spatial-relational,1|2,7,1/2,210359,1
1,2,21,360,0,1212,1,13,6,7,7,single-choice,spatial-relational,6|7,7,6/7,210360,6
1,2,21,361,0,682,1,11,5,6,6,single-choice,spatial-relational,5|6,7,5/6,210361,5
1,2,21,362,1,1678,1,7,3,3,4,single-choice,spatial-relational,3|4,7,3/4,210362,3
1,2,21,363,0,1926,1,9,4,5,5,single-choice,spatial-relational,4|5,7,4/5,210363,4
1,2,21,364,1,652,1,3,1,1,2,single-choice,spatial-relational,1|2,7,1/2,210364,1
1,2,21,365,1,965,1,3,1,1,2,single-choice,spatial-relational,1|2,7,1/2,210365,1
1,2,21,366,0,1025,1,11,5,6,6,single-choice,spatial-relational,5|6,7,5/6,210366,5
1,2,21,367,1,1344,1,7,3,3,4,single-choice,spatial-relational,3|4,7,3/4,210367,3
1,2,21,368,1,1072,1,5,2,2,3,single-choice,spatial-relational,2|3,7,2/3,210368,2
1,2,21,369,0,1187,1,5,2,3,3,single-choice,spatial-relational,2|3,7,2/3,210369,2
1,2,21,370,1,8360,1,13,6,6,7,single-choice,spatial-relational,6|7,7,6/7,210370,6
1,2,21,371,1,1166,1,9,4,4,5,single-choice,spatial-relational,4|5,7,4/5,210371,4
1,2,21,372,0,1307,1,13,6,7,7,single-choice,spatial-relational,6|7,7,6/7,210372,6
1,2,21,373,0,1535,1,11,5,6,6,single-choice,spatial-relational,5|6,7,5/6,210373,5
1,2,21,374,0,999,1,7,3,4,4,single-choice,spatial-relational,3|4,7,3/4,210374,3
1,2,21,375,1,937,1,9,4,4,5,single-choice,spatial-relational,4|5,7,4/5,210375,4
1,2,21,376,1,1995,1,13,6,6,7,single-choice,spatial-relational,6|7,7,6/7,210376,6
1,2,21,377,1,1688,1,13,6,6,7,single-choice,spatial-relational,6|7,7,6/7,210377,6
1,2,21,378,1,1802,1,5,2,2,3,single-choice,spatial-relational,2|3,7,2/3,210378,2
1,2,21,379,1,1474,1,3,1,1,2,single-choice,spatial-relational,1|2,7,1/2,210379,1
1,2,21,380,1,822,1,3,1,1,2,single-choice,spatial-relational,1|2,7,1/2,210380,1
1,2,21,381,1,937,1,5,2,2,3,single-choice,spatial-relational,2|3,7,2/3,210381,2
1,2,21,382,0,1044,1,11,5,6,6,single-choice,spatial-relational,5|6,7,5/6,210382,5
1,2,21,383,1,975,1,7,3,3,4,single-choice,spatial-relational,3|4,7,3/4,210383,3
1,2,21,384,0,1356,1,9,4,5,5,single-choice,spatial-relational,4|5,7,4/5,210384,4
1,2,21,385,1,975,1,7,3,3,4,single-choice,spatial-relational,3|4,7,3/4,210385,3
1,2,21,386,0,991,1,3,1,2,2,single-choice,spatial-relational,1|2,7,1/2,210386,1
1,2,21,387,1,1055,1,13,6,6,7,single-choice,spatial-relational,6|7,7,6/7,210387,6
1,2,21,388,0,2344,1,9,4,5,5,single-choice,spatial-relational,4|5,7,4/5,210388,4
1,2,21,389,0,1001,1,11,5,6,6,single-choice,spatial-relational,5|6,7,5/6,210389,5
1,2,21,390,1,706,1,5,2,2,3,single-choice,spatial-relational,2|3,7,2/3,210390,2
1,2,21,391,0,936,1,3,1,2,2,single-choice,spatial-relational,1|2,7,1/2,210391,1
1,2,21,392,1,1203,1,9,4,4,5,single-choice,spatial-relational,4|5,7,4/5,210392,4
1,2,21,393,0,1257,1,5,2,3,3,single-choice,spatial-relational,2|3,7,2/3,210393,2
1,2,21,394,0,560,1,11,5,6,6,single-choice,spatial-relational,5|6,7,5/6,210394,5
1,2,21,395,1,724,1,7,3,3,4,single-choice,spatial-relational,3|4,7,3/4,210395,3
1,2,21,396,1,1998,1,13,6,6,7,single-choice,spatial-relational,6|7,7,6/7,210396,6
1,2,21,397,0,1775,1,11,5,6,6,single-choice,spatial-relational,5|6,7,5/6,210397,5
1,2,21,398,0,606,1,7,3,4,4,single-choice,spatial-relational,3|4,7,3/4,210398,3
1,2,21,399,0,777,1,7,3,4,4,single-choice,spatial-relational,3|4,7,3/4,210399,3
1,2,21,400,0,568,1,11,5,6,6,single-choice,spatial-relational,5|6,7,5/6,210400,5
1,2,21,401,1,853,1,3,1,1,2,single-choice,spatial-relational,1|2,7,1/2,210401,1
1,2,21,402,1,1439,1,13,6,6,7,single-choice,spatial-relational,6|7,7,6/7,210402,6
1,2,21,403,0,1326,1,5,2,3,3,single-choice,spatial-relational,2|3,7,2/3,210403,2
1,2,21,404,1,705,1,3,1,1,2,single-choice,spatial-relational,1|2,7,1/2,210404,1
1,2,21,405,1,926,1,5,2,2,3,single-choice,spatial-relational,2|3,7,2/3,210405,2
1,2,21,406,1,796,1,9,4,4,5,single-choice,spatial-relational,4|5,7,4/5,210406,4
1,2,21,407,1,2444,1,9,4,4,5,single-choice,spatial-relational,4|5,7,4/5,210407,4
1,2,21,408,0,1751,1,13,6,7,7,single-choice,spatial-relational,6|7,7,6/7,210408,6
1,2,21,409,1,1176,1,9,4,4,5,single-choice,spatial-relational,4|5,7,4/5,210409,4
1,2,21,410,1,1055,1,3,1,1,2,single-choice,spatial-relational,1|2,7,1/2,210410,1
1,2,21,411,1,922,1,5,2,2,3,single-choice,spatial-relational,2|3,7,2/3,210411,2
1,2,21,412,0,1105,1,9,4,5,5,single-choice,spatial-relational,4|5,7,4/5,210412,4
1,2,21,413,0,1191,1,11,5,6,6,single-choice,spatial-relational,5|6,7,5/6,210413,5
1,2,21,414,1,1270,1,7,3,3,4,single-choice,spatial-relational,3|4,7,3/4,210414,3
1,2,21,415,0,1779,1,3,1,2,2,single-choice,spatial-relational,1|2,7,1/2,210415,1
1,2,21,416,1,574,1,13,6,6,7,single-choice,spatial-relational,6|7,7,6/7,210416,6
1,2,21,417,0,1246,1,5,2,3,3,single-choice,spatial-relational,2|3,7,2/3,210417,2
1,2,21,418,0,707,1,11,5,6,6,single-choice,spatial-relational,5|6,7,5/6,210418,5
1,2,21,419,0,716,1,7,3,4,4,single-choice,spatial-relational,3|4,7,3/4,210419,3
1,2,21,420,1,1254,1,13,6,6,7,single-choice,spatial-relational,6|7,7,6/7,210420,6
1,2,21,421,1,2518,1,9,4,4,5,single-choice,spatial-relational,4|5,7,4/5,210421,4
1,2,21,422,0,1991,1,3,1,2,2,single-choice,spatial-relational,1|2,7,1/2,210422,1
1,2,21,423,1,1742,1,13,6,6,7,single-choice,spatial-relational,6|7,7,6/7,210423,6
1,2,21,424,1,3304,1,7,3,3,4,single-choice,spatial-relational,3|4,7,3/4,210424,3
1,2,21,425,1,1264,1,13,6,6,7,single-choice,spatial-relational,6|7,7,6/7,210425,6
1,2,21,426,1,1209,1,9,4,4,5,single-choice,spatial-relational,4|5,7,4/5,210426,4
1,2,21,427,0,1229,1,5,2,3,3,single-choice,spatial-relational,2|3,7,2/3,210427,2
1,2,21,428,0,999,1,5,2,3,3,single-choice,spatial-relational,2|3,7,2/3,210428,2
1,2,21,429,0,534,1,11,5,6,6,single-choice,spatial-relational,5|6,7,5/6,210429,5
1,2,21,430,0,785,1,11,5,6,6,single-choice,spatial-relational,5|6,7,5/6,210430,5
1,2,21,431,1,715,1,3,1,1,2,single-choice,spatial-relational,1|2,7,1/2,210431,1
1,2,21,432,0,732,1,7,3,4,4,single-choice,spatial-relational,3|4,7,3/4,210432,3
1,2,21,433,1,495,1,13,6,6,7,single-choice,spatial-relational,6|7,7,6/7,210433,6
1,2,21,434,1,1599,1,3,1,1,2,single-choice,spatial-relational,1|2,7,1/2,210434,1
1,2,21,435,0,1721,1,5,2,3,3,single-choice,spatial-relational,2|3,7,2/3,210435,2
1,2,21,436,1,2511,1,13,6,6,7,single-choice,spatial-relational,6|7,7,6/7,210436,6
1,2,21,437,1,2464,1,7,3,3,4,single-choice,spatial-relational,3|4,7,3/4,210437,3
1,2,21,438,1,1153,1,3,1,1,2,single-choice,spatial-relational,1|2,7,1/2,210438,1
1,2,21,439,0,606,1,11,5,6,6,single-choice,spatial-relational,5|6,7,5/6,210439,5
1,2,21,440,1,1221,1,7,3,3,4,single-choice,spatial-relational,3|4,7,3/4,210440,3
1,2,21,441,0,1197,1,11,5,6,6,single-choice,spatial-relational,5|6,7,5/6,210441,5
1,2,21,442,1,1286,1,9,4,4,5,single-choice,spatial-relational,4|5,7,4/5,210442,4
1,2,21,443,1,1738,1,9,4,4,5,single-choice,spatial-relational,4|5,7,4/5,210443,4
1,2,21,444,1,2568,1,5,2,2,3,single-choice,spatial-relational,2|3,7,2/3,210444,2
1,2,21,445,1,899,1,13,6,6,7,single-choice,spatial-relational,6|7,7,6/7,210445,6
1,2,21,446,0,1625,1,7,3,4,4,single-choice,spatial-relational,3|4,7,3/4,210446,3
1,2,21,447,0,616,1,5,2,3,3,single-choice,spatial-relational,2|3,7,2/3,210447,2
1,2,21,448,1,1040,1,9,4,4,5,single-choice,spatial-relational,4|5,7,4/5,210448,4
1,2,21,449,1,1394,1,5,2,2,3,single-choice,spatial-relational,2|3,7,2/3,210449,2
1,2,21,450,1,1570,1,9,4,4,5,single-choice,spatial-relational,4|5,7,4/5,210450,4
1,2,21,451,1,1942,1,3,1,1,2,single-choice,spatial-relational,1|2,7,1/2,210451,1
1,2,21,452,0,722,1,7,3,4,4,single-choice,spatial-relational,3|4,7,3/4,210452,3
1,2,21,453,1,839,1,13,6,6,7,single-choice,spatial-relational,6|7,7,6/7,210453,6
1,2,21,454,1,2076,1,11,5,5,6,single-choice,spatial-relational,5|6,7,5/6,210454,5
1,2,21,455,0,1515,1,11,5,6,6,single-choice,spatial-relational,5|6,7,5/6,210455,5
1,2,21,456,0,1107,1,3,1,2,2,single-choice,spatial-relational,1|2,7,1/2,210456,1
1,2,21,457,1,1411,1,7,3,3,4,single-choice,spatial-relational,3|4,7,3/4,210457,3
1,2,21,458,1,1118,1,5,2,2,3,single-choice,spatial-relational,2|3,7,2/3,210458,2
1,2,21,459,1,1905,1,13,6,6,7,single-choice,spatial-relational,6|7,7,6/7,210459,6
1,2,21,460,0,1261,1,3,1,2,2,single-choice,spatial-relational,1|2,7,1/2,210460,1
1,2,21,461,1,1505,1,9,4,4,5,single-choice,spatial-relational,4|5,7,4/5,210461,4
1,2,21,462,0,3222,1,11,5,6,6,single-choice,spatial-relational,5|6,7,5/6,210462,5
1,2,21,463,0,572,1,11,5,6,6,single-choice,spatial-relational,5|6,7,5/6,210463,5
1,2,21,464,1,1430,1,3,1,1,2,single-choice,spatial-relational,1|2,7,1/2,210464,1
1,2,21,465,1,744,1,9,4,4,5,single-choice,spatial-relational,4|5,7,4/5,210465,4
1,2,21,466,1,1349,1,13,6,6,7,single-choice,spatial-relational,6|7,7,6/7,210466,6
1,2,21,467,0,1765,1,5,2,3,3,single-choice,spatial-relational,2|3,7,2/3,210467,2
1,2,21,468,0,712,1,7,3,4,4,single-choice,spatial-relational,3|4,7,3/4,210468,3
1,2,21,469,1,822,1,5,2,2,3,single-choice,spatial-relational,2|3,7,2/3,210469,2
1,2,21,470,0,1576,1,7,3,4,4,single-choice,spatial-relational,3|4,7,3/4,210470,3
1,2,21,471,0,652,1,11,5,6,6,single-choice,spatial-relational,5|6,7,5/6,210471,5
1,2,21,472,1,821,1,9,4,4,5,single-choice,spatial-relational,4|5,7,4/5,210472,4
1,2,21,473,1,1955,1,13,6,6,7,single-choice,spatial-relational,6|7,7,6/7,210473,6
1,2,21,474,1,1414,1,5,2,2,3,single-choice,spatial-relational,2|3,7,2/3,210474,2
1,2,21,475,0,1115,1,3,1,2,2,single-choice,spatial-relational,1|2,7,1/2,210475,1
1,2,21,476,0,1083,1,3,1,2,2,single-choice,spatial-relational,1|2,7,1/2,210476,1
1,2,21,477,0,808,1,7,3,4,4,single-choice,spatial-relational,3|4,7,3/4,210477,3
1,2,21,478,1,517,1,13,6,6,7,single-choice,spatial-relational,6|7,7,6/7,210478,6
1,2,21,479,0,2786,1,11,5,6,6,single-choice,spatial-relational,5|6,7,5/6,210479,5
1,2,21,480,1,755,1,9,4,4,5,single-choice,spatial-relational,4|5,7,4/5,210480,4
1,2,21,481,0,1238,1,7,3,4,4,single-choice,spatial-relational,3|4,7,3/4,210481,3
1,2,21,482,0,785,1,11,5,6,6,single-choice,spatial-relational,5|6,7,5/6,210482,5
1,2,21,483,0,1239,1,5,2,3,3,single-choice,spatial-relational,2|3,7,2/3,210483,2
1,2,21,484,0,702,1,3,1,2,2,single-choice,spatial-relational,1|2,7,1/2,210484,1
1,2,21,485,1,739,1,13,6,6,7,single-choice,spatial-relational,6|7,7,6/7,210485,6
1,2,21,486,1,1222,1,5,2,2,3,single-choice,spatial-relational,2|3,7,2/3,210486,2
1,2,21,487,0,881,1,9,4,5,5,single-choice,spatial-relational,4|5,7,4/5,210487,4
1,2,21,488,1,659,1,13,6,6,7,single-choice,spatial-relational,6|7,7,6/7,210488,6
1,2,21,489,0,1496,1,7,3,4,4,single-choice,spatial-relational,3|4,7,3/4,210489,3
1,2,21,490,1,1071,1,3,1,1,2,single-choice,spatial-relational,1|2,7,1/2,210490,1
1,2,21,491,1,1913,1,9,4,4,5,single-choice,spatial-relational,4|5,7,4/5,210491,4
1,2,21,492,0,1067,1,11,5,6,6,single-choice,spatial-relational,5|6,7,5/6,210492,5
1,2,21,493,0,1224,1,11,5,6,6,single-choice,spatial-relational,5|6,7,5/6,210493,5
1,2,21,494,0,1201,1,11,5,6,6,single-choice,spatial-relational,5|6,7,5/6,210494,5
1,2,21,495,1,644,1,13,6,6,7,single-choice,spatial-relational,6|7,7,6/7,210495,6
1,2,21,496,0,1362,1,3,1,2,2,single-choice,spatial-relational,1|2,7,1/2,210496,1
1,2,21,497,1,1745,1,9,4,4,5,single-choice,spatial-relational,4|5,7,4/5,210497,4
1,2,21,498,1,951,1,13,6,6,7,single-choice,spatial-relational,6|7,7,6/7,210498,6
1,2,21,499,0,3463,1,5,2,3,3,single-choice,spatial-relational,2|3,7,2/3,210499,2
1,2,21,500,1,1441,1,3,1,1,2,single-choice,spatial-relational,1|2,7,1/2,210500,1
1,2,21,501,1,948,1,9,4,4,5,single-choice,spatial-relational,4|5,7,4/5,210501,4
1,2,21,502,0,1761,1,7,3,4,4,single-choice,spatial-relational,3|4,7,3/4,210502,3
1,2,21,503,0,869,1,5,2,3,3,single-choice,spatial-relational,2|3,7,2/3,210503,2
1,2,21,504,0,589,1,7,3,4,4,single-choice,spatial-relational,3|4,7,3/4,210504,3
1,2,21,505,1,824,1,9,4,4,5,single-choice,spatial-relational,4|5,7,4/5,210505,4
1,2,21,506,1,1536,1,5,2,2,3,single-choice,spatial-relational,2|3,7,2/3,210506,2
1,2,21,507,0,1670,1,11,5,6,6,single-choice,spatial-relational,5|6,7,5/6,210507,5
1,2,21,508,1,598,1,13,6,6,7,single-choice,spatial-relational,6|7,7,6/7,210508,6
1,2,21,509,1,1126,1,3,1,1,2,single-choice,spatial-relational,1|2,7,1/2,210509,1
1,2,21,510,1,1449,1,3,1,1,2,single-choice,spatial-relational,1|2,7,1/2,210510,1
1,2,21,511,1,1466,1,11,5,5,6,single-choice,spatial-relational,5|6,7,5/6,210511,5
1,2,21,512,1,1826,1,13,6,6,7,single-choice,spatial-relational,6|7,7,6/7,210512,6
1,2,21,513,0,1132,1,7,3,4,4,single-choice,spatial-relational,3|4,7,3/4,210513,3
1,2,21,514,1,1137,1,9,4,4,5,single-choice,spatial-relational,4|5,7,4/5,210514,4
1,2,21,515,1,1467,1,5,2,2,3,single-choice,spatial-relational,2|3,7,2/3,210515,2
1,2,21,516,0,1325,1,7,3,4,4,single-choice,spatial-relational,3|4,7,3/4,210516,3
1,2,21,517,0,617,1,7,3,4,4,single-choice,spatial-relational,3|4,7,3/4,210517,3
1,2,21,518,1,1013,1,5,2,2,3,single-choice,spatial-relational,2|3,7,2/3,210518,2
1,2,21,519,0,747,1,7,3,4,4,single-choice,spatial-relational,3|4,7,3/4,210519,3
1,2,21,520,1,626,1,9,4,4,5,single-choice,spatial-relational,4|5,7,4/5,210520,4
1,2,21,521,1,1180,1,3,1,1,2,single-choice,spatial-relational,1|2,7,1/2,210521,1
1,2,21,522,1,1045,1,3,1,1,2,single-choice,spatial-relational,1|2,7,1/2,210522,1
1,2,21,523,1,1228,1,13,6,6,7,single-choice,spatial-relational,6|7,7,6/7,210523,6
1,2,21,524,1,831,1,13,6,6,7,single-choice,spatial-relational,6|7,7,6/7,210524,6
1,2,21,525,0,2274,1,11,5,6,6,single-choice,spatial-relational,5|6,7,5/6,210525,5
1,2,21,526,1,1252,1,5,2,2,3,single-choice,spatial-relational,2|3,7,2/3,210526,2
1,2,21,527,0,613,1,9,4,5,5,single-choice,spatial-relational,4|5,7,4/5,210527,4
1,2,21,528,0,539,1,11,5,6,6,single-choice,spatial-relational,5|6,7,5/6,210528,5
1,2,21,529,1,719,1,9,4,4,5,single-choice,spatial-relational,4|5,7,4/5,210529,4
1,2,21,530,0,1478,1,9,4,5,5,single-choice,spatial-relational,4|5,7,4/5,210530,4
1,2,21,531,1,743,1,5,2,2,3,single-choice,spatial-relational,2|3,7,2/3,210531,2
1,2,21,532,0,661,1,11,5,6,6,single-choice,spatial-relational,5|6,7,5/6,210532,5
1,2,21,533,1,1353,1,3,1,1,2,single-choice,spatial-relational,1|2,7,1/2,210533,1
1,2,21,534,0,889,1,7,3,4,4,single-choice,spatial-relational,3|4,7,3/4,210534,3
1,2,21,535,0,146,1,3,1,2,2,single-choice,spatial-relational,1|2,7,1/2,210535,1
1,2,21,536,1,48,1,13,6,6,7,single-choice,spatial-relational,6|7,7,6/7,210536,6
1,2,21,537,1,1721,1,13,6,6,7,single-choice,spatial-relational,6|7,7,6/7,210537,6
1,2,21,538,1,1383,1,5,2,2,3,single-choice,spatial-relational,2|3,7,2/3,210538,2
1,2,21,539,0,1312,1,7,3,4,4,single-choice,spatial-relational,3|4,7,3/4,210539,3
1,2,21,540,0,601,1,11,5,6,6,single-choice,spatial-relational,5|6,7,5/6,210540,5
1,2,21,541,1,532,1,9,4,4,5,single-choice,spatial-relational,4|5,7,4/5,210541,4
1,2,21,542,0,2232,1,9,4,5,5,single-choice,spatial-relational,4|5,7,4/5,210542,4
1,2,21,543,1,599,1,13,6,6,7,single-choice,spatial-relational,6|7,7,6/7,210543,6
1,2,21,544,1,1815,1,13,6,6,7,single-choice,spatial-relational,6|7,7,6/7,210544,6
1,2,21,545,1,1119,1,3,1,1,2,single-choice,spatial-relational,1|2,7,1/2,210545,1
1,2,21,546,0,1985,1,7,3,4,4,single-choice,spatial-relational,3|4,7,3/4,210546,3
1,2,21,547,1,894,1,5,2,2,3,single-choice,spatial-relational,2|3,7,2/3,210547,2
1,2,21,548,0,612,1,11,5,6,6,single-choice,spatial-relational,5|6,7,5/6,210548,5
1,2,21,549,0,592,1,11,5,6,6,single-choice,spatial-relational,5|6,7,5/6,210549,5
1,2,21,550,0,714,1,3,1,2,2,single-choice,spatial-relational,1|2,7,1/2,210550,1
1,2,21,551,0,112,1,5,2,3,3,single-choice,spatial-relational,2|3,7,2/3,210551,2
1,2,21,552,0,1320,1,7,3,4,4,single-choice,spatial-relational,3|4,7,3/4,210552,3
1,2,21,553,1,755,1,3,1,1,2,single-choice,spatial-relational,1|2,7,1/2,210553,1
1,2,21,554,0,1378,1,11,5,6,6,single-choice,spatial-relational,5|6,7,5/6,210554,5
1,2,21,555,0,727,1,7,3,4,4,single-choice,spatial-relational,3|4,7,3/4,210555,3
1,2,21,556,1,598,1,5,2,2,3,single-choice,spatial-relational,2|3,7,2/3,210556,2
1,2,21,557,0,2096,1,9,4,5,5,single-choice,spatial-relational,4|5,7,4/5,210557,4
1,2,21,558,1,624,1,13,6,6,7,single-choice,spatial-relational,6|7,7,6/7,210558,6
1,2,21,559,1,2118,1,3,1,1,2,single-choice,spatial-relational,1|2,7,1/2,210559,1
1,2,21,560,0,1478,1,9,4,5,5,single-choice,spatial-relational,4|5,7,4/5,210560,4
1,2,21,561,0,578,1,11,5,6,6,single-choice,spatial-relational,5|6,7,5/6,210561,5
1,2,21,562,1,495,1,13,6,6,7,single-choice,spatial-relational,6|7,7,6/7,210562,6
1,2,21,563,1,2109,1,7,3,3,4,single-choice,spatial-relational,3|4,7,3/4,210563,3
1,2,21,564,1,1122,1,5,2,2,3,single-choice,spatial-relational,2|3,7,2/3,210564,2
1,2,21,565,1,1184,1,3,1,1,2,single-choice,spatial-relational,1|2,7,1/2,210565,1
1,2,21,566,1,1026,1,3,1,1,2,single-choice,spatial-relational,1|2,7,1/2,210566,1
1,2,21,567,1,808,1,5,2,2,3,single-choice,spatial-relational,2|3,7,2/3,210567,2
1,2,21,568,0,1673,1,11,5,6,6,single-choice,spatial-relational,5|6,7,5/6,210568,5
1,2,21,569,1,2022,1,9,4,4,5,single-choice,spatial-relational,4|5,7,4/5,210569,4
1,2,21,570,1,1454,1,5,2,2,3,single-choice,spatial-relational,2|3,7,2/3,210570,2
1,2,21,571,1,1512,1,7,3,3,4,single-choice,spatial-relational,3|4,7,3/4,210571,3
1,2,21,572,1,862,1,13,6,6,7,single-choice,spatial-relational,6|7,7,6/7,210572,6
1,2,21,573,0,976,1,11,5,6,6,single-choice,spatial-relational,5|6,7,5/6,210573,5
1,2,21,574,1,519,1,13,6,6,7,single-choice,spatial-relational,6|7,7,6/7,210574,6
1,2,21,575,0,1937,1,9,4,5,5,single-choice,spatial-relational,4|5,7,4/5,210575,4
1,2,21,576,0,639,1,7,3,4,4,single-choice,spatial-relational,3|4,7,3/4,210576,3
1,2,21,577,0,717,1,3,1,2,2,single-choice,spatial-relational,1|2,7,1/2,210577,1
1,2,21,578,1,736,1,3,1,1,2,single-choice,spatial-relational,1|2,7,1/2,210578,1
1,2,21,579,1,635,1,13,6,6,7,single-choice,spatial-relational,6|7,7,6/7,210579,6
1,2,21,580,1,1733,1,5,2,2,3,single-choice,spatial-relational,2|3,7,2/3,210580,2
1,2,21,581,1,909,1,5,2,2,3,single-choice,spatial-relational,2|3,7,2/3,210581,2
1,2,21,582,0,1275,1,11,5,6,6,single-choice,spatial-relational,5|6,7,5/6,210582,5
1,2,21,583,1,604,1,13,6,6,7,single-choice,spatial-relational,6|7,7,6/7,210583,6
1,2,21,584,1,1878,1,9,4,4,5,single-choice,spatial-relational,4|5,7,4/5,210584,4
1,2,21,585,1,2211,1,9,4,4,5,single-choice,spatial-relational,4|5,7,4/5,210585,4
1,2,21,586,1,1912,1,7,3,3,4,single-choice,spatial-relational,3|4,7,3/4,210586,3
1,2,21,587,0,1423,1,11,5,6,6,single-choice,spatial-relational,5|6,7,5/6,210587,5
1,2,21,588,0,634,1,7,3,4,4,single-choice,spatial-relational,3|4,7,3/4,210588,3
1,2,21,589,1,1012,1,9,4,4,5,single-choice,spatial-relational,4|5,7,4/5,210589,4
1,2,21,590,1,1643,1,5,2,2,3,single-choice,spatial-relational,2|3,7,2/3,210590,2
1,2,21,591,1,1476,1,3,1,1,2,single-choice,spatial-relational,1|2,7,1/2,210591,1
1,2,21,592,1,881,1,3,1,1,2,single-choice,spatial-relational,1|2,7,1/2,210592,1
1,2,21,593,0,1203,1,11,5,6,6,single-choice,spatial-relational,5|6,7,5/6,210593,5
1,2,21,594,1,505,1,13,6,6,7,single-choice,spatial-relational,6|7,7,6/7,210594,6
1,2,21,595,1,911,1,5,2,2,3,single-choice,spatial-relational,2|3,7,2/3,210595,2
1,2,21,596,1,1446,1,13,6,6,7,single-choice,spatial-relational,6|7,7,6/7,210596,6
1,2,21,597,1,3512,1,7,3,3,4,single-choice,spatial-relational,3|4,7,3/4,210597,3
1,2,21,598,1,1265,1,7,3,3,4,single-choice,spatial-relational,3|4,7,3/4,210598,3
1,2,21,599,0,1350,1,11,5,6,6,single-choice,spatial-relational,5|6,7,5/6,210599,5
1,2,21,600,0,825,1,9,4,5,5,single-choice,spatial-relational,4|5,7,4/5,210600,4
2,2,21,1,0,674,1,5,2,3,3,single-choice,spatial-relational,2|3,7,2/3,210001,2
2,2,21,2,0,550,1,13,6,7,7,single-choice,spatial-relational,6|7,7,6/7,210002,6
2,2,21,3,0,1040,1,7,3,4,4,single-choice,spatial-relational,3|4,7,3/4,210003,3
2,2,21,4,1,974,1,3,1,1,2,single-choice,spatial-relational,1|2,7,1/2,210004,1
2,2,21,5,1,1322,1,9,4,4,5,single-choice,spatial-relational,4|5,7,4/5,210005,4
2,2,21,6,1,1295,1,13,6,6,7,single-choice,spatial-relational,6|7,7,6/7,210006,6
2,2,21,7,0,1611,1,3,1,2,2,single-choice,spatial-relational,1|2,7,1/2,210007,1
2,2,21,8,1,590,1,5,2,2,3,single-choice,spatial-relational,2|3,7,2/3,210008,2
2,2,21,9,1,1041,1,9,4,4,5,single-choice,spatial-relational,4|5,7,4/5,210009,4
2,2,21,10,1,53,1,11,5,5,6,single-choice,spatial-relational,5|6,7,5/6,210010,5
2,2,21,11,0,1073,1,7,3,4,4,single-choice,spatial-relational,3|4,7,3/4,210011,3
2,2,21,12,0,514,1,11,5,6,6,single-choice,spatial-relational,5|6,7,5/6,210012,5
2,2,21,13,0,704,1,7,3,4,4,single-choice,spatial-relational,3|4,7,3/4,210013,3
2,2,21,14,1,559,1,5,2,2,3,single-choice,spatial-relational,2|3,7,2/3,210014,2
2,2,21,15,0,866,1,11,5,6,6,single-choice,spatial-relational,5|6,7,5/6,210015,5
2,2,21,16,1,186,1,3,1,1,2,single-choice,spatial-relational,1|2,7,1/2,210016,1
2,2,21,17,1,810,1,7,3,3,4,single-choice,spatial-relational,3|4,7,3/4,210017,3
2,2,21,18,0,1502,1,3,1,2,2,single-choice,spatial-relational,1|2,7,1/2,210018,1
2,2,21,19,1,991,1,9,4,4,5,single-choice,spatial-relational,4|5,7,4/5,210019,4
2,2,21,20,1,1539,1,13,6,6,7,single-choice,spatial-relational,6|7,7,6/7,210020,6
2,2,21,21,1,1673,1,9,4,4,5,single-choice,spatial-relational,4|5,7,4/5,210021,4
2,2,21,22,1,813,1,13,6,6,7,single-choice,spatial-relational,6|7,7,6/7,210022,6
2,2,21,23,0,1173,1,11,5,6,6,single-choice,spatial-relational,5|6,7,5/6,210023,5
2,2,21,24,1,575,1,5,2,2,3,single-choice,spatial-relational,2|3,7,2/3,210024,2
2,2,21,25,1,974,1,9,4,4,5,single-choice,spatial-relational,4|5,7,4/5,210025,4
2,2,21,26,1,1613,1,7,3,3,4,single-choice,spatial-relational,3|4,7,3/4,210026,3
2,2,21,27,1,1397,1,9,4,4,5,single-choice,spatial-relational,4|5,7,4/5,210027,4
2,2,21,28,0,891,1,3,1,2,2,single-choice,spatial-relational,1|2,7,1/2,210028,1
2,2,21,29,1,509,1,13,6,6,7,single-choice,spatial-relational,6|7,7,6/7,210029,6
2,2,21,30,1,892,1,13,6,6,7,single-choice,spatial-relational,6|7,7,6/7,210030,6
2,2,21,31,0,1099,1,5,2,3,3,single-choice,spatial-relational,2|3,7,2/3,210031,2
2,2,21,32,0,513,1,11,5,6,6,single-choice,spatial-relational,5|6,7,5/6,210032,5
2,2,21,33,0,860,1,3,1,2,2,single-choice,spatial-relational,1|2,7,1/2,210033,1
2,2,21,34,0,452,1,11,5,6,6,single-choice,spatial-relational,5|6,7,5/6,210034,5
2,2,21,35,1,543,1,5,2,2,3,single-choice,spatial-relational,2|3,7,2/3,210035,2
2,2,21,36,0,801,1,7,3,4,4,single-choice,spatial-relational,3|4,7,3/4,210036,3
2,2,21,37,0,617,1,7,3,4,4,single-choice,spatial-relational,3|4,7,3/4,210037,3
2,2,21,38,0,535,1,3,1,2,2,single-choice,spatial-relational,1|2,7,1/2,210038,1
2,2,21,39,1,487,1,13,6,6,7,single-choice,spatial-relational,6|7,7,6/7,210039,6
2,2,21,40,0,1168,1,5,2,3,3,single-choice,spatial-relational,2|3,7,2/3,210040,2
2,2,21,41,0,1296,1,3,1,2,2,single-choice,spatial-relational,1|2,7,1/2,210041,1
2,2,21,42,1,584,1,9,4,4,5,single-choice,spatial-relational,4|5,7,4/5,210042,4
2,2,21,43,0,1340,1,11,5,6,6,single-choice,spatial-relational,5|6,7,5/6,210043,5
2,2,21,44,1,482,1,13,6,6,7,single-choice,spatial-relational,6|7,7,6/7,210044,6
2,2,21,45,0,994,1,7,3,4,4,single-choice,spatial-relational,3|4,7,3/4,210045,3
2,2,21,46,0,194,1,5,2,3,3,single-choice,spatial-relational,2|3,7,2/3,210046,2
2,2,21,47,0,447,1,11,5,6,6,single-choice,spatial-relational,5|6,7,5/6,210047,5
2,2,21,48,1,866,1,9,4,4,5,single-choice,spatial-relational,4|5,7,4/5,210048,4
2,2,21,49,0,1357,1,5,2,3,3,single-choice,spatial-relational,2|3,7,2/3,210049,2
2,2,21,50,0,1296,1,7,3,4,4,single-choice,spatial-relational,3|4,7,3/4,210050,3
2,2,21,51,1,1508,1,3,1,1,2,single-choice,spatial-relational,1|2,7,1/2,210051,1
2,2,21,52,0,845,1,5,2,3,3,single-choice,spatial-relational,2|3,7,2/3,210052,2
2,2,21,53,1,86,1,11,5,5,6,single-choice,spatial-relational,5|6,7,5/6,210053,5
2,2,21,54,1,2437,1,7,3,3,4,single-choice,spatial-relational,3|4,7,3/4,210054,3
2,2,21,55,0,1261,1,3,1,2,2,single-choice,spatial-relational,1|2,7,1/2,210055,1
2,2,21,56,1,868,1,9,4,4,5,single-choice,spatial-relational,4|5,7,4/5,210056,4
2,2,21,57,1,1781,1,13,6,6,7,single-choice,spatial-relational,6|7,7,6/7,210057,6
2,2,21,58,0,1180,1,11,5,6,6,single-choice,spatial-relational,5|6,7,5/6,210058,5
2,2,21,59,1,688,1,9,4,4,5,single-choice,spatial-relational,4|5,7,4/5,210059,4
2,2,21,60,1,751,1,13,6,6,7,single-choice,spatial-relational,6|7,7,6/7,210060,6
2,2,21,61,1,1158,1,13,6,6,7,single-choice,spatial-relational,6|7,7,6/7,210061,6
2,2,21,62,0,1832,1,5,2,3,3,single-choice,spatial-relational,2|3,7,2/3,210062,2
2,2,21,63,0,492,1,7,3,4,4,single-choice,spatial-relational,3|4,7,3/4,210063,3
2,2,21,64,0,778,1,11,5,6,6,single-choice,spatial-relational,5|6,7,5/6,210064,5
2,2,21,65,0,794,1,3,1,2,2,single-choice,spatial-relational,1|2,7,1/2,210065,1
2,2,21,66,0,507,1,11,5,6,6,single-choice,spatial-relational,5|6,7,5/6,210066,5
2,2,21,67,0,585,1,7,3,4,4,single-choice,spatial-relational,3|4,7,3/4,210067,3
2,2,21,68,1,1042,1,9,4,4,5,single-choice,spatial-relational,4|5,7,4/5,210068,4
2,2,21,69,1,1660,1,9,4,4,5,single-choice,spatial-relational,4|5,7,4/5,210069,4
2,2,21,70,1,1875,1,3,1,1,2,single-choice,spatial-relational,1|2,7,1/2,210070,1
2,2,21,71,1,1397,1,13,6,6,7,single-choice,spatial-relational,6|7,7,6/7,210071,6
2,2,21,72,0,1309,1,5,2,3,3,single-choice,spatial-relational,2|3,7,2/3,210072,2
2,2,21,73,0,501,1,11,5,6,6,single-choice,spatial-relational,5|6,7,5/6,210073,5
2,2,21,74,1,512,1,13,6,6,7,single-choice,spatial-relational,6|7,7,6/7,210074,6
2,2,21,75,1,1175,1,13,6,6,7,single-choice,spatial-relational,6|7,7,6/7,210075,6
2,2,21,76,0,1404,1,11,5,6,6,single-choice,spatial-relational,5|6,7,5/6,210076,5
2,2,21,77,1,954,1,3,1,1,2,single-choice,spatial-relational,1|2,7,1/2,210077,1
2,2,21,78,0,2259,1,5,2,3,3,single-choice,spatial-relational,2|3,7,2/3,210078,2
2,2,21,79,0,544,1,7,3,4,4,single-choice,spatial-relational,3|4,7,3/4,210079,3
2,2,21,80,1,804,1,9,4,4,5,single-choice,spatial-relational,4|5,7,4/5,210080,4
2,2,21,81,1,1197,1,3,1,1,2,single-choice,spatial-relational,1|2,7,1/2,210081,1
2,2,21,82,0,709,1,7,3,4,4,single-choice,spatial-relational,3|4,7,3/4,210082,3
2,2,21,83,1,1553,1,9,4,4,5,single-choice,spatial-relational,4|5,7,4/5,210083,4
2,2,21,84,1,1584,1,5,2,2,3,single-choice,spatial-relational,2|3,7,2/3,210084,2
2,2,21,85,1,1513,1,5,2,2,3,single-choice,spatial-relational,2|3,7,2/3,210085,2
2,2,21,86,0,1978,1,7,3,4,4,single-choice,spatial-relational,3|4,7,3/4,210086,3
2,2,21,87,0,1049,1,5,2,3,3,single-choice,spatial-relational,2|3,7,2/3,210087,2
2,2,21,88,1,492,1,13,6,6,7,single-choice,spatial-relational,6|7,7,6/7,210088,6
2,2,21,89,0,1296,1,11,5,6,6,single-choice,spatial-relational,5|6,7,5/6,210089,5
2,2,21,90,1,871,1,3,1,1,2,single-choice,spatial-relational,1|2,7,1/2,210090,1
2,2,21,91,1,1564,1,9,4,4,5,single-choice,spatial-relational,4|5,7,4/5,210091,4
2,2,21,92,0,1814,1,7,3,4,4,single-choice,spatial-relational,3|4,7,3/4,210092,3
2,2,21,93,1,576,1,13,6,6,7,single-choice,spatial-relational,6|7,7,6/7,210093,6
2,2,21,94,1,1263,1,3,1,1,2,single-choice,spatial-relational,1|2,7,1/2,210094,1
2,2,21,95,0,683,1,11,5,6,6,single-choice,spatial-relational,5|6,7,5/6,210095,5
2,2,21,96,1,916,1,9,4,4,5,single-choice,spatial-relational,4|5,7,4/5,210096,4
2,2,21,97,1,1425,1,13,6,6,7,single-choice,spatial-relational,6|7,7,6/7,210097,6
2,2,21,98,1,1182,1,3,1,1,2,single-choice,spatial-relational,1|2,7,1/2,210098,1
2,2,21,99,0,706,1,11,5,6,6,single-choice,spatial-relational,5|6,7,5/6,210099,5
2,2,21,100,1,763,1,5,2,2,3,single-choice,spatial-relational,2|3,7,2/3,210100,2
2,2,21,101,1,1096,1,13,6,6,7,single-choice,spatial-relational,6|7,7,6/7,210101,6
2,2,21,102,1,1733,1,5,2,2,3,single-choice,spatial-relational,2|3,7,2/3,210102,2
2,2,21,103,1,1446,1,9,4,4,5,single-choice,spatial-relational,4|5,7,4/5,210103,4
2,2,21,104,1,1570,1,9,4,4,5,single-choice,spatial-relational,4|5,7,4/5,210104,4
2,2,21,105,0,3505,1,7,3,4,4,single-choice,spatial-relational,3|4,7,3/4,210105,3
2,2,21,106,0,1067,1,11,5,6,6,single-choice,spatial-relational,5|6,7,5/6,210106,5
2,2,21,107,1,2329,1,7,3,3,4,single-choice,spatial-relational,3|4,7,3/4,210107,3
2,2,21,108,0,1323,1,3,1,2,2,single-choice,spatial-relational,1|2,7,1/2,210108,1
2,2,21,109,1,943,1,3,1,1,2,single-choice,spatial-relational,1|2,7,1/2,210109,1
2,2,21,110,1,1004,1,3,1,1,2,single-choice,spatial-relational,1|2,7,1/2,210110,1
2,2,21,111,1,1536,1,9,4,4,5,single-choice,spatial-relational,4|5,7,4/5,210111,4
2,2,21,112,0,2221,1,11,5,6,6,single-choice,spatial-relational,5|6,7,5/6,210112,5
2,2,21,113,0,515,1,11,5,6,6,single-choice,spatial-relational,5|6,7,5/6,210113,5
2,2,21,114,1,1320,1,5,2,2,3,single-choice,spatial-relational,2|3,7,2/3,210114,2
2,2,21,115,1,2395,1,13,6,6,7,single-choice,spatial-relational,6|7,7,6/7,210115,6
2,2,21,116,1,1111,1,5,2,2,3,single-choice,spatial-relational,2|3,7,2/3,210116,2
2,2,21,117,1,2167,1,9,4,4,5,single-choice,spatial-relational,4|5,7,4/5,210117,4
2,2,21,118,1,1455,1,7,3,3,4,single-choice,spatial-relational,3|4,7,3/4,210118,3
2,2,21,119,1,2260,1,13,6,6,7,single-choice,spatial-relational,6|7,7,6/7,210119,6
2,2,21,120,1,2380,1,7,3,3,4,single-choice,spatial-relational,3|4,7,3/4,210120,3
2,2,21,121,1,1891,1,9,4,4,5,single-choice,spatial-relational,4|5,7,4/5,210121,4
2,2,21,122,1,1357,1,9,4,4,5,single-choice,spatial-relational,4|5,7,4/5,210122,4
2,2,21,123,1,1340,1,7,3,3,4,single-choice,spatial-relational,3|4,7,3/4,210123,3
2,2,21,124,0,2019,1,3,1,2,2,single-choice,spatial-relational,1|2,7,1/2,210124,1
2,2,21,125,1,1065,1,7,3,3,4,single-choice,spatial-relational,3|4,7,3/4,210125,3
2,2,21,126,1,799,1,5,2,2,3,single-choice,spatial-relational,2|3,7,2/3,210126,2
2,2,21,127,0,1278,1,11,5,6,6,single-choice,spatial-relational,5|6,7,5/6,210127,5
2,2,21,128,1,1283,1,3,1,1,2,single-choice,spatial-relational,1|2,7,1/2,210128,1
2,2,21,129,0,1438,1,11,5,6,6,single-choice,spatial-relational,5|6,7,5/6,210129,5
2,2,21,130,1,793,1,13,6,6,7,single-choice,spatial-relational,6|7,7,6/7,210130,6
2,2,21,131,1,2886,1,13,6,6,7,single-choice,spatial-relational,6|7,7,6/7,210131,6
2,2,21,132,0,2139,1,5,2,3,3,single-choice,spatial-relational,2|3,7,2/3,210132,2
2,2,21,133,1,800,1,3,1,1,2,single-choice,spatial-relational,1|2,7,1/2,210133,1
2,2,21,134,1,2306,1,7,3,3,4,single-choice,spatial-relational,3|4,7,3/4,210134,3
2,2,21,135,0,2258,1,11,5,6,6,single-choice,spatial-relational,5|6,7,5/6,210135,5
2,2,21,136,1,1316,1,9,4,4,5,single-choice,spatial-relational,4|5,7,4/5,210136,4
2,2,21,137,1,912,1,5,2,2,3,single-choice,spatial-relational,2|3,7,2/3,210137,2
2,2,21,138,1,2041,1,5,2,2,3,single-choice,spatial-relational,2|3,7,2/3,210138,2
2,2,21,139,1,1829,1,13,6,6,7,single-choice,spatial-relational,6|7,7,6/7,210139,6
2,2,21,140,1,2450,1,13,6,6,7,single-choice,spatial-relational,6|7,7,6/7,210140,6
2,2,21,141,0,882,1,11,5,6,6,single-choice,spatial-relational,5|6,7,5/6,210141,5
2,2,21,142,1,610,1,3,1,1,2,single-choice,spatial-relational,1|2,7,1/2,210142,1
2,2,21,143,1,675,1,9,4,4,5,single-choice,spatial-relational,4|5,7,4/5,210143,4
2,2,21,144,1,2275,1,7,3,3,4,single-choice,spatial-relational,3|4,7,3/4,210144,3
2,2,21,145,1,1375,1,9,4,4,5,single-choice,spatial-relational,4|5,7,4/5,210145,4
2,2,21,146,0,1099,1,3,1,2,2,single-choice,spatial-relational,1|2,7,1/2,210146,1
2,2,21,147,0,634,1,7,3,4,4,single-choice,spatial-relational,3|4,7,3/4,210147,3
2,2,21,148,1,1115,1,7,3,3,4,single-choice,spatial-relational,3|4,7,3/4,210148,3
2,2,21,149,0,2528,1,11,5,6,6,single-choice,spatial-relational,5|6,7,5/6,210149,5
2,2,21,150,0,753,1,3,1,2,2,single-choice,spatial-relational,1|2,7,1/2,210150,1
2,2,21,151,1,1645,1,13,6,6,7,single-choice,spatial-relational,6|7,7,6/7,210151,6
2,2,21,152,1,3449,1,13,6,6,7,single-choice,spatial-relational,6|7,7,6/7,210152,6
2,2,21,153,1,1614,1,5,2,2,3,single-choice,spatial-relational,2|3,7,2/3,210153,2
2,2,21,154,1,1370,1,9,4,4,5,single-choice,spatial-relational,4|5,7,4/5,210154,4
2,2,21,155,0,3068,1,11,5,6,6,single-choice,spatial-relational,5|6,7,5/6,210155,5
2,2,21,156,0,801,1,5,2,3,3,single-choice,spatial-relational,2|3,7,2/3,210156,2
2,2,21,157,1,746,1,13,6,6,7,single-choice,spatial-relational,6|7,7,6/7,210157,6
2,2,21,158,1,1800,1,9,4,4,5,single-choice,spatial-relational,4|5,7,4/5,210158,4
2,2,21,159,0,2995,1,11,5,6,6,single-choice,spatial-relational,5|6,7,5/6,210159,5
2,2,21,160,0,2804,1,7,3,4,4,single-choice,spatial-relational,3|4,7,3/4,210160,3
2,2,21,161,0,544,1,11,5,6,6,single-choice,spatial-relational,5|6,7,5/6,210161,5
2,2,21,162,1,1149,1,7,3,3,4,single-choice,spatial-relational,3|4,7,3/4,210162,3
2,2,21,163,1,3295,1,13,6,6,7,single-choice,spatial-relational,6|7,7,6/7,210163,6
2,2,21,164,1,911,1,5,2,2,3,single-choice,spatial-relational,2|3,7,2/3,210164,2
2,2,21,165,1,1241,1,3,1,1,2,single-choice,spatial-relational,1|2,7,1/2,210165,1
2,2,21,166,1,1348,1,5,2,2,3,single-choice,spatial-relational,2|3,7,2/3,210166,2
2,2,21,167,0,1126,1,3,1,2,2,single-choice,spatial-relational,1|2,7,1/2,210167,1
2,2,21,168,1,1103,1,9,4,4,5,single-choice,spatial-relational,4|5,7,4/5,210168,4
2,2,21,169,1,1224,1,5,2,2,3,single-choice,spatial-relational,2|3,7,2/3,210169,2
2,2,21,170,1,1837,1,7,3,3,4,single-choice,spatial-relational,3|4,7,3/4,210170,3
2,2,21,171,0,4049,1,11,5,6,6,single-choice,spatial-relational,5|6,7,5/6,210171,5
2,2,21,172,1,1161,1,11,5,5,6,single-choice,spatial-relational,5|6,7,5/6,210172,5
2,2,21,173,1,1791,1,7,3,3,4,single-choice,spatial-relational,3|4,7,3/4,210173,3
2,2,21,174,0,1673,1,13,6,7,7,single-choice,spatial-relational,6|7,7,6/7,210174,6
2,2,21,175,1,797,1,5,2,2,3,single-choice,spatial-relational,2|3,7,2/3,210175,2
2,2,21,176,1,1840,1,3,1,1,2,single-choice,spatial-relational,1|2,7,1/2,210176,1
2,2,21,177,1,989,1,9,4,4,5,single-choice,spatial-relational,4|5,7,4/5,210177,4
2,2,21,178,1,1153,1,3,1,1,2,single-choice,spatial-relational,1|2,7,1/2,210178,1
2,2,21,179,1,1201,1,9,4,4,5,single-choice,spatial-relational,4|5,7,4/5,210179,4
2,2,21,180,1,1871,1,13,6,6,7,single-choice,spatial-relational,6|7,7,6/7,210180,6
2,2,21,181,1,1617,1,7,3,3,4,single-choice,spatial-relational,3|4,7,3/4,210181,3
2,2,21,182,1,1712,1,13,6,6,7,single-choice,spatial-relational,6|7,7,6/7,210182,6
2,2,21,183,0,1597,1,3,1,2,2,single-choice,spatial-relational,1|2,7,1/2,210183,1
2,2,21,184,0,1760,1,13,6,7,7,single-choice,spatial-relational,6|7,7,6/7,210184,6
2,2,21,185,1,830,1,9,4,4,5,single-choice,spatial-relational,4|5,7,4/5,210185,4
2,2,21,186,0,2460,1,7,3,4,4,single-choice,spatial-relational,3|4,7,3/4,210186,3
2,2,21,187,1,1106,1,11,5,5,6,single-choice,spatial-relational,5|6,7,5/6,210187,5
2,2,21,188,0,1076,1,5,2,3,3,single-choice,spatial-relational,2|3,7,2/3,210188,2
2,2,21,189,1,2045,1,3,1,1,2,single-choice,spatial-relational,1|2,7,1/2,210189,1
2,2,21,190,0,1406,1,11,5,6,6,single-choice,spatial-relational,5|6,7,5/6,210190,5
2,2,21,191,1,721,1,5,2,2,3,single-choice,spatial-relational,2|3,7,2/3,210191,2
2,2,21,192,1,1011,1,9,4,4,5,single-choice,spatial-relational,4|5,7,4/5,210192,4
2,2,21,193,1,799,1,9,4,4,5,single-choice,spatial-relational,4|5,7,4/5,210193,4
2,2,21,194,0,2494,1,7,3,4,4,single-choice,spatial-relational,3|4,7,3/4,210194,3
2,2,21,195,1,1446,1,13,6,6,7,single-choice,spatial-relational,6|7,7,6/7,210195,6
2,2,21,196,0,959,1,3,1,2,2,single-choice,spatial-relational,1|2,7,1/2,210196,1
2,2,21,197,0,601,1,7,3,4,4,single-choice,spatial-relational,3|4,7,3/4,210197,3
2,2,21,198,1,1996,1,11,5,5,6,single-choice,spatial-relational,5|6,7,5/6,210198,5
2,2,21,199,1,789,1,5,2,2,3,single-choice,spatial-relational,2|3,7,2/3,210199,2
2,2,21,200,1,1086,1,9,4,4,5,single-choice,spatial-relational,4|5,7,4/5,210200,4
2,2,21,201,1,1377,1,13,6,6,7,single-choice,spatial-relational,6|7,7,6/7,210201,6
2,2,21,202,1,1162,1,11,5,5,6,single-choice,spatial-relational,5|6,7,5/6,210202,5
2,2,21,203,1,2858,1,3,1,1,2,single-choice,spatial-relational,1|2,7,1/2,210203,1
2,2,21,204,1,999,1,5,2,2,3,single-choice,spatial-relational,2|3,7,2/3,210204,2
2,2,21,205,0,1252,1,7,3,4,4,single-choice,spatial-relational,3|4,7,3/4,210205,3
2,2,21,206,1,1028,1,11,5,5,6,single-choice,spatial-relational,5|6,7,5/6,210206,5
2,2,21,207,1,960,1,5,2,2,3,single-choice,spatial-relational,2|3,7,2/3,210207,2
2,2,21,208,1,1771,1,13,6,6,7,single-choice,spatial-relational,6|7,7,6/7,210208,6
2,2,21,209,1,1265,1,13,6,6,7,single-choice,spatial-relational,6|7,7,6/7,210209,6
2,2,21,210,1,1579,1,7,3,3,4,single-choice,spatial-relational,3|4,7,3/4,210210,3
2,2,21,211,1,877,1,5,2,2,3,single-choice,spatial-relational,2|3,7,2/3,210211,2
2,2,21,212,1,1424,1,11,5,5,6,single-choice,spatial-relational,5|6,7,5/6,210212,5
2,2,21,213,0,1900,1,9,4,5,5,single-choice,spatial-relational,4|5,7,4/5,210213,4
2,2,21,214,0,1164,1,3,1,2,2,single-choice,spatial-relational,1|2,7,1/2,210214,1
2,2,21,215,0,754,1,3,1,2,2,single-choice,spatial-relational,1|2,7,1/2,210215,1
2,2,21,216,1,1700,1,9,4,4,5,single-choice,spatial-relational,4|5,7,4/5,210216,4
2,2,21,217,1,1696,1,9,4,4,5,single-choice,spatial-relational,4|5,7,4/5,210217,4
2,2,21,218,1,1950,1,9,4,4,5,single-choice,spatial-relational,4|5,7,4/5,210218,4
2,2,21,219,1,1966,1,11,5,5,6,single-choice,spatial-relational,5|6,7,5/6,210219,5
2,2,21,220,0,1072,1,3,1,2,2,single-choice,spatial-relational,1|2,7,1/2,210220,1
2,2,21,221,1,966,1,11,5,5,6,single-choice,spatial-relational,5|6,7,5/6,210221,5
2,2,21,222,1,1440,1,13,6,6,7,single-choice,spatial-relational,6|7,7,6/7,210222,6
2,2,21,223,1,2519,1,7,3,3,4,single-choice,spatial-relational,3|4,7,3/4,210223,3
2,2,21,224,1,1781,1,7,3,3,4,single-choice,spatial-relational,3|4,7,3/4,210224,3
2,2,21,225,1,1783,1,13,6,6,7,single-choice,spatial-relational,6|7,7,6/7,210225,6
2,2,21,226,0,1122,1,3,1,2,2,single-choice,spatial-relational,1|2,7,1/2,210226,1
2,2,21,227,0,1348,1,5,2,3,3,single-choice,spatial-relational,2|3,7,2/3,210227,2
2,2,21,228,1,1541,1,5,2,2,3,single-choice,spatial-relational,2|3,7,2/3,210228,2
2,2,21,229,0,882,1,3,1,2,2,single-choice,spatial-relational,1|2,7,1/2,210229,1
2,2,21,230,1,1814,1,5,2,2,3,single-choice,spatial-relational,2|3,7,2/3,210230,2
2,2,21,231,1,830,1,9,4,4,5,single-choice,spatial-relational,4|5,7,4/5,210231,4
2,2,21,232,1,1223,1,13,6,6,7,single-choice,spatial-relational,6|7,7,6/7,210232,6
2,2,21,233,1,1479,1,9,4,4,5,single-choice,spatial-relational,4|5,7,4/5,210233,4
2,2,21,234,0,3181,1,11,5,6,6,single-choice,spatial-relational,5|6,7,5/6,210234,5
2,2,21,235,1,1175,1,3,1,1,2,single-choice,spatial-relational,1|2,7,1/2,210235,1
2,2,21,236,1,1073,1,13,6,6,7,single-choice,spatial-relational,6|7,7,6/7,210236,6
2,2,21,237,1,1588,1,5,2,2,3,single-choice,spatial-relational,2|3,7,2/3,210237,2
2,2,21,238,1,1262,1,7,3,3,4,single-choice,spatial-relational,3|4,7,3/4,210238,3
2,2,21,239,1,1458,1,11,5,5,6,single-choice,spatial-relational,5|6,7,5/6,210239,5
2,2,21,240,0,1490,1,7,3,4,4,single-choice,spatial-relational,3|4,7,3/4,210240,3
2,2,21,241,1,2303,1,11,5,5,6,single-choice,spatial-relational,5|6,7,5/6,210241,5
2,2,21,242,1,2116,1,13,6,6,7,single-choice,spatial-relational,6|7,7,6/7,210242,6
2,2,21,243,1,1524,1,5,2,2,3,single-choice,spatial-relational,2|3,7,2/3,210243,2
2,2,21,244,1,799,1,9,4,4,5,single-choice,spatial-relational,4|5,7,4/5,210244,4
2,2,21,245,1,2572,1,13,6,6,7,single-choice,spatial-relational,6|7,7,6/7,210245,6
2,2,21,246,0,1289,1,3,1,2,2,single-choice,spatial-relational,1|2,7,1/2,210246,1
2,2,21,247,0,707,1,3,1,2,2,single-choice,spatial-relational,1|2,7,1/2,210247,1
2,2,21,248,1,2298,1,5,2,2,3,single-choice,spatial-relational,2|3,7,2/3,210248,2
2,2,21,249,0,1048,1,9,4,5,5,single-choice,spatial-relational,4|5,7,4/5,210249,4
2,2,21,250,1,1140,1,7,3,3,4,single-choice,spatial-relational,3|4,7,3/4,210250,3
2,2,21,251,1,1110,1,7,3,3,4,single-choice,spatial-relational,3|4,7,3/4,210251,3
2,2,21,252,0,1165,1,11,5,6,6,single-choice,spatial-relational,5|6,7,5/6,210252,5
2,2,21,253,1,2605,1,13,6,6,7,single-choice,spatial-relational,6|7,7,6/7,210253,6
2,2,21,254,1,1265,1,5,2,2,3,single-choice,spatial-relational,2|3,7,2/3,210254,2
2,2,21,255,1,1400,1,9,4,4,5,single-choice,spatial-relational,4|5,7,4/5,210255,4
2,2,21,256,1,1332,1,11,5,5,6,single-choice,spatial-relational,5|6,7,5/6,210256,5
2,2,21,257,1,1191,1,3,1,1,2,single-choice,spatial-relational,1|2,7,1/2,210257,1
2,2,21,258,1,1836,1,3,1,1,2,single-choice,spatial-relational,1|2,7,1/2,210258,1
2,2,21,259,0,2018,1,11,5,6,6,single-choice,spatial-relational,5|6,7,5/6,210259,5
2,2,21,260,0,547,1,7,3,4,4,single-choice,spatial-relational,3|4,7,3/4,210260,3
2,2,21,261,1,687,1,13,6,6,7,single-choice,spatial-relational,6|7,7,6/7,210261,6
2,2,21,262,1,1744,1,9,4,4,5,single-choice,spatial-relational,4|5,7,4/5,210262,4
2,2,21,263,0,2768,1,5,2,3,3,single-choice,spatial-relational,2|3,7,2/3,210263,2
2,2,21,264,1,1011,1,7,3,3,4,single-choice,spatial-relational,3|4,7,3/4,210264,3
2,2,21,265,1,1353,1,13,6,6,7,single-choice,spatial-relational,6|7,7,6/7,210265,6
2,2,21,266,1,2167,1,5,2,2,3,single-choice,spatial-relational,2|3,7,2/3,210266,2
2,2,21,267,1,3318,1,11,5,5,6,single-choice,spatial-relational,5|6,7,5/6,210267,5
2,2,21,268,1,1226,1,11,5,5,6,single-choice,spatial-relational,5|6,7,5/6,210268,5
2,2,21,269,1,835,1,9,4,4,5,single-choice,spatial-relational,4|5,7,4/5,210269,4
2,2,21,270,0,1049,1,5,2,3,3,single-choice,spatial-relational,2|3,7,2/3,210270,2
2,2,21,271,1,916,1,7,3,3,4,single-choice,spatial-relational,3|4,7,3/4,210271,3
2,2,21,272,1,2119,1,3,1,1,2,single-choice,spatial-relational,1|2,7,1/2,210272,1
2,2,21,273,1,1017,1,13,6,6,7,single-choice,spatial-relational,6|7,7,6/7,210273,6
2,2,21,274,1,1437,1,9,4,4,5,single-choice,spatial-relational,4|5,7,4/5,210274,4
2,2,21,275,0,1270,1,3,1,2,2,single-choice,spatial-relational,1|2,7,1/2,210275,1
2,2,21,276,1,1209,1,7,3,3,4,single-choice,spatial-relational,3|4,7,3/4,210276,3
2,2,21,277,1,1958,1,5,2,2,3,single-choice,spatial-relational,2|3,7,2/3,210277,2
2,2,21,278,0,1135,1,5,2,3,3,single-choice,spatial-relational,2|3,7,2/3,210278,2
2,2,21,279,1,1201,1,9,4,4,5,single-choice,spatial-relational,4|5,7,4/5,210279,4
2,2,21,280,1,1114,1,7,3,3,4,single-choice,spatial-relational,3|4,7,3/4,210280,3
2,2,21,281,1,1450,1,13,6,6,7,single-choice,spatial-relational,6|7,7,6/7,210281,6
2,2,21,282,1,1174,1,13,6,6,7,single-choice,spatial-relational,6|7,7,6/7,210282,6
2,2,21,283,1,2282,1,7,3,3,4,single-choice,spatial-relational,3|4,7,3/4,210283,3
2,2,21,284,1,3618,1,11,5,5,6,single-choice,spatial-relational,5|6,7,5/6,210284,5
2,2,21,285,0,1314,1,3,1,2,2,single-choice,spatial-relational,1|2,7,1/2,210285,1
2,2,21,286,1,935,1,11,5,5,6,single-choice,spatial-relational,5|6,7,5/6,210286,5
2,2,21,287,1,1244,1,3,1,1,2,single-choice,spatial-relational,1|2,7,1/2,210287,1
2,2,21,288,1,1200,1,9,4,4,5,single-choice,spatial-relational,4|5,7,4/5,210288,4
2,2,21,289,1,1633,1,11,5,5,6,single-choice,spatial-relational,5|6,7,5/6,210289,5
2,2,21,290,1,1123,1,11,5,5,6,single-choice,spatial-relational,5|6,7,5/6,210290,5
2,2,21,291,0,1164,1,5,2,3,3,single-choice,spatial-relational,2|3,7,2/3,210291,2
2,2,21,292,0,1364,1,9,4,5,5,single-choice,spatial-relational,4|5,7,4/5,210292,4
2,2,21,293,1,881,1,7,3,3,4,single-choice,spatial-relational,3|4,7,3/4,210293,3
2,2,21,294,1,1118,1,3,1,1,2,single-choice,spatial-relational,1|2,7,1/2,210294,1
2,2,21,295,0,804,1,7,3,4,4,single-choice,spatial-relational,3|4,7,3/4,210295,3
2,2,21,296,1,1419,1,3,1,1,2,single-choice,spatial-relational,1|2,7,1/2,210296,1
2,2,21,297,1,1069,1,13,6,6,7,single-choice,spatial-relational,6|7,7,6/7,210297,6
2,2,21,298,1,2079,1,5,2,2,3,single-choice,spatial-relational,2|3,7,2/3,210298,2
2,2,21,299,0,1599,1,9,4,5,5,single-choice,spatial-relational,4|5,7,4/5,210299,4
2,2,21,300,1,1302,1,13,6,6,7,single-choice,spatial-relational,6|7,7,6/7,210300,6
2,2,21,301,1,1518,1,5,2,2,3,single-choice,spatial-relational,2|3,7,2/3,210301,2
2,2,21,302,1,1900,1,11,5,5,6,single-choice,spatial-relational,5|6,7,5/6,210302,5
2,2,21,303,0,1010,1,3,1,2,2,single-choice,spatial-relational,1|2,7,1/2,210303,1
2,2,21,304,1,896,1,3,1,1,2,single-choice,spatial-relational,1|2,7,1/2,210304,1
2,2,21,305,1,1062,1,13,6,6,7,single-choice,spatial-relational,6|7,7,6/7,210305,6
2,2,21,306,0,1361,1,11,5,6,6,single-choice,spatial-relational,5|6,7,5/6,210306,5
2,2,21,307,0,1045,1,5,2,3,3,single-choice,spatial-relational,2|3,7,2/3,210307,2
2,2,21,308,1,1443,1,13,6,6,7,single-choice,spatial-relational,6|7,7,6/7,210308,6
2,2,21,309,1,1866,1,7,3,3,4,single-choice,spatial-relational,3|4,7,3/4,210309,3
2,2,21,310,1,1207,1,7,3,3,4,single-choice,spatial-relational,3|4,7,3/4,210310,3
2,2,21,311,1,2042,1,9,4,4,5,single-choice,spatial-relational,4|5,7,4/5,210311,4
2,2,21,312,0,1478,1,9,4,5,5,single-choice,spatial-relational,4|5,7,4/5,210312,4
2,2,21,313,1,1132,1,3,1,1,2,single-choice,spatial-relational,1|2,7,1/2,210313,1
2,2,21,314,0,1255,1,3,1,2,2,single-choice,spatial-relational,1|2,7,1/2,210314,1
2,2,21,315,1,1435,1,5,2,2,3,single-choice,spatial-relational,2|3,7,2/3,210315,2
2,2,21,316,1,1437,1,7,3,3,4,single-choice,spatial-relational,3|4,7,3/4,210316,3
2,2,21,317,1,2019,1,9,4,4,5,single-choice,spatial-relational,4|5,7,4/5,210317,4
2,2,21,318,1,1310,1,9,4,4,5,single-choice,spatial-relational,4|5,7,4/5,210318,4
2,2,21,319,1,1573,1,7,3,3,4,single-choice,spatial-relational,3|4,7,3/4,210319,3
2,2,21,320,1,1352,1,13,6,6,7,single-choice,spatial-relational,6|7,7,6/7,210320,6
2,2,21,321,1,1595,1,13,6,6,7,single-choice,spatial-relational,6|7,7,6/7,210321,6
2,2,21,322,1,2126,1,11,5,5,6,single-choice,spatial-relational,5|6,7,5/6,210322,5
2,2,21,323,1,1177,1,11,5,5,6,single-choice,spatial-relational,5|6,7,5/6,210323,5
2,2,21,324,0,1901,1,5,2,3,3,single-choice,spatial-relational,2|3,7,2/3,210324,2
2,2,21,325,1,1088,1,13,6,6,7,single-choice,spatial-relational,6|7,7,6/7,210325,6
2,2,21,326,1,1481,1,9,4,4,5,single-choice,spatial-relational,4|5,7,4/5,210326,4
2,2,21,327,0,2154,1,5,2,3,3,single-choice,spatial-relational,2|3,7,2/3,210327,2
2,2,21,328,1,747,1,13,6,6,7,single-choice,spatial-relational,6|7,7,6/7,210328,6
2,2,21,329,0,1209,1,3,1,2,2,single-choice,spatial-relational,1|2,7,1/2,210329,1
2,2,21,330,1,3272,1,7,3,3,4,single-choice,spatial-relational,3|4,7,3/4,210330,3
2,2,21,331,1,1318,1,3,1,1,2,single-choice,spatial-relational,1|2,7,1/2,210331,1
2,2,21,332,1,1397,1,7,3,3,4,single-choice,spatial-relational,3|4,7,3/4,210332,3
2,2,21,333,0,1256,1,11,5,6,6,single-choice,spatial-relational,5|6,7,5/6,210333,5
2,2,21,334,1,1125,1,5,2,2,3,single-choice,spatial-relational,2|3,7,2/3,210334,2
2,2,21,335,1,1558,1,9,4,4,5,single-choice,spatial-relational,4|5,7,4/5,210335,4
2,2,21,336,0,3655,1,11,5,6,6,single-choice,spatial-relational,5|6,7,5/6,210336,5
2,2,21,337,1,1254,1,7,3,3,4,single-choice,spatial-relational,3|4,7,3/4,210337,3
2,2,21,338,1,163,1,5,2,2,3,single-choice,spatial-relational,2|3,7,2/3,210338,2
2,2,21,339,1,1790,1,9,4,4,5,single-choice,spatial-relational,4|5,7,4/5,210339,4
2,2,21,340,1,3056,1,9,4,4,5,single-choice,spatial-relational,4|5,7,4/5,210340,4
2,2,21,341,1,1295,1,11,5,5,6,single-choice,spatial-relational,5|6,7,5/6,210341,5
2,2,21,342,0,1330,1,13,6,7,7,single-choice,spatial-relational,6|7,7,6/7,210342,6
2,2,21,343,1,1302,1,3,1,1,2,single-choice,spatial-relational,1|2,7,1/2,210343,1
2,2,21,344,1,788,1,13,6,6,7,single-choice,spatial-relational,6|7,7,6/7,210344,6
2,2,21,345,1,1319,1,3,1,1,2,single-choice,spatial-relational,1|2,7,1/2,210345,1
2,2,21,346,0,1675,1,11,5,6,6,single-choice,spatial-relational,5|6,7,5/6,210346,5
2,2,21,347,1,973,1,7,3,3,4,single-choice,spatial-relational,3|4,7,3/4,210347,3
2,2,21,348,0,1029,1,5,2,3,3,single-choice,spatial-relational,2|3,7,2/3,210348,2
2,2,21,349,1,1455,1,13,6,6,7,single-choice,spatial-relational,6|7,7,6/7,210349,6
2,2,21,350,1,2435,1,9,4,4,5,single-choice,spatial-relational,4|5,7,4/5,210350,4
2,2,21,351,0,1302,1,11,5,6,6,single-choice,spatial-relational,5|6,7,5/6,210351,5
2,2,21,352,0,580,1,11,5,6,6,single-choice,spatial-relational,5|6,7,5/6,210352,5
2,2,21,353,1,1666,1,7,3,3,4,single-choice,spatial-relational,3|4,7,3/4,210353,3
2,2,21,354,1,1606,1,5,2,2,3,single-choice,spatial-relational,2|3,7,2/3,210354,2
2,2,21,355,0,990,1,3,1,2,2,single-choice,spatial-relational,1|2,7,1/2,210355,1
2,2,21,356,1,1149,1,3,1,1,2,single-choice,spatial-relational,1|2,7,1/2,210356,1
2,2,21,357,1,1294,1,13,6,6,7,single-choice,spatial-relational,6|7,7,6/7,210357,6
2,2,21,358,0,1185,1,5,2,3,3,single-choice,spatial-relational,2|3,7,2/3,210358,2
2,2,21,359,1,1291,1,7,3,3,4,single-choice,spatial-relational,3|4,7,3/4,210359,3
2,2,21,360,1,1898,1,9,4,4,5,single-choice,spatial-relational,4|5,7,4/5,210360,4
2,2,21,361,1,1311,1,7,3,3,4,single-choice,spatial-relational,3|4,7,3/4,210361,3
2,2,21,362,0,1244,1,3,1,2,2,single-choice,spatial-relational,1|2,7,1/2,210362,1
2,2,21,363,1,1517,1,9,4,4,5,single-choice,spatial-relational,4|5,7,4/5,210363,4
2,2,21,364,1,968,1,3,1,1,2,single-choice,spatial-relational,1|2,7,1/2,210364,1
2,2,21,365,1,874,1,9,4,4,5,single-choice,spatial-relational,4|5,7,4/5,210365,4
2,2,21,366,1,1700,1,11,5,5,6,single-choice,spatial-relational,5|6,7,5/6,210366,5
2,2,21,367,0,2459,1,5,2,3,3,single-choice,spatial-relational,2|3,7,2/3,210367,2
2,2,21,368,1,1285,1,7,3,3,4,single-choice,spatial-relational,3|4,7,3/4,210368,3
2,2,21,369,0,1607,1,13,6,7,7,single-choice,spatial-relational,6|7,7,6/7,210369,6
2,2,21,370,1,1097,1,11,5,5,6,single-choice,spatial-relational,5|6,7,5/6,210370,5
2,2,21,371,1,1387,1,13,6,6,7,single-choice,spatial-relational,6|7,7,6/7,210371,6
2,2,21,372,1,1433,1,5,2,2,3,single-choice,spatial-relational,2|3,7,2/3,210372,2
2,2,21,373,0,751,1,7,3,4,4,single-choice,spatial-relational,3|4,7,3/4,210373,3
2,2,21,374,1,1153,1,13,6,6,7,single-choice,spatial-relational,6|7,7,6/7,210374,6
2,2,21,375,1,1836,1,11,5,5,6,single-choice,spatial-relational,5|6,7,5/6,210375,5
2,2,21,376,1,1463,1,3,1,1,2,single-choice,spatial-relational,1|2,7,1/2,210376,1
2,2,21,377,1,957,1,3,1,1,2,single-choice,spatial-relational,1|2,7,1/2,210377,1
2,2,21,378,1,1340,1,5,2,2,3,single-choice,spatial-relational,2|3,7,2/3,210378,2
2,2,21,379,1,1695,1,9,4,4,5,single-choice,spatial-relational,4|5,7,4/5,210379,4
2,2,21,380,1,1943,1,7,3,3,4,single-choice,spatial-relational,3|4,7,3/4,210380,3
2,2,21,381,0,1756,1,11,5,6,6,single-choice,spatial-relational,5|6,7,5/6,210381,5
2,2,21,382,1,1042,1,5,2,2,3,single-choice,spatial-relational,2|3,7,2/3,210382,2
2,2,21,383,1,1300,1,13,6,6,7,single-choice,spatial-relational,6|7,7,6/7,210383,6
2,2,21,384,1,845,1,9,4,4,5,single-choice,spatial-relational,4|5,7,4/5,210384,4
2,2,21,385,1,1395,1,3,1,1,2,single-choice,spatial-relational,1|2,7,1/2,210385,1
2,2,21,386,1,1397,1,13,6,6,7,single-choice,spatial-relational,6|7,7,6/7,210386,6
2,2,21,387,1,134,1,7,3,3,4,single-choice,spatial-relational,3|4,7,3/4,210387,3
2,2,21,388,1,1375,1,5,2,2,3,single-choice,spatial-relational,2|3,7,2/3,210388,2
2,2,21,389,1,1432,1,9,4,4,5,single-choice,spatial-relational,4|5,7,4/5,210389,4
2,2,21,390,1,959,1,11,5,5,6,single-choice,spatial-relational,5|6,7,5/6,210390,5
2,2,21,391,0,1089,1,11,5,6,6,single-choice,spatial-relational,5|6,7,5/6,210391,5
2,2,21,392,1,969,1,13,6,6,7,single-choice,spatial-relational,6|7,7,6/7,210392,6
2,2,21,393,1,944,1,5,2,2,3,single-choice,spatial-relational,2|3,7,2/3,210393,2
2,2,21,394,0,1223,1,7,3,4,4,single-choice,spatial-relational,3|4,7,3/4,210394,3
2,2,21,395,1,1157,1,3,1,1,2,single-choice,spatial-relational,1|2,7,1/2,210395,1
2,2,21,396,1,1188,1,9,4,4,5,single-choice,spatial-relational,4|5,7,4/5,210396,4
2,2,21,397,0,2784,1,11,5,6,6,single-choice,spatial-relational,5|6,7,5/6,210397,5
2,2,21,398,1,921,1,9,4,4,5,single-choice,spatial-relational,4|5,7,4/5,210398,4
2,2,21,399,1,2027,1,5,2,2,3,single-choice,spatial-relational,2|3,7,2/3,210399,2
2,2,21,400,1,1321,1,11,5,5,6,single-choice,spatial-relational,5|6,7,5/6,210400,5
2,2,21,401,1,951,1,3,1,1,2,single-choice,spatial-relational,1|2,7,1/2,210401,1
2,2,21,402,1,1529,1,13,6,6,7,single-choice,spatial-relational,6|7,7,6/7,210402,6
2,2,21,403,0,1376,1,7,3,4,4,single-choice,spatial-relational,3|4,7,3/4,210403,3
2,2,21,404,0,657,1,3,1,2,2,single-choice,spatial-relational,1|2,7,1/2,210404,1
2,2,21,405,1,1125,1,5,2,2,3,single-choice,spatial-relational,2|3,7,2/3,210405,2
2,2,21,406,0,1644,1,13,6,7,7,single-choice,spatial-relational,6|7,7,6/7,210406,6
2,2,21,407,1,1860,1,7,3,3,4,single-choice,spatial-relational,3|4,7,3/4,210407,3
2,2,21,408,1,1437,1,9,4,4,5,single-choice,spatial-relational,4|5,7,4/5,210408,4
2,2,21,409,1,892,1,3,1,1,2,single-choice,spatial-relational,1|2,7,1/2,210409,1
2,2,21,410,1,982,1,13,6,6,7,single-choice,spatial-relational,6|7,7,6/7,210410,6
2,2,21,411,1,1397,1,5,2,2,3,single-choice,spatial-relational,2|3,7,2/3,210411,2
2,2,21,412,1,1504,1,7,3,3,4,single-choice,spatial-relational,3|4,7,3/4,210412,3
2,2,21,413,1,1509,1,9,4,4,5,single-choice,spatial-relational,4|5,7,4/5,210413,4
2,2,21,414,1,1748,1,13,6,6,7,single-choice,spatial-relational,6|7,7,6/7,210414,6
2,2,21,415,0,1522,1,11,5,6,6,single-choice,spatial-relational,5|6,7,5/6,210415,5
2,2,21,416,1,851,1,3,1,1,2,single-choice,spatial-relational,1|2,7,1/2,210416,1
2,2,21,417,1,1114,1,7,3,3,4,single-choice,spatial-relational,3|4,7,3/4,210417,3
2,2,21,418,1,1342,1,11,5,5,6,single-choice,spatial-relational,5|6,7,5/6,210418,5
2,2,21,419,0,1278,1,5,2,3,3,single-choice,spatial-relational,2|3,7,2/3,210419,2
2,2,21,420,1,1349,1,9,4,4,5,single-choice,spatial-relational,4|5,7,4/5,210420,4
2,2,21,421,1,1262,1,11,5,5,6,single-choice,spatial-relational,5|6,7,5/6,210421,5
2,2,21,422,1,1213,1,13,6,6,7,single-choice,spatial-relational,6|7,7,6/7,210422,6
2,2,21,423,1,2502,1,11,5,5,6,single-choice,spatial-relational,5|6,7,5/6,210423,5
2,2,21,424,1,1515,1,3,1,1,2,single-choice,spatial-relational,1|2,7,1/2,210424,1
2,2,21,425,1,743,1,9,4,4,5,single-choice,spatial-relational,4|5,7,4/5,210425,4
2,2,21,426,0,1012,1,5,2,3,3,single-choice,spatial-relational,2|3,7,2/3,210426,2
2,2,21,427,1,2154,1,9,4,4,5,single-choice,spatial-relational,4|5,7,4/5,210427,4
2,2,21,428,1,1258,1,7,3,3,4,single-choice,spatial-relational,3|4,7,3/4,210428,3
2,2,21,429,1,1612,1,7,3,3,4,single-choice,spatial-relational,3|4,7,3/4,210429,3
2,2,21,430,1,1260,1,5,2,2,3,single-choice,spatial-relational,2|3,7,2/3,210430,2
2,2,21,431,1,1488,1,13,6,6,7,single-choice,spatial-relational,6|7,7,6/7,210431,6
2,2,21,432,0,851,1,3,1,2,2,single-choice,spatial-relational,1|2,7,1/2,210432,1
2,2,21,433,1,985,1,13,6,6,7,single-choice,spatial-relational,6|7,7,6/7,210433,6
2,2,21,434,1,1819,1,3,1,1,2,single-choice,spatial-relational,1|2,7,1/2,210434,1
2,2,21,435,1,1747,1,7,3,3,4,single-choice,spatial-relational,3|4,7,3/4,210435,3
2,2,21,436,1,1483,1,9,4,4,5,single-choice,spatial-relational,4|5,7,4/5,210436,4
2,2,21,437,1,1597,1,7,3,3,4,single-choice,spatial-relational,3|4,7,3/4,210437,3
2,2,21,438,0,2303,1,11,5,6,6,single-choice,spatial-relational,5|6,7,5/6,210438,5
2,2,21,439,0,900,1,5,2,3,3,single-choice,spatial-relational,2|3,7,2/3,210439,2
2,2,21,440,1,982,1,13,6,6,7,single-choice,spatial-relational,6|7,7,6/7,210440,6
2,2,21,441,0,1809,1,9,4,5,5,single-choice,spatial-relational,4|5,7,4/5,210441,4
2,2,21,442,1,1019,1,3,1,1,2,single-choice,spatial-relational,1|2,7,1/2,210442,1
2,2,21,443,0,994,1,5,2,3,3,single-choice,spatial-relational,2|3,7,2/3,210443,2
2,2,21,444,1,1080,1,11,5,5,6,single-choice,spatial-relational,5|6,7,5/6,210444,5
2,2,21,445,1,1144,1,11,5,5,6,single-choice,spatial-relational,5|6,7,5/6,210445,5
2,2,21,446,1,915,1,3,1,1,2,single-choice,spatial-relational,1|2,7,1/2,210446,1
2,2,21,447,1,1294,1,5,2,2,3,single-choice,spatial-relational,2|3,7,2/3,210447,2
2,2,21,448,1,1333,1,13,6,6,7,single-choice,spatial-relational,6|7,7,6/7,210448,6
2,2,21,449,1,1679,1,13,6,6,7,single-choice,spatial-relational,6|7,7,6/7,210449,6
2,2,21,450,0,822,1,5,2,3,3,single-choice,spatial-relational,2|3,7,2/3,210450,2
2,2,21,451,1,1707,1,9,4,4,5,single-choice,spatial-relational,4|5,7,4/5,210451,4
2,2,21,452,1,2381,1,11,5,5,6,single-choice,spatial-relational,5|6,7,5/6,210452,5
2,2,21,453,1,1399,1,9,4,4,5,single-choice,spatial-relational,4|5,7,4/5,210453,4
2,2,21,454,1,1488,1,7,3,3,4,single-choice,spatial-relational,3|4,7,3/4,210454,3
2,2,21,455,0,1000,1,3,1,2,2,single-choice,spatial-relational,1|2,7,1/2,210455,1
2,2,21,456,1,854,1,7,3,3,4,single-choice,spatial-relational,3|4,7,3/4,210456,3
2,2,21,457,1,1607,1,7,3,3,4,single-choice,spatial-relational,3|4,7,3/4,210457,3
2,2,21,458,1,2046,1,9,4,4,5,single-choice,spatial-relational,4|5,7,4/5,210458,4
2,2,21,459,0,664,1,5,2,3,3,single-choice,spatial-relational,2|3,7,2/3,210459,2
2,2,21,460,1,1219,1,13,6,6,7,single-choice,spatial-relational,6|7,7,6/7,210460,6
2,2,21,461,1,1768,1,11,5,5,6,single-choice,spatial-relational,5|6,7,5/6,210461,5
2,2,21,462,1,1770,1,9,4,4,5,single-choice,spatial-relational,4|5,7,4/5,210462,4
2,2,21,463,1,1373,1,7,3,3,4,single-choice,spatial-relational,3|4,7,3/4,210463,3
2,2,21,464,1,2066,1,3,1,1,2,single-choice,spatial-relational,1|2,7,1/2,210464,1
2,2,21,465,1,1564,1,13,6,6,7,single-choice,spatial-relational,6|7,7,6/7,210465,6
2,2,21,466,1,160,1,11,5,5,6,single-choice,spatial-relational,5|6,7,5/6,210466,5
2,2,21,467,1,2274,1,5,2,2,3,single-choice,spatial-relational,2|3,7,2/3,210467,2
2,2,21,468,0,1053,1,3,1,2,2,single-choice,spatial-relational,1|2,7,1/2,210468,1
2,2,21,469,0,1109,1,9,4,5,5,single-choice,spatial-relational,4|5,7,4/5,210469,4
2,2,21,470,1,1062,1,7,3,3,4,single-choice,spatial-relational,3|4,7,3/4,210470,3
2,2,21,471,1,1083,1,5,2,2,3,single-choice,spatial-relational,2|3,7,2/3,210471,2
2,2,21,472,1,1025,1,5,2,2,3,single-choice,spatial-relational,2|3,7,2/3,210472,2
2,2,21,473,0,1383,1,11,5,6,6,single-choice,spatial-relational,5|6,7,5/6,210473,5
2,2,21,474,1,1728,1,13,6,6,7,single-choice,spatial-relational,6|7,7,6/7,210474,6
2,2,21,475,0,967,1,3,1,2,2,single-choice,spatial-relational,1|2,7,1/2,210475,1
2,2,21,476,1,896,1,7,3,3,4,single-choice,spatial-relational,3|4,7,3/4,210476,3
2,2,21,477,1,1227,1,9,4,4,5,single-choice,spatial-relational,4|5,7,4/5,210477,4
2,2,21,478,1,961,1,3,1,1,2,single-choice,spatial-relational,1|2,7,1/2,210478,1
2,2,21,479,1,1568,1,11,5,5,6,single-choice,spatial-relational,5|6,7,5/6,210479,5
2,2,21,480,1,1732,1,13,6,6,7,single-choice,spatial-relational,6|7,7,6/7,210480,6
2,2,21,481,0,980,1,7,3,4,4,single-choice,spatial-relational,3|4,7,3/4,210481,3
2,2,21,482,1,1731,1,11,5,5,6,single-choice,spatial-relational,5|6,7,5/6,210482,5
2,2,21,483,1,1353,1,9,4,4,5,single-choice,spatial-relational,4|5,7,4/5,210483,4
2,2,21,484,1,1476,1,5,2,2,3,single-choice,spatial-relational,2|3,7,2/3,210484,2
2,2,21,485,0,966,1,3,1,2,2,single-choice,spatial-relational,1|2,7,1/2,210485,1
2,2,21,486,1,618,1,13,6,6,7,single-choice,spatial-relational,6|7,7,6/7,210486,6
2,2,21,487,0,1002,1,3,1,2,2,single-choice,spatial-relational,1|2,7,1/2,210487,1
2,2,21,488,1,1059,1,7,3,3,4,single-choice,spatial-relational,3|4,7,3/4,210488,3
2,2,21,489,1,2582,1,13,6,6,7,single-choice,spatial-relational,6|7,7,6/7,210489,6
2,2,21,490,0,2133,1,11,5,6,6,single-choice,spatial-relational,5|6,7,5/6,210490,5
2,2,21,491,1,1271,1,5,2,2,3,single-choice,spatial-relational,2|3,7,2/3,210491,2
2,2,21,492,1,1223,1,9,4,4,5,single-choice,spatial-relational,4|5,7,4/5,210492,4
2,2,21,493,1,1863,1,5,2,2,3,single-choice,spatial-relational,2|3,7,2/3,210493,2
2,2,21,494,1,1236,1,5,2,2,3,single-choice,spatial-relational,2|3,7,2/3,210494,2
2,2,21,495,1,1078,1,9,4,4,5,single-choice,spatial-relational,4|5,7,4/5,210495,4
2,2,21,496,1,1581,1,7,3,3,4,single-choice,spatial-relational,3|4,7,3/4,210496,3
2,2,21,497,0,1526,1,9,4,5,5,single-choice,spatial-relational,4|5,7,4/5,210497,4
2,2,21,498,1,1024,1,3,1,1,2,single-choice,spatial-relational,1|2,7,1/2,210498,1
2,2,21,499,0,873,1,13,6,7,7,single-choice,spatial-relational,6|7,7,6/7,210499,6
2,2,21,500,1,2341,1,7,3,3,4,single-choice,spatial-relational,3|4,7,3/4,210500,3
2,2,21,501,1,945,1,11,5,5,6,single-choice,spatial-relational,5|6,7,5/6,210501,5
2,2,21,502,1,1164,1,13,6,6,7,single-choice,spatial-relational,6|7,7,6/7,210502,6
2,2,21,503,1,1549,1,11,5,5,6,single-choice,spatial-relational,5|6,7,5/6,210503,5
2,2,21,504,1,888,1,3,1,1,2,single-choice,spatial-relational,1|2,7,1/2,210504,1
2,2,21,505,1,894,1,7,3,3,4,single-choice,spatial-relational,3|4,7,3/4,210505,3
2,2,21,506,0,981,1,3,1,2,2,single-choice,spatial-relational,1|2,7,1/2,210506,1
2,2,21,507,0,1333,1,5,2,3,3,single-choice,spatial-relational,2|3,7,2/3,210507,2
2,2,21,508,1,1240,1,7,3,3,4,single-choice,spatial-relational,3|4,7,3/4,210508,3
2,2,21,509,0,1164,1,5,2,3,3,single-choice,spatial-relational,2|3,7,2/3,210509,2
2,2,21,510,1,971,1,13,6,6,7,single-choice,spatial-relational,6|7,7,6/7,210510,6
2,2,21,511,0,2095,1,3,1,2,2,single-choice,spatial-relational,1|2,7,1/2,210511,1
2,2,21,512,1,1053,1,11,5,5,6,single-choice,spatial-relational,5|6,7,5/6,210512,5
2,2,21,513,1,1507,1,9,4,4,5,single-choice,spatial-relational,4|5,7,4/5,210513,4
2,2,21,514,1,937,1,11,5,5,6,single-choice,spatial-relational,5|6,7,5/6,210514,5
2,2,21,515,0,1387,1,9,4,5,5,single-choice,spatial-relational,4|5,7,4/5,210515,4
2,2,21,516,1,944,1,13,6,6,7,single-choice,spatial-relational,6|7,7,6/7,210516,6
2,2,21,517,1,1180,1,3,1,1,2,single-choice,spatial-relational,1|2,7,1/2,210517,1
2,2,21,518,1,808,1,9,4,4,5,single-choice,spatial-relational,4|5,7,4/5,210518,4
2,2,21,519,0,1653,1,5,2,3,3,single-choice,spatial-relational,2|3,7,2/3,210519,2
2,2,21,520,1,40,1,13,6,6,7,single-choice,spatial-relational,6|7,7,6/7,210520,6
2,2,21,521,1,1799,1,9,4,4,5,single-choice,spatial-relational,4|5,7,4/5,210521,4
2,2,21,522,1,1582,1,3,1,1,2,single-choice,spatial-relational,1|2,7,1/2,210522,1
2,2,21,523,0,811,1,5,2,3,3,single-choice,spatial-relational,2|3,7,2/3,210523,2
2,2,21,524,1,1163,1,7,3,3,4,single-choice,spatial-relational,3|4,7,3/4,210524,3
2,2,21,525,0,971,1,7,3,4,4,single-choice,spatial-relational,3|4,7,3/4,210525,3
2,2,21,526,1,1995,1,11,5,5,6,single-choice,spatial-relational,5|6,7,5/6,210526,5
2,2,21,527,0,1424,1,13,6,7,7,single-choice,spatial-relational,6|7,7,6/7,210527,6
2,2,21,528,1,914,1,11,5,5,6,single-choice,spatial-relational,5|6,7,5/6,210528,5
2,2,21,529,1,1886,1,13,6,6,7,single-choice,spatial-relational,6|7,7,6/7,210529,6
2,2,21,530,1,1319,1,5,2,2,3,single-choice,spatial-relational,2|3,7,2/3,210530,2
2,2,21,531,1,1045,1,13,6,6,7,single-choice,spatial-relational,6|7,7,6/7,210531,6
2,2,21,532,1,1300,1,11,5,5,6,single-choice,spatial-relational,5|6,7,5/6,210532,5
2,2,21,533,1,1303,1,7,3,3,4,single-choice,spatial-relational,3|4,7,3/4,210533,3
2,2,21,534,1,1353,1,11,5,5,6,single-choice,spatial-relational,5|6,7,5/6,210534,5
2,2,21,535,0,1676,1,7,3,4,4,single-choice,spatial-relational,3|4,7,3/4,210535,3
2,2,21,536,0,983,1,5,2,3,3,single-choice,spatial-relational,2|3,7,2/3,210536,2
2,2,21,537,0,1014,1,9,4,5,5,single-choice,spatial-relational,4|5,7,4/5,210537,4
2,2,21,538,1,964,1,3,1,1,2,single-choice,spatial-relational,1|2,7,1/2,210538,1
2,2,21,539,0,1602,1,3,1,2,2,single-choice,spatial-relational,1|2,7,1/2,210539,1
2,2,21,540,0,849,1,9,4,5,5,single-choice,spatial-relational,4|5,7,4/5,210540,4
2,2,21,541,0,943,1,9,4,5,5,single-choice,spatial-relational,4|5,7,4/5,210541,4
2,2,21,542,0,1420,1,11,5,6,6,single-choice,spatial-relational,5|6,7,5/6,210542,5
2,2,21,543,1,1217,1,5,2,2,3,single-choice,spatial-relational,2|3,7,2/3,210543,2
2,2,21,544,0,1023,1,3,1,2,2,single-choice,spatial-relational,1|2,7,1/2,210544,1
2,2,21,545,1,1437,1,7,3,3,4,single-choice,spatial-relational,3|4,7,3/4,210545,3
2,2,21,546,1,1471,1,7,3,3,4,single-choice,spatial-relational,3|4,7,3/4,210546,3
2,2,21,547,1,1349,1,13,6,6,7,single-choice,spatial-relational,6|7,7,6/7,210547,6
2,2,21,548,1,1373,1,13,6,6,7,single-choice,spatial-relational,6|7,7,6/7,210548,6
2,2,21,549,1,2015,1,11,5,5,6,single-choice,spatial-relational,5|6,7,5/6,210549,5
2,2,21,550,1,1332,1,3,1,1,2,single-choice,spatial-relational,1|2,7,1/2,210550,1
2,2,21,551,1,1231,1,5,2,2,3,single-choice,spatial-relational,2|3,7,2/3,210551,2
2,2,21,552,1,1282,1,9,4,4,5,single-choice,spatial-relational,4|5,7,4/5,210552,4
2,2,21,553,1,1163,1,11,5,5,6,single-choice,spatial-relational,5|6,7,5/6,210553,5
2,2,21,554,0,1502,1,9,4,5,5,single-choice,spatial-relational,4|5,7,4/5,210554,4
2,2,21,555,1,1549,1,13,6,6,7,single-choice,spatial-relational,6|7,7,6/7,210555,6
2,2,21,556,0,1161,1,3,1,2,2,single-choice,spatial-relational,1|2,7,1/2,210556,1
2,2,21,557,0,1335,1,5,2,3,3,single-choice,spatial-relational,2|3,7,2/3,210557,2
2,2,21,558,0,1030,1,3,1,2,2,single-choice,spatial-relational,1|2,7,1/2,210558,1
2,2,21,559,1,752,1,13,6,6,7,single-choice,spatial-relational,6|7,7,6/7,210559,6
2,2,21,560,1,1921,1,7,3,3,4,single-choice,spatial-relational,3|4,7,3/4,210560,3
2,2,21,561,1,1448,1,5,2,2,3,single-choice,spatial-relational,2|3,7,2/3,210561,2
2,2,21,562,1,1187,1,9,4,4,5,single-choice,spatial-relational,4|5,7,4/5,210562,4
2,2,21,563,0,1342,1,11,5,6,6,single-choice,spatial-relational,5|6,7,5/6,210563,5
2,2,21,564,1,1180,1,7,3,3,4,single-choice,spatial-relational,3|4,7,3/4,210564,3
2,2,21,565,1,1628,1,7,3,3,4,single-choice,spatial-relational,3|4,7,3/4,210565,3
2,2,21,566,1,849,1,3,1,1,2,single-choice,spatial-relational,1|2,7,1/2,210566,1
2,2,21,567,1,1344,1,5,2,2,3,single-choice,spatial-relational,2|3,7,2/3,210567,2
2,2,21,568,0,1315,1,3,1,2,2,single-choice,spatial-relational,1|2,7,1/2,210568,1
2,2,21,569,0,1360,1,9,4,5,5,single-choice,spatial-relational,4|5,7,4/5,210569,4
2,2,21,570,0,2049,1,9,4,5,5,single-choice,spatial-relational,4|5,7,4/5,210570,4
2,2,21,571,1,1584,1,13,6,6,7,single-choice,spatial-relational,6|7,7,6/7,210571,6
2,2,21,572,1,1719,1,7,3,3,4,single-choice,spatial-relational,3|4,7,3/4,210572,3
2,2,21,573,1,2244,1,11,5,5,6,single-choice,spatial-relational,5|6,7,5/6,210573,5
2,2,21,574,1,1640,1,11,5,5,6,single-choice,spatial-relational,5|6,7,5/6,210574,5
2,2,21,575,1,743,1,13,6,6,7,single-choice,spatial-relational,6|7,7,6/7,210575,6
2,2,21,576,1,46880,1,5,2,2,3,single-choice,spatial-relational,2|3,7,2/3,210576,2
2,2,21,577,1,1172,1,13,6,6,7,single-choice,spatial-relational,6|7,7,6/7,210577,6
2,2,21,578,1,1457,1,13,6,6,7,single-choice,spatial-relational,6|7,7,6/7,210578,6
2,2,21,579,0,1071,1,5,2,3,3,single-choice,spatial-relational,2|3,7,2/3,210579,2
2,2,21,580,1,1048,1,11,5,5,6,single-choice,spatial-relational,5|6,7,5/6,210580,5
2,2,21,581,1,9996,1,7,3,3,4,single-choice,spatial-relational,3|4,7,3/4,210581,3
2,2,21,582,0,1406,1,11,5,6,6,single-choice,spatial-relational,5|6,7,5/6,210582,5
2,2,21,583,0,783,1,5,2,3,3,single-choice,spatial-relational,2|3,7,2/3,210583,2
2,2,21,584,1,1015,1,7,3,3,4,single-choice,spatial-relational,3|4,7,3/4,210584,3
2,2,21,585,1,1222,1,9,4,4,5,single-choice,spatial-relational,4|5,7,4/5,210585,4
2,2,21,586,0,815,1,3,1,2,2,single-choice,spatial-relational,1|2,7,1/2,210586,1
2,2,21,587,1,931,1,3,1,1,2,single-choice,spatial-relational,1|2,7,1/2,210587,1
2,2,21,588,1,1371,1,9,4,4,5,single-choice,spatial-relational,4|5,7,4/5,210588,4
2,2,21,589,0,1542,1,11,5,6,6,single-choice,spatial-relational,5|6,7,5/6,210589,5
2,2,21,590,1,1055,1,7,3,3,4,single-choice,spatial-relational,3|4,7,3/4,210590,3
2,2,21,591,1,2296,1,3,1,1,2,single-choice,spatial-relational,1|2,7,1/2,210591,1
2,2,21,592,1,742,1,5,2,2,3,single-choice,spatial-relational,2|3,7,2/3,210592,2
2,2,21,593,1,1974,1,11,5,5,6,single-choice,spatial-relational,5|6,7,5/6,210593,5
2,2,21,594,1,1117,1,13,6,6,7,single-choice,spatial-relational,6|7,7,6/7,210594,6
2,2,21,595,1,1132,1,9,4,4,5,single-choice,spatial-relational,4|5,7,4/5,210595,4
2,2,21,596,1,1502,1,13,6,6,7,single-choice,spatial-relational,6|7,7,6/7,210596,6
2,2,21,597,0,891,1,7,3,4,4,single-choice,spatial-relational,3|4,7,3/4,210597,3
2,2,21,598,0,954,1,9,4,5,5,single-choice,spatial-relational,4|5,7,4/5,210598,4
2,2,21,599,0,774,1,3,1,2,2,single-choice,spatial-relational,1|2,7,1/2,210599,1
2,2,21,600,0,673,1,5,2,3,3,single-choice,spatial-relational,2|3,7,2/3,210600,2
3,2,21,1,0,830,1,7,3,4,4,single-choice,spatial-relational,3|4,7,3/4,210001,3
3,2,21,2,1,170,1,11,5,5,6,single-choice,spatial-relational,5|6,7,5/6,210002,5
3,2,21,3,1,871,1,13,6,6,7,single-choice,spatial-relational,6|7,7,6/7,210003,6
3,2,21,4,0,1192,1,3,1,2,2,single-choice,spatial-relational,1|2,7,1/2,210004,1
3,2,21,5,0,1715,1,9,4,5,5,single-choice,spatial-relational,4|5,7,4/5,210005,4
3,2,21,6,0,1247,1,5,2,3,3,single-choice,spatial-relational,2|3,7,2/3,210006,2
3,2,21,7,0,696,1,7,3,4,4,single-choice,spatial-relational,3|4,7,3/4,210007,3
3,2,21,8,0,528,1,11,5,6,6,single-choice,spatial-relational,5|6,7,5/6,210008,5
3,2,21,9,1,784,1,5,2,2,3,single-choice,spatial-relational,2|3,7,2/3,210009,2
3,2,21,10,0,913,1,3,1,2,2,single-choice,spatial-relational,1|2,7,1/2,210010,1
3,2,21,11,1,1430,1,9,4,4,5,single-choice,spatial-relational,4|5,7,4/5,210011,4
3,2,21,12,1,1245,1,13,6,6,7,single-choice,spatial-relational,6|7,7,6/7,210012,6
3,2,21,13,1,2826,1,5,2,2,3,single-choice,spatial-relational,2|3,7,2/3,210013,2
3,2,21,14,0,2541,1,7,3,4,4,single-choice,spatial-relational,3|4,7,3/4,210014,3
3,2,21,15,1,806,1,3,1,1,2,single-choice,spatial-relational,1|2,7,1/2,210015,1
3,2,21,16,1,1378,1,9,4,4,5,single-choice,spatial-relational,4|5,7,4/5,210016,4
3,2,21,17,1,1791,1,9,4,4,5,single-choice,spatial-relational,4|5,7,4/5,210017,4
3,2,21,18,1,3241,1,7,3,3,4,single-choice,spatial-relational,3|4,7,3/4,210018,3
3,2,21,19,1,1338,1,3,1,1,2,single-choice,spatial-relational,1|2,7,1/2,210019,1
3,2,21,20,1,2190,1,5,2,2,3,single-choice,spatial-relational,2|3,7,2/3,210020,2
3,2,21,21,0,1857,1,11,5,6,6,single-choice,spatial-relational,5|6,7,5/6,210021,5
3,2,21,22,1,642,1,13,6,6,7,single-choice,spatial-relational,6|7,7,6/7,210022,6
3,2,21,23,1,1770,1,13,6,6,7,single-choice,spatial-relational,6|7,7,6/7,210023,6
3,2,21,24,1,1295,1,11,5,5,6,single-choice,spatial-relational,5|6,7,5/6,210024,5
3,2,21,25,1,2316,1,3,1,1,2,single-choice,spatial-relational,1|2,7,1/2,210025,1
3,2,21,26,1,1081,1,13,6,6,7,single-choice,spatial-relational,6|7,7,6/7,210026,6
3,2,21,27,0,2047,1,9,4,5,5,single-choice,spatial-relational,4|5,7,4/5,210027,4
3,2,21,28,0,567,1,7,3,4,4,single-choice,spatial-relational,3|4,7,3/4,210028,3
3,2,21,29,1,863,1,7,3,3,4,single-choice,spatial-relational,3|4,7,3/4,210029,3
3,2,21,30,1,1221,1,11,5,5,6,single-choice,spatial-relational,5|6,7,5/6,210030,5
3,2,21,31,1,2884,1,5,2,2,3,single-choice,spatial-relational,2|3,7,2/3,210031,2
3,2,21,32,0,1048,1,11,5,6,6,single-choice,spatial-relational,5|6,7,5/6,210032,5
3,2,21,33,1,649,1,13,6,6,7,single-choice,spatial-relational,6|7,7,6/7,210033,6
3,2,21,34,1,1679,1,9,4,4,5,single-choice,spatial-relational,4|5,7,4/5,210034,4
3,2,21,35,0,2101,1,5,2,3,3,single-choice,spatial-relational,2|3,7,2/3,210035,2
3,2,21,36,1,165,1,3,1,1,2,single-choice,spatial-relational,1|2,7,1/2,210036,1
3,2,21,37,1,1395,1,9,4,4,5,single-choice,spatial-relational,4|5,7,4/5,210037,4
3,2,21,38,1,1271,1,7,3,3,4,single-choice,spatial-relational,3|4,7,3/4,210038,3
3,2,21,39,0,4398,1,5,2,3,3,single-choice,spatial-relational,2|3,7,2/3,210039,2
3,2,21,40,1,960,1,13,6,6,7,single-choice,spatial-relational,6|7,7,6/7,210040,6
3,2,21,41,1,1238,1,5,2,2,3,single-choice,spatial-relational,2|3,7,2/3,210041,2
3,2,21,42,1,1382,1,3,1,1,2,single-choice,spatial-relational,1|2,7,1/2,210042,1
3,2,21,43,1,2801,1,11,5,5,6,single-choice,spatial-relational,5|6,7,5/6,210043,5
3,2,21,44,0,1168,1,3,1,2,2,single-choice,spatial-relational,1|2,7,1/2,210044,1
3,2,21,45,1,1048,1,13,6,6,7,single-choice,spatial-relational,6|7,7,6/7,210045,6
3,2,21,46,1,1544,1,9,4,4,5,single-choice,spatial-relational,4|5,7,4/5,210046,4
3,2,21,47,1,1874,1,7,3,3,4,single-choice,spatial-relational,3|4,7,3/4,210047,3
3,2,21,48,1,1833,1,11,5,5,6,single-choice,spatial-relational,5|6,7,5/6,210048,5
3,2,21,49,1,1897,1,9,4,4,5,single-choice,spatial-relational,4|5,7,4/5,210049,4
3,2,21,50,0,1365,1,7,3,4,4,single-choice,spatial-relational,3|4,7,3/4,210050,3
3,2,21,51,1,926,1,3,1,1,2,single-choice,spatial-relational,1|2,7,1/2,210051,1
3,2,21,52,1,1841,1,5,2,2,3,single-choice,spatial-relational,2|3,7,2/3,210052,2
3,2,21,53,1,1152,1,13,6,6,7,single-choice,spatial-relational,6|7,7,6/7,210053,6
3,2,21,54,1,1107,1,11,5,5,6,single-choice,spatial-relational,5|6,7,5/6,210054,5
3,2,21,55,1,1470,1,7,3,3,4,single-choice,spatial-relational,3|4,7,3/4,210055,3
3,2,21,56,1,1198,1,11,5,5,6,single-choice,spatial-relational,5|6,7,5/6,210056,5
3,2,21,57,1,3585,1,5,2,2,3,single-choice,spatial-relational,2|3,7,2/3,210057,2
3,2,21,58,1,1029,1,3,1,1,2,single-choice,spatial-relational,1|2,7,1/2,210058,1
3,2,21,59,0,888,1,9,4,5,5,single-choice,spatial-relational,4|5,7,4/5,210059,4
3,2,21,60,1,984,1,13,6,6,7,single-choice,spatial-relational,6|7,7,6/7,210060,6
3,2,21,61,0,1445,1,11,5,6,6,single-choice,spatial-relational,5|6,7,5/6,210061,5
3,2,21,62,0,1412,1,9,4,5,5,single-choice,spatial-relational,4|5,7,4/5,210062,4
3,2,21,63,1,1190,1,13,6,6,7,single-choice,spatial-relational,6|7,7,6/7,210063,6
3,2,21,64,1,1962,1,13,6,6,7,single-choice,spatial-relational,6|7,7,6/7,210064,6
3,2,21,65,0,1385,1,5,2,3,3,single-choice,spatial-relational,2|3,7,2/3,210065,2
3,2,21,66,1,675,1,3,1,1,2,single-choice,spatial-relational,1|2,7,1/2,210066,1
3,2,21,67,1,1588,1,9,4,4,5,single-choice,spatial-relational,4|5,7,4/5,210067,4
3,2,21,68,1,1772,1,7,3,3,4,single-choice,spatial-relational,3|4,7,3/4,210068,3
3,2,21,69,1,2499,1,11,5,5,6,single-choice,spatial-relational,5|6,7,5/6,210069,5
3,2,21,70,1,1012,1,3,1,1,2,single-choice,spatial-relational,1|2,7,1/2,210070,1
3,2,21,71,1,1647,1,7,3,3,4,single-choice,spatial-relational,3|4,7,3/4,210071,3
3,2,21,72,1,1423,1,5,2,2,3,single-choice,spatial-relational,2|3,7,2/3,210072,2
3,2,21,73,1,1068,1,7,3,3,4,single-choice,spatial-relational,3|4,7,3/4,210073,3
3,2,21,74,1,1297,1,5,2,2,3,single-choice,spatial-relational,2|3,7,2/3,210074,2
3,2,21,75,1,1519,1,7,3,3,4,single-choice,spatial-relational,3|4,7,3/4,210075,3
3,2,21,76,0,1058,1,11,5,6,6,single-choice,spatial-relational,5|6,7,5/6,210076,5
3,2,21,77,1,1025,1,3,1,1,2,single-choice,spatial-relational,1|2,7,1/2,210077,1
3,2,21,78,1,988,1,11,5,5,6,single-choice,spatial-relational,5|6,7,5/6,210078,5
3,2,21,79,0,1375,1,9,4,5,5,single-choice,spatial-relational,4|5,7,4/5,210079,4
3,2,21,80,1,2120,1,5,2,2,3,single-choice,spatial-relational,2|3,7,2/3,210080,2
3,2,21,81,1,978,1,3,1,1,2,single-choice,spatial-relational,1|2,7,1/2,210081,1
3,2,21,82,1,1048,1,13,6,6,7,single-choice,spatial-relational,6|7,7,6/7,210082,6
3,2,21,83,1,1559,1,9,4,4,5,single-choice,spatial-relational,4|5,7,4/5,210083,4
3,2,21,84,1,1988,1,13,6,6,7,single-choice,spatial-relational,6|7,7,6/7,210084,6
3,2,21,85,1,1199,1,11,5,5,6,single-choice,spatial-relational,5|6,7,5/6,210085,5
3,2,21,86,1,2954,1,7,3,3,4,single-choice,spatial-relational,3|4,7,3/4,210086,3
3,2,21,87,1,1112,1,13,6,6,7,single-choice,spatial-relational,6|7,7,6/7,210087,6
3,2,21,88,0,2094,1,5,2,3,3,single-choice,spatial-relational,2|3,7,2/3,210088,2
3,2,21,89,1,910,1,11,5,5,6,single-choice,spatial-relational,5|6,7,5/6,210089,5
3,2,21,90,1,1538,1,13,6,6,7,single-choice,spatial-relational,6|7,7,6/7,210090,6
3,2,21,91,0,1118,1,5,2,3,3,single-choice,spatial-relational,2|3,7,2/3,210091,2
3,2,21,92,1,800,1,3,1,1,2,single-choice,spatial-relational,1|2,7,1/2,210092,1
3,2,21,93,1,813,1,3,1,1,2,single-choice,spatial-relational,1|2,7,1/2,210093,1
3,2,21,94,1,1445,1,9,4,4,5,single-choice,spatial-relational,4|5,7,4/5,210094,4
3,2,21,95,1,1151,1,7,3,3,4,single-choice,spatial-relational,3|4,7,3/4,210095,3
3,2,21,96,0,822,1,9,4,5,5,single-choice,spatial-relational,4|5,7,4/5,210096,4
3,2,21,97,1,123,1,13,6,6,7,single-choice,spatial-relational,6|7,7,6/7,210097,6
3,2,21,98,1,1139,1,5,2,2,3,single-choice,spatial-relational,2|3,7,2/3,210098,2
3,2,21,99,1,1584,1,7,3,3,4,single-choice,spatial-relational,3|4,7,3/4,210099,3
3,2,21,100,1,1469,1,7,3,3,4,single-choice,spatial-relational,3|4,7,3/4,210100,3
3,2,21,101,1,1795,1,13,6,6,7,single-choice,spatial-relational,6|7,7,6/7,210101,6
3,2,21,102,1,1395,1,5,2,2,3,single-choice,spatial-relational,2|3,7,2/3,210102,2
3,2,21,103,1,1249,1,9,4,4,5,single-choice,spatial-relational,4|5,7,4/5,210103,4
3,2,21,104,0,1343,1,3,1,2,2,single-choice,spatial-relational,1|2,7,1/2,210104,1
3,2,21,105,0,565,1,11,5,6,6,single-choice,spatial-relational,5|6,7,5/6,210105,5
3,2,21,106,1,868,1,3,1,1,2,single-choice,spatial-relational,1|2,7,1/2,210106,1
3,2,21,107,0,586,1,11,5,6,6,single-choice,spatial-relational,5|6,7,5/6,210107,5
3,2,21,108,0,1110,1,9,4,5,5,single-choice,spatial-relational,4|5,7,4/5,210108,4
3,2,21,109,0,577,1,7,3,4,4,single-choice,spatial-relational,3|4,7,3/4,210109,3
3,2,21,110,1,1519,1,13,6,6,7,single-choice,spatial-relational,6|7,7,6/7,210110,6
3,2,21,111,1,2152,1,7,3,3,4,single-choice,spatial-relational,3|4,7,3/4,210111,3
3,2,21,112,0,1634,1,11,5,6,6,single-choice,spatial-relational,5|6,7,5/6,210112,5
3,2,21,113,0,1184,1,9,4,5,5,single-choice,spatial-relational,4|5,7,4/5,210113,4
3,2,21,114,1,1339,1,5,2,2,3,single-choice,spatial-relational,2|3,7,2/3,210114,2
3,2,21,115,1,1100,1,11,5,5,6,single-choice,spatial-relational,5|6,7,5/6,210115,5
3,2,21,116,0,1042,1,3,1,2,2,single-choice,spatial-relational,1|2,7,1/2,210116,1
3,2,21,117,1,1498,1,3,1,1,2,single-choice,spatial-relational,1|2,7,1/2,210117,1
3,2,21,118,1,1335,1,9,4,4,5,single-choice,spatial-relational,4|5,7,4/5,210118,4
3,2,21,119,1,1929,1,13,6,6,7,single-choice,spatial-relational,6|7,7,6/7,210119,6
3,2,21,120,0,1150,1,5,2,3,3,single-choice,spatial-relational,2|3,7,2/3,210120,2
3,2,21,121,1,965,1,7,3,3,4,single-choice,spatial-relational,3|4,7,3/4,210121,3
3,2,21,122,1,1255,1,3,1,1,2,single-choice,spatial-relational,1|2,7,1/2,210122,1
3,2,21,123,1,1563,1,7,3,3,4,single-choice,spatial-relational,3|4,7,3/4,210123,3
3,2,21,124,1,2054,1,13,6,6,7,single-choice,spatial-relational,6|7,7,6/7,210124,6
3,2,21,125,1,4805,1,11,5,5,6,single-choice,spatial-relational,5|6,7,5/6,210125,5
3,2,21,126,1,2140,1,13,6,6,7,single-choice,spatial-relational,6|7,7,6/7,210126,6
3,2,21,127,1,1594,1,5,2,2,3,single-choice,spatial-relational,2|3,7,2/3,210127,2
3,2,21,128,0,1593,1,3,1,2,2,single-choice,spatial-relational,1|2,7,1/2,210128,1
3,2,21,129,0,1527,1,9,4,5,5,single-choice,spatial-relational,4|5,7,4/5,210129,4
3,2,21,130,1,1166,1,5,2,2,3,single-choice,spatial-relational,2|3,7,2/3,210130,2
3,2,21,131,1,1142,1,9,4,4,5,single-choice,spatial-relational,4|5,7,4/5,210131,4
3,2,21,132,1,3650,1,11,5,5,6,single-choice,spatial-relational,5|6,7,5/6,210132,5
3,2,21,133,0,1694,1,3,1,2,2,single-choice,spatial-relational,1|2,7,1/2,210133,1
3,2,21,134,1,1506,1,9,4,4,5,single-choice,spatial-relational,4|5,7,4/5,210134,4
3,2,21,135,0,1141,1,3,1,2,2,single-choice,spatial-relational,1|2,7,1/2,210135,1
3,2,21,136,1,930,1,11,5,5,6,single-choice,spatial-relational,5|6,7,5/6,210136,5
3,2,21,137,1,1384,1,7,3,3,4,single-choice,spatial-relational,3|4,7,3/4,210137,3
3,2,21,138,1,3132,1,7,3,3,4,single-choice,spatial-relational,3|4,7,3/4,210138,3
3,2,21,139,1,2343,1,13,6,6,7,single-choice,spatial-relational,6|7,7,6/7,210139,6
3,2,21,140,1,1228,1,11,5,5,6,single-choice,spatial-relational,5|6,7,5/6,210140,5
3,2,21,141,0,968,1,5,2,3,3,single-choice,spatial-relational,2|3,7,2/3,210141,2
3,2,21,142,1,1488,1,9,4,4,5,single-choice,spatial-relational,4|5,7,4/5,210142,4
3,2,21,143,1,1486,1,13,6,6,7,single-choice,spatial-relational,6|7,7,6/7,210143,6
3,2,21,144,0,1438,1,5,2,3,3,single-choice,spatial-relational,2|3,7,2/3,210144,2
3,2,21,145,1,943,1,7,3,3,4,single-choice,spatial-relational,3|4,7,3/4,210145,3
3,2,21,146,1,1727,1,5,2,2,3,single-choice,spatial-relational,2|3,7,2/3,210146,2
3,2,21,147,1,1059,1,3,1,1,2,single-choice,spatial-relational,1|2,7,1/2,210147,1
3,2,21,148,1,1361,1,5,2,2,3,single-choice,spatial-relational,2|3,7,2/3,210148,2
3,2,21,149,1,1622,1,13,6,6,7,single-choice,spatial-relational,6|7,7,6/7,210149,6
3,2,21,150,0,1166,1,3,1,2,2,single-choice,spatial-relational,1|2,7,1/2,210150,1
3,2,21,151,1,1063,1,7,3,3,4,single-choice,spatial-relational,3|4,7,3/4,210151,3
3,2,21,152,1,1222,1,9,4,4,5,single-choice,spatial-relational,4|5,7,4/5,210152,4
3,2,21,153,0,2241,1,11,5,6,6,single-choice,spatial-relational,5|6,7,5/6,210153,5
3,2,21,154,1,87,1,13,6,6,7,single-choice,spatial-relational,6|7,7,6/7,210154,6
3,2,21,155,1,1398,1,11,5,5,6,single-choice,spatial-relational,5|6,7,5/6,210155,5
3,2,21,156,1,1701,1,9,4,4,5,single-choice,spatial-relational,4|5,7,4/5,210156,4
3,2,21,157,1,2202,1,11,5,5,6,single-choice,spatial-relational,5|6,7,5/6,210157,5
3,2,21,158,0,2165,1,13,6,7,7,single-choice,spatial-relational,6|7,7,6/7,210158,6
3,2,21,159,1,1759,1,3,1,1,2,single-choice,spatial-relational,1|2,7,1/2,210159,1
3,2,21,160,1,1268,1,7,3,3,4,single-choice,spatial-relational,3|4,7,3/4,210160,3
3,2,21,161,1,1999,1,13,6,6,7,single-choice,spatial-relational,6|7,7,6/7,210161,6
3,2,21,162,1,1594,1,9,4,4,5,single-choice,spatial-relational,4|5,7,4/5,210162,4
3,2,21,163,1,1381,1,5,2,2,3,single-choice,spatial-relational,2|3,7,2/3,210163,2
3,2,21,164,1,1658,1,3,1,1,2,single-choice,spatial-relational,1|2,7,1/2,210164,1
3,2,21,165,1,1268,1,5,2,2,3,single-choice,spatial-relational,2|3,7,2/3,210165,2
3,2,21,166,1,1189,1,11,5,5,6,single-choice,spatial-relational,5|6,7,5/6,210166,5
3,2,21,167,1,1376,1,9,4,4,5,single-choice,spatial-relational,4|5,7,4/5,210167,4
3,2,21,168,1,2348,1,7,3,3,4,single-choice,spatial-relational,3|4,7,3/4,210168,3
3,2,21,169,1,1327,1,5,2,2,3,single-choice,spatial-relational,2|3,7,2/3,210169,2
3,2,21,170,0,1344,1,3,1,2,2,single-choice,spatial-relational,1|2,7,1/2,210170,1
3,2,21,171,1,1117,1,9,4,4,5,single-choice,spatial-relational,4|5,7,4/5,210171,4
3,2,21,172,1,1805,1,13,6,6,7,single-choice,spatial-relational,6|7,7,6/7,210172,6
3,2,21,173,1,1754,1,7,3,3,4,single-choice,spatial-relational,3|4,7,3/4,210173,3
3,2,21,174,1,1598,1,11,5,5,6,single-choice,spatial-relational,5|6,7,5/6,210174,5
3,2,21,175,1,1371,1,9,4,4,5,single-choice,spatial-relational,4|5,7,4/5,210175,4
3,2,21,176,1,1306,1,13,6,6,7,single-choice,spatial-relational,6|7,7,6/7,210176,6
3,2,21,177,0,2519,1,5,2,3,3,single-choice,spatial-relational,2|3,7,2/3,210177,2
3,2,21,178,1,1261,1,11,5,5,6,single-choice,spatial-relational,5|6,7,5/6,210178,5
3,2,21,179,0,1734,1,7,3,4,4,single-choice,spatial-relational,3|4,7,3/4,210179,3
3,2,21,180,1,1267,1,3,1,1,2,single-choice,spatial-relational,1|2,7,1/2,210180,1
3,2,21,181,1,1069,1,9,4,4,5,single-choice,spatial-relational,4|5,7,4/5,210181,4
3,2,21,182,0,211,1,7,3,4,4,single-choice,spatial-relational,3|4,7,3/4,210182,3
3,2,21,183,1,1001,1,9,4,4,5,single-choice,spatial-relational,4|5,7,4/5,210183,4
3,2,21,184,1,1515,1,5,2,2,3,single-choice,spatial-relational,2|3,7,2/3,210184,2
3,2,21,185,1,947,1,13,6,6,7,single-choice,spatial-relational,6|7,7,6/7,210185,6
3,2,21,186,0,902,1,7,3,4,4,single-choice,spatial-relational,3|4,7,3/4,210186,3
3,2,21,187,1,922,1,3,1,1,2,single-choice,spatial-relational,1|2,7,1/2,210187,1
3,2,21,188,1,1236,1,5,2,2,3,single-choice,spatial-relational,2|3,7,2/3,210188,2
3,2,21,189,1,1385,1,11,5,5,6,single-choice,spatial-relational,5|6,7,5/6,210189,5
3,2,21,190,1,2042,1,3,1,1,2,single-choice,spatial-relational,1|2,7,1/2,210190,1
3,2,21,191,1,1548,1,11,5,5,6,single-choice,spatial-relational,5|6,7,5/6,210191,5
3,2,21,192,1,2930,1,13,6,6,7,single-choice,spatial-relational,6|7,7,6/7,210192,6
3,2,21,193,1,1748,1,9,4,4,5,single-choice,spatial-relational,4|5,7,4/5,210193,4
3,2,21,194,1,1059,1,3,1,1,2,single-choice,spatial-relational,1|2,7,1/2,210194,1
3,2,21,195,1,2582,1,7,3,3,4,single-choice,spatial-relational,3|4,7,3/4,210195,3
3,2,21,196,0,2219,1,11,5,6,6,single-choice,spatial-relational,5|6,7,5/6,210196,5
3,2,21,197,0,638,1,3,1,2,2,single-choice,spatial-relational,1|2,7,1/2,210197,1
3,2,21,198,1,987,1,5,2,2,3,single-choice,spatial-relational,2|3,7,2/3,210198,2
3,2,21,199,1,959,1,5,2,2,3,single-choice,spatial-relational,2|3,7,2/3,210199,2
3,2,21,200,1,1444,1,11,5,5,6,single-choice,spatial-relational,5|6,7,5/6,210200,5
3,2,21,201,1,866,1,9,4,4,5,single-choice,spatial-relational,4|5,7,4/5,210201,4
3,2,21,202,1,1335,1,13,6,6,7,single-choice,spatial-relational,6|7,7,6/7,210202,6
3,2,21,203,1,1585,1,13,6,6,7,single-choice,spatial-relational,6|7,7,6/7,210203,6
3,2,21,204,1,1747,1,7,3,3,4,single-choice,spatial-relational,3|4,7,3/4,210204,3
3,2,21,205,1,1783,1,7,3,3,4,single-choice,spatial-relational,3|4,7,3/4,210205,3
3,2,21,206,1,1213,1,13,6,6,7,single-choice,spatial-relational,6|7,7,6/7,210206,6
3,2,21,207,1,1259,1,11,5,5,6,single-choice,spatial-relational,5|6,7,5/6,210207,5
3,2,21,208,1,1295,1,3,1,1,2,single-choice,spatial-relational,1|2,7,1/2,210208,1
3,2,21,209,1,1204,1,9,4,4,5,single-choice,spatial-relational,4|5,7,4/5,210209,4
3,2,21,210,1,1611,1,5,2,2,3,single-choice,spatial-relational,2|3,7,2/3,210210,2
3,2,21,211,1,1149,1,7,3,3,4,single-choice,spatial-relational,3|4,7,3/4,210211,3
3,2,21,212,1,1013,1,9,4,4,5,single-choice,spatial-relational,4|5,7,4/5,210212,4
3,2,21,213,0,1293,1,3,1,2,2,single-choice,spatial-relational,1|2,7,1/2,210213,1
3,2,21,214,0,118,1,11,5,6,6,single-choice,spatial-relational,5|6,7,5/6,210214,5
3,2,21,215,1,950,1,13,6,6,7,single-choice,spatial-relational,6|7,7,6/7,210215,6
3,2,21,216,1,1058,1,5,2,2,3,single-choice,spatial-relational,2|3,7,2/3,210216,2
3,2,21,217,1,2407,1,11,5,5,6,single-choice,spatial-relational,5|6,7,5/6,210217,5
3,2,21,218,0,1542,1,7,3,4,4,single-choice,spatial-relational,3|4,7,3/4,210218,3
3,2,21,219,1,972,1,5,2,2,3,single-choice,spatial-relational,2|3,7,2/3,210219,2
3,2,21,220,1,1947,1,3,1,1,2,single-choice,spatial-relational,1|2,7,1/2,210220,1
3,2,21,221,1,1025,1,13,6,6,7,single-choice,spatial-relational,6|7,7,6/7,210221,6
3,2,21,222,1,2434,1,11,5,5,6,single-choice,spatial-relational,5|6,7,5/6,210222,5
3,2,21,223,1,1604,1,5,2,2,3,single-choice,spatial-relational,2|3,7,2/3,210223,2
3,2,21,224,1,2161,1,9,4,4,5,single-choice,spatial-relational,4|5,7,4/5,210224,4
3,2,21,225,0,1135,1,3,1,2,2,single-choice,spatial-relational,1|2,7,1/2,210225,1
3,2,21,226,1,1004,1,7,3,3,4,single-choice,spatial-relational,3|4,7,3/4,210226,3
3,2,21,227,1,1509,1,9,4,4,5,single-choice,spatial-relational,4|5,7,4/5,210227,4
3,2,21,228,1,1668,1,13,6,6,7,single-choice,spatial-relational,6|7,7,6/7,210228,6
3,2,21,229,1,1990,1,3,1,1,2,single-choice,spatial-relational,1|2,7,1/2,210229,1
3,2,21,230,1,1939,1,11,5,5,6,single-choice,spatial-relational,5|6,7,5/6,210230,5
3,2,21,231,1,1338,1,9,4,4,5,single-choice,spatial-relational,4|5,7,4/5,210231,4
3,2,21,232,1,1906,1,13,6,6,7,single-choice,spatial-relational,6|7,7,6/7,210232,6
3,2,21,233,1,906,1,9,4,4,5,single-choice,spatial-relational,4|5,7,4/5,210233,4
3,2,21,234,1,2400,1,5,2,2,3,single-choice,spatial-relational,2|3,7,2/3,210234,2
3,2,21,235,1,1216,1,7,3,3,4,single-choice,spatial-relational,3|4,7,3/4,210235,3
3,2,21,236,1,1433,1,13,6,6,7,single-choice,spatial-relational,6|7,7,6/7,210236,6
3,2,21,237,1,3435,1,7,3,3,4,single-choice,spatial-relational,3|4,7,3/4,210237,3
3,2,21,238,0,1478,1,3,1,2,2,single-choice,spatial-relational,1|2,7,1/2,210238,1
3,2,21,239,1,1257,1,11,5,5,6,single-choice,spatial-relational,5|6,7,5/6,210239,5
3,2,21,240,1,1362,1,5,2,2,3,single-choice,spatial-relational,2|3,7,2/3,210240,2
3,2,21,241,1,1382,1,7,3,3,4,single-choice,spatial-relational,3|4,7,3/4,210241,3
3,2,21,242,1,1099,1,7,3,3,4,single-choice,spatial-relational,3|4,7,3/4,210242,3
3,2,21,243,0,874,1,5,2,3,3,single-choice,spatial-relational,2|3,7,2/3,210243,2
3,2,21,244,1,1355,1,11,5,5,6,single-choice,spatial-relational,5|6,7,5/6,210244,5
3,2,21,245,1,1111,1,5,2,2,3,single-choice,spatial-relational,2|3,7,2/3,210245,2
3,2,21,246,1,1141,1,13,6,6,7,single-choice,spatial-relational,6|7,7,6/7,210246,6
3,2,21,247,1,2087,1,9,4,4,5,single-choice,spatial-relational,4|5,7,4/5,210247,4
3,2,21,248,1,1030,1,9,4,4,5,single-choice,spatial-relational,4|5,7,4/5,210248,4
3,2,21,249,1,3131,1,11,5,5,6,single-choice,spatial-relational,5|6,7,5/6,210249,5
3,2,21,250,1,1653,1,13,6,6,7,single-choice,spatial-relational,6|7,7,6/7,210250,6
3,2,21,251,1,1146,1,3,1,1,2,single-choice,spatial-relational,1|2,7,1/2,210251,1
3,2,21,252,1,1914,1,3,1,1,2,single-choice,spatial-relational,1|2,7,1/2,210252,1
3,2,21,253,0,1196,1,7,3,4,4,single-choice,spatial-relational,3|4,7,3/4,210253,3
3,2,21,254,1,884,1,11,5,5,6,single-choice,spatial-relational,5|6,7,5/6,210254,5
3,2,21,255,1,2138,1,11,5,5,6,single-choice,spatial-relational,5|6,7,5/6,210255,5
3,2,21,256,0,1224,1,3,1,2,2,single-choice,spatial-relational,1|2,7,1/2,210256,1
3,2,21,257,1,802,1,13,6,6,7,single-choice,spatial-relational,6|7,7,6/7,210257,6
3,2,21,258,1,1221,1,9,4,4,5,single-choice,spatial-relational,4|5,7,4/5,210258,4
3,2,21,259,1,1489,1,9,4,4,5,single-choice,spatial-relational,4|5,7,4/5,210259,4
3,2,21,260,1,1141,1,13,6,6,7,single-choice,spatial-relational,6|7,7,6/7,210260,6
3,2,21,261,1,2021,1,5,2,2,3,single-choice,spatial-relational,2|3,7,2/3,210261,2
3,2,21,262,1,1252,1,5,2,2,3,single-choice,spatial-relational,2|3,7,2/3,210262,2
3,2,21,263,1,1198,1,3,1,1,2,single-choice,spatial-relational,1|2,7,1/2,210263,1
3,2,21,264,1,1251,1,7,3,3,4,single-choice,spatial-relational,3|4,7,3/4,210264,3
3,2,21,265,1,1419,1,7,3,3,4,single-choice,spatial-relational,3|4,7,3/4,210265,3
3,2,21,266,1,929,1,9,4,4,5,single-choice,spatial-relational,4|5,7,4/5,210266,4
3,2,21,267,1,2775,1,7,3,3,4,single-choice,spatial-relational,3|4,7,3/4,210267,3
3,2,21,268,1,1712,1,11,5,5,6,single-choice,spatial-relational,5|6,7,5/6,210268,5
3,2,21,269,1,1257,1,5,2,2,3,single-choice,spatial-relational,2|3,7,2/3,210269,2
3,2,21,270,0,989,1,3,1,2,2,single-choice,spatial-relational,1|2,7,1/2,210270,1
3,2,21,271,1,1468,1,13,6,6,7,single-choice,spatial-relational,6|7,7,6/7,210271,6
3,2,21,272,0,1597,1,9,4,5,5,single-choice,spatial-relational,4|5,7,4/5,210272,4
3,2,21,273,1,930,1,13,6,6,7,single-choice,spatial-relational,6|7,7,6/7,210273,6
3,2,21,274,1,2636,1,3,1,1,2,single-choice,spatial-relational,1|2,7,1/2,210274,1
3,2,21,275,1,1403,1,5,2,2,3,single-choice,spatial-relational,2|3,7,2/3,210275,2
3,2,21,276,1,1510,1,11,5,5,6,single-choice,spatial-relational,5|6,7,5/6,210276,5
3,2,21,277,1,1854,1,5,2,2,3,single-choice,spatial-relational,2|3,7,2/3,210277,2
3,2,21,278,0,1474,1,7,3,4,4,single-choice,spatial-relational,3|4,7,3/4,210278,3
3,2,21,279,1,1007,1,13,6,6,7,single-choice,spatial-relational,6|7,7,6/7,210279,6
3,2,21,280,0,1506,1,9,4,5,5,single-choice,spatial-relational,4|5,7,4/5,210280,4
3,2,21,281,1,1056,1,5,2,2,3,single-choice,spatial-relational,2|3,7,2/3,210281,2
3,2,21,282,0,1054,1,11,5,6,6,single-choice,spatial-relational,5|6,7,5/6,210282,5
3,2,21,283,1,1300,1,13,6,6,7,single-choice,spatial-relational,6|7,7,6/7,210283,6
3,2,21,284,1,1622,1,7,3,3,4,single-choice,spatial-relational,3|4,7,3/4,210284,3
3,2,21,285,0,1558,1,3,1,2,2,single-choice,spatial-relational,1|2,7,1/2,210285,1
3,2,21,286,1,1165,1,11,5,5,6,single-choice,spatial-relational,5|6,7,5/6,210286,5
3,2,21,287,1,1089,1,9,4,4,5,single-choice,spatial-relational,4|5,7,4/5,210287,4
3,2,21,288,1,2588,1,3,1,1,2,single-choice,spatial-relational,1|2,7,1/2,210288,1
3,2,21,289,1,1322,1,5,2,2,3,single-choice,spatial-relational,2|3,7,2/3,210289,2
3,2,21,290,1,1530,1,13,6,6,7,single-choice,spatial-relational,6|7,7,6/7,210290,6
3,2,21,291,1,2659,1,9,4,4,5,single-choice,spatial-relational,4|5,7,4/5,210291,4
3,2,21,292,1,1071,1,9,4,4,5,single-choice,spatial-relational,4|5,7,4/5,210292,4
3,2,21,293,1,1163,1,3,1,1,2,single-choice,spatial-relational,1|2,7,1/2,210293,1
3,2,21,294,1,1187,1,13,6,6,7,single-choice,spatial-relational,6|7,7,6/7,210294,6
3,2,21,295,1,1929,1,11,5,5,6,single-choice,spatial-relational,5|6,7,5/6,210295,5
3,2,21,296,1,1962,1,7,3,3,4,single-choice,spatial-relational,3|4,7,3/4,210296,3
3,2,21,297,1,2470,1,11,5,5,6,single-choice,spatial-relational,5|6,7,5/6,210297,5
3,2,21,298,1,2913,1,7,3,3,4,single-choice,spatial-relational,3|4,7,3/4,210298,3
3,2,21,299,1,2082,1,5,2,2,3,single-choice,spatial-relational,2|3,7,2/3,210299,2
3,2,21,300,0,1038,1,3,1,2,2,single-choice,spatial-relational,1|2,7,1/2,210300,1
3,2,21,301,1,895,1,11,5,5,6,single-choice,spatial-relational,5|6,7,5/6,210301,5
3,2,21,302,0,2004,1,3,1,2,2,single-choice,spatial-relational,1|2,7,1/2,210302,1
3,2,21,303,1,986,1,7,3,3,4,single-choice,spatial-relational,3|4,7,3/4,210303,3
3,2,21,304,1,1728,1,9,4,4,5,single-choice,spatial-relational,4|5,7,4/5,210304,4
3,2,21,305,1,1061,1,9,4,4,5,single-choice,spatial-relational,4|5,7,4/5,210305,4
3,2,21,306,1,2551,1,5,2,2,3,single-choice,spatial-relational,2|3,7,2/3,210306,2
3,2,21,307,1,1601,1,3,1,1,2,single-choice,spatial-relational,1|2,7,1/2,210307,1
3,2,21,308,1,1471,1,7,3,3,4,single-choice,spatial-relational,3|4,7,3/4,210308,3
3,2,21,309,1,2384,1,5,2,2,3,single-choice,spatial-relational,2|3,7,2/3,210309,2
3,2,21,310,1,1579,1,13,6,6,7,single-choice,spatial-relational,6|7,7,6/7,210310,6
3,2,21,311,1,1521,1,11,5,5,6,single-choice,spatial-relational,5|6,7,5/6,210311,5
3,2,21,312,1,1529,1,13,6,6,7,single-choice,spatial-relational,6|7,7,6/7,210312,6
3,2,21,313,1,1876,1,3,1,1,2,single-choice,spatial-relational,1|2,7,1/2,210313,1
3,2,21,314,1,1642,1,5,2,2,3,single-choice,spatial-relational,2|3,7,2/3,210314,2
3,2,21,315,0,2283,1,7,3,4,4,single-choice,spatial-relational,3|4,7,3/4,210315,3
3,2,21,316,1,955,1,7,3,3,4,single-choice,spatial-relational,3|4,7,3/4,210316,3
3,2,21,317,1,1661,1,11,5,5,6,single-choice,spatial-relational,5|6,7,5/6,210317,5
3,2,21,318,1,1966,1,13,6,6,7,single-choice,spatial-relational,6|7,7,6/7,210318,6
3,2,21,319,1,950,1,9,4,4,5,single-choice,spatial-relational,4|5,7,4/5,210319,4
3,2,21,320,1,1697,1,13,6,6,7,single-choice,spatial-relational,6|7,7,6/7,210320,6
3,2,21,321,1,2181,1,3,1,1,2,single-choice,spatial-relational,1|2,7,1/2,210321,1
3,2,21,322,1,1312,1,5,2,2,3,single-choice,spatial-relational,2|3,7,2/3,210322,2
3,2,21,323,1,793,1,11,5,5,6,single-choice,spatial-relational,5|6,7,5/6,210323,5
3,2,21,324,0,1604,1,9,4,5,5,single-choice,spatial-relational,4|5,7,4/5,210324,4
3,2,21,325,1,967,1,13,6,6,7,single-choice,spatial-relational,6|7,7,6/7,210325,6
3,2,21,326,1,1794,1,11,5,5,6,single-choice,spatial-relational,5|6,7,5/6,210326,5
3,2,21,327,1,1713,1,13,6,6,7,single-choice,spatial-relational,6|7,7,6/7,210327,6
3,2,21,328,1,1836,1,7,3,3,4,single-choice,spatial-relational,3|4,7,3/4,210328,3
3,2,21,329,1,1498,1,11,5,5,6,single-choice,spatial-relational,5|6,7,5/6,210329,5
3,2,21,330,1,1893,1,5,2,2,3,single-choice,spatial-relational,2|3,7,2/3,210330,2
3,2,21,331,1,2327,1,7,3,3,4,single-choice,spatial-relational,3|4,7,3/4,210331,3
3,2,21,332,0,1236,1,3,1,2,2,single-choice,spatial-relational,1|2,7,1/2,210332,1
3,2,21,333,1,1119,1,5,2,2,3,single-choice,spatial-relational,2|3,7,2/3,210333,2
3,2,21,334,1,1448,1,9,4,4,5,single-choice,spatial-relational,4|5,7,4/5,210334,4
3,2,21,335,1,1120,1,3,1,1,2,single-choice,spatial-relational,1|2,7,1/2,210335,1
3,2,21,336,1,898,1,9,4,4,5,single-choice,spatial-relational,4|5,7,4/5,210336,4
3,2,21,337,1,2187,1,13,6,6,7,single-choice,spatial-relational,6|7,7,6/7,210337,6
3,2,21,338,1,3598,1,11,5,5,6,single-choice,spatial-relational,5|6,7,5/6,210338,5
3,2,21,339,1,843,1,9,4,4,5,single-choice,spatial-relational,4|5,7,4/5,210339,4
3,2,21,340,1,1627,1,13,6,6,7,single-choice,spatial-relational,6|7,7,6/7,210340,6
3,2,21,341,0,963,1,11,5,6,6,single-choice,spatial-relational,5|6,7,5/6,210341,5
3,2,21,342,1,1098,1,5,2,2,3,single-choice,spatial-relational,2|3,7,2/3,210342,2
3,2,21,343,0,992,1,3,1,2,2,single-choice,spatial-relational,1|2,7,1/2,210343,1
3,2,21,344,1,973,1,7,3,3,4,single-choice,spatial-relational,3|4,7,3/4,210344,3
3,2,21,345,0,1550,1,9,4,5,5,single-choice,spatial-relational,4|5,7,4/5,210345,4
3,2,21,346,1,1086,1,3,1,1,2,single-choice,spatial-relational,1|2,7,1/2,210346,1
3,2,21,347,1,1185,1,7,3,3,4,single-choice,spatial-relational,3|4,7,3/4,210347,3
3,2,21,348,1,1166,1,5,2,2,3,single-choice,spatial-relational,2|3,7,2/3,210348,2
3,2,21,349,1,1537,1,13,6,6,7,single-choice,spatial-relational,6|7,7,6/7,210349,6
3,2,21,350,1,1594,1,11,5,5,6,single-choice,spatial-relational,5|6,7,5/6,210350,5
3,2,21,351,0,1154,1,5,2,3,3,single-choice,spatial-relational,2|3,7,2/3,210351,2
3,2,21,352,1,1043,1,3,1,1,2,single-choice,spatial-relational,1|2,7,1/2,210352,1
3,2,21,353,1,1153,1,7,3,3,4,single-choice,spatial-relational,3|4,7,3/4,210353,3
3,2,21,354,1,1293,1,13,6,6,7,single-choice,spatial-relational,6|7,7,6/7,210354,6
3,2,21,355,0,1075,1,3,1,2,2,single-choice,spatial-relational,1|2,7,1/2,210355,1
3,2,21,356,1,2247,1,5,2,2,3,single-choice,spatial-relational,2|3,7,2/3,210356,2
3,2,21,357,0,1204,1,11,5,6,6,single-choice,spatial-relational,5|6,7,5/6,210357,5
3,2,21,358,0,795,1,9,4,5,5,single-choice,spatial-relational,4|5,7,4/5,210358,4
3,2,21,359,0,828,1,9,4,5,5,single-choice,spatial-relational,4|5,7,4/5,210359,4
3,2,21,360,1,994,1,7,3,3,4,single-choice,spatial-relational,3|4,7,3/4,210360,3
3,2,21,361,1,1487,1,3,1,1,2,single-choice,spatial-relational,1|2,7,1/2,210361,1
3,2,21,362,1,1012,1,13,6,6,7,single-choice,spatial-relational,6|7,7,6/7,210362,6
3,2,21,363,1,1838,1,11,5,5,6,single-choice,spatial-relational,5|6,7,5/6,210363,5
3,2,21,364,1,2399,1,13,6,6,7,single-choice,spatial-relational,6|7,7,6/7,210364,6
3,2,21,365,1,1550,1,7,3,3,4,single-choice,spatial-relational,3|4,7,3/4,210365,3
3,2,21,366,1,1555,1,5,2,2,3,single-choice,spatial-relational,2|3,7,2/3,210366,2
3,2,21,367,0,1882,1,9,4,5,5,single-choice,spatial-relational,4|5,7,4/5,210367,4
3,2,21,368,1,1396,1,11,5,5,6,single-choice,spatial-relational,5|6,7,5/6,210368,5
3,2,21,369,1,1108,1,9,4,4,5,single-choice,spatial-relational,4|5,7,4/5,210369,4
3,2,21,370,0,1462,1,3,1,2,2,single-choice,spatial-relational,1|2,7,1/2,210370,1
3,2,21,371,1,1183,1,5,2,2,3,single-choice,spatial-relational,2|3,7,2/3,210371,2
3,2,21,372,1,1871,1,7,3,3,4,single-choice,spatial-relational,3|4,7,3/4,210372,3
3,2,21,373,1,1305,1,13,6,6,7,single-choice,spatial-relational,6|7,7,6/7,210373,6
3,2,21,374,0,2531,1,11,5,6,6,single-choice,spatial-relational,5|6,7,5/6,210374,5
3,2,21,375,1,1092,1,5,2,2,3,single-choice,spatial-relational,2|3,7,2/3,210375,2
3,2,21,376,1,1569,1,9,4,4,5,single-choice,spatial-relational,4|5,7,4/5,210376,4
3,2,21,377,0,1132,1,5,2,3,3,single-choice,spatial-relational,2|3,7,2/3,210377,2
3,2,21,378,0,1808,1,11,5,6,6,single-choice,spatial-relational,5|6,7,5/6,210378,5
3,2,21,379,1,899,1,7,3,3,4,single-choice,spatial-relational,3|4,7,3/4,210379,3
3,2,21,380,0,2420,1,3,1,2,2,single-choice,spatial-relational,1|2,7,1/2,210380,1
3,2,21,381,1,1346,1,9,4,4,5,single-choice,spatial-relational,4|5,7,4/5,210381,4
3,2,21,382,0,1800,1,7,3,4,4,single-choice,spatial-relational,3|4,7,3/4,210382,3
3,2,21,383,1,1205,1,13,6,6,7,single-choice,spatial-relational,6|7,7,6/7,210383,6
3,2,21,384,1,1588,1,3,1,1,2,single-choice,spatial-relational,1|2,7,1/2,210384,1
3,2,21,385,1,851,1,3,1,1,2,single-choice,spatial-relational,1|2,7,1/2,210385,1
3,2,21,386,0,1702,1,5,2,3,3,single-choice,spatial-relational,2|3,7,2/3,210386,2
3,2,21,387,1,1279,1,9,4,4,5,single-choice,spatial-relational,4|5,7,4/5,210387,4
3,2,21,388,1,2341,1,11,5,5,6,single-choice,spatial-relational,5|6,7,5/6,210388,5
3,2,21,389,1,1149,1,13,6,6,7,single-choice,spatial-relational,6|7,7,6/7,210389,6
3,2,21,390,1,1734,1,9,4,4,5,single-choice,spatial-relational,4|5,7,4/5,210390,4
3,2,21,391,1,2598,1,11,5,5,6,single-choice,spatial-relational,5|6,7,5/6,210391,5
3,2,21,392,1,1278,1,5,2,2,3,single-choice,spatial-relational,2|3,7,2/3,210392,2
3,2,21,393,1,1292,1,7,3,3,4,single-choice,spatial-relational,3|4,7,3/4,210393,3
3,2,21,394,1,2333,1,7,3,3,4,single-choice,spatial-relational,3|4,7,3/4,210394,3
3,2,21,395,0,1090,1,3,1,2,2,single-choice,spatial-relational,1|2,7,1/2,210395,1
3,2,21,396,1,1697,1,13,6,6,7,single-choice,spatial-relational,6|7,7,6/7,210396,6
3,2,21,397,1,1547,1,9,4,4,5,single-choice,spatial-relational,4|5,7,4/5,210397,4
3,2,21,398,1,1307,1,13,6,6,7,single-choice,spatial-relational,6|7,7,6/7,210398,6
3,2,21,399,0,2434,1,9,4,5,5,single-choice,spatial-relational,4|5,7,4/5,210399,4
3,2,21,400,1,999,1,7,3,3,4,single-choice,spatial-relational,3|4,7,3/4,210400,3
3,2,21,401,0,1591,1,11,5,6,6,single-choice,spatial-relational,5|6,7,5/6,210401,5
3,2,21,402,1,1090,1,5,2,2,3,single-choice,spatial-relational,2|3,7,2/3,210402,2
3,2,21,403,1,816,1,5,2,2,3,single-choice,spatial-relational,2|3,7,2/3,210403,2
3,2,21,404,1,1035,1,3,1,1,2,single-choice,spatial-relational,1|2,7,1/2,210404,1
3,2,21,405,1,879,1,11,5,5,6,single-choice,spatial-relational,5|6,7,5/6,210405,5
3,2,21,406,1,1631,1,13,6,6,7,single-choice,spatial-relational,6|7,7,6/7,210406,6
3,2,21,407,1,2363,1,7,3,3,4,single-choice,spatial-relational,3|4,7,3/4,210407,3
3,2,21,408,0,932,1,3,1,2,2,single-choice,spatial-relational,1|2,7,1/2,210408,1
3,2,21,409,1,1697,1,11,5,5,6,single-choice,spatial-relational,5|6,7,5/6,210409,5
3,2,21,410,1,1443,1,9,4,4,5,single-choice,spatial-relational,4|5,7,4/5,210410,4
3,2,21,411,1,1206,1,13,6,6,7,single-choice,spatial-relational,6|7,7,6/7,210411,6
3,2,21,412,1,929,1,3,1,1,2,single-choice,spatial-relational,1|2,7,1/2,210412,1
3,2,21,413,1,1708,1,7,3,3,4,single-choice,spatial-relational,3|4,7,3/4,210413,3
3,2,21,414,1,1234,1,7,3,3,4,single-choice,spatial-relational,3|4,7,3/4,210414,3
3,2,21,415,1,1323,1,3,1,1,2,single-choice,spatial-relational,1|2,7,1/2,210415,1
3,2,21,416,0,1346,1,11,5,6,6,single-choice,spatial-relational,5|6,7,5/6,210416,5
3,2,21,417,1,1474,1,9,4,4,5,single-choice,spatial-relational,4|5,7,4/5,210417,4
3,2,21,418,1,1370,1,5,2,2,3,single-choice,spatial-relational,2|3,7,2/3,210418,2
3,2,21,419,1,1877,1,5,2,2,3,single-choice,spatial-relational,2|3,7,2/3,210419,2
3,2,21,420,1,1168,1,13,6,6,7,single-choice,spatial-relational,6|7,7,6/7,210420,6
3,2,21,421,1,1058,1,13,6,6,7,single-choice,spatial-relational,6|7,7,6/7,210421,6
3,2,21,422,1,1503,1,3,1,1,2,single-choice,spatial-relational,1|2,7,1/2,210422,1
3,2,21,423,1,1067,1,3,1,1,2,single-choice,spatial-relational,1|2,7,1/2,210423,1
3,2,21,424,1,1248,1,13,6,6,7,single-choice,spatial-relational,6|7,7,6/7,210424,6
3,2,21,425,1,900,1,5,2,2,3,single-choice,spatial-relational,2|3,7,2/3,210425,2
3,2,21,426,1,1348,1,9,4,4,5,single-choice,spatial-relational,4|5,7,4/5,210426,4
3,2,21,427,0,776,1,11,5,6,6,single-choice,spatial-relational,5|6,7,5/6,210427,5
3,2,21,428,0,1941,1,11,5,6,6,single-choice,spatial-relational,5|6,7,5/6,210428,5
3,2,21,429,1,979,1,7,3,3,4,single-choice,spatial-relational,3|4,7,3/4,210429,3
3,2,21,430,1,1983,1,7,3,3,4,single-choice,spatial-relational,3|4,7,3/4,210430,3
3,2,21,431,1,1462,1,9,4,4,5,single-choice,spatial-relational,4|5,7,4/5,210431,4
3,2,21,432,1,2027,1,5,2,2,3,single-choice,spatial-relational,2|3,7,2/3,210432,2
3,2,21,433,1,1413,1,9,4,4,5,single-choice,spatial-relational,4|5,7,4/5,210433,4
3,2,21,434,1,1050,1,5,2,2,3,single-choice,spatial-relational,2|3,7,2/3,210434,2
3,2,21,435,1,1141,1,7,3,3,4,single-choice,spatial-relational,3|4,7,3/4,210435,3
3,2,21,436,1,1483,1,3,1,1,2,single-choice,spatial-relational,1|2,7,1/2,210436,1
3,2,21,437,1,1522,1,11,5,5,6,single-choice,spatial-relational,5|6,7,5/6,210437,5
3,2,21,438,1,1174,1,3,1,1,2,single-choice,spatial-relational,1|2,7,1/2,210438,1
3,2,21,439,1,1396,1,9,4,4,5,single-choice,spatial-relational,4|5,7,4/5,210439,4
3,2,21,440,1,1598,1,13,6,6,7,single-choice,spatial-relational,6|7,7,6/7,210440,6
3,2,21,441,0,76,1,11,5,6,6,single-choice,spatial-relational,5|6,7,5/6,210441,5
3,2,21,442,1,975,1,13,6,6,7,single-choice,spatial-relational,6|7,7,6/7,210442,6
3,2,21,443,0,1165,1,5,2,3,3,single-choice,spatial-relational,2|3,7,2/3,210443,2
3,2,21,444,1,908,1,7,3,3,4,single-choice,spatial-relational,3|4,7,3/4,210444,3
3,2,21,445,1,1096,1,9,4,4,5,single-choice,spatial-relational,4|5,7,4/5,210445,4
3,2,21,446,1,1219,1,7,3,3,4,single-choice,spatial-relational,3|4,7,3/4,210446,3
3,2,21,447,0,1043,1,3,1,2,2,single-choice,spatial-relational,1|2,7,1/2,210447,1
3,2,21,448,1,2206,1,5,2,2,3,single-choice,spatial-relational,2|3,7,2/3,210448,2
3,2,21,449,0,1090,1,3,1,2,2,single-choice,spatial-relational,1|2,7,1/2,210449,1
3,2,21,450,1,1049,1,7,3,3,4,single-choice,spatial-relational,3|4,7,3/4,210450,3
3,2,21,451,1,1288,1,5,2,2,3,single-choice,spatial-relational,2|3,7,2/3,210451,2
3,2,21,452,1,1191,1,13,6,6,7,single-choice,spatial-relational,6|7,7,6/7,210452,6
3,2,21,453,1,848,1,9,4,4,5,single-choice,spatial-relational,4|5,7,4/5,210453,4
3,2,21,454,0,177,1,13,6,7,7,single-choice,spatial-relational,6|7,7,6/7,210454,6
3,2,21,455,1,993,1,11,5,5,6,single-choice,spatial-relational,5|6,7,5/6,210455,5
3,2,21,456,1,1280,1,11,5,5,6,single-choice,spatial-relational,5|6,7,5/6,210456,5
3,2,21,457,1,1525,1,7,3,3,4,single-choice,spatial-relational,3|4,7,3/4,210457,3
3,2,21,458,0,990,1,3,1,2,2,single-choice,spatial-relational,1|2,7,1/2,210458,1
3,2,21,459,1,1679,1,11,5,5,6,single-choice,spatial-relational,5|6,7,5/6,210459,5
3,2,21,460,1,1063,1,3,1,1,2,single-choice,spatial-relational,1|2,7,1/2,210460,1
3,2,21,461,1,1107,1,9,4,4,5,single-choice,spatial-relational,4|5,7,4/5,210461,4
3,2,21,462,1,949,1,11,5,5,6,single-choice,spatial-relational,5|6,7,5/6,210462,5
3,2,21,463,1,1343,1,9,4,4,5,single-choice,spatial-relational,4|5,7,4/5,210463,4
3,2,21,464,0,751,1,5,2,3,3,single-choice,spatial-relational,2|3,7,2/3,210464,2
3,2,21,465,1,1682,1,7,3,3,4,single-choice,spatial-relational,3|4,7,3/4,210465,3
3,2,21,466,1,1169,1,13,6,6,7,single-choice,spatial-relational,6|7,7,6/7,210466,6
3,2,21,467,1,99070,1,13,6,6,7,single-choice,spatial-relational,6|7,7,6/7,210467,6
3,2,21,468,1,1678,1,5,2,2,3,single-choice,spatial-relational,2|3,7,2/3,210468,2
3,2,21,469,0,847,1,3,1,2,2,single-choice,spatial-relational,1|2,7,1/2,210469,1
3,2,21,470,1,1413,1,5,2,2,3,single-choice,spatial-relational,2|3,7,2/3,210470,2
3,2,21,471,1,1131,1,9,4,4,5,single-choice,spatial-relational,4|5,7,4/5,210471,4
3,2,21,472,1,1055,1,13,6,6,7,single-choice,spatial-relational,6|7,7,6/7,210472,6
3,2,21,473,0,1882,1,11,5,6,6,single-choice,spatial-relational,5|6,7,5/6,210473,5
3,2,21,474,1,1112,1,7,3,3,4,single-choice,spatial-relational,3|4,7,3/4,210474,3
3,2,21,475,1,1446,1,13,6,6,7,single-choice,spatial-relational,6|7,7,6/7,210475,6
3,2,21,476,1,1050,1,3,1,1,2,single-choice,spatial-relational,1|2,7,1/2,210476,1
3,2,21,477,1,127,1,5,2,2,3,single-choice,spatial-relational,2|3,7,2/3,210477,2
3,2,21,478,1,1008,1,7,3,3,4,single-choice,spatial-relational,3|4,7,3/4,210478,3
3,2,21,479,1,116,1,11,5,5,6,single-choice,spatial-relational,5|6,7,5/6,210479,5
3,2,21,480,1,1526,1,9,4,4,5,single-choice,spatial-relational,4|5,7,4/5,210480,4
3,2,21,481,1,1212,1,13,6,6,7,single-choice,spatial-relational,6|7,7,6/7,210481,6
3,2,21,482,1,1772,1,13,6,6,7,single-choice,spatial-relational,6|7,7,6/7,210482,6
3,2,21,483,1,1410,1,9,4,4,5,single-choice,spatial-relational,4|5,7,4/5,210483,4
3,2,21,484,1,1286,1,9,4,4,5,single-choice,spatial-relational,4|5,7,4/5,210484,4
3,2,21,485,1,966,1,7,3,3,4,single-choice,spatial-relational,3|4,7,3/4,210485,3
3,2,21,486,1,816,1,3,1,1,2,single-choice,spatial-relational,1|2,7,1/2,210486,1
3,2,21,487,1,1027,1,7,3,3,4,single-choice,spatial-relational,3|4,7,3/4,210487,3
3,2,21,488,0,756,1,5,2,3,3,single-choice,spatial-relational,2|3,7,2/3,210488,2
3,2,21,489,1,1267,1,5,2,2,3,single-choice,spatial-relational,2|3,7,2/3,210489,2
3,2,21,490,0,1065,1,11,5,6,6,single-choice,spatial-relational,5|6,7,5/6,210490,5
3,2,21,491,0,1053,1,11,5,6,6,single-choice,spatial-relational,5|6,7,5/6,210491,5
3,2,21,492,1,1034,1,3,1,1,2,single-choice,spatial-relational,1|2,7,1/2,210492,1
3,2,21,493,0,1108,1,5,2,3,3,single-choice,spatial-relational,2|3,7,2/3,210493,2
3,2,21,494,1,1391,1,11,5,5,6,single-choice,spatial-relational,5|6,7,5/6,210494,5
3,2,21,495,1,1173,1,7,3,3,4,single-choice,spatial-relational,3|4,7,3/4,210495,3
3,2,21,496,0,1636,1,9,4,5,5,single-choice,spatial-relational,4|5,7,4/5,210496,4
3,2,21,497,1,1161,1,3,1,1,2,single-choice,spatial-relational,1|2,7,1/2,210497,1
3,2,21,498,1,896,1,3,1,1,2,single-choice,spatial-relational,1|2,7,1/2,210498,1
3,2,21,499,1,1574,1,13,6,6,7,single-choice,spatial-relational,6|7,7,6/7,210499,6
3,2,21,500,0,1085,1,7,3,4,4,single-choice,spatial-relational,3|4,7,3/4,210500,3
3,2,21,501,0,808,1,9,4,5,5,single-choice,spatial-relational,4|5,7,4/5,210501,4
3,2,21,502,1,1121,1,5,2,2,3,single-choice,spatial-relational,2|3,7,2/3,210502,2
3,2,21,503,1,1387,1,13,6,6,7,single-choice,spatial-relational,6|7,7,6/7,210503,6
3,2,21,504,0,1169,1,11,5,6,6,single-choice,spatial-relational,5|6,7,5/6,210504,5
3,2,21,505,1,1231,1,9,4,4,5,single-choice,spatial-relational,4|5,7,4/5,210505,4
3,2,21,506,1,1556,1,13,6,6,7,single-choice,spatial-relational,6|7,7,6/7,210506,6
3,2,21,507,1,2407,1,7,3,3,4,single-choice,spatial-relational,3|4,7,3/4,210507,3
3,2,21,508,1,1028,1,9,4,4,5,single-choice,spatial-relational,4|5,7,4/5,210508,4
3,2,21,509,1,938,1,7,3,3,4,single-choice,spatial-relational,3|4,7,3/4,210509,3
3,2,21,510,1,1153,1,13,6,6,7,single-choice,spatial-relational,6|7,7,6/7,210510,6
3,2,21,511,1,859,1,3,1,1,2,single-choice,spatial-relational,1|2,7,1/2,210511,1
3,2,21,512,0,612,1,3,1,2,2,single-choice,spatial-relational,1|2,7,1/2,210512,1
3,2,21,513,0,1235,1,11,5,6,6,single-choice,spatial-relational,5|6,7,5/6,210513,5
3,2,21,514,1,1800,1,5,2,2,3,single-choice,spatial-relational,2|3,7,2/3,210514,2
3,2,21,515,1,1960,1,11,5,5,6,single-choice,spatial-relational,5|6,7,5/6,210515,5
3,2,21,516,1,1254,1,5,2,2,3,single-choice,spatial-relational,2|3,7,2/3,210516,2
3,2,21,517,1,1152,1,3,1,1,2,single-choice,spatial-relational,1|2,7,1/2,210517,1
3,2,21,518,1,1369,1,3,1,1,2,single-choice,spatial-relational,1|2,7,1/2,210518,1
3,2,21,519,1,1041,1,7,3,3,4,single-choice,spatial-relational,3|4,7,3/4,210519,3
3,2,21,520,1,1567,1,9,4,4,5,single-choice,spatial-relational,4|5,7,4/5,210520,4
3,2,21,521,1,2379,1,5,2,2,3,single-choice,spatial-relational,2|3,7,2/3,210521,2
3,2,21,522,1,2634,1,7,3,3,4,single-choice,spatial-relational,3|4,7,3/4,210522,3
3,2,21,523,1,1223,1,13,6,6,7,single-choice,spatial-relational,6|7,7,6/7,210523,6
3,2,21,524,1,1060,1,13,6,6,7,single-choice,spatial-relational,6|7,7,6/7,210524,6
3,2,21,525,1,1215,1,9,4,4,5,single-choice,spatial-relational,4|5,7,4/5,210525,4
3,2,21,526,1,1299,1,11,5,5,6,single-choice,spatial-relational,5|6,7,5/6,210526,5
3,2,21,527,0,1862,1,11,5,6,6,single-choice,spatial-relational,5|6,7,5/6,210527,5
3,2,21,528,1,1386,1,5,2,2,3,single-choice,spatial-relational,2|3,7,2/3,210528,2
3,2,21,529,1,1309,1,9,4,4,5,single-choice,spatial-relational,4|5,7,4/5,210529,4
3,2,21,530,0,895,1,5,2,3,3,single-choice,spatial-relational,2|3,7,2/3,210530,2
3,2,21,531,1,1488,1,5,2,2,3,single-choice,spatial-relational,2|3,7,2/3,210531,2
3,2,21,532,1,1060,1,9,4,4,5,single-choice,spatial-relational,4|5,7,4/5,210532,4
3,2,21,533,1,1326,1,11,5,5,6,single-choice,spatial-relational,5|6,7,5/6,210533,5
3,2,21,534,1,1166,1,7,3,3,4,single-choice,spatial-relational,3|4,7,3/4,210534,3
3,2,21,535,0,897,1,3,1,2,2,single-choice,spatial-relational,1|2,7,1/2,210535,1
3,2,21,536,1,923,1,7,3,3,4,single-choice,spatial-relational,3|4,7,3/4,210536,3
3,2,21,537,1,1077,1,13,6,6,7,single-choice,spatial-relational,6|7,7,6/7,210537,6
3,2,21,538,0,1269,1,11,5,6,6,single-choice,spatial-relational,5|6,7,5/6,210538,5
3,2,21,539,1,973,1,13,6,6,7,single-choice,spatial-relational,6|7,7,6/7,210539,6
3,2,21,540,1,1001,1,3,1,1,2,single-choice,spatial-relational,1|2,7,1/2,210540,1
3,2,21,541,1,1211,1,3,1,1,2,single-choice,spatial-relational,1|2,7,1/2,210541,1
3,2,21,542,1,1775,1,11,5,5,6,single-choice,spatial-relational,5|6,7,5/6,210542,5
3,2,21,543,1,1227,1,5,2,2,3,single-choice,spatial-relational,2|3,7,2/3,210543,2
3,2,21,544,1,1089,1,7,3,3,4,single-choice,spatial-relational,3|4,7,3/4,210544,3
3,2,21,545,1,1170,1,11,5,5,6,single-choice,spatial-relational,5|6,7,5/6,210545,5
3,2,21,546,1,850,1,9,4,4,5,single-choice,spatial-relational,4|5,7,4/5,210546,4
3,2,21,547,1,1354,1,13,6,6,7,single-choice,spatial-relational,6|7,7,6/7,210547,6
3,2,21,548,1,1477,1,7,3,3,4,single-choice,spatial-relational,3|4,7,3/4,210548,3
3,2,21,549,1,1817,1,5,2,2,3,single-choice,spatial-relational,2|3,7,2/3,210549,2
3,2,21,550,1,1454,1,13,6,6,7,single-choice,spatial-relational,6|7,7,6/7,210550,6
3,2,21,551,1,882,1,3,1,1,2,single-choice,spatial-relational,1|2,7,1/2,210551,1
3,2,21,552,1,765,1,9,4,4,5,single-choice,spatial-relational,4|5,7,4/5,210552,4
3,2,21,553,1,1103,1,5,2,2,3,single-choice,spatial-relational,2|3,7,2/3,210553,2
3,2,21,554,1,1100,1,3,1,1,2,single-choice,spatial-relational,1|2,7,1/2,210554,1
3,2,21,555,1,1106,1,13,6,6,7,single-choice,spatial-relational,6|7,7,6/7,210555,6
3,2,21,556,0,2079,1,7,3,4,4,single-choice,spatial-relational,3|4,7,3/4,210556,3
3,2,21,557,1,1027,1,13,6,6,7,single-choice,spatial-relational,6|7,7,6/7,210557,6
3,2,21,558,1,1318,1,3,1,1,2,single-choice,spatial-relational,1|2,7,1/2,210558,1
3,2,21,559,1,1167,1,9,4,4,5,single-choice,spatial-relational,4|5,7,4/5,210559,4
3,2,21,560,1,1269,1,11,5,5,6,single-choice,spatial-relational,5|6,7,5/6,210560,5
3,2,21,561,1,1264,1,5,2,2,3,single-choice,spatial-relational,2|3,7,2/3,210561,2
3,2,21,562,1,868,1,11,5,5,6,single-choice,spatial-relational,5|6,7,5/6,210562,5
3,2,21,563,1,811,1,9,4,4,5,single-choice,spatial-relational,4|5,7,4/5,210563,4
3,2,21,564,1,2075,1,7,3,3,4,single-choice,spatial-relational,3|4,7,3/4,210564,3
3,2,21,565,0,805,1,3,1,2,2,single-choice,spatial-relational,1|2,7,1/2,210565,1
3,2,21,566,1,1017,1,13,6,6,7,single-choice,spatial-relational,6|7,7,6/7,210566,6
3,2,21,567,1,1399,1,13,6,6,7,single-choice,spatial-relational,6|7,7,6/7,210567,6
3,2,21,568,1,1047,1,5,2,2,3,single-choice,spatial-relational,2|3,7,2/3,210568,2
3,2,21,569,1,1086,1,5,2,2,3,single-choice,spatial-relational,2|3,7,2/3,210569,2
3,2,21,570,1,1054,1,11,5,5,6,single-choice,spatial-relational,5|6,7,5/6,210570,5
3,2,21,571,1,1143,1,9,4,4,5,single-choice,spatial-relational,4|5,7,4/5,210571,4
3,2,21,572,0,714,1,11,5,6,6,single-choice,spatial-relational,5|6,7,5/6,210572,5
3,2,21,573,1,1508,1,7,3,3,4,single-choice,spatial-relational,3|4,7,3/4,210573,3
3,2,21,574,1,1123,1,3,1,1,2,single-choice,spatial-relational,1|2,7,1/2,210574,1
3,2,21,575,1,1757,1,7,3,3,4,single-choice,spatial-relational,3|4,7,3/4,210575,3
3,2,21,576,1,1328,1,9,4,4,5,single-choice,spatial-relational,4|5,7,4/5,210576,4
3,2,21,577,0,838,1,3,1,2,2,single-choice,spatial-relational,1|2,7,1/2,210577,1
3,2,21,578,1,974,1,7,3,3,4,single-choice,spatial-relational,3|4,7,3/4,210578,3
3,2,21,579,0,1985,1,11,5,6,6,single-choice,spatial-relational,5|6,7,5/6,210579,5
3,2,21,580,1,1034,1,13,6,6,7,single-choice,spatial-relational,6|7,7,6/7,210580,6
3,2,21,581,1,1162,1,9,4,4,5,single-choice,spatial-relational,4|5,7,4/5,210581,4
3,2,21,582,1,1200,1,9,4,4,5,single-choice,spatial-relational,4|5,7,4/5,210582,4
3,2,21,583,1,1479,1,5,2,2,3,single-choice,spatial-relational,2|3,7,2/3,210583,2
3,2,21,584,1,907,1,3,1,1,2,single-choice,spatial-relational,1|2,7,1/2,210584,1
3,2,21,585,1,927,1,13,6,6,7,single-choice,spatial-relational,6|7,7,6/7,210585,6
3,2,21,586,0,1396,1,11,5,6,6,single-choice,spatial-relational,5|6,7,5/6,210586,5
3,2,21,587,1,1083,1,7,3,3,4,single-choice,spatial-relational,3|4,7,3/4,210587,3
3,2,21,588,1,1214,1,5,2,2,3,single-choice,spatial-relational,2|3,7,2/3,210588,2
3,2,21,589,1,1226,1,5,2,2,3,single-choice,spatial-relational,2|3,7,2/3,210589,2
3,2,21,590,1,1177,1,13,6,6,7,single-choice,spatial-relational,6|7,7,6/7,210590,6
3,2,21,591,1,1021,1,11,5,5,6,single-choice,spatial-relational,5|6,7,5/6,210591,5
3,2,21,592,1,1141,1,9,4,4,5,single-choice,spatial-relational,4|5,7,4/5,210592,4
3,2,21,593,1,1268,1,5,2,2,3,single-choice,spatial-relational,2|3,7,2/3,210593,2
3,2,21,594,1,1330,1,9,4,4,5,single-choice,spatial-relational,4|5,7,4/5,210594,4
3,2,21,595,1,1283,1,7,3,3,4,single-choice,spatial-relational,3|4,7,3/4,210595,3
3,2,21,596,0,1177,1,11,5,6,6,single-choice,spatial-relational,5|6,7,5/6,210596,5
3,2,21,597,1,1313,1,3,1,1,2,single-choice,spatial-relational,1|2,7,1/2,210597,1
3,2,21,598,0,1077,1,3,1,2,2,single-choice,spatial-relational,1|2,7,1/2,210598,1
3,2,21,599,1,1035,1,7,3,3,4,single-choice,spatial-relational,3|4,7,3/4,210599,3
3,2,21,600,1,1380,1,13,6,6,7,single-choice,spatial-relational,6|7,7,6/7,210600,6
4,2,21,1,0,725,1,11,5,6,6,single-choice,spatial-relational,5|6,7,5/6,210001,5
4,2,21,2,1,1551,1,9,4,4,5,single-choice,spatial-relational,4|5,7,4/5,210002,4
4,2,21,3,1,1451,1,13,6,6,7,single-choice,spatial-relational,6|7,7,6/7,210003,6
4,2,21,4,0,1071,1,7,3,4,4,single-choice,spatial-relational,3|4,7,3/4,210004,3
4,2,21,5,1,2040,1,3,1,1,2,single-choice,spatial-relational,1|2,7,1/2,210005,1
4,2,21,6,1,768,1,5,2,2,3,single-choice,spatial-relational,2|3,7,2/3,210006,2
4,2,21,7,1,1295,1,5,2,2,3,single-choice,spatial-relational,2|3,7,2/3,210007,2
4,2,21,8,0,1523,1,7,3,4,4,single-choice,spatial-relational,3|4,7,3/4,210008,3
4,2,21,9,0,142,1,13,6,7,7,single-choice,spatial-relational,6|7,7,6/7,210009,6
4,2,21,10,0,1873,1,11,5,6,6,single-choice,spatial-relational,5|6,7,5/6,210010,5
4,2,21,11,1,1092,1,3,1,1,2,single-choice,spatial-relational,1|2,7,1/2,210011,1
4,2,21,12,0,1191,1,9,4,5,5,single-choice,spatial-relational,4|5,7,4/5,210012,4
4,2,21,13,1,1099,1,7,3,3,4,single-choice,spatial-relational,3|4,7,3/4,210013,3
4,2,21,14,1,1175,1,3,1,1,2,single-choice,spatial-relational,1|2,7,1/2,210014,1
4,2,21,15,0,1063,1,3,1,2,2,single-choice,spatial-relational,1|2,7,1/2,210015,1
4,2,21,16,1,876,1,11,5,5,6,single-choice,spatial-relational,5|6,7,5/6,210016,5
4,2,21,17,1,2434,1,13,6,6,7,single-choice,spatial-relational,6|7,7,6/7,210017,6
4,2,21,18,1,2137,1,9,4,4,5,single-choice,spatial-relational,4|5,7,4/5,210018,4
4,2,21,19,1,1421,1,5,2,2,3,single-choice,spatial-relational,2|3,7,2/3,210019,2
4,2,21,20,1,889,1,5,2,2,3,single-choice,spatial-relational,2|3,7,2/3,210020,2
4,2,21,21,1,1868,1,13,6,6,7,single-choice,spatial-relational,6|7,7,6/7,210021,6
4,2,21,22,0,1525,1,9,4,5,5,single-choice,spatial-relational,4|5,7,4/5,210022,4
4,2,21,23,1,1085,1,7,3,3,4,single-choice,spatial-relational,3|4,7,3/4,210023,3
4,2,21,24,1,981,1,11,5,5,6,single-choice,spatial-relational,5|6,7,5/6,210024,5
4,2,21,25,0,1944,1,9,4,5,5,single-choice,spatial-relational,4|5,7,4/5,210025,4
4,2,21,26,1,1070,1,11,5,5,6,single-choice,spatial-relational,5|6,7,5/6,210026,5
4,2,21,27,0,1000,1,5,2,3,3,single-choice,spatial-relational,2|3,7,2/3,210027,2
4,2,21,28,1,212,1,3,1,1,2,single-choice,spatial-relational,1|2,7,1/2,210028,1
4,2,21,29,1,846,1,7,3,3,4,single-choice,spatial-relational,3|4,7,3/4,210029,3
4,2,21,30,1,1564,1,9,4,4,5,single-choice,spatial-relational,4|5,7,4/5,210030,4
4,2,21,31,1,1326,1,11,5,5,6,single-choice,spatial-relational,5|6,7,5/6,210031,5
4,2,21,32,0,2085,1,3,1,2,2,single-choice,spatial-relational,1|2,7,1/2,210032,1
4,2,21,33,0,656,1,5,2,3,3,single-choice,spatial-relational,2|3,7,2/3,210033,2
4,2,21,34,1,849,1,13,6,6,7,single-choice,spatial-relational,6|7,7,6/7,210034,6
4,2,21,35,1,1337,1,13,6,6,7,single-choice,spatial-relational,6|7,7,6/7,210035,6
4,2,21,36,0,1932,1,7,3,4,4,single-choice,spatial-relational,3|4,7,3/4,210036,3
4,2,21,37,0,701,1,11,5,6,6,single-choice,spatial-relational,5|6,7,5/6,210037,5
4,2,21,38,0,1772,1,5,2,3,3,single-choice,spatial-relational,2|3,7,2/3,210038,2
4,2,21,39,1,1836,1,3,1,1,2,single-choice,spatial-relational,1|2,7,1/2,210039,1
4,2,21,40,0,209,1,13,6,7,7,single-choice,spatial-relational,6|7,7,6/7,210040,6
4,2,21,41,0,689,1,9,4,5,5,single-choice,spatial-relational,4|5,7,4/5,210041,4
4,2,21,42,1,957,1,5,2,2,3,single-choice,spatial-relational,2|3,7,2/3,210042,2
4,2,21,43,0,841,1,3,1,2,2,single-choice,spatial-relational,1|2,7,1/2,210043,1
4,2,21,44,1,895,1,7,3,3,4,single-choice,spatial-relational,3|4,7,3/4,210044,3
4,2,21,45,0,1756,1,9,4,5,5,single-choice,spatial-relational,4|5,7,4/5,210045,4
4,2,21,46,1,994,1,13,6,6,7,single-choice,spatial-relational,6|7,7,6/7,210046,6
4,2,21,47,1,1620,1,7,3,3,4,single-choice,spatial-relational,3|4,7,3/4,210047,3
4,2,21,48,0,1487,1,11,5,6,6,single-choice,spatial-relational,5|6,7,5/6,210048,5
4,2,21,49,1,1181,1,11,5,5,6,single-choice,spatial-relational,5|6,7,5/6,210049,5
4,2,21,50,1,1772,1,7,3,3,4,single-choice,spatial-relational,3|4,7,3/4,210050,3
4,2,21,51,1,1123,1,13,6,6,7,single-choice,spatial-relational,6|7,7,6/7,210051,6
4,2,21,52,0,2741,1,11,5,6,6,single-choice,spatial-relational,5|6,7,5/6,210052,5
4,2,21,53,1,939,1,3,1,1,2,single-choice,spatial-relational,1|2,7,1/2,210053,1
4,2,21,54,1,1687,1,9,4,4,5,single-choice,spatial-relational,4|5,7,4/5,210054,4
4,2,21,55,1,2581,1,5,2,2,3,single-choice,spatial-relational,2|3,7,2/3,210055,2
4,2,21,56,0,960,1,3,1,2,2,single-choice,spatial-relational,1|2,7,1/2,210056,1
4,2,21,57,1,977,1,13,6,6,7,single-choice,spatial-relational,6|7,7,6/7,210057,6
4,2,21,58,1,1137,1,9,4,4,5,single-choice,spatial-relational,4|5,7,4/5,210058,4
4,2,21,59,1,2698,1,7,3,3,4,single-choice,spatial-relational,3|4,7,3/4,210059,3
4,2,21,60,1,2805,1,5,2,2,3,single-choice,spatial-relational,2|3,7,2/3,210060,2
4,2,21,61,1,872,1,9,4,4,5,single-choice,spatial-relational,4|5,7,4/5,210061,4
4,2,21,62,1,4107,1,9,4,4,5,single-choice,spatial-relational,4|5,7,4/5,210062,4
4,2,21,63,1,2437,1,5,2,2,3,single-choice,spatial-relational,2|3,7,2/3,210063,2
4,2,21,64,1,1878,1,13,6,6,7,single-choice,spatial-relational,6|7,7,6/7,210064,6
4,2,21,65,0,1178,1,5,2,3,3,single-choice,spatial-relational,2|3,7,2/3,210065,2
4,2,21,66,1,823,1,13,6,6,7,single-choice,spatial-relational,6|7,7,6/7,210066,6
4,2,21,67,1,1824,1,3,1,1,2,single-choice,spatial-relational,1|2,7,1/2,210067,1
4,2,21,68,1,1813,1,3,1,1,2,single-choice,spatial-relational,1|2,7,1/2,210068,1
4,2,21,69,1,1274,1,7,3,3,4,single-choice,spatial-relational,3|4,7,3/4,210069,3
4,2,21,70,0,2036,1,11,5,6,6,single-choice,spatial-relational,5|6,7,5/6,210070,5
4,2,21,71,1,986,1,11,5,5,6,single-choice,spatial-relational,5|6,7,5/6,210071,5
4,2,21,72,1,3098,1,7,3,3,4,single-choice,spatial-relational,3|4,7,3/4,210072,3
4,2,21,73,1,1429,1,9,4,4,5,single-choice,spatial-relational,4|5,7,4/5,210073,4
4,2,21,74,1,2655,1,11,5,5,6,single-choice,spatial-relational,5|6,7,5/6,210074,5
4,2,21,75,0,1227,1,5,2,3,3,single-choice,spatial-relational,2|3,7,2/3,210075,2
4,2,21,76,1,1034,1,13,6,6,7,single-choice,spatial-relational,6|7,7,6/7,210076,6
4,2,21,77,1,2141,1,3,1,1,2,single-choice,spatial-relational,1|2,7,1/2,210077,1
4,2,21,78,1,1402,1,9,4,4,5,single-choice,spatial-relational,4|5,7,4/5,210078,4
4,2,21,79,1,1638,1,7,3,3,4,single-choice,spatial-relational,3|4,7,3/4,210079,3
4,2,21,80,0,1072,1,5,2,3,3,single-choice,spatial-relational,2|3,7,2/3,210080,2
4,2,21,81,1,849,1,11,5,5,6,single-choice,spatial-relational,5|6,7,5/6,210081,5
4,2,21,82,0,828,1,7,3,4,4,single-choice,spatial-relational,3|4,7,3/4,210082,3
4,2,21,83,1,1111,1,13,6,6,7,single-choice,spatial-relational,6|7,7,6/7,210083,6
4,2,21,84,1,2216,1,3,1,1,2,single-choice,spatial-relational,1|2,7,1/2,210084,1
4,2,21,85,1,1388,1,7,3,3,4,single-choice,spatial-relational,3|4,7,3/4,210085,3
4,2,21,86,1,1470,1,11,5,5,6,single-choice,spatial-relational,5|6,7,5/6,210086,5
4,2,21,87,1,1236,1,7,3,3,4,single-choice,spatial-relational,3|4,7,3/4,210087,3
4,2,21,88,1,1141,1,3,1,1,2,single-choice,spatial-relational,1|2,7,1/2,210088,1
4,2,21,89,0,131,1,5,2,3,3,single-choice,spatial-relational,2|3,7,2/3,210089,2
4,2,21,90,1,1617,1,11,5,5,6,single-choice,spatial-relational,5|6,7,5/6,210090,5
4,2,21,91,0,1561,1,13,6,7,7,single-choice,spatial-relational,6|7,7,6/7,210091,6
4,2,21,92,0,563,1,9,4,5,5,single-choice,spatial-relational,4|5,7,4/5,210092,4
4,2,21,93,0,729,1,13,6,7,7,single-choice,spatial-relational,6|7,7,6/7,210093,6
4,2,21,94,1,1529,1,9,4,4,5,single-choice,spatial-relational,4|5,7,4/5,210094,4
4,2,21,95,1,1658,1,5,2,2,3,single-choice,spatial-relational,2|3,7,2/3,210095,2
4,2,21,96,0,1048,1,3,1,2,2,single-choice,spatial-relational,1|2,7,1/2,210096,1
4,2,21,97,1,1381,1,5,2,2,3,single-choice,spatial-relational,2|3,7,2/3,210097,2
4,2,21,98,1,923,1,7,3,3,4,single-choice,spatial-relational,3|4,7,3/4,210098,3
4,2,21,99,0,1588,1,11,5,6,6,single-choice,spatial-relational,5|6,7,5/6,210099,5
4,2,21,100,1,894,1,3,1,1,2,single-choice,spatial-relational,1|2,7,1/2,210100,1
4,2,21,101,1,1926,1,11,5,5,6,single-choice,spatial-relational,5|6,7,5/6,210101,5
4,2,21,102,1,1814,1,3,1,1,2,single-choice,spatial-relational,1|2,7,1/2,210102,1
4,2,21,103,1,1099,1,9,4,4,5,single-choice,spatial-relational,4|5,7,4/5,210103,4
4,2,21,104,1,1296,1,9,4,4,5,single-choice,spatial-relational,4|5,7,4/5,210104,4
4,2,21,105,1,2588,1,7,3,3,4,single-choice,spatial-relational,3|4,7,3/4,210105,3
4,2,21,106,1,1965,1,13,6,6,7,single-choice,spatial-relational,6|7,7,6/7,210106,6
4,2,21,107,1,3705,1,5,2,2,3,single-choice,spatial-relational,2|3,7,2/3,210107,2
4,2,21,108,1,117,1,13,6,6,7,single-choice,spatial-relational,6|7,7,6/7,210108,6
4,2,21,109,1,1211,1,5,2,2,3,single-choice,spatial-relational,2|3,7,2/3,210109,2
4,2,21,110,1,1299,1,3,1,1,2,single-choice,spatial-relational,1|2,7,1/2,210110,1
4,2,21,111,1,983,1,13,6,6,7,single-choice,spatial-relational,6|7,7,6/7,210111,6
4,2,21,112,1,2464,1,11,5,5,6,single-choice,spatial-relational,5|6,7,5/6,210112,5
4,2,21,113,1,1397,1,9,4,4,5,single-choice,spatial-relational,4|5,7,4/5,210113,4
4,2,21,114,1,1114,1,7,3,3,4,single-choice,spatial-relational,3|4,7,3/4,210114,3
4,2,21,115,0,1027,1,5,2,3,3,single-choice,spatial-relational,2|3,7,2/3,210115,2
4,2,21,116,1,1114,1,3,1,1,2,single-choice,spatial-relational,1|2,7,1/2,210116,1
4,2,21,117,1,1173,1,9,4,4,5,single-choice,spatial-relational,4|5,7,4/5,210117,4
4,2,21,118,1,1005,1,7,3,3,4,single-choice,spatial-relational,3|4,7,3/4,210118,3
4,2,21,119,0,2024,1,11,5,6,6,single-choice,spatial-relational,5|6,7,5/6,210119,5
4,2,21,120,1,907,1,13,6,6,7,single-choice,spatial-relational,6|7,7,6/7,210120,6
4,2,21,121,1,1447,1,5,2,2,3,single-choice,spatial-relational,2|3,7,2/3,210121,2
4,2,21,122,0,1479,1,3,1,2,2,single-choice,spatial-relational,1|2,7,1/2,210122,1
4,2,21,123,1,1104,1,13,6,6,7,single-choice,spatial-relational,6|7,7,6/7,210123,6
4,2,21,124,1,1347,1,9,4,4,5,single-choice,spatial-relational,4|5,7,4/5,210124,4
4,2,21,125,1,1382,1,11,5,5,6,single-choice,spatial-relational,5|6,7,5/6,210125,5
4,2,21,126,0,2932,1,11,5,6,6,single-choice,spatial-relational,5|6,7,5/6,210126,5
4,2,21,127,1,1103,1,7,3,3,4,single-choice,spatial-relational,3|4,7,3/4,210127,3
4,2,21,128,1,1327,1,13,6,6,7,single-choice,spatial-relational,6|7,7,6/7,210128,6
4,2,21,129,1,1428,1,7,3,3,4,single-choice,spatial-relational,3|4,7,3/4,210129,3
4,2,21,130,1,922,1,9,4,4,5,single-choice,spatial-relational,4|5,7,4/5,210130,4
4,2,21,131,1,1389,1,5,2,2,3,single-choice,spatial-relational,2|3,7,2/3,210131,2
4,2,21,132,0,1010,1,3,1,2,2,single-choice,spatial-relational,1|2,7,1/2,210132,1
4,2,21,133,1,1051,1,3,1,1,2,single-choice,spatial-relational,1|2,7,1/2,210133,1
4,2,21,134,1,1438,1,9,4,4,5,single-choice,spatial-relational,4|5,7,4/5,210134,4
4,2,21,135,1,1303,1,13,6,6,7,single-choice,spatial-relational,6|7,7,6/7,210135,6
4,2,21,136,0,1047,1,3,1,2,2,single-choice,spatial-relational,1|2,7,1/2,210136,1
4,2,21,137,1,1196,1,5,2,2,3,single-choice,spatial-relational,2|3,7,2/3,210137,2
4,2,21,138,1,1368,1,7,3,3,4,single-choice,spatial-relational,3|4,7,3/4,210138,3
4,2,21,139,0,1084,1,5,2,3,3,single-choice,spatial-relational,2|3,7,2/3,210139,2
4,2,21,140,1,980,1,9,4,4,5,single-choice,spatial-relational,4|5,7,4/5,210140,4
4,2,21,141,1,2722,1,11,5,5,6,single-choice,spatial-relational,5|6,7,5/6,210141,5
4,2,21,142,1,1552,1,11,5,5,6,single-choice,spatial-relational,5|6,7,5/6,210142,5
4,2,21,143,0,1032,1,13,6,7,7,single-choice,spatial-relational,6|7,7,6/7,210143,6
4,2,21,144,1,699,1,7,3,3,4,single-choice,spatial-relational,3|4,7,3/4,210144,3
4,2,21,145,1,1490,1,13,6,6,7,single-choice,spatial-relational,6|7,7,6/7,210145,6
4,2,21,146,0,2369,1,11,5,6,6,single-choice,spatial-relational,5|6,7,5/6,210146,5
4,2,21,147,1,792,1,13,6,6,7,single-choice,spatial-relational,6|7,7,6/7,210147,6
4,2,21,148,1,1287,1,5,2,2,3,single-choice,spatial-relational,2|3,7,2/3,210148,2
4,2,21,149,1,739,1,9,4,4,5,single-choice,spatial-relational,4|5,7,4/5,210149,4
4,2,21,150,0,970,1,3,1,2,2,single-choice,spatial-relational,1|2,7,1/2,210150,1
4,2,21,151,1,958,1,7,3,3,4,single-choice,spatial-relational,3|4,7,3/4,210151,3
4,2,21,152,1,1278,1,5,2,2,3,single-choice,spatial-relational,2|3,7,2/3,210152,2
4,2,21,153,1,1103,1,11,5,5,6,single-choice,spatial-relational,5|6,7,5/6,210153,5
4,2,21,154,1,1796,1,7,3,3,4,single-choice,spatial-relational,3|4,7,3/4,210154,3
4,2,21,155,0,2535,1,3,1,2,2,single-choice,spatial-relational,1|2,7,1/2,210155,1
4,2,21,156,1,1193,1,9,4,4,5,single-choice,spatial-relational,4|5,7,4/5,210156,4
4,2,21,157,1,1026,1,9,4,4,5,single-choice,spatial-relational,4|5,7,4/5,210157,4
4,2,21,158,1,1214,1,11,5,5,6,single-choice,spatial-relational,5|6,7,5/6,210158,5
4,2,21,159,1,1878,1,3,1,1,2,single-choice,spatial-relational,1|2,7,1/2,210159,1
4,2,21,160,1,1249,1,5,2,2,3,single-choice,spatial-relational,2|3,7,2/3,210160,2
4,2,21,161,1,1609,1,13,6,6,7,single-choice,spatial-relational,6|7,7,6/7,210161,6
4,2,21,162,1,4053,1,5,2,2,3,single-choice,spatial-relational,2|3,7,2/3,210162,2
4,2,21,163,1,1112,1,13,6,6,7,single-choice,spatial-relational,6|7,7,6/7,210163,6
4,2,21,164,0,1339,1,11,5,6,6,single-choice,spatial-relational,5|6,7,5/6,210164,5
4,2,21,165,1,719,1,9,4,4,5,single-choice,spatial-relational,4|5,7,4/5,210165,4
4,2,21,166,1,1588,1,7,3,3,4,single-choice,spatial-relational,3|4,7,3/4,210166,3
4,2,21,167,0,1033,1,3,1,2,2,single-choice,spatial-relational,1|2,7,1/2,210167,1
4,2,21,168,1,917,1,7,3,3,4,single-choice,spatial-relational,3|4,7,3/4,210168,3
4,2,21,169,1,1035,1,13,6,6,7,single-choice,spatial-relational,6|7,7,6/7,210169,6
4,2,21,170,1,1556,1,7,3,3,4,single-choice,spatial-relational,3|4,7,3/4,210170,3
4,2,21,171,1,1280,1,5,2,2,3,single-choice,spatial-relational,2|3,7,2/3,210171,2
4,2,21,172,1,1464,1,11,5,5,6,single-choice,spatial-relational,5|6,7,5/6,210172,5
4,2,21,173,0,1315,1,3,1,2,2,single-choice,spatial-relational,1|2,7,1/2,210173,1
4,2,21,174,1,66,1,11,5,5,6,single-choice,spatial-relational,5|6,7,5/6,210174,5
4,2,21,175,1,1013,1,9,4,4,5,single-choice,spatial-relational,4|5,7,4/5,210175,4
4,2,21,176,1,1974,1,9,4,4,5,single-choice,spatial-relational,4|5,7,4/5,210176,4
4,2,21,177,1,1571,1,7,3,3,4,single-choice,spatial-relational,3|4,7,3/4,210177,3
4,2,21,178,1,2549,1,5,2,2,3,single-choice,spatial-relational,2|3,7,2/3,210178,2
4,2,21,179,1,1496,1,13,6,6,7,single-choice,spatial-relational,6|7,7,6/7,210179,6
4,2,21,180,0,904,1,3,1,2,2,single-choice,spatial-relational,1|2,7,1/2,210180,1
4,2,21,181,1,972,1,13,6,6,7,single-choice,spatial-relational,6|7,7,6/7,210181,6
4,2,21,182,1,1293,1,5,2,2,3,single-choice,spatial-relational,2|3,7,2/3,210182,2
4,2,21,183,1,923,1,9,4,4,5,single-choice,spatial-relational,4|5,7,4/5,210183,4
4,2,21,184,1,1965,1,5,2,2,3,single-choice,spatial-relational,2|3,7,2/3,210184,2
4,2,21,185,1,1434,1,3,1,1,2,single-choice,spatial-relational,1|2,7,1/2,210185,1
4,2,21,186,1,1234,1,13,6,6,7,single-choice,spatial-relational,6|7,7,6/7,210186,6
4,2,21,187,0,1997,1,3,1,2,2,single-choice,spatial-relational,1|2,7,1/2,210187,1
4,2,21,188,1,843,1,7,3,3,4,single-choice,spatial-relational,3|4,7,3/4,210188,3
4,2,21,189,1,1524,1,11,5,5,6,single-choice,spatial-relational,5|6,7,5/6,210189,5
4,2,21,190,1,1797,1,11,5,5,6,single-choice,spatial-relational,5|6,7,5/6,210190,5
4,2,21,191,1,1044,1,9,4,4,5,single-choice,spatial-relational,4|5,7,4/5,210191,4
4,2,21,192,1,2610,1,7,3,3,4,single-choice,spatial-relational,3|4,7,3/4,210192,3
4,2,21,193,0,2323,1,3,1,2,2,single-choice,spatial-relational,1|2,7,1/2,210193,1
4,2,21,194,1,1221,1,11,5,5,6,single-choice,spatial-relational,5|6,7,5/6,210194,5
4,2,21,195,1,952,1,9,4,4,5,single-choice,spatial-relational,4|5,7,4/5,210195,4
4,2,21,196,1,1258,1,13,6,6,7,single-choice,spatial-relational,6|7,7,6/7,210196,6
4,2,21,197,1,1423,1,5,2,2,3,single-choice,spatial-relational,2|3,7,2/3,210197,2
4,2,21,198,0,978,1,5,2,3,3,single-choice,spatial-relational,2|3,7,2/3,210198,2
4,2,21,199,1,798,1,7,3,3,4,single-choice,spatial-relational,3|4,7,3/4,210199,3
4,2,21,200,1,1138,1,11,5,5,6,single-choice,spatial-relational,5|6,7,5/6,210200,5
4,2,21,201,1,1297,1,13,6,6,7,single-choice,spatial-relational,6|7,7,6/7,210201,6
4,2,21,202,1,1945,1,7,3,3,4,single-choice,spatial-relational,3|4,7,3/4,210202,3
4,2,21,203,0,1183,1,3,1,2,2,single-choice,spatial-relational,1|2,7,1/2,210203,1
4,2,21,204,1,888,1,9,4,4,5,single-choice,spatial-relational,4|5,7,4/5,210204,4
4,2,21,205,1,1427,1,7,3,3,4,single-choice,spatial-relational,3|4,7,3/4,210205,3
4,2,21,206,0,1644,1,5,2,3,3,single-choice,spatial-relational,2|3,7,2/3,210206,2
4,2,21,207,1,860,1,11,5,5,6,single-choice,spatial-relational,5|6,7,5/6,210207,5
4,2,21,208,0,1605,1,13,6,7,7,single-choice,spatial-relational,6|7,7,6/7,210208,6
4,2,21,209,0,1222,1,3,1,2,2,single-choice,spatial-relational,1|2,7,1/2,210209,1
4,2,21,210,1,874,1,7,3,3,4,single-choice,spatial-relational,3|4,7,3/4,210210,3
4,2,21,211,1,1100,1,13,6,6,7,single-choice,spatial-relational,6|7,7,6/7,210211,6
4,2,21,212,1,922,1,11,5,5,6,single-choice,spatial-relational,5|6,7,5/6,210212,5
4,2,21,213,1,1335,1,5,2,2,3,single-choice,spatial-relational,2|3,7,2/3,210213,2
4,2,21,214,0,999,1,9,4,5,5,single-choice,spatial-relational,4|5,7,4/5,210214,4
4,2,21,215,1,1118,1,3,1,1,2,single-choice,spatial-relational,1|2,7,1/2,210215,1
4,2,21,216,1,732,1,9,4,4,5,single-choice,spatial-relational,4|5,7,4/5,210216,4
4,2,21,217,1,1275,1,9,4,4,5,single-choice,spatial-relational,4|5,7,4/5,210217,4
4,2,21,218,1,1125,1,13,6,6,7,single-choice,spatial-relational,6|7,7,6/7,210218,6
4,2,21,219,1,997,1,11,5,5,6,single-choice,spatial-relational,5|6,7,5/6,210219,5
4,2,21,220,1,2333,1,5,2,2,3,single-choice,spatial-relational,2|3,7,2/3,210220,2
4,2,21,221,1,1187,1,5,2,2,3,single-choice,spatial-relational,2|3,7,2/3,210221,2
4,2,21,222,0,1149,1,11,5,6,6,single-choice,spatial-relational,5|6,7,5/6,210222,5
4,2,21,223,0,1047,1,3,1,2,2,single-choice,spatial-relational,1|2,7,1/2,210223,1
4,2,21,224,1,782,1,7,3,3,4,single-choice,spatial-relational,3|4,7,3/4,210224,3
4,2,21,225,1,1033,1,13,6,6,7,single-choice,spatial-relational,6|7,7,6/7,210225,6
4,2,21,226,1,1591,1,9,4,4,5,single-choice,spatial-relational,4|5,7,4/5,210226,4
4,2,21,227,1,1077,1,7,3,3,4,single-choice,spatial-relational,3|4,7,3/4,210227,3
4,2,21,228,0,1790,1,3,1,2,2,single-choice,spatial-relational,1|2,7,1/2,210228,1
4,2,21,229,1,48,1,11,5,5,6,single-choice,spatial-relational,5|6,7,5/6,210229,5
4,2,21,230,1,1339,1,3,1,1,2,single-choice,spatial-relational,1|2,7,1/2,210230,1
4,2,21,231,1,1581,1,7,3,3,4,single-choice,spatial-relational,3|4,7,3/4,210231,3
4,2,21,232,1,1516,1,5,2,2,3,single-choice,spatial-relational,2|3,7,2/3,210232,2
4,2,21,233,1,996,1,9,4,4,5,single-choice,spatial-relational,4|5,7,4/5,210233,4
4,2,21,234,1,987,1,13,6,6,7,single-choice,spatial-relational,6|7,7,6/7,210234,6
4,2,21,235,0,1010,1,3,1,2,2,single-choice,spatial-relational,1|2,7,1/2,210235,1
4,2,21,236,0,634,1,5,2,3,3,single-choice,spatial-relational,2|3,7,2/3,210236,2
4,2,21,237,1,900,1,7,3,3,4,single-choice,spatial-relational,3|4,7,3/4,210237,3
4,2,21,238,1,1568,1,11,5,5,6,single-choice,spatial-relational,5|6,7,5/6,210238,5
4,2,21,239,1,1740,1,9,4,4,5,single-choice,spatial-relational,4|5,7,4/5,210239,4
4,2,21,240,1,1162,1,13,6,6,7,single-choice,spatial-relational,6|7,7,6/7,210240,6
4,2,21,241,1,1426,1,9,4,4,5,single-choice,spatial-relational,4|5,7,4/5,210241,4
4,2,21,242,0,1720,1,11,5,6,6,single-choice,spatial-relational,5|6,7,5/6,210242,5
4,2,21,243,0,711,1,5,2,3,3,single-choice,spatial-relational,2|3,7,2/3,210243,2
4,2,21,244,1,1732,1,13,6,6,7,single-choice,spatial-relational,6|7,7,6/7,210244,6
4,2,21,245,1,2551,1,7,3,3,4,single-choice,spatial-relational,3|4,7,3/4,210245,3
4,2,21,246,0,935,1,5,2,3,3,single-choice,spatial-relational,2|3,7,2/3,210246,2
4,2,21,247,1,1054,1,13,6,6,7,single-choice,spatial-relational,6|7,7,6/7,210247,6
4,2,21,248,1,1116,1,3,1,1,2,single-choice,spatial-relational,1|2,7,1/2,210248,1
4,2,21,249,1,1292,1,7,3,3,4,single-choice,spatial-relational,3|4,7,3/4,210249,3
4,2,21,250,0,1078,1,3,1,2,2,single-choice,spatial-relational,1|2,7,1/2,210250,1
4,2,21,251,1,1053,1,9,4,4,5,single-choice,spatial-relational,4|5,7,4/5,210251,4
4,2,21,252,1,1938,1,11,5,5,6,single-choice,spatial-relational,5|6,7,5/6,210252,5
4,2,21,253,1,2010,1,5,2,2,3,single-choice,spatial-relational,2|3,7,2/3,210253,2
4,2,21,254,1,2670,1,7,3,3,4,single-choice,spatial-relational,3|4,7,3/4,210254,3
4,2,21,255,1,1532,1,13,6,6,7,single-choice,spatial-relational,6|7,7,6/7,210255,6
4,2,21,256,0,2140,1,3,1,2,2,single-choice,spatial-relational,1|2,7,1/2,210256,1
4,2,21,257,1,1122,1,13,6,6,7,single-choice,spatial-relational,6|7,7,6/7,210257,6
4,2,21,258,1,1182,1,11,5,5,6,single-choice,spatial-relational,5|6,7,5/6,210258,5
4,2,21,259,1,1501,1,7,3,3,4,single-choice,spatial-relational,3|4,7,3/4,210259,3
4,2,21,260,0,2440,1,11,5,6,6,single-choice,spatial-relational,5|6,7,5/6,210260,5
4,2,21,261,1,1448,1,5,2,2,3,single-choice,spatial-relational,2|3,7,2/3,210261,2
4,2,21,262,0,871,1,3,1,2,2,single-choice,spatial-relational,1|2,7,1/2,210262,1
4,2,21,263,1,863,1,9,4,4,5,single-choice,spatial-relational,4|5,7,4/5,210263,4
4,2,21,264,1,1908,1,9,4,4,5,single-choice,spatial-relational,4|5,7,4/5,210264,4
4,2,21,265,0,2345,1,7,3,4,4,single-choice,spatial-relational,3|4,7,3/4,210265,3
4,2,21,266,1,1259,1,11,5,5,6,single-choice,spatial-relational,5|6,7,5/6,210266,5
4,2,21,267,1,1287,1,11,5,5,6,single-choice,spatial-relational,5|6,7,5/6,210267,5
4,2,21,268,1,1271,1,9,4,4,5,single-choice,spatial-relational,4|5,7,4/5,210268,4
4,2,21,269,0,1963,1,7,3,4,4,single-choice,spatial-relational,3|4,7,3/4,210269,3
4,2,21,270,1,1161,1,5,2,2,3,single-choice,spatial-relational,2|3,7,2/3,210270,2
4,2,21,271,1,971,1,13,6,6,7,single-choice,spatial-relational,6|7,7,6/7,210271,6
4,2,21,272,1,1415,1,9,4,4,5,single-choice,spatial-relational,4|5,7,4/5,210272,4
4,2,21,273,1,1333,1,13,6,6,7,single-choice,spatial-relational,6|7,7,6/7,210273,6
4,2,21,274,1,1598,1,5,2,2,3,single-choice,spatial-relational,2|3,7,2/3,210274,2
4,2,21,275,1,1225,1,3,1,1,2,single-choice,spatial-relational,1|2,7,1/2,210275,1
4,2,21,276,1,1315,1,3,1,1,2,single-choice,spatial-relational,1|2,7,1/2,210276,1
4,2,21,277,0,628,1,5,2,3,3,single-choice,spatial-relational,2|3,7,2/3,210277,2
4,2,21,278,1,965,1,3,1,1,2,single-choice,spatial-relational,1|2,7,1/2,210278,1
4,2,21,279,1,701,1,11,5,5,6,single-choice,spatial-relational,5|6,7,5/6,210279,5
4,2,21,280,1,959,1,9,4,4,5,single-choice,spatial-relational,4|5,7,4/5,210280,4
4,2,21,281,1,2837,1,7,3,3,4,single-choice,spatial-relational,3|4,7,3/4,210281,3
4,2,21,282,1,1348,1,11,5,5,6,single-choice,spatial-relational,5|6,7,5/6,210282,5
4,2,21,283,0,1695,1,7,3,4,4,single-choice,spatial-relational,3|4,7,3/4,210283,3
4,2,21,284,1,1005,1,5,2,2,3,single-choice,spatial-relational,2|3,7,2/3,210284,2
4,2,21,285,1,1184,1,13,6,6,7,single-choice,spatial-relational,6|7,7,6/7,210285,6
4,2,21,286,1,1508,1,13,6,6,7,single-choice,spatial-relational,6|7,7,6/7,210286,6
4,2,21,287,1,1133,1,3,1,1,2,single-choice,spatial-relational,1|2,7,1/2,210287,1
4,2,21,288,1,1292,1,9,4,4,5,single-choice,spatial-relational,4|5,7,4/5,210288,4
4,2,21,289,0,1348,1,3,1,2,2,single-choice,spatial-relational,1|2,7,1/2,210289,1
4,2,21,290,1,960,1,11,5,5,6,single-choice,spatial-relational,5|6,7,5/6,210290,5
4,2,21,291,0,2083,1,9,4,5,5,single-choice,spatial-relational,4|5,7,4/5,210291,4
4,2,21,292,1,1251,1,11,5,5,6,single-choice,spatial-relational,5|6,7,5/6,210292,5
4,2,21,293,1,1566,1,7,3,3,4,single-choice,spatial-relational,3|4,7,3/4,210293,3
4,2,21,294,1,1080,1,3,1,1,2,single-choice,spatial-relational,1|2,7,1/2,210294,1
4,2,21,295,1,1439,1,9,4,4,5,single-choice,spatial-relational,4|5,7,4/5,210295,4
4,2,21,296,1,1405,1,5,2,2,3,single-choice,spatial-relational,2|3,7,2/3,210296,2
4,2,21,297,1,1154,1,13,6,6,7,single-choice,spatial-relational,6|7,7,6/7,210297,6
4,2,21,298,1,1696,1,13,6,6,7,single-choice,spatial-relational,6|7,7,6/7,210298,6
4,2,21,299,0,2633,1,5,2,3,3,single-choice,spatial-relational,2|3,7,2/3,210299,2
4,2,21,300,1,873,1,7,3,3,4,single-choice,spatial-relational,3|4,7,3/4,210300,3
4,2,21,301,1,1817,1,3,1,1,2,single-choice,spatial-relational,1|2,7,1/2,210301,1
4,2,21,302,1,1170,1,7,3,3,4,single-choice,spatial-relational,3|4,7,3/4,210302,3
4,2,21,303,1,1277,1,11,5,5,6,single-choice,spatial-relational,5|6,7,5/6,210303,5
4,2,21,304,1,1688,1,13,6,6,7,single-choice,spatial-relational,6|7,7,6/7,210304,6
4,2,21,305,1,1337,1,9,4,4,5,single-choice,spatial-relational,4|5,7,4/5,210305,4
4,2,21,306,1,1339,1,5,2,2,3,single-choice,spatial-relational,2|3,7,2/3,210306,2
4,2,21,307,1,1520,1,13,6,6,7,single-choice,spatial-relational,6|7,7,6/7,210307,6
4,2,21,308,0,1431,1,9,4,5,5,single-choice,spatial-relational,4|5,7,4/5,210308,4
4,2,21,309,1,909,1,5,2,2,3,single-choice,spatial-relational,2|3,7,2/3,210309,2
4,2,21,310,1,999,1,3,1,1,2,single-choice,spatial-relational,1|2,7,1/2,210310,1
4,2,21,311,1,1891,1,7,3,3,4,single-choice,spatial-relational,3|4,7,3/4,210311,3
4,2,21,312,0,1130,1,11,5,6,6,single-choice,spatial-relational,5|6,7,5/6,210312,5
4,2,21,313,1,1441,1,3,1,1,2,single-choice,spatial-relational,1|2,7,1/2,210313,1
4,2,21,314,0,1410,1,11,5,6,6,single-choice,spatial-relational,5|6,7,5/6,210314,5
4,2,21,315,1,1146,1,7,3,3,4,single-choice,spatial-relational,3|4,7,3/4,210315,3
4,2,21,316,1,1612,1,13,6,6,7,single-choice,spatial-relational,6|7,7,6/7,210316,6
4,2,21,317,1,1588,1,9,4,4,5,single-choice,spatial-relational,4|5,7,4/5,210317,4
4,2,21,318,0,1173,1,5,2,3,3,single-choice,spatial-relational,2|3,7,2/3,210318,2
4,2,21,319,1,857,1,3,1,1,2,single-choice,spatial-relational,1|2,7,1/2,210319,1
4,2,21,320,1,1542,1,5,2,2,3,single-choice,spatial-relational,2|3,7,2/3,210320,2
4,2,21,321,1,1470,1,11,5,5,6,single-choice,spatial-relational,5|6,7,5/6,210321,5
4,2,21,322,1,1122,1,9,4,4,5,single-choice,spatial-relational,4|5,7,4/5,210322,4
4,2,21,323,1,1262,1,7,3,3,4,single-choice,spatial-relational,3|4,7,3/4,210323,3
4,2,21,324,1,1678,1,13,6,6,7,single-choice,spatial-relational,6|7,7,6/7,210324,6
4,2,21,325,1,1841,1,3,1,1,2,single-choice,spatial-relational,1|2,7,1/2,210325,1
4,2,21,326,0,2440,1,11,5,6,6,single-choice,spatial-relational,5|6,7,5/6,210326,5
4,2,21,327,0,764,1,9,4,5,5,single-choice,spatial-relational,4|5,7,4/5,210327,4
4,2,21,328,1,1115,1,5,2,2,3,single-choice,spatial-relational,2|3,7,2/3,210328,2
4,2,21,329,1,913,1,9,4,4,5,single-choice,spatial-relational,4|5,7,4/5,210329,4
4,2,21,330,1,1326,1,5,2,2,3,single-choice,spatial-relational,2|3,7,2/3,210330,2
4,2,21,331,1,1188,1,7,3,3,4,single-choice,spatial-relational,3|4,7,3/4,210331,3
4,2,21,332,1,2049,1,13,6,6,7,single-choice,spatial-relational,6|7,7,6/7,210332,6
4,2,21,333,0,1257,1,3,1,2,2,single-choice,spatial-relational,1|2,7,1/2,210333,1
4,2,21,334,1,844,1,7,3,3,4,single-choice,spatial-relational,3|4,7,3/4,210334,3
4,2,21,335,1,1449,1,13,6,6,7,single-choice,spatial-relational,6|7,7,6/7,210335,6
4,2,21,336,0,2041,1,11,5,6,6,single-choice,spatial-relational,5|6,7,5/6,210336,5
4,2,21,337,1,770,1,11,5,5,6,single-choice,spatial-relational,5|6,7,5/6,210337,5
4,2,21,338,1,1259,1,9,4,4,5,single-choice,spatial-relational,4|5,7,4/5,210338,4
4,2,21,339,1,1515,1,13,6,6,7,single-choice,spatial-relational,6|7,7,6/7,210339,6
4,2,21,340,0,1900,1,3,1,2,2,single-choice,spatial-relational,1|2,7,1/2,210340,1
4,2,21,341,1,912,1,13,6,6,7,single-choice,spatial-relational,6|7,7,6/7,210341,6
4,2,21,342,1,1574,1,9,4,4,5,single-choice,spatial-relational,4|5,7,4/5,210342,4
4,2,21,343,1,1665,1,5,2,2,3,single-choice,spatial-relational,2|3,7,2/3,210343,2
4,2,21,344,1,1537,1,7,3,3,4,single-choice,spatial-relational,3|4,7,3/4,210344,3
4,2,21,345,1,2036,1,11,5,5,6,single-choice,spatial-relational,5|6,7,5/6,210345,5
4,2,21,346,0,1202,1,3,1,2,2,single-choice,spatial-relational,1|2,7,1/2,210346,1
4,2,21,347,1,950,1,7,3,3,4,single-choice,spatial-relational,3|4,7,3/4,210347,3
4,2,21,348,0,2890,1,5,2,3,3,single-choice,spatial-relational,2|3,7,2/3,210348,2
4,2,21,349,1,1478,1,5,2,2,3,single-choice,spatial-relational,2|3,7,2/3,210349,2
4,2,21,350,1,1600,1,11,5,5,6,single-choice,spatial-relational,5|6,7,5/6,210350,5
4,2,21,351,0,1074,1,3,1,2,2,single-choice,spatial-relational,1|2,7,1/2,210351,1
4,2,21,352,1,958,1,13,6,6,7,single-choice,spatial-relational,6|7,7,6/7,210352,6
4,2,21,353,0,1067,1,7,3,4,4,single-choice,spatial-relational,3|4,7,3/4,210353,3
4,2,21,354,1,1247,1,9,4,4,5,single-choice,spatial-relational,4|5,7,4/5,210354,4
4,2,21,355,1,1861,1,9,4,4,5,single-choice,spatial-relational,4|5,7,4/5,210355,4
4,2,21,356,1,1233,1,13,6,6,7,single-choice,spatial-relational,6|7,7,6/7,210356,6
4,2,21,357,0,1325,1,11,5,6,6,single-choice,spatial-relational,5|6,7,5/6,210357,5
4,2,21,358,1,1312,1,3,1,1,2,single-choice,spatial-relational,1|2,7,1/2,210358,1
4,2,21,359,1,1131,1,5,2,2,3,single-choice,spatial-relational,2|3,7,2/3,210359,2
4,2,21,360,1,1357,1,7,3,3,4,single-choice,spatial-relational,3|4,7,3/4,210360,3
4,2,21,361,1,1643,1,9,4,4,5,single-choice,spatial-relational,4|5,7,4/5,210361,4
4,2,21,362,0,1053,1,3,1,2,2,single-choice,spatial-relational,1|2,7,1/2,210362,1
4,2,21,363,1,876,1,7,3,3,4,single-choice,spatial-relational,3|4,7,3/4,210363,3
4,2,21,364,1,1104,1,5,2,2,3,single-choice,spatial-relational,2|3,7,2/3,210364,2
4,2,21,365,1,1352,1,9,4,4,5,single-choice,spatial-relational,4|5,7,4/5,210365,4
4,2,21,366,1,1713,1,11,5,5,6,single-choice,spatial-relational,5|6,7,5/6,210366,5
4,2,21,367,1,2254,1,5,2,2,3,single-choice,spatial-relational,2|3,7,2/3,210367,2
4,2,21,368,1,1159,1,7,3,3,4,single-choice,spatial-relational,3|4,7,3/4,210368,3
4,2,21,369,1,2611,1,11,5,5,6,single-choice,spatial-relational,5|6,7,5/6,210369,5
4,2,21,370,0,1754,1,3,1,2,2,single-choice,spatial-relational,1|2,7,1/2,210370,1
4,2,21,371,0,745,1,13,6,7,7,single-choice,spatial-relational,6|7,7,6/7,210371,6
4,2,21,372,1,852,1,13,6,6,7,single-choice,spatial-relational,6|7,7,6/7,210372,6
4,2,21,373,1,2656,1,11,5,5,6,single-choice,spatial-relational,5|6,7,5/6,210373,5
4,2,21,374,1,2188,1,13,6,6,7,single-choice,spatial-relational,6|7,7,6/7,210374,6
4,2,21,375,0,1153,1,3,1,2,2,single-choice,spatial-relational,1|2,7,1/2,210375,1
4,2,21,376,1,841,1,9,4,4,5,single-choice,spatial-relational,4|5,7,4/5,210376,4
4,2,21,377,1,1952,1,7,3,3,4,single-choice,spatial-relational,3|4,7,3/4,210377,3
4,2,21,378,1,1846,1,7,3,3,4,single-choice,spatial-relational,3|4,7,3/4,210378,3
4,2,21,379,1,1522,1,5,2,2,3,single-choice,spatial-relational,2|3,7,2/3,210379,2
4,2,21,380,1,1202,1,3,1,1,2,single-choice,spatial-relational,1|2,7,1/2,210380,1
4,2,21,381,1,688,1,11,5,5,6,single-choice,spatial-relational,5|6,7,5/6,210381,5
4,2,21,382,1,1340,1,5,2,2,3,single-choice,spatial-relational,2|3,7,2/3,210382,2
4,2,21,383,1,1059,1,13,6,6,7,single-choice,spatial-relational,6|7,7,6/7,210383,6
4,2,21,384,1,1840,1,9,4,4,5,single-choice,spatial-relational,4|5,7,4/5,210384,4
4,2,21,385,0,1007,1,5,2,3,3,single-choice,spatial-relational,2|3,7,2/3,210385,2
4,2,21,386,1,1141,1,5,2,2,3,single-choice,spatial-relational,2|3,7,2/3,210386,2
4,2,21,387,0,1096,1,11,5,6,6,single-choice,spatial-relational,5|6,7,5/6,210387,5
4,2,21,388,1,1395,1,3,1,1,2,single-choice,spatial-relational,1|2,7,1/2,210388,1
4,2,21,389,1,1048,1,7,3,3,4,single-choice,spatial-relational,3|4,7,3/4,210389,3
4,2,21,390,1,1306,1,9,4,4,5,single-choice,spatial-relational,4|5,7,4/5,210390,4
4,2,21,391,1,1411,1,13,6,6,7,single-choice,spatial-relational,6|7,7,6/7,210391,6
4,2,21,392,0,1430,1,11,5,6,6,single-choice,spatial-relational,5|6,7,5/6,210392,5
4,2,21,393,1,1151,1,7,3,3,4,single-choice,spatial-relational,3|4,7,3/4,210393,3
4,2,21,394,1,1529,1,13,6,6,7,single-choice,spatial-relational,6|7,7,6/7,210394,6
4,2,21,395,1,1318,1,3,1,1,2,single-choice,spatial-relational,1|2,7,1/2,210395,1
4,2,21,396,1,791,1,9,4,4,5,single-choice,spatial-relational,4|5,7,4/5,210396,4
4,2,21,397,0,2185,1,7,3,4,4,single-choice,spatial-relational,3|4,7,3/4,210397,3
4,2,21,398,1,1037,1,3,1,1,2,single-choice,spatial-relational,1|2,7,1/2,210398,1
4,2,21,399,1,1060,1,5,2,2,3,single-choice,spatial-relational,2|3,7,2/3,210399,2
4,2,21,400,1,1069,1,13,6,6,7,single-choice,spatial-relational,6|7,7,6/7,210400,6
4,2,21,401,1,1798,1,9,4,4,5,single-choice,spatial-relational,4|5,7,4/5,210401,4
4,2,21,402,0,2025,1,11,5,6,6,single-choice,spatial-relational,5|6,7,5/6,210402,5
4,2,21,403,1,851,1,13,6,6,7,single-choice,spatial-relational,6|7,7,6/7,210403,6
4,2,21,404,1,1666,1,11,5,5,6,single-choice,spatial-relational,5|6,7,5/6,210404,5
4,2,21,405,1,1183,1,5,2,2,3,single-choice,spatial-relational,2|3,7,2/3,210405,2
4,2,21,406,1,1165,1,7,3,3,4,single-choice,spatial-relational,3|4,7,3/4,210406,3
4,2,21,407,0,1882,1,9,4,5,5,single-choice,spatial-relational,4|5,7,4/5,210407,4
4,2,21,408,0,693,1,3,1,2,2,single-choice,spatial-relational,1|2,7,1/2,210408,1
4,2,21,409,1,840,1,13,6,6,7,single-choice,spatial-relational,6|7,7,6/7,210409,6
4,2,21,410,1,1401,1,13,6,6,7,single-choice,spatial-relational,6|7,7,6/7,210410,6
4,2,21,411,1,2419,1,11,5,5,6,single-choice,spatial-relational,5|6,7,5/6,210411,5
4,2,21,412,1,1484,1,5,2,2,3,single-choice,spatial-relational,2|3,7,2/3,210412,2
4,2,21,413,1,1252,1,5,2,2,3,single-choice,spatial-relational,2|3,7,2/3,210413,2
4,2,21,414,1,2108,1,7,3,3,4,single-choice,spatial-relational,3|4,7,3/4,210414,3
4,2,21,415,0,1705,1,3,1,2,2,single-choice,spatial-relational,1|2,7,1/2,210415,1
4,2,21,416,1,980,1,11,5,5,6,single-choice,spatial-relational,5|6,7,5/6,210416,5
4,2,21,417,0,984,1,3,1,2,2,single-choice,spatial-relational,1|2,7,1/2,210417,1
4,2,21,418,1,893,1,9,4,4,5,single-choice,spatial-relational,4|5,7,4/5,210418,4
4,2,21,419,1,1734,1,7,3,3,4,single-choice,spatial-relational,3|4,7,3/4,210419,3
4,2,21,420,0,1960,1,9,4,5,5,single-choice,spatial-relational,4|5,7,4/5,210420,4
4,2,21,421,1,813,1,7,3,3,4,single-choice,spatial-relational,3|4,7,3/4,210421,3
4,2,21,422,1,1564,1,5,2,2,3,single-choice,spatial-relational,2|3,7,2/3,210422,2
4,2,21,423,1,1076,1,9,4,4,5,single-choice,spatial-relational,4|5,7,4/5,210423,4
4,2,21,424,1,1250,1,13,6,6,7,single-choice,spatial-relational,6|7,7,6/7,210424,6
4,2,21,425,1,1082,1,3,1,1,2,single-choice,spatial-relational,1|2,7,1/2,210425,1
4,2,21,426,1,2032,1,11,5,5,6,single-choice,spatial-relational,5|6,7,5/6,210426,5
4,2,21,427,0,1289,1,7,3,4,4,single-choice,spatial-relational,3|4,7,3/4,210427,3
4,2,21,428,0,590,1,13,6,7,7,single-choice,spatial-relational,6|7,7,6/7,210428,6
4,2,21,429,1,1097,1,5,2,2,3,single-choice,spatial-relational,2|3,7,2/3,210429,2
4,2,21,430,1,1004,1,11,5,5,6,single-choice,spatial-relational,5|6,7,5/6,210430,5
4,2,21,431,0,1050,1,3,1,2,2,single-choice,spatial-relational,1|2,7,1/2,210431,1
4,2,21,432,1,755,1,9,4,4,5,single-choice,spatial-relational,4|5,7,4/5,210432,4
4,2,21,433,1,1379,1,11,5,5,6,single-choice,spatial-relational,5|6,7,5/6,210433,5
4,2,21,434,0,1072,1,3,1,2,2,single-choice,spatial-relational,1|2,7,1/2,210434,1
4,2,21,435,1,1011,1,3,1,1,2,single-choice,spatial-relational,1|2,7,1/2,210435,1
4,2,21,436,0,1095,1,11,5,6,6,single-choice,spatial-relational,5|6,7,5/6,210436,5
4,2,21,437,1,1092,1,9,4,4,5,single-choice,spatial-relational,4|5,7,4/5,210437,4
4,2,21,438,1,1256,1,5,2,2,3,single-choice,spatial-relational,2|3,7,2/3,210438,2
4,2,21,439,1,1586,1,9,4,4,5,single-choice,spatial-relational,4|5,7,4/5,210439,4
4,2,21,440,1,919,1,13,6,6,7,single-choice,spatial-relational,6|7,7,6/7,210440,6
4,2,21,441,0,1624,1,13,6,7,7,single-choice,spatial-relational,6|7,7,6/7,210441,6
4,2,21,442,1,1011,1,7,3,3,4,single-choice,spatial-relational,3|4,7,3/4,210442,3
4,2,21,443,1,1663,1,7,3,3,4,single-choice,spatial-relational,3|4,7,3/4,210443,3
4,2,21,444,1,1135,1,5,2,2,3,single-choice,spatial-relational,2|3,7,2/3,210444,2
4,2,21,445,0,1381,1,3,1,2,2,single-choice,spatial-relational,1|2,7,1/2,210445,1
4,2,21,446,1,1053,1,13,6,6,7,single-choice,spatial-relational,6|7,7,6/7,210446,6
4,2,21,447,0,1463,1,3,1,2,2,single-choice,spatial-relational,1|2,7,1/2,210447,1
4,2,21,448,1,1069,1,13,6,6,7,single-choice,spatial-relational,6|7,7,6/7,210448,6
4,2,21,449,0,1162,1,5,2,3,3,single-choice,spatial-relational,2|3,7,2/3,210449,2
4,2,21,450,1,995,1,7,3,3,4,single-choice,spatial-relational,3|4,7,3/4,210450,3
4,2,21,451,1,1030,1,5,2,2,3,single-choice,spatial-relational,2|3,7,2/3,210451,2
4,2,21,452,1,1187,1,9,4,4,5,single-choice,spatial-relational,4|5,7,4/5,210452,4
4,2,21,453,1,1587,1,11,5,5,6,single-choice,spatial-relational,5|6,7,5/6,210453,5
4,2,21,454,1,1914,1,11,5,5,6,single-choice,spatial-relational,5|6,7,5/6,210454,5
4,2,21,455,1,1222,1,7,3,3,4,single-choice,spatial-relational,3|4,7,3/4,210455,3
4,2,21,456,1,1682,1,9,4,4,5,single-choice,spatial-relational,4|5,7,4/5,210456,4
4,2,21,457,0,2242,1,11,5,6,6,single-choice,spatial-relational,5|6,7,5/6,210457,5
4,2,21,458,1,1018,1,7,3,3,4,single-choice,spatial-relational,3|4,7,3/4,210458,3
4,2,21,459,0,1515,1,7,3,4,4,single-choice,spatial-relational,3|4,7,3/4,210459,3
4,2,21,460,0,8559,1,11,5,6,6,single-choice,spatial-relational,5|6,7,5/6,210460,5
4,2,21,461,1,851,1,3,1,1,2,single-choice,spatial-relational,1|2,7,1/2,210461,1
4,2,21,462,1,3625,1,13,6,6,7,single-choice,spatial-relational,6|7,7,6/7,210462,6
4,2,21,463,1,2584,1,9,4,4,5,single-choice,spatial-relational,4|5,7,4/5,210463,4
4,2,21,464,0,2393,1,5,2,3,3,single-choice,spatial-relational,2|3,7,2/3,210464,2
4,2,21,465,1,1898,1,5,2,2,3,single-choice,spatial-relational,2|3,7,2/3,210465,2
4,2,21,466,1,1123,1,13,6,6,7,single-choice,spatial-relational,6|7,7,6/7,210466,6
4,2,21,467,0,2471,1,9,4,5,5,single-choice,spatial-relational,4|5,7,4/5,210467,4
4,2,21,468,1,873,1,3,1,1,2,single-choice,spatial-relational,1|2,7,1/2,210468,1
4,2,21,469,1,1136,1,5,2,2,3,single-choice,spatial-relational,2|3,7,2/3,210469,2
4,2,21,470,1,904,1,5,2,2,3,single-choice,spatial-relational,2|3,7,2/3,210470,2
4,2,21,471,1,1062,1,13,6,6,7,single-choice,spatial-relational,6|7,7,6/7,210471,6
4,2,21,472,0,2692,1,7,3,4,4,single-choice,spatial-relational,3|4,7,3/4,210472,3
4,2,21,473,0,655,1,3,1,2,2,single-choice,spatial-relational,1|2,7,1/2,210473,1
4,2,21,474,1,21633,1,11,5,5,6,single-choice,spatial-relational,5|6,7,5/6,210474,5
4,2,21,475,1,1544,1,11,5,5,6,single-choice,spatial-relational,5|6,7,5/6,210475,5
4,2,21,476,0,1130,1,3,1,2,2,single-choice,spatial-relational,1|2,7,1/2,210476,1
4,2,21,477,1,808,1,7,3,3,4,single-choice,spatial-relational,3|4,7,3/4,210477,3
4,2,21,478,1,991,1,9,4,4,5,single-choice,spatial-relational,4|5,7,4/5,210478,4
4,2,21,479,1,4003,1,13,6,6,7,single-choice,spatial-relational,6|7,7,6/7,210479,6
4,2,21,480,1,1129,1,9,4,4,5,single-choice,spatial-relational,4|5,7,4/5,210480,4
4,2,21,481,1,31433,1,5,2,2,3,single-choice,spatial-relational,2|3,7,2/3,210481,2
4,2,21,482,1,1305,1,11,5,5,6,single-choice,spatial-relational,5|6,7,5/6,210482,5
4,2,21,483,0,942,1,3,1,2,2,single-choice,spatial-relational,1|2,7,1/2,210483,1
4,2,21,484,1,879,1,13,6,6,7,single-choice,spatial-relational,6|7,7,6/7,210484,6
4,2,21,485,0,1599,1,9,4,5,5,single-choice,spatial-relational,4|5,7,4/5,210485,4
4,2,21,486,1,851,1,13,6,6,7,single-choice,spatial-relational,6|7,7,6/7,210486,6
4,2,21,487,1,1668,1,9,4,4,5,single-choice,spatial-relational,4|5,7,4/5,210487,4
4,2,21,488,0,1637,1,7,3,4,4,single-choice,spatial-relational,3|4,7,3/4,210488,3
4,2,21,489,1,2259,1,5,2,2,3,single-choice,spatial-relational,2|3,7,2/3,210489,2
4,2,21,490,1,772,1,11,5,5,6,single-choice,spatial-relational,5|6,7,5/6,210490,5
4,2,21,491,1,1052,1,7,3,3,4,single-choice,spatial-relational,3|4,7,3/4,210491,3
4,2,21,492,1,13286,1,3,1,1,2,single-choice,spatial-relational,1|2,7,1/2,210492,1
4,2,21,493,1,1938,1,13,6,6,7,single-choice,spatial-relational,6|7,7,6/7,210493,6
4,2,21,494,1,1592,1,5,2,2,3,single-choice,spatial-relational,2|3,7,2/3,210494,2
4,2,21,495,1,867,1,11,5,5,6,single-choice,spatial-relational,5|6,7,5/6,210495,5
4,2,21,496,1,2256,1,7,3,3,4,single-choice,spatial-relational,3|4,7,3/4,210496,3
4,2,21,497,1,1221,1,7,3,3,4,single-choice,spatial-relational,3|4,7,3/4,210497,3
4,2,21,498,1,2390,1,11,5,5,6,single-choice,spatial-relational,5|6,7,5/6,210498,5
4,2,21,499,1,1068,1,5,2,2,3,single-choice,spatial-relational,2|3,7,2/3,210499,2
4,2,21,500,1,1457,1,9,4,4,5,single-choice,spatial-relational,4|5,7,4/5,210500,4
4,2,21,501,0,1832,1,9,4,5,5,single-choice,spatial-relational,4|5,7,4/5,210501,4
4,2,21,502,1,1095,1,3,1,1,2,single-choice,spatial-relational,1|2,7,1/2,210502,1
4,2,21,503,0,3299,1,3,1,2,2,single-choice,spatial-relational,1|2,7,1/2,210503,1
4,2,21,504,1,773,1,13,6,6,7,single-choice,spatial-relational,6|7,7,6/7,210504,6
4,2,21,505,1,1086,1,7,3,3,4,single-choice,spatial-relational,3|4,7,3/4,210505,3
4,2,21,506,0,1130,1,3,1,2,2,single-choice,spatial-relational,1|2,7,1/2,210506,1
4,2,21,507,1,1104,1,5,2,2,3,single-choice,spatial-relational,2|3,7,2/3,210507,2
4,2,21,508,0,905,1,3,1,2,2,single-choice,spatial-relational,1|2,7,1/2,210508,1
4,2,21,509,1,1105,1,7,3,3,4,single-choice,spatial-relational,3|4,7,3/4,210509,3
4,2,21,510,1,2483,1,11,5,5,6,single-choice,spatial-relational,5|6,7,5/6,210510,5
4,2,21,511,1,1154,1,11,5,5,6,single-choice,spatial-relational,5|6,7,5/6,210511,5
4,2,21,512,1,2037,1,5,2,2,3,single-choice,spatial-relational,2|3,7,2/3,210512,2
4,2,21,513,1,1521,1,13,6,6,7,single-choice,spatial-relational,6|7,7,6/7,210513,6
4,2,21,514,1,2014,1,13,6,6,7,single-choice,spatial-relational,6|7,7,6/7,210514,6
4,2,21,515,1,2917,1,9,4,4,5,single-choice,spatial-relational,4|5,7,4/5,210515,4
4,2,21,516,1,1379,1,9,4,4,5,single-choice,spatial-relational,4|5,7,4/5,210516,4
4,2,21,517,1,1078,1,13,6,6,7,single-choice,spatial-relational,6|7,7,6/7,210517,6
4,2,21,518,0,952,1,5,2,3,3,single-choice,spatial-relational,2|3,7,2/3,210518,2
4,2,21,519,1,1190,1,7,3,3,4,single-choice,spatial-relational,3|4,7,3/4,210519,3
4,2,21,520,1,1107,1,7,3,3,4,single-choice,spatial-relational,3|4,7,3/4,210520,3
4,2,21,521,0,997,1,3,1,2,2,single-choice,spatial-relational,1|2,7,1/2,210521,1
4,2,21,522,1,864,1,13,6,6,7,single-choice,spatial-relational,6|7,7,6/7,210522,6
4,2,21,523,1,2154,1,11,5,5,6,single-choice,spatial-relational,5|6,7,5/6,210523,5
4,2,21,524,0,1379,1,3,1,2,2,single-choice,spatial-relational,1|2,7,1/2,210524,1
4,2,21,525,0,885,1,11,5,6,6,single-choice,spatial-relational,5|6,7,5/6,210525,5
4,2,21,526,1,121,1,5,2,2,3,single-choice,spatial-relational,2|3,7,2/3,210526,2
4,2,21,527,1,1232,1,9,4,4,5,single-choice,spatial-relational,4|5,7,4/5,210527,4
4,2,21,528,1,1727,1,9,4,4,5,single-choice,spatial-relational,4|5,7,4/5,210528,4
4,2,21,529,0,1030,1,3,1,2,2,single-choice,spatial-relational,1|2,7,1/2,210529,1
4,2,21,530,1,5806,1,7,3,3,4,single-choice,spatial-relational,3|4,7,3/4,210530,3
4,2,21,531,1,1413,1,11,5,5,6,single-choice,spatial-relational,5|6,7,5/6,210531,5
4,2,21,532,1,1463,1,9,4,4,5,single-choice,spatial-relational,4|5,7,4/5,210532,4
4,2,21,533,1,1674,1,5,2,2,3,single-choice,spatial-relational,2|3,7,2/3,210533,2
4,2,21,534,1,2419,1,7,3,3,4,single-choice,spatial-relational,3|4,7,3/4,210534,3
4,2,21,535,1,1559,1,3,1,1,2,single-choice,spatial-relational,1|2,7,1/2,210535,1
4,2,21,536,1,1443,1,11,5,5,6,single-choice,spatial-relational,5|6,7,5/6,210536,5
4,2,21,537,1,1318,1,13,6,6,7,single-choice,spatial-relational,6|7,7,6/7,210537,6
4,2,21,538,0,1716,1,9,4,5,5,single-choice,spatial-relational,4|5,7,4/5,210538,4
4,2,21,539,1,1019,1,13,6,6,7,single-choice,spatial-relational,6|7,7,6/7,210539,6
4,2,21,540,1,1218,1,5,2,2,3,single-choice,spatial-relational,2|3,7,2/3,210540,2
4,2,21,541,1,1077,1,7,3,3,4,single-choice,spatial-relational,3|4,7,3/4,210541,3
4,2,21,542,1,1175,1,13,6,6,7,single-choice,spatial-relational,6|7,7,6/7,210542,6
4,2,21,543,1,1983,1,3,1,1,2,single-choice,spatial-relational,1|2,7,1/2,210543,1
4,2,21,544,1,858,1,11,5,5,6,single-choice,spatial-relational,5|6,7,5/6,210544,5
4,2,21,545,0,2857,1,3,1,2,2,single-choice,spatial-relational,1|2,7,1/2,210545,1
4,2,21,546,1,991,1,9,4,4,5,single-choice,spatial-relational,4|5,7,4/5,210546,4
4,2,21,547,1,1806,1,11,5,5,6,single-choice,spatial-relational,5|6,7,5/6,210547,5
4,2,21,548,1,2594,1,7,3,3,4,single-choice,spatial-relational,3|4,7,3/4,210548,3
4,2,21,549,1,1622,1,9,4,4,5,single-choice,spatial-relational,4|5,7,4/5,210549,4
4,2,21,550,1,1553,1,5,2,2,3,single-choice,spatial-relational,2|3,7,2/3,210550,2
4,2,21,551,1,888,1,5,2,2,3,single-choice,spatial-relational,2|3,7,2/3,210551,2
4,2,21,552,1,1056,1,13,6,6,7,single-choice,spatial-relational,6|7,7,6/7,210552,6
4,2,21,553,1,1313,1,11,5,5,6,single-choice,spatial-relational,5|6,7,5/6,210553,5
4,2,21,554,1,1796,1,13,6,6,7,single-choice,spatial-relational,6|7,7,6/7,210554,6
4,2,21,555,1,1167,1,7,3,3,4,single-choice,spatial-relational,3|4,7,3/4,210555,3
4,2,21,556,0,1002,1,5,2,3,3,single-choice,spatial-relational,2|3,7,2/3,210556,2
4,2,21,557,1,1141,1,5,2,2,3,single-choice,spatial-relational,2|3,7,2/3,210557,2
4,2,21,558,0,885,1,3,1,2,2,single-choice,spatial-relational,1|2,7,1/2,210558,1
4,2,21,559,1,922,1,7,3,3,4,single-choice,spatial-relational,3|4,7,3/4,210559,3
4,2,21,560,1,1935,1,9,4,4,5,single-choice,spatial-relational,4|5,7,4/5,210560,4
4,2,21,561,1,2482,1,13,6,6,7,single-choice,spatial-relational,6|7,7,6/7,210561,6
4,2,21,562,1,1276,1,3,1,1,2,single-choice,spatial-relational,1|2,7,1/2,210562,1
4,2,21,563,1,1185,1,11,5,5,6,single-choice,spatial-relational,5|6,7,5/6,210563,5
4,2,21,564,1,1525,1,9,4,4,5,single-choice,spatial-relational,4|5,7,4/5,210564,4
4,2,21,565,1,1294,1,3,1,1,2,single-choice,spatial-relational,1|2,7,1/2,210565,1
4,2,21,566,1,1495,1,7,3,3,4,single-choice,spatial-relational,3|4,7,3/4,210566,3
4,2,21,567,1,1018,1,13,6,6,7,single-choice,spatial-relational,6|7,7,6/7,210567,6
4,2,21,568,0,1113,1,9,4,5,5,single-choice,spatial-relational,4|5,7,4/5,210568,4
4,2,21,569,1,916,1,7,3,3,4,single-choice,spatial-relational,3|4,7,3/4,210569,3
4,2,21,570,1,1356,1,9,4,4,5,single-choice,spatial-relational,4|5,7,4/5,210570,4
4,2,21,571,1,1060,1,5,2,2,3,single-choice,spatial-relational,2|3,7,2/3,210571,2
4,2,21,572,1,1469,1,3,1,1,2,single-choice,spatial-relational,1|2,7,1/2,210572,1
4,2,21,573,1,1061,1,11,5,5,6,single-choice,spatial-relational,5|6,7,5/6,210573,5
4,2,21,574,1,2803,1,5,2,2,3,single-choice,spatial-relational,2|3,7,2/3,210574,2
4,2,21,575,1,1042,1,13,6,6,7,single-choice,spatial-relational,6|7,7,6/7,210575,6
4,2,21,576,1,2102,1,11,5,5,6,single-choice,spatial-relational,5|6,7,5/6,210576,5
4,2,21,577,1,1996,1,13,6,6,7,single-choice,spatial-relational,6|7,7,6/7,210577,6
4,2,21,578,1,983,1,7,3,3,4,single-choice,spatial-relational,3|4,7,3/4,210578,3
4,2,21,579,1,1078,1,5,2,2,3,single-choice,spatial-relational,2|3,7,2/3,210579,2
4,2,21,580,1,1090,1,5,2,2,3,single-choice,spatial-relational,2|3,7,2/3,210580,2
4,2,21,581,1,2034,1,11,5,5,6,single-choice,spatial-relational,5|6,7,5/6,210581,5
4,2,21,582,0,1984,1,9,4,5,5,single-choice,spatial-relational,4|5,7,4/5,210582,4
4,2,21,583,1,865,1,13,6,6,7,single-choice,spatial-relational,6|7,7,6/7,210583,6
4,2,21,584,1,1530,1,9,4,4,5,single-choice,spatial-relational,4|5,7,4/5,210584,4
4,2,21,585,0,1757,1,11,5,6,6,single-choice,spatial-relational,5|6,7,5/6,210585,5
4,2,21,586,0,844,1,3,1,2,2,single-choice,spatial-relational,1|2,7,1/2,210586,1
4,2,21,587,1,735,1,3,1,1,2,single-choice,spatial-relational,1|2,7,1/2,210587,1
4,2,21,588,1,1335,1,7,3,3,4,single-choice,spatial-relational,3|4,7,3/4,210588,3
4,2,21,589,0,728,1,11,5,6,6,single-choice,spatial-relational,5|6,7,5/6,210589,5
4,2,21,590,1,932,1,7,3,3,4,single-choice,spatial-relational,3|4,7,3/4,210590,3
4,2,21,591,1,1047,1,9,4,4,5,single-choice,spatial-relational,4|5,7,4/5,210591,4
4,2,21,592,1,2098,1,7,3,3,4,single-choice,spatial-relational,3|4,7,3/4,210592,3
4,2,21,593,1,995,1,5,2,2,3,single-choice,spatial-relational,2|3,7,2/3,210593,2
4,2,21,594,0,764,1,5,2,3,3,single-choice,spatial-relational,2|3,7,2/3,210594,2
4,2,21,595,1,1260,1,11,5,5,6,single-choice,spatial-relational,5|6,7,5/6,210595,5
4,2,21,596,1,1199,1,9,4,4,5,single-choice,spatial-relational,4|5,7,4/5,210596,4
4,2,21,597,0,991,1,3,1,2,2,single-choice,spatial-relational,1|2,7,1/2,210597,1
4,2,21,598,1,1191,1,3,1,1,2,single-choice,spatial-relational,1|2,7,1/2,210598,1
4,2,21,599,1,1461,1,13,6,6,7,single-choice,spatial-relational,6|7,7,6/7,210599,6
4,2,21,600,1,961,1,13,6,6,7,single-choice,spatial-relational,6|7,7,6/7,210600,6
5,2,21,1,0,808,1,3,1,2,2,single-choice,spatial-relational,1|2,7,1/2,210001,1
5,2,21,2,1,790,1,5,2,2,3,single-choice,spatial-relational,2|3,7,2/3,210002,2
5,2,21,3,0,1765,1,7,3,4,4,single-choice,spatial-relational,3|4,7,3/4,210003,3
5,2,21,4,0,777,1,11,5,6,6,single-choice,spatial-relational,5|6,7,5/6,210004,5
5,2,21,5,1,1652,1,11,5,5,6,single-choice,spatial-relational,5|6,7,5/6,210005,5
5,2,21,6,0,1048,1,3,1,2,2,single-choice,spatial-relational,1|2,7,1/2,210006,1
5,2,21,7,0,646,1,9,4,5,5,single-choice,spatial-relational,4|5,7,4/5,210007,4
5,2,21,8,1,1341,1,13,6,6,7,single-choice,spatial-relational,6|7,7,6/7,210008,6
5,2,21,9,1,95,1,13,6,6,7,single-choice,spatial-relational,6|7,7,6/7,210009,6
5,2,21,10,1,1592,1,7,3,3,4,single-choice,spatial-relational,3|4,7,3/4,210010,3
5,2,21,11,0,1344,1,5,2,3,3,single-choice,spatial-relational,2|3,7,2/3,210011,2
5,2,21,12,1,1058,1,9,4,4,5,single-choice,spatial-relational,4|5,7,4/5,210012,4
5,2,21,13,1,990,1,7,3,3,4,single-choice,spatial-relational,3|4,7,3/4,210013,3
5,2,21,14,1,1195,1,11,5,5,6,single-choice,spatial-relational,5|6,7,5/6,210014,5
5,2,21,15,1,1334,1,9,4,4,5,single-choice,spatial-relational,4|5,7,4/5,210015,4
5,2,21,16,1,1658,1,7,3,3,4,single-choice,spatial-relational,3|4,7,3/4,210016,3
5,2,21,17,1,1763,1,13,6,6,7,single-choice,spatial-relational,6|7,7,6/7,210017,6
5,2,21,18,1,1015,1,13,6,6,7,single-choice,spatial-relational,6|7,7,6/7,210018,6
5,2,21,19,0,1521,1,5,2,3,3,single-choice,spatial-relational,2|3,7,2/3,210019,2
5,2,21,20,0,864,1,3,1,2,2,single-choice,spatial-relational,1|2,7,1/2,210020,1
5,2,21,21,1,990,1,3,1,1,2,single-choice,spatial-relational,1|2,7,1/2,210021,1
5,2,21,22,1,980,1,11,5,5,6,single-choice,spatial-relational,5|6,7,5/6,210022,5
5,2,21,23,1,1137,1,5,2,2,3,single-choice,spatial-relational,2|3,7,2/3,210023,2
5,2,21,24,1,1375,1,9,4,4,5,single-choice,spatial-relational,4|5,7,4/5,210024,4
5,2,21,25,1,921,1,11,5,5,6,single-choice,spatial-relational,5|6,7,5/6,210025,5
5,2,21,26,0,1071,1,3,1,2,2,single-choice,spatial-relational,1|2,7,1/2,210026,1
5,2,21,27,1,1013,1,11,5,5,6,single-choice,spatial-relational,5|6,7,5/6,210027,5
5,2,21,28,1,1180,1,13,6,6,7,single-choice,spatial-relational,6|7,7,6/7,210028,6
5,2,21,29,0,1330,1,5,2,3,3,single-choice,spatial-relational,2|3,7,2/3,210029,2
5,2,21,30,1,1086,1,5,2,2,3,single-choice,spatial-relational,2|3,7,2/3,210030,2
5,2,21,31,0,1568,1,3,1,2,2,single-choice,spatial-relational,1|2,7,1/2,210031,1
5,2,21,32,1,2091,1,7,3,3,4,single-choice,spatial-relational,3|4,7,3/4,210032,3
5,2,21,33,1,1619,1,9,4,4,5,single-choice,spatial-relational,4|5,7,4/5,210033,4
5,2,21,34,1,1697,1,7,3,3,4,single-choice,spatial-relational,3|4,7,3/4,210034,3
5,2,21,35,1,1232,1,13,6,6,7,single-choice,spatial-relational,6|7,7,6/7,210035,6
5,2,21,36,0,1203,1,9,4,5,5,single-choice,spatial-relational,4|5,7,4/5,210036,4
5,2,21,37,0,988,1,5,2,3,3,single-choice,spatial-relational,2|3,7,2/3,210037,2
5,2,21,38,0,888,1,3,1,2,2,single-choice,spatial-relational,1|2,7,1/2,210038,1
5,2,21,39,0,808,1,9,4,5,5,single-choice,spatial-relational,4|5,7,4/5,210039,4
5,2,21,40,1,1707,1,11,5,5,6,single-choice,spatial-relational,5|6,7,5/6,210040,5
5,2,21,41,1,1101,1,9,4,4,5,single-choice,spatial-relational,4|5,7,4/5,210041,4
5,2,21,42,1,1127,1,3,1,1,2,single-choice,spatial-relational,1|2,7,1/2,210042,1
5,2,21,43,1,1247,1,13,6,6,7,single-choice,spatial-relational,6|7,7,6/7,210043,6
5,2,21,44,1,1576,1,7,3,3,4,single-choice,spatial-relational,3|4,7,3/4,210044,3
5,2,21,45,1,2011,1,7,3,3,4,single-choice,spatial-relational,3|4,7,3/4,210045,3
5,2,21,46,1,1047,1,13,6,6,7,single-choice,spatial-relational,6|7,7,6/7,210046,6
5,2,21,47,0,1656,1,11,5,6,6,single-choice,spatial-relational,5|6,7,5/6,210047,5
5,2,21,48,1,1376,1,5,2,2,3,single-choice,spatial-relational,2|3,7,2/3,210048,2
5,2,21,49,1,1120,1,13,6,6,7,single-choice,spatial-relational,6|7,7,6/7,210049,6
5,2,21,50,1,992,1,13,6,6,7,single-choice,spatial-relational,6|7,7,6/7,210050,6
5,2,21,51,0,2790,1,5,2,3,3,single-choice,spatial-relational,2|3,7,2/3,210051,2
5,2,21,52,1,118,1,9,4,4,5,single-choice,spatial-relational,4|5,7,4/5,210052,4
5,2,21,53,1,2617,1,7,3,3,4,single-choice,spatial-relational,3|4,7,3/4,210053,3
5,2,21,54,1,1026,1,9,4,4,5,single-choice,spatial-relational,4|5,7,4/5,210054,4
5,2,21,55,1,1133,1,11,5,5,6,single-choice,spatial-relational,5|6,7,5/6,210055,5
5,2,21,56,0,1108,1,3,1,2,2,single-choice,spatial-relational,1|2,7,1/2,210056,1
5,2,21,57,1,993,1,7,3,3,4,single-choice,spatial-relational,3|4,7,3/4,210057,3
5,2,21,58,1,1624,1,5,2,2,3,single-choice,spatial-relational,2|3,7,2/3,210058,2
5,2,21,59,1,1023,1,3,1,1,2,single-choice,spatial-relational,1|2,7,1/2,210059,1
5,2,21,60,1,922,1,11,5,5,6,single-choice,spatial-relational,5|6,7,5/6,210060,5
5,2,21,61,0,1176,1,11,5,6,6,single-choice,spatial-relational,5|6,7,5/6,210061,5
5,2,21,62,1,1066,1,9,4,4,5,single-choice,spatial-relational,4|5,7,4/5,210062,4
5,2,21,63,1,1436,1,13,6,6,7,single-choice,spatial-relational,6|7,7,6/7,210063,6
5,2,21,64,1,1168,1,9,4,4,5,single-choice,spatial-relational,4|5,7,4/5,210064,4
5,2,21,65,1,1224,1,7,3,3,4,single-choice,spatial-relational,3|4,7,3/4,210065,3
5,2,21,66,1,1181,1,3,1,1,2,single-choice,spatial-relational,1|2,7,1/2,210066,1
5,2,21,67,1,1251,1,5,2,2,3,single-choice,spatial-relational,2|3,7,2/3,210067,2
5,2,21,68,1,962,1,7,3,3,4,single-choice,spatial-relational,3|4,7,3/4,210068,3
5,2,21,69,1,1229,1,11,5,5,6,single-choice,spatial-relational,5|6,7,5/6,210069,5
5,2,21,70,1,1133,1,5,2,2,3,single-choice,spatial-relational,2|3,7,2/3,210070,2
5,2,21,71,0,796,1,3,1,2,2,single-choice,spatial-relational,1|2,7,1/2,210071,1
5,2,21,72,1,953,1,13,6,6,7,single-choice,spatial-relational,6|7,7,6/7,210072,6
5,2,21,73,1,1287,1,11,5,5,6,single-choice,spatial-relational,5|6,7,5/6,210073,5
5,2,21,74,1,1314,1,3,1,1,2,single-choice,spatial-relational,1|2,7,1/2,210074,1
5,2,21,75,0,646,1,13,6,7,7,single-choice,spatial-relational,6|7,7,6/7,210075,6
5,2,21,76,1,912,1,9,4,4,5,single-choice,spatial-relational,4|5,7,4/5,210076,4
5,2,21,77,0,1679,1,5,2,3,3,single-choice,spatial-relational,2|3,7,2/3,210077,2
5,2,21,78,0,789,1,5,2,3,3,single-choice,spatial-relational,2|3,7,2/3,210078,2
5,2,21,79,1,1461,1,11,5,5,6,single-choice,spatial-relational,5|6,7,5/6,210079,5
5,2,21,80,1,1554,1,13,6,6,7,single-choice,spatial-relational,6|7,7,6/7,210080,6
5,2,21,81,1,2359,1,7,3,3,4,single-choice,spatial-relational,3|4,7,3/4,210081,3
5,2,21,82,1,1150,1,9,4,4,5,single-choice,spatial-relational,4|5,7,4/5,210082,4
5,2,21,83,1,2713,1,7,3,3,4,single-choice,spatial-relational,3|4,7,3/4,210083,3
5,2,21,84,0,998,1,3,1,2,2,single-choice,spatial-relational,1|2,7,1/2,210084,1
5,2,21,85,0,698,1,9,4,5,5,single-choice,spatial-relational,4|5,7,4/5,210085,4
5,2,21,86,1,1478,1,11,5,5,6,single-choice,spatial-relational,5|6,7,5/6,210086,5
5,2,21,87,0,1038,1,5,2,3,3,single-choice,spatial-relational,2|3,7,2/3,210087,2
5,2,21,88,1,830,1,13,6,6,7,single-choice,spatial-relational,6|7,7,6/7,210088,6
5,2,21,89,1,1014,1,3,1,1,2,single-choice,spatial-relational,1|2,7,1/2,210089,1
5,2,21,90,1,1413,1,9,4,4,5,single-choice,spatial-relational,4|5,7,4/5,210090,4
5,2,21,91,0,1392,1,11,5,6,6,single-choice,spatial-relational,5|6,7,5/6,210091,5
5,2,21,92,1,944,1,7,3,3,4,single-choice,spatial-relational,3|4,7,3/4,210092,3
5,2,21,93,1,1080,1,3,1,1,2,single-choice,spatial-relational,1|2,7,1/2,210093,1
5,2,21,94,0,1422,1,7,3,4,4,single-choice,spatial-relational,3|4,7,3/4,210094,3
5,2,21,95,1,849,1,13,6,6,7,single-choice,spatial-relational,6|7,7,6/7,210095,6
5,2,21,96,0,1228,1,5,2,3,3,single-choice,spatial-relational,2|3,7,2/3,210096,2
5,2,21,97,1,1059,1,5,2,2,3,single-choice,spatial-relational,2|3,7,2/3,210097,2
5,2,21,98,1,1142,1,5,2,2,3,single-choice,spatial-relational,2|3,7,2/3,210098,2
5,2,21,99,1,1749,1,7,3,3,4,single-choice,spatial-relational,3|4,7,3/4,210099,3
5,2,21,100,1,1410,1,13,6,6,7,single-choice,spatial-relational,6|7,7,6/7,210100,6
5,2,21,101,1,1499,1,11,5,5,6,single-choice,spatial-relational,5|6,7,5/6,210101,5
5,2,21,102,1,1356,1,11,5,5,6,single-choice,spatial-relational,5|6,7,5/6,210102,5
5,2,21,103,1,1566,1,9,4,4,5,single-choice,spatial-relational,4|5,7,4/5,210103,4
5,2,21,104,1,1516,1,3,1,1,2,single-choice,spatial-relational,1|2,7,1/2,210104,1
5,2,21,105,1,1488,1,7,3,3,4,single-choice,spatial-relational,3|4,7,3/4,210105,3
5,2,21,106,0,1021,1,9,4,5,5,single-choice,spatial-relational,4|5,7,4/5,210106,4
5,2,21,107,1,1056,1,13,6,6,7,single-choice,spatial-relational,6|7,7,6/7,210107,6
5,2,21,108,1,1126,1,3,1,1,2,single-choice,spatial-relational,1|2,7,1/2,210108,1
5,2,21,109,1,944,1,9,4,4,5,single-choice,spatial-relational,4|5,7,4/5,210109,4
5,2,21,110,1,1372,1,11,5,5,6,single-choice,spatial-relational,5|6,7,5/6,210110,5
5,2,21,111,1,2756,1,5,2,2,3,single-choice,spatial-relational,2|3,7,2/3,210111,2
5,2,21,112,1,1270,1,3,1,1,2,single-choice,spatial-relational,1|2,7,1/2,210112,1
5,2,21,113,1,1387,1,3,1,1,2,single-choice,spatial-relational,1|2,7,1/2,210113,1
5,2,21,114,1,947,1,7,3,3,4,single-choice,spatial-relational,3|4,7,3/4,210114,3
5,2,21,115,1,1294,1,13,6,6,7,single-choice,spatial-relational,6|7,7,6/7,210115,6
5,2,21,116,1,2314,1,7,3,3,4,single-choice,spatial-relational,3|4,7,3/4,210116,3
5,2,21,117,1,1107,1,5,2,2,3,single-choice,spatial-relational,2|3,7,2/3,210117,2
5,2,21,118,0,2928,1,11,5,6,6,single-choice,spatial-relational,5|6,7,5/6,210118,5
5,2,21,119,1,1038,1,9,4,4,5,single-choice,spatial-relational,4|5,7,4/5,210119,4
5,2,21,120,1,1292,1,13,6,6,7,single-choice,spatial-relational,6|7,7,6/7,210120,6
5,2,21,121,1,1691,1,11,5,5,6,single-choice,spatial-relational,5|6,7,5/6,210121,5
5,2,21,122,1,1935,1,11,5,5,6,single-choice,spatial-relational,5|6,7,5/6,210122,5
5,2,21,123,1,1868,1,9,4,4,5,single-choice,spatial-relational,4|5,7,4/5,210123,4
5,2,21,124,1,1755,1,7,3,3,4,single-choice,spatial-relational,3|4,7,3/4,210124,3
5,2,21,125,1,1634,1,13,6,6,7,single-choice,spatial-relational,6|7,7,6/7,210125,6
5,2,21,126,0,2397,1,9,4,5,5,single-choice,spatial-relational,4|5,7,4/5,210126,4
5,2,21,127,1,695,1,13,6,6,7,single-choice,spatial-relational,6|7,7,6/7,210127,6
5,2,21,128,0,1322,1,3,1,2,2,single-choice,spatial-relational,1|2,7,1/2,210128,1
5,2,21,129,1,1019,1,5,2,2,3,single-choice,spatial-relational,2|3,7,2/3,210129,2
5,2,21,130,1,1220,1,5,2,2,3,single-choice,spatial-relational,2|3,7,2/3,210130,2
5,2,21,131,0,1247,1,3,1,2,2,single-choice,spatial-relational,1|2,7,1/2,210131,1
5,2,21,132,1,987,1,7,3,3,4,single-choice,spatial-relational,3|4,7,3/4,210132,3
5,2,21,133,1,1047,1,5,2,2,3,single-choice,spatial-relational,2|3,7,2/3,210133,2
5,2,21,134,1,1396,1,11,5,5,6,single-choice,spatial-relational,5|6,7,5/6,210134,5
5,2,21,135,1,1227,1,7,3,3,4,single-choice,spatial-relational,3|4,7,3/4,210135,3
5,2,21,136,0,1039,1,3,1,2,2,single-choice,spatial-relational,1|2,7,1/2,210136,1
5,2,21,137,1,1093,1,7,3,3,4,single-choice,spatial-relational,3|4,7,3/4,210137,3
5,2,21,138,1,1038,1,13,6,6,7,single-choice,spatial-relational,6|7,7,6/7,210138,6
5,2,21,139,1,1156,1,9,4,4,5,single-choice,spatial-relational,4|5,7,4/5,210139,4
5,2,21,140,1,1920,1,11,5,5,6,single-choice,spatial-relational,5|6,7,5/6,210140,5
5,2,21,141,0,2008,1,5,2,3,3,single-choice,spatial-relational,2|3,7,2/3,210141,2
5,2,21,142,1,938,1,13,6,6,7,single-choice,spatial-relational,6|7,7,6/7,210142,6
5,2,21,143,1,1970,1,9,4,4,5,single-choice,spatial-relational,4|5,7,4/5,210143,4
5,2,21,144,0,965,1,3,1,2,2,single-choice,spatial-relational,1|2,7,1/2,210144,1
5,2,21,145,1,1043,1,13,6,6,7,single-choice,spatial-relational,6|7,7,6/7,210145,6
5,2,21,146,1,1786,1,3,1,1,2,single-choice,spatial-relational,1|2,7,1/2,210146,1
5,2,21,147,1,1507,1,11,5,5,6,single-choice,spatial-relational,5|6,7,5/6,210147,5
5,2,21,148,1,1197,1,5,2,2,3,single-choice,spatial-relational,2|3,7,2/3,210148,2
5,2,21,149,1,963,1,9,4,4,5,single-choice,spatial-relational,4|5,7,4/5,210149,4
5,2,21,150,0,1163,1,3,1,2,2,single-choice,spatial-relational,1|2,7,1/2,210150,1
5,2,21,151,1,1319,1,9,4,4,5,single-choice,spatial-relational,4|5,7,4/5,210151,4
5,2,21,152,0,852,1,5,2,3,3,single-choice,spatial-relational,2|3,7,2/3,210152,2
5,2,21,153,1,893,1,13,6,6,7,single-choice,spatial-relational,6|7,7,6/7,210153,6
5,2,21,154,1,1563,1,7,3,3,4,single-choice,spatial-relational,3|4,7,3/4,210154,3
5,2,21,155,1,1592,1,11,5,5,6,single-choice,spatial-relational,5|6,7,5/6,210155,5
5,2,21,156,0,1657,1,7,3,4,4,single-choice,spatial-relational,3|4,7,3/4,210156,3
5,2,21,157,1,1004,1,13,6,6,7,single-choice,spatial-relational,6|7,7,6/7,210157,6
5,2,21,158,1,1574,1,9,4,4,5,single-choice,spatial-relational,4|5,7,4/5,210158,4
5,2,21,159,1,967,1,13,6,6,7,single-choice,spatial-relational,6|7,7,6/7,210159,6
5,2,21,160,1,1533,1,11,5,5,6,single-choice,spatial-relational,5|6,7,5/6,210160,5
5,2,21,161,1,1594,1,3,1,1,2,single-choice,spatial-relational,1|2,7,1/2,210161,1
5,2,21,162,1,1157,1,7,3,3,4,single-choice,spatial-relational,3|4,7,3/4,210162,3
5,2,21,163,1,1550,1,11,5,5,6,single-choice,spatial-relational,5|6,7,5/6,210163,5
5,2,21,164,1,1810,1,7,3,3,4,single-choice,spatial-relational,3|4,7,3/4,210164,3
5,2,21,165,1,2347,1,9,4,4,5,single-choice,spatial-relational,4|5,7,4/5,210165,4
5,2,21,166,0,1036,1,3,1,2,2,single-choice,spatial-relational,1|2,7,1/2,210166,1
5,2,21,167,1,1548,1,5,2,2,3,single-choice,spatial-relational,2|3,7,2/3,210167,2
5,2,21,168,1,978,1,5,2,2,3,single-choice,spatial-relational,2|3,7,2/3,210168,2
5,2,21,169,1,1414,1,3,1,1,2,single-choice,spatial-relational,1|2,7,1/2,210169,1
5,2,21,170,1,1285,1,7,3,3,4,single-choice,spatial-relational,3|4,7,3/4,210170,3
5,2,21,171,1,1255,1,7,3,3,4,single-choice,spatial-relational,3|4,7,3/4,210171,3
5,2,21,172,1,1218,1,11,5,5,6,single-choice,spatial-relational,5|6,7,5/6,210172,5
5,2,21,173,1,1162,1,11,5,5,6,single-choice,spatial-relational,5|6,7,5/6,210173,5
5,2,21,174,0,1062,1,3,1,2,2,single-choice,spatial-relational,1|2,7,1/2,210174,1
5,2,21,175,0,713,1,9,4,5,5,single-choice,spatial-relational,4|5,7,4/5,210175,4
5,2,21,176,1,1644,1,5,2,2,3,single-choice,spatial-relational,2|3,7,2/3,210176,2
5,2,21,177,1,812,1,13,6,6,7,single-choice,spatial-relational,6|7,7,6/7,210177,6
5,2,21,178,1,1170,1,13,6,6,7,single-choice,spatial-relational,6|7,7,6/7,210178,6
5,2,21,179,0,1389,1,9,4,5,5,single-choice,spatial-relational,4|5,7,4/5,210179,4
5,2,21,180,1,979,1,5,2,2,3,single-choice,spatial-relational,2|3,7,2/3,210180,2
5,2,21,181,0,827,1,3,1,2,2,single-choice,spatial-relational,1|2,7,1/2,210181,1
5,2,21,182,1,965,1,5,2,2,3,single-choice,spatial-relational,2|3,7,2/3,210182,2
5,2,21,183,1,998,1,3,1,1,2,single-choice,spatial-relational,1|2,7,1/2,210183,1
5,2,21,184,0,1239,1,11,5,6,6,single-choice,spatial-relational,5|6,7,5/6,210184,5
5,2,21,185,1,867,1,13,6,6,7,single-choice,spatial-relational,6|7,7,6/7,210185,6
5,2,21,186,0,1480,1,11,5,6,6,single-choice,spatial-relational,5|6,7,5/6,210186,5
5,2,21,187,1,818,1,9,4,4,5,single-choice,spatial-relational,4|5,7,4/5,210187,4
5,2,21,188,0,1350,1,5,2,3,3,single-choice,spatial-relational,2|3,7,2/3,210188,2
5,2,21,189,1,983,1,7,3,3,4,single-choice,spatial-relational,3|4,7,3/4,210189,3
5,2,21,190,1,1158,1,13,6,6,7,single-choice,spatial-relational,6|7,7,6/7,210190,6
5,2,21,191,1,2502,1,9,4,4,5,single-choice,spatial-relational,4|5,7,4/5,210191,4
5,2,21,192,1,1122,1,7,3,3,4,single-choice,spatial-relational,3|4,7,3/4,210192,3
5,2,21,193,1,1032,1,7,3,3,4,single-choice,spatial-relational,3|4,7,3/4,210193,3
5,2,21,194,1,1314,1,13,6,6,7,single-choice,spatial-relational,6|7,7,6/7,210194,6
5,2,21,195,1,2725,1,9,4,4,5,single-choice,spatial-relational,4|5,7,4/5,210195,4
5,2,21,196,1,1249,1,5,2,2,3,single-choice,spatial-relational,2|3,7,2/3,210196,2
5,2,21,197,0,1208,1,3,1,2,2,single-choice,spatial-relational,1|2,7,1/2,210197,1
5,2,21,198,1,1302,1,5,2,2,3,single-choice,spatial-relational,2|3,7,2/3,210198,2
5,2,21,199,1,1310,1,9,4,4,5,single-choice,spatial-relational,4|5,7,4/5,210199,4
5,2,21,200,1,1106,1,13,6,6,7,single-choice,spatial-relational,6|7,7,6/7,210200,6
5,2,21,201,1,1246,1,11,5,5,6,single-choice,spatial-relational,5|6,7,5/6,210201,5
5,2,21,202,1,1449,1,11,5,5,6,single-choice,spatial-relational,5|6,7,5/6,210202,5
5,2,21,203,1,1838,1,7,3,3,4,single-choice,spatial-relational,3|4,7,3/4,210203,3
5,2,21,204,0,853,1,3,1,2,2,single-choice,spatial-relational,1|2,7,1/2,210204,1
5,2,21,205,1,1230,1,7,3,3,4,single-choice,spatial-relational,3|4,7,3/4,210205,3
5,2,21,206,1,1002,1,11,5,5,6,single-choice,spatial-relational,5|6,7,5/6,210206,5
5,2,21,207,1,1079,1,13,6,6,7,single-choice,spatial-relational,6|7,7,6/7,210207,6
5,2,21,208,1,1335,1,3,1,1,2,single-choice,spatial-relational,1|2,7,1/2,210208,1
5,2,21,209,1,1686,1,9,4,4,5,single-choice,spatial-relational,4|5,7,4/5,210209,4
5,2,21,210,1,1463,1,7,3,3,4,single-choice,spatial-relational,3|4,7,3/4,210210,3
5,2,21,211,0,1007,1,5,2,3,3,single-choice,spatial-relational,2|3,7,2/3,210211,2
5,2,21,212,1,1048,1,9,4,4,5,single-choice,spatial-relational,4|5,7,4/5,210212,4
5,2,21,213,1,1804,1,11,5,5,6,single-choice,spatial-relational,5|6,7,5/6,210213,5
5,2,21,214,1,1012,1,13,6,6,7,single-choice,spatial-relational,6|7,7,6/7,210214,6
5,2,21,215,1,1512,1,3,1,1,2,single-choice,spatial-relational,1|2,7,1/2,210215,1
5,2,21,216,1,1284,1,5,2,2,3,single-choice,spatial-relational,2|3,7,2/3,210216,2
5,2,21,217,0,1039,1,11,5,6,6,single-choice,spatial-relational,5|6,7,5/6,210217,5
5,2,21,218,1,1028,1,3,1,1,2,single-choice,spatial-relational,1|2,7,1/2,210218,1
5,2,21,219,1,1079,1,9,4,4,5,single-choice,spatial-relational,4|5,7,4/5,210219,4
5,2,21,220,1,3064,1,5,2,2,3,single-choice,spatial-relational,2|3,7,2/3,210220,2
5,2,21,221,1,1029,1,9,4,4,5,single-choice,spatial-relational,4|5,7,4/5,210221,4
5,2,21,222,1,1210,1,13,6,6,7,single-choice,spatial-relational,6|7,7,6/7,210222,6
5,2,21,223,1,1022,1,13,6,6,7,single-choice,spatial-relational,6|7,7,6/7,210223,6
5,2,21,224,1,1481,1,5,2,2,3,single-choice,spatial-relational,2|3,7,2/3,210224,2
5,2,21,225,1,696,1,11,5,5,6,single-choice,spatial-relational,5|6,7,5/6,210225,5
5,2,21,226,1,1813,1,7,3,3,4,single-choice,spatial-relational,3|4,7,3/4,210226,3
5,2,21,227,1,1427,1,3,1,1,2,single-choice,spatial-relational,1|2,7,1/2,210227,1
5,2,21,228,1,1242,1,7,3,3,4,single-choice,spatial-relational,3|4,7,3/4,210228,3
5,2,21,229,1,1456,1,9,4,4,5,single-choice,spatial-relational,4|5,7,4/5,210229,4
5,2,21,230,1,1248,1,5,2,2,3,single-choice,spatial-relational,2|3,7,2/3,210230,2
5,2,21,231,1,1442,1,11,5,5,6,single-choice,spatial-relational,5|6,7,5/6,210231,5
5,2,21,232,1,1098,1,3,1,1,2,single-choice,spatial-relational,1|2,7,1/2,210232,1
5,2,21,233,1,893,1,9,4,4,5,single-choice,spatial-relational,4|5,7,4/5,210233,4
5,2,21,234,0,1213,1,13,6,7,7,single-choice,spatial-relational,6|7,7,6/7,210234,6
5,2,21,235,1,783,1,7,3,3,4,single-choice,spatial-relational,3|4,7,3/4,210235,3
5,2,21,236,1,1056,1,13,6,6,7,single-choice,spatial-relational,6|7,7,6/7,210236,6
5,2,21,237,0,996,1,11,5,6,6,single-choice,spatial-relational,5|6,7,5/6,210237,5
5,2,21,238,0,590,1,5,2,3,3,single-choice,spatial-relational,2|3,7,2/3,210238,2
5,2,21,239,0,938,1,3,1,2,2,single-choice,spatial-relational,1|2,7,1/2,210239,1
5,2,21,240,1,1119,1,7,3,3,4,single-choice,spatial-relational,3|4,7,3/4,210240,3
5,2,21,241,1,1072,1,9,4,4,5,single-choice,spatial-relational,4|5,7,4/5,210241,4
5,2,21,242,1,1057,1,5,2,2,3,single-choice,spatial-relational,2|3,7,2/3,210242,2
5,2,21,243,1,860,1,11,5,5,6,single-choice,spatial-relational,5|6,7,5/6,210243,5
5,2,21,244,1,1475,1,5,2,2,3,single-choice,spatial-relational,2|3,7,2/3,210244,2
5,2,21,245,1,978,1,9,4,4,5,single-choice,spatial-relational,4|5,7,4/5,210245,4
5,2,21,246,1,1009,1,13,6,6,7,single-choice,spatial-relational,6|7,7,6/7,210246,6
5,2,21,247,1,1498,1,7,3,3,4,single-choice,spatial-relational,3|4,7,3/4,210247,3
5,2,21,248,1,1795,1,3,1,1,2,single-choice,spatial-relational,1|2,7,1/2,210248,1
5,2,21,249,1,1035,1,3,1,1,2,single-choice,spatial-relational,1|2,7,1/2,210249,1
5,2,21,250,1,1720,1,11,5,5,6,single-choice,spatial-relational,5|6,7,5/6,210250,5
5,2,21,251,1,911,1,13,6,6,7,single-choice,spatial-relational,6|7,7,6/7,210251,6
5,2,21,252,1,1733,1,7,3,3,4,single-choice,spatial-relational,3|4,7,3/4,210252,3
5,2,21,253,1,1729,1,9,4,4,5,single-choice,spatial-relational,4|5,7,4/5,210253,4
5,2,21,254,1,851,1,3,1,1,2,single-choice,spatial-relational,1|2,7,1/2,210254,1
5,2,21,255,1,1225,1,11,5,5,6,single-choice,spatial-relational,5|6,7,5/6,210255,5
5,2,21,256,1,964,1,13,6,6,7,single-choice,spatial-relational,6|7,7,6/7,210256,6
5,2,21,257,1,1041,1,7,3,3,4,single-choice,spatial-relational,3|4,7,3/4,210257,3
5,2,21,258,1,1288,1,11,5,5,6,single-choice,spatial-relational,5|6,7,5/6,210258,5
5,2,21,259,1,1239,1,5,2,2,3,single-choice,spatial-relational,2|3,7,2/3,210259,2
5,2,21,260,1,1387,1,5,2,2,3,single-choice,spatial-relational,2|3,7,2/3,210260,2
5,2,21,261,1,1033,1,7,3,3,4,single-choice,spatial-relational,3|4,7,3/4,210261,3
5,2,21,262,1,1302,1,13,6,6,7,single-choice,spatial-relational,6|7,7,6/7,210262,6
5,2,21,263,0,1800,1,9,4,5,5,single-choice,spatial-relational,4|5,7,4/5,210263,4
5,2,21,264,0,736,1,3,1,2,2,single-choice,spatial-relational,1|2,7,1/2,210264,1
5,2,21,265,1,1100,1,5,2,2,3,single-choice,spatial-relational,2|3,7,2/3,210265,2
5,2,21,266,1,997,1,7,3,3,4,single-choice,spatial-relational,3|4,7,3/4,210266,3
5,2,21,267,1,1145,1,11,5,5,6,single-choice,spatial-relational,5|6,7,5/6,210267,5
5,2,21,268,1,1196,1,3,1,1,2,single-choice,spatial-relational,1|2,7,1/2,210268,1
5,2,21,269,1,81,1,13,6,6,7,single-choice,spatial-relational,6|7,7,6/7,210269,6
5,2,21,270,0,1315,1,11,5,6,6,single-choice,spatial-relational,5|6,7,5/6,210270,5
5,2,21,271,1,1649,1,5,2,2,3,single-choice,spatial-relational,2|3,7,2/3,210271,2
5,2,21,272,1,1002,1,9,4,4,5,single-choice,spatial-relational,4|5,7,4/5,210272,4
5,2,21,273,1,1019,1,7,3,3,4,single-choice,spatial-relational,3|4,7,3/4,210273,3
5,2,21,274,1,1682,1,3,1,1,2,single-choice,spatial-relational,1|2,7,1/2,210274,1
5,2,21,275,1,1184,1,9,4,4,5,single-choice,spatial-relational,4|5,7,4/5,210275,4
5,2,21,276,1,1279,1,13,6,6,7,single-choice,spatial-relational,6|7,7,6/7,210276,6
5,2,21,277,1,914,1,13,6,6,7,single-choice,spatial-relational,6|7,7,6/7,210277,6
5,2,21,278,1,1053,1,13,6,6,7,single-choice,spatial-relational,6|7,7,6/7,210278,6
5,2,21,279,1,991,1,9,4,4,5,single-choice,spatial-relational,4|5,7,4/5,210279,4
5,2,21,280,1,943,1,3,1,1,2,single-choice,spatial-relational,1|2,7,1/2,210280,1
5,2,21,281,1,631,1,11,5,5,6,single-choice,spatial-relational,5|6,7,5/6,210281,5
5,2,21,282,1,1206,1,11,5,5,6,single-choice,spatial-relational,5|6,7,5/6,210282,5
5,2,21,283,1,1028,1,7,3,3,4,single-choice,spatial-relational,3|4,7,3/4,210283,3
5,2,21,284,1,1170,1,9,4,4,5,single-choice,spatial-relational,4|5,7,4/5,210284,4
5,2,21,285,0,10985,1,3,1,2,2,single-choice,spatial-relational,1|2,7,1/2,210285,1
5,2,21,286,1,1151,1,7,3,3,4,single-choice,spatial-relational,3|4,7,3/4,210286,3
5,2,21,287,1,936,1,5,2,2,3,single-choice,spatial-relational,2|3,7,2/3,210287,2
5,2,21,288,0,928,1,5,2,3,3,single-choice,spatial-relational,2|3,7,2/3,210288,2
5,2,21,289,1,1097,1,5,2,2,3,single-choice,spatial-relational,2|3,7,2/3,210289,2
5,2,21,290,0,829,1,11,5,6,6,single-choice,spatial-relational,5|6,7,5/6,210290,5
5,2,21,291,0,1021,1,11,5,6,6,single-choice,spatial-relational,5|6,7,5/6,210291,5
5,2,21,292,1,697,1,7,3,3,4,single-choice,spatial-relational,3|4,7,3/4,210292,3
5,2,21,293,1,998,1,9,4,4,5,single-choice,spatial-relational,4|5,7,4/5,210293,4
5,2,21,294,1,1179,1,9,4,4,5,single-choice,spatial-relational,4|5,7,4/5,210294,4
5,2,21,295,1,1030,1,13,6,6,7,single-choice,spatial-relational,6|7,7,6/7,210295,6
5,2,21,296,0,1047,1,3,1,2,2,single-choice,spatial-relational,1|2,7,1/2,210296,1
5,2,21,297,1,945,1,3,1,1,2,single-choice,spatial-relational,1|2,7,1/2,210297,1
5,2,21,298,1,1289,1,7,3,3,4,single-choice,spatial-relational,3|4,7,3/4,210298,3
5,2,21,299,0,801,1,5,2,3,3,single-choice,spatial-relational,2|3,7,2/3,210299,2
5,2,21,300,1,1437,1,13,6,6,7,single-choice,spatial-relational,6|7,7,6/7,210300,6
5,2,21,301,1,2423,1,13,6,6,7,single-choice,spatial-relational,6|7,7,6/7,210301,6
5,2,21,302,1,1213,1,11,5,5,6,single-choice,spatial-relational,5|6,7,5/6,210302,5
5,2,21,303,1,1449,1,3,1,1,2,single-choice,spatial-relational,1|2,7,1/2,210303,1
5,2,21,304,0,1208,1,9,4,5,5,single-choice,spatial-relational,4|5,7,4/5,210304,4
5,2,21,305,1,994,1,9,4,4,5,single-choice,spatial-relational,4|5,7,4/5,210305,4
5,2,21,306,1,1159,1,3,1,1,2,single-choice,spatial-relational,1|2,7,1/2,210306,1
5,2,21,307,1,1072,1,7,3,3,4,single-choice,spatial-relational,3|4,7,3/4,210307,3
5,2,21,308,1,2344,1,11,5,5,6,single-choice,spatial-relational,5|6,7,5/6,210308,5
5,2,21,309,1,1004,1,13,6,6,7,single-choice,spatial-relational,6|7,7,6/7,210309,6
5,2,21,310,1,2359,1,7,3,3,4,single-choice,spatial-relational,3|4,7,3/4,210310,3
5,2,21,311,1,1824,1,5,2,2,3,single-choice,spatial-relational,2|3,7,2/3,210311,2
5,2,21,312,1,1037,1,5,2,2,3,single-choice,spatial-relational,2|3,7,2/3,210312,2
5,2,21,313,1,7854,1,3,1,1,2,single-choice,spatial-relational,1|2,7,1/2,210313,1
5,2,21,314,1,1066,1,11,5,5,6,single-choice,spatial-relational,5|6,7,5/6,210314,5
5,2,21,315,1,1298,1,7,3,3,4,single-choice,spatial-relational,3|4,7,3/4,210315,3
5,2,21,316,1,1696,1,5,2,2,3,single-choice,spatial-relational,2|3,7,2/3,210316,2
5,2,21,317,1,1045,1,11,5,5,6,single-choice,spatial-relational,5|6,7,5/6,210317,5
5,2,21,318,1,1970,1,5,2,2,3,single-choice,spatial-relational,2|3,7,2/3,210318,2
5,2,21,319,1,1090,1,13,6,6,7,single-choice,spatial-relational,6|7,7,6/7,210319,6
5,2,21,320,0,1106,1,7,3,4,4,single-choice,spatial-relational,3|4,7,3/4,210320,3
5,2,21,321,1,1163,1,3,1,1,2,single-choice,spatial-relational,1|2,7,1/2,210321,1
5,2,21,322,1,1118,1,9,4,4,5,single-choice,spatial-relational,4|5,7,4/5,210322,4
5,2,21,323,1,1275,1,13,6,6,7,single-choice,spatial-relational,6|7,7,6/7,210323,6
5,2,21,324,1,1292,1,9,4,4,5,single-choice,spatial-relational,4|5,7,4/5,210324,4
5,2,21,325,0,1538,1,11,5,6,6,single-choice,spatial-relational,5|6,7,5/6,210325,5
5,2,21,326,1,911,1,3,1,1,2,single-choice,spatial-relational,1|2,7,1/2,210326,1
5,2,21,327,1,1043,1,11,5,5,6,single-choice,spatial-relational,5|6,7,5/6,210327,5
5,2,21,328,0,1122,1,7,3,4,4,single-choice,spatial-relational,3|4,7,3/4,210328,3
5,2,21,329,0,699,1,5,2,3,3,single-choice,spatial-relational,2|3,7,2/3,210329,2
5,2,21,330,1,1025,1,9,4,4,5,single-choice,spatial-relational,4|5,7,4/5,210330,4
5,2,21,331,1,1467,1,13,6,6,7,single-choice,spatial-relational,6|7,7,6/7,210331,6
5,2,21,332,1,1117,1,13,6,6,7,single-choice,spatial-relational,6|7,7,6/7,210332,6
5,2,21,333,1,1120,1,7,3,3,4,single-choice,spatial-relational,3|4,7,3/4,210333,3
5,2,21,334,1,999,1,9,4,4,5,single-choice,spatial-relational,4|5,7,4/5,210334,4
5,2,21,335,0,955,1,3,1,2,2,single-choice,spatial-relational,1|2,7,1/2,210335,1
5,2,21,336,1,1636,1,5,2,2,3,single-choice,spatial-relational,2|3,7,2/3,210336,2
5,2,21,337,1,873,1,11,5,5,6,single-choice,spatial-relational,5|6,7,5/6,210337,5
5,2,21,338,1,1122,1,11,5,5,6,single-choice,spatial-relational,5|6,7,5/6,210338,5
5,2,21,339,1,1141,1,3,1,1,2,single-choice,spatial-relational,1|2,7,1/2,210339,1
5,2,21,340,1,1063,1,13,6,6,7,single-choice,spatial-relational,6|7,7,6/7,210340,6
5,2,21,341,1,1979,1,3,1,1,2,single-choice,spatial-relational,1|2,7,1/2,210341,1
5,2,21,342,1,1530,1,7,3,3,4,single-choice,spatial-relational,3|4,7,3/4,210342,3
5,2,21,343,1,1237,1,13,6,6,7,single-choice,spatial-relational,6|7,7,6/7,210343,6
5,2,21,344,1,2808,1,5,2,2,3,single-choice,spatial-relational,2|3,7,2/3,210344,2
5,2,21,345,1,1120,1,5,2,2,3,single-choice,spatial-relational,2|3,7,2/3,210345,2
5,2,21,346,0,1220,1,9,4,5,5,single-choice,spatial-relational,4|5,7,4/5,210346,4
5,2,21,347,1,1399,1,9,4,4,5,single-choice,spatial-relational,4|5,7,4/5,210347,4
5,2,21,348,1,1070,1,7,3,3,4,single-choice,spatial-relational,3|4,7,3/4,210348,3
5,2,21,349,1,1195,1,5,2,2,3,single-choice,spatial-relational,2|3,7,2/3,210349,2
5,2,21,350,1,792,1,7,3,3,4,single-choice,spatial-relational,3|4,7,3/4,210350,3
5,2,21,351,1,860,1,7,3,3,4,single-choice,spatial-relational,3|4,7,3/4,210351,3
5,2,21,352,1,986,1,13,6,6,7,single-choice,spatial-relational,6|7,7,6/7,210352,6
5,2,21,353,0,1140,1,9,4,5,5,single-choice,spatial-relational,4|5,7,4/5,210353,4
5,2,21,354,1,1710,1,9,4,4,5,single-choice,spatial-relational,4|5,7,4/5,210354,4
5,2,21,355,0,1747,1,5,2,3,3,single-choice,spatial-relational,2|3,7,2/3,210355,2
5,2,21,356,1,2268,1,11,5,5,6,single-choice,spatial-relational,5|6,7,5/6,210356,5
5,2,21,357,1,1391,1,13,6,6,7,single-choice,spatial-relational,6|7,7,6/7,210357,6
5,2,21,358,0,1003,1,3,1,2,2,single-choice,spatial-relational,1|2,7,1/2,210358,1
5,2,21,359,1,2475,1,11,5,5,6,single-choice,spatial-relational,5|6,7,5/6,210359,5
5,2,21,360,1,1186,1,3,1,1,2,single-choice,spatial-relational,1|2,7,1/2,210360,1
5,2,21,361,1,1156,1,7,3,3,4,single-choice,spatial-relational,3|4,7,3/4,210361,3
5,2,21,362,1,1038,1,5,2,2,3,single-choice,spatial-relational,2|3,7,2/3,210362,2
5,2,21,363,0,900,1,9,4,5,5,single-choice,spatial-relational,4|5,7,4/5,210363,4
5,2,21,364,1,1021,1,11,5,5,6,single-choice,spatial-relational,5|6,7,5/6,210364,5
5,2,21,365,1,1032,1,13,6,6,7,single-choice,spatial-relational,6|7,7,6/7,210365,6
5,2,21,366,0,906,1,3,1,2,2,single-choice,spatial-relational,1|2,7,1/2,210366,1
5,2,21,367,1,1451,1,5,2,2,3,single-choice,spatial-relational,2|3,7,2/3,210367,2
5,2,21,368,1,1484,1,9,4,4,5,single-choice,spatial-relational,4|5,7,4/5,210368,4
5,2,21,369,0,1327,1,11,5,6,6,single-choice,spatial-relational,5|6,7,5/6,210369,5
5,2,21,370,0,618,1,13,6,7,7,single-choice,spatial-relational,6|7,7,6/7,210370,6
5,2,21,371,1,897,1,3,1,1,2,single-choice,spatial-relational,1|2,7,1/2,210371,1
5,2,21,372,1,1348,1,7,3,3,4,single-choice,spatial-relational,3|4,7,3/4,210372,3
5,2,21,373,1,1572,1,11,5,5,6,single-choice,spatial-relational,5|6,7,5/6,210373,5
5,2,21,374,1,2239,1,5,2,2,3,single-choice,spatial-relational,2|3,7,2/3,210374,2
5,2,21,375,1,1498,1,9,4,4,5,single-choice,spatial-relational,4|5,7,4/5,210375,4
5,2,21,376,0,991,1,3,1,2,2,single-choice,spatial-relational,1|2,7,1/2,210376,1
5,2,21,377,1,849,1,13,6,6,7,single-choice,spatial-relational,6|7,7,6/7,210377,6
5,2,21,378,1,2120,1,7,3,3,4,single-choice,spatial-relational,3|4,7,3/4,210378,3
5,2,21,379,1,1504,1,5,2,2,3,single-choice,spatial-relational,2|3,7,2/3,210379,2
5,2,21,380,1,998,1,13,6,6,7,single-choice,spatial-relational,6|7,7,6/7,210380,6
5,2,21,381,0,1251,1,7,3,4,4,single-choice,spatial-relational,3|4,7,3/4,210381,3
5,2,21,382,1,1233,1,9,4,4,5,single-choice,spatial-relational,4|5,7,4/5,210382,4
5,2,21,383,0,2163,1,11,5,6,6,single-choice,spatial-relational,5|6,7,5/6,210383,5
5,2,21,384,1,1360,1,3,1,1,2,single-choice,spatial-relational,1|2,7,1/2,210384,1
5,2,21,385,0,762,1,3,1,2,2,single-choice,spatial-relational,1|2,7,1/2,210385,1
5,2,21,386,0,892,1,11,5,6,6,single-choice,spatial-relational,5|6,7,5/6,210386,5
5,2,21,387,1,1252,1,7,3,3,4,single-choice,spatial-relational,3|4,7,3/4,210387,3
5,2,21,388,1,829,1,9,4,4,5,single-choice,spatial-relational,4|5,7,4/5,210388,4
5,2,21,389,1,1079,1,9,4,4,5,single-choice,spatial-relational,4|5,7,4/5,210389,4
5,2,21,390,1,945,1,13,6,6,7,single-choice,spatial-relational,6|7,7,6/7,210390,6
5,2,21,391,1,1613,1,7,3,3,4,single-choice,spatial-relational,3|4,7,3/4,210391,3
5,2,21,392,1,1123,1,5,2,2,3,single-choice,spatial-relational,2|3,7,2/3,210392,2
5,2,21,393,1,955,1,13,6,6,7,single-choice,spatial-relational,6|7,7,6/7,210393,6
5,2,21,394,0,1165,1,3,1,2,2,single-choice,spatial-relational,1|2,7,1/2,210394,1
5,2,21,395,1,1686,1,5,2,2,3,single-choice,spatial-relational,2|3,7,2/3,210395,2
5,2,21,396,1,1242,1,11,5,5,6,single-choice,spatial-relational,5|6,7,5/6,210396,5
5,2,21,397,1,1127,1,5,2,2,3,single-choice,spatial-relational,2|3,7,2/3,210397,2
5,2,21,398,1,1504,1,7,3,3,4,single-choice,spatial-relational,3|4,7,3/4,210398,3
5,2,21,399,1,1294,1,13,6,6,7,single-choice,spatial-relational,6|7,7,6/7,210399,6
5,2,21,400,1,1415,1,7,3,3,4,single-choice,spatial-relational,3|4,7,3/4,210400,3
5,2,21,401,1,1027,1,11,5,5,6,single-choice,spatial-relational,5|6,7,5/6,210401,5
5,2,21,402,1,1164,1,5,2,2,3,single-choice,spatial-relational,2|3,7,2/3,210402,2
5,2,21,403,0,1273,1,9,4,5,5,single-choice,spatial-relational,4|5,7,4/5,210403,4
5,2,21,404,1,1074,1,13,6,6,7,single-choice,spatial-relational,6|7,7,6/7,210404,6
5,2,21,405,1,1458,1,9,4,4,5,single-choice,spatial-relational,4|5,7,4/5,210405,4
5,2,21,406,1,1282,1,3,1,1,2,single-choice,spatial-relational,1|2,7,1/2,210406,1
5,2,21,407,1,837,1,3,1,1,2,single-choice,spatial-relational,1|2,7,1/2,210407,1
5,2,21,408,1,1115,1,11,5,5,6,single-choice,spatial-relational,5|6,7,5/6,210408,5
5,2,21,409,1,1350,1,5,2,2,3,single-choice,spatial-relational,2|3,7,2/3,210409,2
5,2,21,410,1,1041,1,11,5,5,6,single-choice,spatial-relational,5|6,7,5/6,210410,5
5,2,21,411,1,1996,1,5,2,2,3,single-choice,spatial-relational,2|3,7,2/3,210411,2
5,2,21,412,1,1387,1,7,3,3,4,single-choice,spatial-relational,3|4,7,3/4,210412,3
5,2,21,413,1,1486,1,9,4,4,5,single-choice,spatial-relational,4|5,7,4/5,210413,4
5,2,21,414,1,1471,1,7,3,3,4,single-choice,spatial-relational,3|4,7,3/4,210414,3
5,2,21,415,0,891,1,3,1,2,2,single-choice,spatial-relational,1|2,7,1/2,210415,1
5,2,21,416,1,1251,1,3,1,1,2,single-choice,spatial-relational,1|2,7,1/2,210416,1
5,2,21,417,1,1567,1,13,6,6,7,single-choice,spatial-relational,6|7,7,6/7,210417,6
5,2,21,418,1,1320,1,11,5,5,6,single-choice,spatial-relational,5|6,7,5/6,210418,5
5,2,21,419,1,1449,1,13,6,6,7,single-choice,spatial-relational,6|7,7,6/7,210419,6
5,2,21,420,1,1434,1,9,4,4,5,single-choice,spatial-relational,4|5,7,4/5,210420,4
5,2,21,421,1,1521,1,9,4,4,5,single-choice,spatial-relational,4|5,7,4/5,210421,4
5,2,21,422,1,1034,1,5,2,2,3,single-choice,spatial-relational,2|3,7,2/3,210422,2
5,2,21,423,0,831,1,3,1,2,2,single-choice,spatial-relational,1|2,7,1/2,210423,1
5,2,21,424,0,1566,1,11,5,6,6,single-choice,spatial-relational,5|6,7,5/6,210424,5
5,2,21,425,1,1231,1,11,5,5,6,single-choice,spatial-relational,5|6,7,5/6,210425,5
5,2,21,426,1,1208,1,5,2,2,3,single-choice,spatial-relational,2|3,7,2/3,210426,2
5,2,21,427,1,971,1,13,6,6,7,single-choice,spatial-relational,6|7,7,6/7,210427,6
5,2,21,428,1,1152,1,3,1,1,2,single-choice,spatial-relational,1|2,7,1/2,210428,1
5,2,21,429,1,1087,1,7,3,3,4,single-choice,spatial-relational,3|4,7,3/4,210429,3
5,2,21,430,1,920,1,7,3,3,4,single-choice,spatial-relational,3|4,7,3/4,210430,3
5,2,21,431,1,1665,1,9,4,4,5,single-choice,spatial-relational,4|5,7,4/5,210431,4
5,2,21,432,1,1013,1,13,6,6,7,single-choice,spatial-relational,6|7,7,6/7,210432,6
5,2,21,433,0,1637,1,9,4,5,5,single-choice,spatial-relational,4|5,7,4/5,210433,4
5,2,21,434,0,1193,1,11,5,6,6,single-choice,spatial-relational,5|6,7,5/6,210434,5
5,2,21,435,1,1355,1,3,1,1,2,single-choice,spatial-relational,1|2,7,1/2,210435,1
5,2,21,436,1,945,1,13,6,6,7,single-choice,spatial-relational,6|7,7,6/7,210436,6
5,2,21,437,1,1233,1,9,4,4,5,single-choice,spatial-relational,4|5,7,4/5,210437,4
5,2,21,438,0,1677,1,11,5,6,6,single-choice,spatial-relational,5|6,7,5/6,210438,5
5,2,21,439,1,1113,1,3,1,1,2,single-choice,spatial-relational,1|2,7,1/2,210439,1
5,2,21,440,1,841,1,13,6,6,7,single-choice,spatial-relational,6|7,7,6/7,210440,6
5,2,21,441,0,1205,1,5,2,3,3,single-choice,spatial-relational,2|3,7,2/3,210441,2
5,2,21,442,1,1840,1,5,2,2,3,single-choice,spatial-relational,2|3,7,2/3,210442,2
5,2,21,443,1,990,1,7,3,3,4,single-choice,spatial-relational,3|4,7,3/4,210443,3
5,2,21,444,1,878,1,7,3,3,4,single-choice,spatial-relational,3|4,7,3/4,210444,3
5,2,21,445,1,985,1,13,6,6,7,single-choice,spatial-relational,6|7,7,6/7,210445,6
5,2,21,446,0,1109,1,3,1,2,2,single-choice,spatial-relational,1|2,7,1/2,210446,1
5,2,21,447,1,1637,1,5,2,2,3,single-choice,spatial-relational,2|3,7,2/3,210447,2
5,2,21,448,1,905,1,13,6,6,7,single-choice,spatial-relational,6|7,7,6/7,210448,6
5,2,21,449,1,1115,1,7,3,3,4,single-choice,spatial-relational,3|4,7,3/4,210449,3
5,2,21,450,0,1426,1,11,5,6,6,single-choice,spatial-relational,5|6,7,5/6,210450,5
5,2,21,451,1,1071,1,7,3,3,4,single-choice,spatial-relational,3|4,7,3/4,210451,3
5,2,21,452,1,1320,1,9,4,4,5,single-choice,spatial-relational,4|5,7,4/5,210452,4
5,2,21,453,1,1501,1,5,2,2,3,single-choice,spatial-relational,2|3,7,2/3,210453,2
5,2,21,454,1,1185,1,9,4,4,5,single-choice,spatial-relational,4|5,7,4/5,210454,4
5,2,21,455,1,1434,1,11,5,5,6,single-choice,spatial-relational,5|6,7,5/6,210455,5
5,2,21,456,1,1651,1,3,1,1,2,single-choice,spatial-relational,1|2,7,1/2,210456,1
5,2,21,457,0,842,1,9,4,5,5,single-choice,spatial-relational,4|5,7,4/5,210457,4
5,2,21,458,1,1012,1,5,2,2,3,single-choice,spatial-relational,2|3,7,2/3,210458,2
5,2,21,459,0,1421,1,11,5,6,6,single-choice,spatial-relational,5|6,7,5/6,210459,5
5,2,21,460,1,953,1,13,6,6,7,single-choice,spatial-relational,6|7,7,6/7,210460,6
5,2,21,461,1,1095,1,7,3,3,4,single-choice,spatial-relational,3|4,7,3/4,210461,3
5,2,21,462,0,985,1,3,1,2,2,single-choice,spatial-relational,1|2,7,1/2,210462,1
5,2,21,463,1,1760,1,11,5,5,6,single-choice,spatial-relational,5|6,7,5/6,210463,5
5,2,21,464,1,2404,1,5,2,2,3,single-choice,spatial-relational,2|3,7,2/3,210464,2
5,2,21,465,1,1152,1,9,4,4,5,single-choice,spatial-relational,4|5,7,4/5,210465,4
5,2,21,466,1,1080,1,7,3,3,4,single-choice,spatial-relational,3|4,7,3/4,210466,3
5,2,21,467,0,1626,1,3,1,2,2,single-choice,spatial-relational,1|2,7,1/2,210467,1
5,2,21,468,1,942,1,13,6,6,7,single-choice,spatial-relational,6|7,7,6/7,210468,6
5,2,21,469,0,1196,1,3,1,2,2,single-choice,spatial-relational,1|2,7,1/2,210469,1
5,2,21,470,0,874,1,11,5,6,6,single-choice,spatial-relational,5|6,7,5/6,210470,5
5,2,21,471,1,1252,1,7,3,3,4,single-choice,spatial-relational,3|4,7,3/4,210471,3
5,2,21,472,1,1367,1,13,6,6,7,single-choice,spatial-relational,6|7,7,6/7,210472,6
5,2,21,473,1,915,1,3,1,1,2,single-choice,spatial-relational,1|2,7,1/2,210473,1
5,2,21,474,1,960,1,7,3,3,4,single-choice,spatial-relational,3|4,7,3/4,210474,3
5,2,21,475,0,1390,1,9,4,5,5,single-choice,spatial-relational,4|5,7,4/5,210475,4
5,2,21,476,1,863,1,13,6,6,7,single-choice,spatial-relational,6|7,7,6/7,210476,6
5,2,21,477,1,1261,1,9,4,4,5,single-choice,spatial-relational,4|5,7,4/5,210477,4
5,2,21,478,1,1218,1,5,2,2,3,single-choice,spatial-relational,2|3,7,2/3,210478,2
5,2,21,479,1,1292,1,5,2,2,3,single-choice,spatial-relational,2|3,7,2/3,210479,2
5,2,21,480,0,824,1,11,5,6,6,single-choice,spatial-relational,5|6,7,5/6,210480,5
5,2,21,481,1,948,1,9,4,4,5,single-choice,spatial-relational,4|5,7,4/5,210481,4
5,2,21,482,1,1253,1,13,6,6,7,single-choice,spatial-relational,6|7,7,6/7,210482,6
5,2,21,483,1,1022,1,3,1,1,2,single-choice,spatial-relational,1|2,7,1/2,210483,1
5,2,21,484,1,1438,1,11,5,5,6,single-choice,spatial-relational,5|6,7,5/6,210484,5
5,2,21,485,1,1628,1,13,6,6,7,single-choice,spatial-relational,6|7,7,6/7,210485,6
5,2,21,486,1,908,1,5,2,2,3,single-choice,spatial-relational,2|3,7,2/3,210486,2
5,2,21,487,0,780,1,3,1,2,2,single-choice,spatial-relational,1|2,7,1/2,210487,1
5,2,21,488,1,1462,1,11,5,5,6,single-choice,spatial-relational,5|6,7,5/6,210488,5
5,2,21,489,1,1092,1,9,4,4,5,single-choice,spatial-relational,4|5,7,4/5,210489,4
5,2,21,490,1,871,1,7,3,3,4,single-choice,spatial-relational,3|4,7,3/4,210490,3
5,2,21,491,1,1090,1,5,2,2,3,single-choice,spatial-relational,2|3,7,2/3,210491,2
5,2,21,492,1,812,1,7,3,3,4,single-choice,spatial-relational,3|4,7,3/4,210492,3
5,2,21,493,1,1216,1,3,1,1,2,single-choice,spatial-relational,1|2,7,1/2,210493,1
5,2,21,494,1,1044,1,7,3,3,4,single-choice,spatial-relational,3|4,7,3/4,210494,3
5,2,21,495,1,1503,1,9,4,4,5,single-choice,spatial-relational,4|5,7,4/5,210495,4
5,2,21,496,1,815,1,7,3,3,4,single-choice,spatial-relational,3|4,7,3/4,210496,3
5,2,21,497,1,1021,1,5,2,2,3,single-choice,spatial-relational,2|3,7,2/3,210497,2
5,2,21,498,0,1256,1,9,4,5,5,single-choice,spatial-relational,4|5,7,4/5,210498,4
5,2,21,499,1,960,1,13,6,6,7,single-choice,spatial-relational,6|7,7,6/7,210499,6
5,2,21,500,1,971,1,13,6,6,7,single-choice,spatial-relational,6|7,7,6/7,210500,6
5,2,21,501,0,1781,1,5,2,3,3,single-choice,spatial-relational,2|3,7,2/3,210501,2
5,2,21,502,1,983,1,3,1,1,2,single-choice,spatial-relational,1|2,7,1/2,210502,1
5,2,21,503,1,947,1,11,5,5,6,single-choice,spatial-relational,5|6,7,5/6,210503,5
5,2,21,504,1,1518,1,11,5,5,6,single-choice,spatial-relational,5|6,7,5/6,210504,5
5,2,21,505,1,1128,1,9,4,4,5,single-choice,spatial-relational,4|5,7,4/5,210505,4
5,2,21,506,1,909,1,11,5,5,6,single-choice,spatial-relational,5|6,7,5/6,210506,5
5,2,21,507,1,1211,1,7,3,3,4,single-choice,spatial-relational,3|4,7,3/4,210507,3
5,2,21,508,1,70532,1,3,1,1,2,single-choice,spatial-relational,1|2,7,1/2,210508,1
5,2,21,509,1,890,1,9,4,4,5,single-choice,spatial-relational,4|5,7,4/5,210509,4
5,2,21,510,1,1741,1,13,6,6,7,single-choice,spatial-relational,6|7,7,6/7,210510,6
5,2,21,511,1,1301,1,5,2,2,3,single-choice,spatial-relational,2|3,7,2/3,210511,2
5,2,21,512,1,901,1,7,3,3,4,single-choice,spatial-relational,3|4,7,3/4,210512,3
5,2,21,513,0,1121,1,3,1,2,2,single-choice,spatial-relational,1|2,7,1/2,210513,1
5,2,21,514,1,1186,1,5,2,2,3,single-choice,spatial-relational,2|3,7,2/3,210514,2
5,2,21,515,1,1577,1,11,5,5,6,single-choice,spatial-relational,5|6,7,5/6,210515,5
5,2,21,516,1,1168,1,13,6,6,7,single-choice,spatial-relational,6|7,7,6/7,210516,6
5,2,21,517,1,1154,1,11,5,5,6,single-choice,spatial-relational,5|6,7,5/6,210517,5
5,2,21,518,1,1423,1,7,3,3,4,single-choice,spatial-relational,3|4,7,3/4,210518,3
5,2,21,519,1,1537,1,5,2,2,3,single-choice,spatial-relational,2|3,7,2/3,210519,2
5,2,21,520,1,918,1,9,4,4,5,single-choice,spatial-relational,4|5,7,4/5,210520,4
5,2,21,521,1,971,1,7,3,3,4,single-choice,spatial-relational,3|4,7,3/4,210521,3
5,2,21,522,0,74595,1,3,1,2,2,single-choice,spatial-relational,1|2,7,1/2,210522,1
5,2,21,523,1,1453,1,11,5,5,6,single-choice,spatial-relational,5|6,7,5/6,210523,5
5,2,21,524,1,1261,1,13,6,6,7,single-choice,spatial-relational,6|7,7,6/7,210524,6
5,2,21,525,0,960,1,13,6,7,7,single-choice,spatial-relational,6|7,7,6/7,210525,6
5,2,21,526,1,826,1,9,4,4,5,single-choice,spatial-relational,4|5,7,4/5,210526,4
5,2,21,527,0,1321,1,3,1,2,2,single-choice,spatial-relational,1|2,7,1/2,210527,1
5,2,21,528,0,708,1,5,2,3,3,single-choice,spatial-relational,2|3,7,2/3,210528,2
5,2,21,529,1,1168,1,11,5,5,6,single-choice,spatial-relational,5|6,7,5/6,210529,5
5,2,21,530,0,1033,1,7,3,4,4,single-choice,spatial-relational,3|4,7,3/4,210530,3
5,2,21,531,1,1080,1,13,6,6,7,single-choice,spatial-relational,6|7,7,6/7,210531,6
5,2,21,532,1,1019,1,5,2,2,3,single-choice,spatial-relational,2|3,7,2/3,210532,2
5,2,21,533,1,1100,1,5,2,2,3,single-choice,spatial-relational,2|3,7,2/3,210533,2
5,2,21,534,1,1063,1,3,1,1,2,single-choice,spatial-relational,1|2,7,1/2,210534,1
5,2,21,535,0,883,1,3,1,2,2,single-choice,spatial-relational,1|2,7,1/2,210535,1
5,2,21,536,1,1235,1,7,3,3,4,single-choice,spatial-relational,3|4,7,3/4,210536,3
5,2,21,537,1,1208,1,9,4,4,5,single-choice,spatial-relational,4|5,7,4/5,210537,4
5,2,21,538,1,1040,1,11,5,5,6,single-choice,spatial-relational,5|6,7,5/6,210538,5
5,2,21,539,1,1045,1,13,6,6,7,single-choice,spatial-relational,6|7,7,6/7,210539,6
5,2,21,540,1,954,1,9,4,4,5,single-choice,spatial-relational,4|5,7,4/5,210540,4
5,2,21,541,0,747,1,5,2,3,3,single-choice,spatial-relational,2|3,7,2/3,210541,2
5,2,21,542,1,1007,1,13,6,6,7,single-choice,spatial-relational,6|7,7,6/7,210542,6
5,2,21,543,1,1096,1,7,3,3,4,single-choice,spatial-relational,3|4,7,3/4,210543,3
5,2,21,544,0,1082,1,3,1,2,2,single-choice,spatial-relational,1|2,7,1/2,210544,1
5,2,21,545,1,1152,1,11,5,5,6,single-choice,spatial-relational,5|6,7,5/6,210545,5
5,2,21,546,0,1190,1,3,1,2,2,single-choice,spatial-relational,1|2,7,1/2,210546,1
5,2,21,547,1,811,1,9,4,4,5,single-choice,spatial-relational,4|5,7,4/5,210547,4
5,2,21,548,0,957,1,5,2,3,3,single-choice,spatial-relational,2|3,7,2/3,210548,2
5,2,21,549,0,636,1,11,5,6,6,single-choice,spatial-relational,5|6,7,5/6,210549,5
5,2,21,550,1,884,1,7,3,3,4,single-choice,spatial-relational,3|4,7,3/4,210550,3
5,2,21,551,1,1032,1,13,6,6,7,single-choice,spatial-relational,6|7,7,6/7,210551,6
5,2,21,552,0,1365,1,9,4,5,5,single-choice,spatial-relational,4|5,7,4/5,210552,4
5,2,21,553,1,1115,1,5,2,2,3,single-choice,spatial-relational,2|3,7,2/3,210553,2
5,2,21,554,0,1825,1,7,3,4,4,single-choice,spatial-relational,3|4,7,3/4,210554,3
5,2,21,555,1,892,1,9,4,4,5,single-choice,spatial-relational,4|5,7,4/5,210555,4
5,2,21,556,0,1470,1,3,1,2,2,single-choice,spatial-relational,1|2,7,1/2,210556,1
5,2,21,557,1,1060,1,3,1,1,2,single-choice,spatial-relational,1|2,7,1/2,210557,1
5,2,21,558,1,1204,1,7,3,3,4,single-choice,spatial-relational,3|4,7,3/4,210558,3
5,2,21,559,1,904,1,11,5,5,6,single-choice,spatial-relational,5|6,7,5/6,210559,5
5,2,21,560,1,1413,1,13,6,6,7,single-choice,spatial-relational,6|7,7,6/7,210560,6
5,2,21,561,0,1688,1,5,2,3,3,single-choice,spatial-relational,2|3,7,2/3,210561,2
5,2,21,562,1,906,1,9,4,4,5,single-choice,spatial-relational,4|5,7,4/5,210562,4
5,2,21,563,1,1044,1,13,6,6,7,single-choice,spatial-relational,6|7,7,6/7,210563,6
5,2,21,564,1,1188,1,11,5,5,6,single-choice,spatial-relational,5|6,7,5/6,210564,5
5,2,21,565,1,979,1,13,6,6,7,single-choice,spatial-relational,6|7,7,6/7,210565,6
5,2,21,566,1,235317,1,5,2,2,3,single-choice,spatial-relational,2|3,7,2/3,210566,2
5,2,21,567,1,959,1,11,5,5,6,single-choice,spatial-relational,5|6,7,5/6,210567,5
5,2,21,568,1,1088,1,9,4,4,5,single-choice,spatial-relational,4|5,7,4/5,210568,4
5,2,21,569,1,1215,1,5,2,2,3,single-choice,spatial-relational,2|3,7,2/3,210569,2
5,2,21,570,1,1837,1,9,4,4,5,single-choice,spatial-relational,4|5,7,4/5,210570,4
5,2,21,571,0,1273,1,3,1,2,2,single-choice,spatial-relational,1|2,7,1/2,210571,1
5,2,21,572,1,1501,1,7,3,3,4,single-choice,spatial-relational,3|4,7,3/4,210572,3
5,2,21,573,1,1499,1,7,3,3,4,single-choice,spatial-relational,3|4,7,3/4,210573,3
5,2,21,574,1,1309,1,3,1,1,2,single-choice,spatial-relational,1|2,7,1/2,210574,1
5,2,21,575,1,1096,1,13,6,6,7,single-choice,spatial-relational,6|7,7,6/7,210575,6
5,2,21,576,1,1268,1,11,5,5,6,single-choice,spatial-relational,5|6,7,5/6,210576,5
5,2,21,577,0,2243,1,3,1,2,2,single-choice,spatial-relational,1|2,7,1/2,210577,1
5,2,21,578,1,16999,1,5,2,2,3,single-choice,spatial-relational,2|3,7,2/3,210578,2
5,2,21,579,1,1014,1,13,6,6,7,single-choice,spatial-relational,6|7,7,6/7,210579,6
5,2,21,580,1,1102,1,7,3,3,4,single-choice,spatial-relational,3|4,7,3/4,210580,3
5,2,21,581,1,913,1,5,2,2,3,single-choice,spatial-relational,2|3,7,2/3,210581,2
5,2,21,582,1,855,1,7,3,3,4,single-choice,spatial-relational,3|4,7,3/4,210582,3
5,2,21,583,1,954,1,11,5,5,6,single-choice,spatial-relational,5|6,7,5/6,210583,5
5,2,21,584,1,914,1,3,1,1,2,single-choice,spatial-relational,1|2,7,1/2,210584,1
5,2,21,585,1,861,1,9,4,4,5,single-choice,spatial-relational,4|5,7,4/5,210585,4
5,2,21,586,1,973,1,11,5,5,6,single-choice,spatial-relational,5|6,7,5/6,210586,5
5,2,21,587,1,1006,1,9,4,4,5,single-choice,spatial-relational,4|5,7,4/5,210587,4
5,2,21,588,1,1057,1,13,6,6,7,single-choice,spatial-relational,6|7,7,6/7,210588,6
5,2,21,589,1,1369,1,11,5,5,6,single-choice,spatial-relational,5|6,7,5/6,210589,5
5,2,21,590,0,2007,1,5,2,3,3,single-choice,spatial-relational,2|3,7,2/3,210590,2
5,2,21,591,1,1018,1,7,3,3,4,single-choice,spatial-relational,3|4,7,3/4,210591,3
5,2,21,592,0,1528,1,9,4,5,5,single-choice,spatial-relational,4|5,7,4/5,210592,4
5,2,21,593,1,950,1,9,4,4,5,single-choice,spatial-relational,4|5,7,4/5,210593,4
5,2,21,594,0,922,1,5,2,3,3,single-choice,spatial-relational,2|3,7,2/3,210594,2
5,2,21,595,1,30465,1,3,1,1,2,single-choice,spatial-relational,1|2,7,1/2,210595,1
5,2,21,596,1,1244,1,11,5,5,6,single-choice,spatial-relational,5|6,7,5/6,210596,5
5,2,21,597,1,935,1,13,6,6,7,single-choice,spatial-relational,6|7,7,6/7,210597,6
5,2,21,598,1,1264,1,7,3,3,4,single-choice,spatial-relational,3|4,7,3/4,210598,3
5,2,21,599,0,4254,1,3,1,2,2,single-choice,spatial-relational,1|2,7,1/2,210599,1
5,2,21,600,0,673,1,13,6,7,7,single-choice,spatial-relational,6|7,7,6/7,210600,6
6,2,21,1,0,945,1,5,2,3,3,single-choice,spatial-relational,2|3,7,2/3,210001,2
6,2,21,2,0,696,1,11,5,6,6,single-choice,spatial-relational,5|6,7,5/6,210002,5
6,2,21,3,1,857,1,9,4,4,5,single-choice,spatial-relational,4|5,7,4/5,210003,4
6,2,21,4,0,932,1,7,3,4,4,single-choice,spatial-relational,3|4,7,3/4,210004,3
6,2,21,5,0,561,1,9,4,5,5,single-choice,spatial-relational,4|5,7,4/5,210005,4
6,2,21,6,1,1603,1,7,3,3,4,single-choice,spatial-relational,3|4,7,3/4,210006,3
6,2,21,7,1,961,1,13,6,6,7,single-choice,spatial-relational,6|7,7,6/7,210007,6
6,2,21,8,1,1358,1,3,1,1,2,single-choice,spatial-relational,1|2,7,1/2,210008,1
6,2,21,9,1,959,1,13,6,6,7,single-choice,spatial-relational,6|7,7,6/7,210009,6
6,2,21,10,1,3452,1,5,2,2,3,single-choice,spatial-relational,2|3,7,2/3,210010,2
6,2,21,11,1,841,1,11,5,5,6,single-choice,spatial-relational,5|6,7,5/6,210011,5
6,2,21,12,1,955,1,3,1,1,2,single-choice,spatial-relational,1|2,7,1/2,210012,1
6,2,21,13,0,1214,1,5,2,3,3,single-choice,spatial-relational,2|3,7,2/3,210013,2
6,2,21,14,1,1323,1,13,6,6,7,single-choice,spatial-relational,6|7,7,6/7,210014,6
6,2,21,15,0,1228,1,9,4,5,5,single-choice,spatial-relational,4|5,7,4/5,210015,4
6,2,21,16,0,661,1,11,5,6,6,single-choice,spatial-relational,5|6,7,5/6,210016,5
6,2,21,17,0,1081,1,5,2,3,3,single-choice,spatial-relational,2|3,7,2/3,210017,2
6,2,21,18,1,32,1,13,6,6,7,single-choice,spatial-relational,6|7,7,6/7,210018,6
6,2,21,19,0,2834,1,7,3,4,4,single-choice,spatial-relational,3|4,7,3/4,210019,3
6,2,21,20,1,56,1,7,3,3,4,single-choice,spatial-relational,3|4,7,3/4,210020,3
6,2,21,21,1,184,1,3,1,1,2,single-choice,spatial-relational,1|2,7,1/2,210021,1
6,2,21,22,1,858,1,3,1,1,2,single-choice,spatial-relational,1|2,7,1/2,210022,1
6,2,21,23,1,1350,1,11,5,5,6,single-choice,spatial-relational,5|6,7,5/6,210023,5
6,2,21,24,0,1337,1,9,4,5,5,single-choice,spatial-relational,4|5,7,4/5,210024,4
6,2,21,25,1,762,1,11,5,5,6,single-choice,spatial-relational,5|6,7,5/6,210025,5
6,2,21,26,1,1149,1,3,1,1,2,single-choice,spatial-relational,1|2,7,1/2,210026,1
6,2,21,27,1,1091,1,11,5,5,6,single-choice,spatial-relational,5|6,7,5/6,210027,5
6,2,21,28,1,1308,1,9,4,4,5,single-choice,spatial-relational,4|5,7,4/5,210028,4
6,2,21,29,1,1668,1,13,6,6,7,single-choice,spatial-relational,6|7,7,6/7,210029,6
6,2,21,30,1,1927,1,5,2,2,3,single-choice,spatial-relational,2|3,7,2/3,210030,2
6,2,21,31,1,2046,1,5,2,2,3,single-choice,spatial-relational,2|3,7,2/3,210031,2
6,2,21,32,1,832,1,13,6,6,7,single-choice,spatial-relational,6|7,7,6/7,210032,6
6,2,21,33,1,2401,1,7,3,3,4,single-choice,spatial-relational,3|4,7,3/4,210033,3
6,2,21,34,1,1033,1,3,1,1,2,single-choice,spatial-relational,1|2,7,1/2,210034,1
6,2,21,35,1,1102,1,9,4,4,5,single-choice,spatial-relational,4|5,7,4/5,210035,4
6,2,21,36,1,1217,1,7,3,3,4,single-choice,spatial-relational,3|4,7,3/4,210036,3
6,2,21,37,1,1747,1,9,4,4,5,single-choice,spatial-relational,4|5,7,4/5,210037,4
6,2,21,38,1,1220,1,11,5,5,6,single-choice,spatial-relational,5|6,7,5/6,210038,5
6,2,21,39,1,1079,1,13,6,6,7,single-choice,spatial-relational,6|7,7,6/7,210039,6
6,2,21,40,1,982,1,5,2,2,3,single-choice,spatial-relational,2|3,7,2/3,210040,2
6,2,21,41,1,1086,1,13,6,6,7,single-choice,spatial-relational,6|7,7,6/7,210041,6
6,2,21,42,1,2472,1,7,3,3,4,single-choice,spatial-relational,3|4,7,3/4,210042,3
6,2,21,43,1,965,1,7,3,3,4,single-choice,spatial-relational,3|4,7,3/4,210043,3
6,2,21,44,1,854,1,11,5,5,6,single-choice,spatial-relational,5|6,7,5/6,210044,5
6,2,21,45,0,147,1,3,1,2,2,single-choice,spatial-relational,1|2,7,1/2,210045,1
6,2,21,46,1,1383,1,5,2,2,3,single-choice,spatial-relational,2|3,7,2/3,210046,2
6,2,21,47,1,1300,1,9,4,4,5,single-choice,spatial-relational,4|5,7,4/5,210047,4
6,2,21,48,1,1411,1,3,1,1,2,single-choice,spatial-relational,1|2,7,1/2,210048,1
6,2,21,49,1,954,1,5,2,2,3,single-choice,spatial-relational,2|3,7,2/3,210049,2
6,2,21,50,0,951,1,9,4,5,5,single-choice,spatial-relational,4|5,7,4/5,210050,4
6,2,21,51,1,991,1,7,3,3,4,single-choice,spatial-relational,3|4,7,3/4,210051,3
6,2,21,52,1,1577,1,11,5,5,6,single-choice,spatial-relational,5|6,7,5/6,210052,5
6,2,21,53,1,835,1,3,1,1,2,single-choice,spatial-relational,1|2,7,1/2,210053,1
6,2,21,54,1,1131,1,5,2,2,3,single-choice,spatial-relational,2|3,7,2/3,210054,2
6,2,21,55,1,1297,1,9,4,4,5,single-choice,spatial-relational,4|5,7,4/5,210055,4
6,2,21,56,1,1271,1,3,1,1,2,single-choice,spatial-relational,1|2,7,1/2,210056,1
6,2,21,57,1,1085,1,7,3,3,4,single-choice,spatial-relational,3|4,7,3/4,210057,3
6,2,21,58,1,998,1,11,5,5,6,single-choice,spatial-relational,5|6,7,5/6,210058,5
6,2,21,59,1,1005,1,13,6,6,7,single-choice,spatial-relational,6|7,7,6/7,210059,6
6,2,21,60,1,1148,1,13,6,6,7,single-choice,spatial-relational,6|7,7,6/7,210060,6
6,2,21,61,1,1048,1,3,1,1,2,single-choice,spatial-relational,1|2,7,1/2,210061,1
6,2,21,62,1,1249,1,11,5,5,6,single-choice,spatial-relational,5|6,7,5/6,210062,5
6,2,21,63,1,1309,1,13,6,6,7,single-choice,spatial-relational,6|7,7,6/7,210063,6
6,2,21,64,1,2598,1,7,3,3,4,single-choice,spatial-relational,3|4,7,3/4,210064,3
6,2,21,65,1,1111,1,5,2,2,3,single-choice,spatial-relational,2|3,7,2/3,210065,2
6,2,21,66,1,823,1,13,6,6,7,single-choice,spatial-relational,6|7,7,6/7,210066,6
6,2,21,67,1,1260,1,9,4,4,5,single-choice,spatial-relational,4|5,7,4/5,210067,4
6,2,21,68,0,2373,1,9,4,5,5,single-choice,spatial-relational,4|5,7,4/5,210068,4
6,2,21,69,1,1054,1,5,2,2,3,single-choice,spatial-relational,2|3,7,2/3,210069,2
6,2,21,70,1,1338,1,11,5,5,6,single-choice,spatial-relational,5|6,7,5/6,210070,5
6,2,21,71,0,1006,1,3,1,2,2,single-choice,spatial-relational,1|2,7,1/2,210071,1
6,2,21,72,1,928,1,7,3,3,4,single-choice,spatial-relational,3|4,7,3/4,210072,3
6,2,21,73,1,1089,1,7,3,3,4,single-choice,spatial-relational,3|4,7,3/4,210073,3
6,2,21,74,1,850,1,11,5,5,6,single-choice,spatial-relational,5|6,7,5/6,210074,5
6,2,21,75,1,1137,1,13,6,6,7,single-choice,spatial-relational,6|7,7,6/7,210075,6
6,2,21,76,1,1359,1,3,1,1,2,single-choice,spatial-relational,1|2,7,1/2,210076,1
6,2,21,77,1,893,1,5,2,2,3,single-choice,spatial-relational,2|3,7,2/3,210077,2
6,2,21,78,1,639,1,11,5,5,6,single-choice,spatial-relational,5|6,7,5/6,210078,5
6,2,21,79,1,1219,1,5,2,2,3,single-choice,spatial-relational,2|3,7,2/3,210079,2
6,2,21,80,1,774,1,3,1,1,2,single-choice,spatial-relational,1|2,7,1/2,210080,1
6,2,21,81,1,1073,1,9,4,4,5,single-choice,spatial-relational,4|5,7,4/5,210081,4
6,2,21,82,0,1734,1,7,3,4,4,single-choice,spatial-relational,3|4,7,3/4,210082,3
6,2,21,83,1,1039,1,9,4,4,5,single-choice,spatial-relational,4|5,7,4/5,210083,4
6,2,21,84,1,1134,1,13,6,6,7,single-choice,spatial-relational,6|7,7,6/7,210084,6
6,2,21,85,0,829,1,3,1,2,2,single-choice,spatial-relational,1|2,7,1/2,210085,1
6,2,21,86,1,1043,1,11,5,5,6,single-choice,spatial-relational,5|6,7,5/6,210086,5
6,2,21,87,1,883,1,13,6,6,7,single-choice,spatial-relational,6|7,7,6/7,210087,6
6,2,21,88,1,1727,1,9,4,4,5,single-choice,spatial-relational,4|5,7,4/5,210088,4
6,2,21,89,1,1037,1,11,5,5,6,single-choice,spatial-relational,5|6,7,5/6,210089,5
6,2,21,90,1,1357,1,7,3,3,4,single-choice,spatial-relational,3|4,7,3/4,210090,3
6,2,21,91,0,959,1,9,4,5,5,single-choice,spatial-relational,4|5,7,4/5,210091,4
6,2,21,92,1,670,1,13,6,6,7,single-choice,spatial-relational,6|7,7,6/7,210092,6
6,2,21,93,0,822,1,5,2,3,3,single-choice,spatial-relational,2|3,7,2/3,210093,2
6,2,21,94,1,719,1,3,1,1,2,single-choice,spatial-relational,1|2,7,1/2,210094,1
6,2,21,95,1,922,1,7,3,3,4,single-choice,spatial-relational,3|4,7,3/4,210095,3
6,2,21,96,0,963,1,5,2,3,3,single-choice,spatial-relational,2|3,7,2/3,210096,2
6,2,21,97,1,862,1,3,1,1,2,single-choice,spatial-relational,1|2,7,1/2,210097,1
6,2,21,98,1,880,1,5,2,2,3,single-choice,spatial-relational,2|3,7,2/3,210098,2
6,2,21,99,1,982,1,7,3,3,4,single-choice,spatial-relational,3|4,7,3/4,210099,3
6,2,21,100,1,934,1,11,5,5,6,single-choice,spatial-relational,5|6,7,5/6,210100,5
6,2,21,101,1,1256,1,3,1,1,2,single-choice,spatial-relational,1|2,7,1/2,210101,1
6,2,21,102,1,1177,1,11,5,5,6,single-choice,spatial-relational,5|6,7,5/6,210102,5
6,2,21,103,1,1118,1,13,6,6,7,single-choice,spatial-relational,6|7,7,6/7,210103,6
6,2,21,104,1,1310,1,13,6,6,7,single-choice,spatial-relational,6|7,7,6/7,210104,6
6,2,21,105,0,1467,1,9,4,5,5,single-choice,spatial-relational,4|5,7,4/5,210105,4
6,2,21,106,1,1933,1,7,3,3,4,single-choice,spatial-relational,3|4,7,3/4,210106,3
6,2,21,107,1,1207,1,9,4,4,5,single-choice,spatial-relational,4|5,7,4/5,210107,4
6,2,21,108,1,1046,1,5,2,2,3,single-choice,spatial-relational,2|3,7,2/3,210108,2
6,2,21,109,1,1126,1,9,4,4,5,single-choice,spatial-relational,4|5,7,4/5,210109,4
6,2,21,110,1,1001,1,11,5,5,6,single-choice,spatial-relational,5|6,7,5/6,210110,5
6,2,21,111,1,1082,1,11,5,5,6,single-choice,spatial-relational,5|6,7,5/6,210111,5
6,2,21,112,1,1310,1,5,2,2,3,single-choice,spatial-relational,2|3,7,2/3,210112,2
6,2,21,113,1,1004,1,5,2,2,3,single-choice,spatial-relational,2|3,7,2/3,210113,2
6,2,21,114,1,1024,1,9,4,4,5,single-choice,spatial-relational,4|5,7,4/5,210114,4
6,2,21,115,1,1007,1,13,6,6,7,single-choice,spatial-relational,6|7,7,6/7,210115,6
6,2,21,116,1,1192,1,3,1,1,2,single-choice,spatial-relational,1|2,7,1/2,210116,1
6,2,21,117,1,1039,1,7,3,3,4,single-choice,spatial-relational,3|4,7,3/4,210117,3
6,2,21,118,1,1051,1,3,1,1,2,single-choice,spatial-relational,1|2,7,1/2,210118,1
6,2,21,119,1,1203,1,7,3,3,4,single-choice,spatial-relational,3|4,7,3/4,210119,3
6,2,21,120,1,1176,1,13,6,6,7,single-choice,spatial-relational,6|7,7,6/7,210120,6
6,2,21,121,1,845,1,13,6,6,7,single-choice,spatial-relational,6|7,7,6/7,210121,6
6,2,21,122,1,1155,1,11,5,5,6,single-choice,spatial-relational,5|6,7,5/6,210122,5
6,2,21,123,1,1264,1,5,2,2,3,single-choice,spatial-relational,2|3,7,2/3,210123,2
6,2,21,124,1,1469,1,11,5,5,6,single-choice,spatial-relational,5|6,7,5/6,210124,5
6,2,21,125,1,1218,1,3,1,1,2,single-choice,spatial-relational,1|2,7,1/2,210125,1
6,2,21,126,1,1116,1,7,3,3,4,single-choice,spatial-relational,3|4,7,3/4,210126,3
6,2,21,127,0,774,1,9,4,5,5,single-choice,spatial-relational,4|5,7,4/5,210127,4
6,2,21,128,1,726,1,9,4,4,5,single-choice,spatial-relational,4|5,7,4/5,210128,4
6,2,21,129,1,1435,1,5,2,2,3,single-choice,spatial-relational,2|3,7,2/3,210129,2
6,2,21,130,1,984,1,13,6,6,7,single-choice,spatial-relational,6|7,7,6/7,210130,6
6,2,21,131,1,1031,1,3,1,1,2,single-choice,spatial-relational,1|2,7,1/2,210131,1
6,2,21,132,1,1189,1,7,3,3,4,single-choice,spatial-relational,3|4,7,3/4,210132,3
6,2,21,133,0,209,1,11,5,6,6,single-choice,spatial-relational,5|6,7,5/6,210133,5
6,2,21,134,1,1544,1,7,3,3,4,single-choice,spatial-relational,3|4,7,3/4,210134,3
6,2,21,135,1,881,1,3,1,1,2,single-choice,spatial-relational,1|2,7,1/2,210135,1
6,2,21,136,1,1166,1,11,5,5,6,single-choice,spatial-relational,5|6,7,5/6,210136,5
6,2,21,137,1,1340,1,5,2,2,3,single-choice,spatial-relational,2|3,7,2/3,210137,2
6,2,21,138,1,927,1,13,6,6,7,single-choice,spatial-relational,6|7,7,6/7,210138,6
6,2,21,139,1,1627,1,9,4,4,5,single-choice,spatial-relational,4|5,7,4/5,210139,4
6,2,21,140,1,1250,1,5,2,2,3,single-choice,spatial-relational,2|3,7,2/3,210140,2
6,2,21,141,0,981,1,3,1,2,2,single-choice,spatial-relational,1|2,7,1/2,210141,1
6,2,21,142,0,142,1,13,6,7,7,single-choice,spatial-relational,6|7,7,6/7,210142,6
6,2,21,143,1,952,1,9,4,4,5,single-choice,spatial-relational,4|5,7,4/5,210143,4
6,2,21,144,1,1048,1,7,3,3,4,single-choice,spatial-relational,3|4,7,3/4,210144,3
6,2,21,145,1,1080,1,7,3,3,4,single-choice,spatial-relational,3|4,7,3/4,210145,3
6,2,21,146,1,1166,1,9,4,4,5,single-choice,spatial-relational,4|5,7,4/5,210146,4
6,2,21,147,0,954,1,3,1,2,2,single-choice,spatial-relational,1|2,7,1/2,210147,1
6,2,21,148,0,844,1,9,4,5,5,single-choice,spatial-relational,4|5,7,4/5,210148,4
6,2,21,149,1,947,1,13,6,6,7,single-choice,spatial-relational,6|7,7,6/7,210149,6
6,2,21,150,1,1255,1,11,5,5,6,single-choice,spatial-relational,5|6,7,5/6,210150,5
6,2,21,151,1,1079,1,3,1,1,2,single-choice,spatial-relational,1|2,7,1/2,210151,1
6,2,21,152,1,725,1,11,5,5,6,single-choice,spatial-relational,5|6,7,5/6,210152,5
6,2,21,153,1,1737,1,7,3,3,4,single-choice,spatial-relational,3|4,7,3/4,210153,3
6,2,21,154,1,860,1,13,6,6,7,single-choice,spatial-relational,6|7,7,6/7,210154,6
6,2,21,155,1,1183,1,5,2,2,3,single-choice,spatial-relational,2|3,7,2/3,210155,2
6,2,21,156,1,1335,1,5,2,2,3,single-choice,spatial-relational,2|3,7,2/3,210156,2
6,2,21,157,0,1153,1,9,4,5,5,single-choice,spatial-relational,4|5,7,4/5,210157,4
6,2,21,158,1,1058,1,11,5,5,6,single-choice,spatial-relational,5|6,7,5/6,210158,5
6,2,21,159,1,1186,1,13,6,6,7,single-choice,spatial-relational,6|7,7,6/7,210159,6
6,2,21,160,1,1141,1,3,1,1,2,single-choice,spatial-relational,1|2,7,1/2,210160,1
6,2,21,161,1,1032,1,7,3,3,4,single-choice,spatial-relational,3|4,7,3/4,210161,3
6,2,21,162,0,1493,1,5,2,3,3,single-choice,spatial-relational,2|3,7,2/3,210162,2
6,2,21,163,0,619,1,9,4,5,5,single-choice,spatial-relational,4|5,7,4/5,210163,4
6,2,21,164,1,672,1,13,6,6,7,single-choice,spatial-relational,6|7,7,6/7,210164,6
6,2,21,165,1,1270,1,11,5,5,6,single-choice,spatial-relational,5|6,7,5/6,210165,5
6,2,21,166,1,1139,1,5,2,2,3,single-choice,spatial-relational,2|3,7,2/3,210166,2
6,2,21,167,0,884,1,7,3,4,4,single-choice,spatial-relational,3|4,7,3/4,210167,3
6,2,21,168,1,121,1,3,1,1,2,single-choice,spatial-relational,1|2,7,1/2,210168,1
6,2,21,169,1,1145,1,7,3,3,4,single-choice,spatial-relational,3|4,7,3/4,210169,3
6,2,21,170,1,1453,1,11,5,5,6,single-choice,spatial-relational,5|6,7,5/6,210170,5
6,2,21,171,1,965,1,13,6,6,7,single-choice,spatial-relational,6|7,7,6/7,210171,6
6,2,21,172,1,1607,1,7,3,3,4,single-choice,spatial-relational,3|4,7,3/4,210172,3
6,2,21,173,1,1224,1,3,1,1,2,single-choice,spatial-relational,1|2,7,1/2,210173,1
6,2,21,174,1,1210,1,9,4,4,5,single-choice,spatial-relational,4|5,7,4/5,210174,4
6,2,21,175,0,1068,1,11,5,6,6,single-choice,spatial-relational,5|6,7,5/6,210175,5
6,2,21,176,1,821,1,9,4,4,5,single-choice,spatial-relational,4|5,7,4/5,210176,4
6,2,21,177,1,1084,1,3,1,1,2,single-choice,spatial-relational,1|2,7,1/2,210177,1
6,2,21,178,1,1157,1,5,2,2,3,single-choice,spatial-relational,2|3,7,2/3,210178,2
6,2,21,179,1,1126,1,13,6,6,7,single-choice,spatial-relational,6|7,7,6/7,210179,6
6,2,21,180,1,915,1,5,2,2,3,single-choice,spatial-relational,2|3,7,2/3,210180,2
6,2,21,181,1,960,1,3,1,1,2,single-choice,spatial-relational,1|2,7,1/2,210181,1
6,2,21,182,1,1078,1,9,4,4,5,single-choice,spatial-relational,4|5,7,4/5,210182,4
6,2,21,183,1,928,1,13,6,6,7,single-choice,spatial-relational,6|7,7,6/7,210183,6
6,2,21,184,1,1238,1,11,5,5,6,single-choice,spatial-relational,5|6,7,5/6,210184,5
6,2,21,185,1,1045,1,3,1,1,2,single-choice,spatial-relational,1|2,7,1/2,210185,1
6,2,21,186,1,1383,1,7,3,3,4,single-choice,spatial-relational,3|4,7,3/4,210186,3
6,2,21,187,1,1557,1,11,5,5,6,single-choice,spatial-relational,5|6,7,5/6,210187,5
6,2,21,188,1,1251,1,5,2,2,3,single-choice,spatial-relational,2|3,7,2/3,210188,2
6,2,21,189,1,928,1,13,6,6,7,single-choice,spatial-relational,6|7,7,6/7,210189,6
6,2,21,190,1,969,1,9,4,4,5,single-choice,spatial-relational,4|5,7,4/5,210190,4
6,2,21,191,1,1071,1,5,2,2,3,single-choice,spatial-relational,2|3,7,2/3,210191,2
6,2,21,192,1,1246,1,7,3,3,4,single-choice,spatial-relational,3|4,7,3/4,210192,3
6,2,21,193,1,1082,1,7,3,3,4,single-choice,spatial-relational,3|4,7,3/4,210193,3
6,2,21,194,1,1376,1,5,2,2,3,single-choice,spatial-relational,2|3,7,2/3,210194,2
6,2,21,195,1,1089,1,13,6,6,7,single-choice,spatial-relational,6|7,7,6/7,210195,6
6,2,21,196,1,1029,1,5,2,2,3,single-choice,spatial-relational,2|3,7,2/3,210196,2
6,2,21,197,1,996,1,13,6,6,7,single-choice,spatial-relational,6|7,7,6/7,210197,6
6,2,21,198,0,893,1,3,1,2,2,single-choice,spatial-relational,1|2,7,1/2,210198,1
6,2,21,199,1,954,1,7,3,3,4,single-choice,spatial-relational,3|4,7,3/4,210199,3
6,2,21,200,1,1517,1,9,4,4,5,single-choice,spatial-relational,4|5,7,4/5,210200,4
6,2,21,201,1,2045,1,3,1,1,2,single-choice,spatial-relational,1|2,7,1/2,210201,1
6,2,21,202,1,983,1,9,4,4,5,single-choice,spatial-relational,4|5,7,4/5,210202,4
6,2,21,203,1,1011,1,11,5,5,6,single-choice,spatial-relational,5|6,7,5/6,210203,5
6,2,21,204,0,1882,1,11,5,6,6,single-choice,spatial-relational,5|6,7,5/6,210204,5
6,2,21,205,1,992,1,7,3,3,4,single-choice,spatial-relational,3|4,7,3/4,210205,3
6,2,21,206,1,1064,1,3,1,1,2,single-choice,spatial-relational,1|2,7,1/2,210206,1
6,2,21,207,1,1216,1,11,5,5,6,single-choice,spatial-relational,5|6,7,5/6,210207,5
6,2,21,208,0,958,1,7,3,4,4,single-choice,spatial-relational,3|4,7,3/4,210208,3
6,2,21,209,1,1146,1,3,1,1,2,single-choice,spatial-relational,1|2,7,1/2,210209,1
6,2,21,210,0,573,1,13,6,7,7,single-choice,spatial-relational,6|7,7,6/7,210210,6
6,2,21,211,1,1255,1,11,5,5,6,single-choice,spatial-relational,5|6,7,5/6,210211,5
6,2,21,212,1,1120,1,9,4,4,5,single-choice,spatial-relational,4|5,7,4/5,210212,4
6,2,21,213,1,1690,1,5,2,2,3,single-choice,spatial-relational,2|3,7,2/3,210213,2
6,2,21,214,1,975,1,13,6,6,7,single-choice,spatial-relational,6|7,7,6/7,210214,6
6,2,21,215,1,879,1,9,4,4,5,single-choice,spatial-relational,4|5,7,4/5,210215,4
6,2,21,216,1,1224,1,5,2,2,3,single-choice,spatial-relational,2|3,7,2/3,210216,2
6,2,21,217,1,903,1,5,2,2,3,single-choice,spatial-relational,2|3,7,2/3,210217,2
6,2,21,218,1,1066,1,11,5,5,6,single-choice,spatial-relational,5|6,7,5/6,210218,5
6,2,21,219,1,941,1,11,5,5,6,single-choice,spatial-relational,5|6,7,5/6,210219,5
6,2,21,220,1,1137,1,7,3,3,4,single-choice,spatial-relational,3|4,7,3/4,210220,3
6,2,21,221,1,889,1,13,6,6,7,single-choice,spatial-relational,6|7,7,6/7,210221,6
6,2,21,222,1,973,1,5,2,2,3,single-choice,spatial-relational,2|3,7,2/3,210222,2
6,2,21,223,1,823,1,3,1,1,2,single-choice,spatial-relational,1|2,7,1/2,210223,1
6,2,21,224,1,923,1,13,6,6,7,single-choice,spatial-relational,6|7,7,6/7,210224,6
6,2,21,225,0,902,1,3,1,2,2,single-choice,spatial-relational,1|2,7,1/2,210225,1
6,2,21,226,1,941,1,7,3,3,4,single-choice,spatial-relational,3|4,7,3/4,210226,3
6,2,21,227,1,1056,1,9,4,4,5,single-choice,spatial-relational,4|5,7,4/5,210227,4
6,2,21,228,1,995,1,9,4,4,5,single-choice,spatial-relational,4|5,7,4/5,210228,4
6,2,21,229,1,1058,1,5,2,2,3,single-choice,spatial-relational,2|3,7,2/3,210229,2
6,2,21,230,0,1012,1,3,1,2,2,single-choice,spatial-relational,1|2,7,1/2,210230,1
6,2,21,231,1,1465,1,7,3,3,4,single-choice,spatial-relational,3|4,7,3/4,210231,3
6,2,21,232,1,1185,1,3,1,1,2,single-choice,spatial-relational,1|2,7,1/2,210232,1
6,2,21,233,1,959,1,9,4,4,5,single-choice,spatial-relational,4|5,7,4/5,210233,4
6,2,21,234,1,1267,1,13,6,6,7,single-choice,spatial-relational,6|7,7,6/7,210234,6
6,2,21,235,1,1390,1,11,5,5,6,single-choice,spatial-relational,5|6,7,5/6,210235,5
6,2,21,236,1,1245,1,5,2,2,3,single-choice,spatial-relational,2|3,7,2/3,210236,2
6,2,21,237,1,865,1,11,5,5,6,single-choice,spatial-relational,5|6,7,5/6,210237,5
6,2,21,238,1,1955,1,9,4,4,5,single-choice,spatial-relational,4|5,7,4/5,210238,4
6,2,21,239,1,1084,1,13,6,6,7,single-choice,spatial-relational,6|7,7,6/7,210239,6
6,2,21,240,1,1347,1,7,3,3,4,single-choice,spatial-relational,3|4,7,3/4,210240,3
6,2,21,241,1,1162,1,13,6,6,7,single-choice,spatial-relational,6|7,7,6/7,210241,6
6,2,21,242,1,855,1,9,4,4,5,single-choice,spatial-relational,4|5,7,4/5,210242,4
6,2,21,243,1,1645,1,5,2,2,3,single-choice,spatial-relational,2|3,7,2/3,210243,2
6,2,21,244,1,878,1,7,3,3,4,single-choice,spatial-relational,3|4,7,3/4,210244,3
6,2,21,245,1,950,1,13,6,6,7,single-choice,spatial-relational,6|7,7,6/7,210245,6
6,2,21,246,1,1583,1,9,4,4,5,single-choice,spatial-relational,4|5,7,4/5,210246,4
6,2,21,247,1,1050,1,3,1,1,2,single-choice,spatial-relational,1|2,7,1/2,210247,1
6,2,21,248,1,1276,1,5,2,2,3,single-choice,spatial-relational,2|3,7,2/3,210248,2
6,2,21,249,1,911,1,11,5,5,6,single-choice,spatial-relational,5|6,7,5/6,210249,5
6,2,21,250,1,1064,1,3,1,1,2,single-choice,spatial-relational,1|2,7,1/2,210250,1
6,2,21,251,1,1308,1,7,3,3,4,single-choice,spatial-relational,3|4,7,3/4,210251,3
6,2,21,252,1,897,1,11,5,5,6,single-choice,spatial-relational,5|6,7,5/6,210252,5
6,2,21,253,1,1081,1,11,5,5,6,single-choice,spatial-relational,5|6,7,5/6,210253,5
6,2,21,254,1,1118,1,5,2,2,3,single-choice,spatial-relational,2|3,7,2/3,210254,2
6,2,21,255,1,922,1,9,4,4,5,single-choice,spatial-relational,4|5,7,4/5,210255,4
6,2,21,256,1,1547,1,7,3,3,4,single-choice,spatial-relational,3|4,7,3/4,210256,3
6,2,21,257,1,1568,1,5,2,2,3,single-choice,spatial-relational,2|3,7,2/3,210257,2
6,2,21,258,1,838,1,11,5,5,6,single-choice,spatial-relational,5|6,7,5/6,210258,5
6,2,21,259,1,1197,1,13,6,6,7,single-choice,spatial-relational,6|7,7,6/7,210259,6
6,2,21,260,0,1049,1,9,4,5,5,single-choice,spatial-relational,4|5,7,4/5,210260,4
6,2,21,261,1,792,1,3,1,1,2,single-choice,spatial-relational,1|2,7,1/2,210261,1
6,2,21,262,1,1100,1,7,3,3,4,single-choice,spatial-relational,3|4,7,3/4,210262,3
6,2,21,263,1,1113,1,3,1,1,2,single-choice,spatial-relational,1|2,7,1/2,210263,1
6,2,21,264,1,831,1,13,6,6,7,single-choice,spatial-relational,6|7,7,6/7,210264,6
6,2,21,265,1,1032,1,5,2,2,3,single-choice,spatial-relational,2|3,7,2/3,210265,2
6,2,21,266,1,1192,1,11,5,5,6,single-choice,spatial-relational,5|6,7,5/6,210266,5
6,2,21,267,1,1098,1,13,6,6,7,single-choice,spatial-relational,6|7,7,6/7,210267,6
6,2,21,268,1,898,1,13,6,6,7,single-choice,spatial-relational,6|7,7,6/7,210268,6
6,2,21,269,1,1250,1,7,3,3,4,single-choice,spatial-relational,3|4,7,3/4,210269,3
6,2,21,270,1,1011,1,5,2,2,3,single-choice,spatial-relational,2|3,7,2/3,210270,2
6,2,21,271,1,887,1,3,1,1,2,single-choice,spatial-relational,1|2,7,1/2,210271,1
6,2,21,272,1,1012,1,9,4,4,5,single-choice,spatial-relational,4|5,7,4/5,210272,4
6,2,21,273,1,1226,1,3,1,1,2,single-choice,spatial-relational,1|2,7,1/2,210273,1
6,2,21,274,1,853,1,9,4,4,5,single-choice,spatial-relational,4|5,7,4/5,210274,4
6,2,21,275,1,1099,1,7,3,3,4,single-choice,spatial-relational,3|4,7,3/4,210275,3
6,2,21,276,1,1508,1,11,5,5,6,single-choice,spatial-relational,5|6,7,5/6,210276,5
6,2,21,277,1,1282,1,9,4,4,5,single-choice,spatial-relational,4|5,7,4/5,210277,4
6,2,21,278,1,1541,1,11,5,5,6,single-choice,spatial-relational,5|6,7,5/6,210278,5
6,2,21,279,1,918,1,13,6,6,7,single-choice,spatial-relational,6|7,7,6/7,210279,6
6,2,21,280,1,1079,1,13,6,6,7,single-choice,spatial-relational,6|7,7,6/7,210280,6
6,2,21,281,1,1379,1,3,1,1,2,single-choice,spatial-relational,1|2,7,1/2,210281,1
6,2,21,282,0,674,1,7,3,4,4,single-choice,spatial-relational,3|4,7,3/4,210282,3
6,2,21,283,1,1015,1,5,2,2,3,single-choice,spatial-relational,2|3,7,2/3,210283,2
6,2,21,284,1,1015,1,3,1,1,2,single-choice,spatial-relational,1|2,7,1/2,210284,1
6,2,21,285,1,1264,1,7,3,3,4,single-choice,spatial-relational,3|4,7,3/4,210285,3
6,2,21,286,0,849,1,9,4,5,5,single-choice,spatial-relational,4|5,7,4/5,210286,4
6,2,21,287,1,1170,1,11,5,5,6,single-choice,spatial-relational,5|6,7,5/6,210287,5
6,2,21,288,1,1111,1,5,2,2,3,single-choice,spatial-relational,2|3,7,2/3,210288,2
6,2,21,289,1,1020,1,9,4,4,5,single-choice,spatial-relational,4|5,7,4/5,210289,4
6,2,21,290,1,915,1,3,1,1,2,single-choice,spatial-relational,1|2,7,1/2,210290,1
6,2,21,291,1,1389,1,3,1,1,2,single-choice,spatial-relational,1|2,7,1/2,210291,1
6,2,21,292,1,1268,1,9,4,4,5,single-choice,spatial-relational,4|5,7,4/5,210292,4
6,2,21,293,1,1393,1,13,6,6,7,single-choice,spatial-relational,6|7,7,6/7,210293,6
6,2,21,294,1,1075,1,13,6,6,7,single-choice,spatial-relational,6|7,7,6/7,210294,6
6,2,21,295,1,2026,1,7,3,3,4,single-choice,spatial-relational,3|4,7,3/4,210295,3
6,2,21,296,1,720,1,11,5,5,6,single-choice,spatial-relational,5|6,7,5/6,210296,5
6,2,21,297,1,1241,1,5,2,2,3,single-choice,spatial-relational,2|3,7,2/3,210297,2
6,2,21,298,1,903,1,11,5,5,6,single-choice,spatial-relational,5|6,7,5/6,210298,5
6,2,21,299,1,1221,1,7,3,3,4,single-choice,spatial-relational,3|4,7,3/4,210299,3
6,2,21,300,1,1072,1,5,2,2,3,single-choice,spatial-relational,2|3,7,2/3,210300,2
6,2,21,301,1,955,1,9,4,4,5,single-choice,spatial-relational,4|5,7,4/5,210301,4
6,2,21,302,1,994,1,7,3,3,4,single-choice,spatial-relational,3|4,7,3/4,210302,3
6,2,21,303,1,830,1,3,1,1,2,single-choice,spatial-relational,1|2,7,1/2,210303,1
6,2,21,304,1,1047,1,9,4,4,5,single-choice,spatial-relational,4|5,7,4/5,210304,4
6,2,21,305,1,1277,1,3,1,1,2,single-choice,spatial-relational,1|2,7,1/2,210305,1
6,2,21,306,1,1290,1,5,2,2,3,single-choice,spatial-relational,2|3,7,2/3,210306,2
6,2,21,307,1,1033,1,11,5,5,6,single-choice,spatial-relational,5|6,7,5/6,210307,5
6,2,21,308,1,1222,1,5,2,2,3,single-choice,spatial-relational,2|3,7,2/3,210308,2
6,2,21,309,1,910,1,11,5,5,6,single-choice,spatial-relational,5|6,7,5/6,210309,5
6,2,21,310,1,1224,1,7,3,3,4,single-choice,spatial-relational,3|4,7,3/4,210310,3
6,2,21,311,1,1511,1,13,6,6,7,single-choice,spatial-relational,6|7,7,6/7,210311,6
6,2,21,312,1,1011,1,13,6,6,7,single-choice,spatial-relational,6|7,7,6/7,210312,6
6,2,21,313,1,1244,1,5,2,2,3,single-choice,spatial-relational,2|3,7,2/3,210313,2
6,2,21,314,1,1034,1,9,4,4,5,single-choice,spatial-relational,4|5,7,4/5,210314,4
6,2,21,315,1,1409,1,3,1,1,2,single-choice,spatial-relational,1|2,7,1/2,210315,1
6,2,21,316,1,1015,1,11,5,5,6,single-choice,spatial-relational,5|6,7,5/6,210316,5
6,2,21,317,1,904,1,5,2,2,3,single-choice,spatial-relational,2|3,7,2/3,210317,2
6,2,21,318,1,959,1,13,6,6,7,single-choice,spatial-relational,6|7,7,6/7,210318,6
6,2,21,319,0,912,1,9,4,5,5,single-choice,spatial-relational,4|5,7,4/5,210319,4
6,2,21,320,1,884,1,13,6,6,7,single-choice,spatial-relational,6|7,7,6/7,210320,6
6,2,21,321,1,1768,1,7,3,3,4,single-choice,spatial-relational,3|4,7,3/4,210321,3
6,2,21,322,1,1423,1,11,5,5,6,single-choice,spatial-relational,5|6,7,5/6,210322,5
6,2,21,323,0,1332,1,3,1,2,2,single-choice,spatial-relational,1|2,7,1/2,210323,1
6,2,21,324,1,919,1,7,3,3,4,single-choice,spatial-relational,3|4,7,3/4,210324,3
6,2,21,325,1,1040,1,3,1,1,2,single-choice,spatial-relational,1|2,7,1/2,210325,1
6,2,21,326,1,1070,1,9,4,4,5,single-choice,spatial-relational,4|5,7,4/5,210326,4
6,2,21,327,1,1361,1,7,3,3,4,single-choice,spatial-relational,3|4,7,3/4,210327,3
6,2,21,328,0,985,1,3,1,2,2,single-choice,spatial-relational,1|2,7,1/2,210328,1
6,2,21,329,1,1062,1,9,4,4,5,single-choice,spatial-relational,4|5,7,4/5,210329,4
6,2,21,330,0,1056,1,5,2,3,3,single-choice,spatial-relational,2|3,7,2/3,210330,2
6,2,21,331,1,792,1,7,3,3,4,single-choice,spatial-relational,3|4,7,3/4,210331,3
6,2,21,332,1,1056,1,5,2,2,3,single-choice,spatial-relational,2|3,7,2/3,210332,2
6,2,21,333,1,881,1,13,6,6,7,single-choice,spatial-relational,6|7,7,6/7,210333,6
6,2,21,334,1,1642,1,13,6,6,7,single-choice,spatial-relational,6|7,7,6/7,210334,6
6,2,21,335,1,1150,1,11,5,5,6,single-choice,spatial-relational,5|6,7,5/6,210335,5
6,2,21,336,1,1241,1,11,5,5,6,single-choice,spatial-relational,5|6,7,5/6,210336,5
6,2,21,337,0,1030,1,3,1,2,2,single-choice,spatial-relational,1|2,7,1/2,210337,1
6,2,21,338,1,856,1,7,3,3,4,single-choice,spatial-relational,3|4,7,3/4,210338,3
6,2,21,339,1,1086,1,11,5,5,6,single-choice,spatial-relational,5|6,7,5/6,210339,5
6,2,21,340,1,839,1,9,4,4,5,single-choice,spatial-relational,4|5,7,4/5,210340,4
6,2,21,341,1,926,1,13,6,6,7,single-choice,spatial-relational,6|7,7,6/7,210341,6
6,2,21,342,1,118,1,13,6,6,7,single-choice,spatial-relational,6|7,7,6/7,210342,6
6,2,21,343,1,1408,1,5,2,2,3,single-choice,spatial-relational,2|3,7,2/3,210343,2
6,2,21,344,1,1039,1,11,5,5,6,single-choice,spatial-relational,5|6,7,5/6,210344,5
6,2,21,345,1,1972,1,9,4,4,5,single-choice,spatial-relational,4|5,7,4/5,210345,4
6,2,21,346,1,1604,1,5,2,2,3,single-choice,spatial-relational,2|3,7,2/3,210346,2
6,2,21,347,0,968,1,3,1,2,2,single-choice,spatial-relational,1|2,7,1/2,210347,1
6,2,21,348,1,805,1,7,3,3,4,single-choice,spatial-relational,3|4,7,3/4,210348,3
6,2,21,349,1,1030,1,7,3,3,4,single-choice,spatial-relational,3|4,7,3/4,210349,3
6,2,21,350,1,1001,1,5,2,2,3,single-choice,spatial-relational,2|3,7,2/3,210350,2
6,2,21,351,1,1060,1,13,6,6,7,single-choice,spatial-relational,6|7,7,6/7,210351,6
6,2,21,352,1,1347,1,13,6,6,7,single-choice,spatial-relational,6|7,7,6/7,210352,6
6,2,21,353,0,827,1,9,4,5,5,single-choice,spatial-relational,4|5,7,4/5,210353,4
6,2,21,354,1,1089,1,7,3,3,4,single-choice,spatial-relational,3|4,7,3/4,210354,3
6,2,21,355,0,1028,1,11,5,6,6,single-choice,spatial-relational,5|6,7,5/6,210355,5
6,2,21,356,1,1188,1,11,5,5,6,single-choice,spatial-relational,5|6,7,5/6,210356,5
6,2,21,357,1,1137,1,9,4,4,5,single-choice,spatial-relational,4|5,7,4/5,210357,4
6,2,21,358,1,1419,1,5,2,2,3,single-choice,spatial-relational,2|3,7,2/3,210358,2
6,2,21,359,1,1031,1,3,1,1,2,single-choice,spatial-relational,1|2,7,1/2,210359,1
6,2,21,360,1,868,1,3,1,1,2,single-choice,spatial-relational,1|2,7,1/2,210360,1
6,2,21,361,1,1232,1,5,2,2,3,single-choice,spatial-relational,2|3,7,2/3,210361,2
6,2,21,362,1,1300,1,11,5,5,6,single-choice,spatial-relational,5|6,7,5/6,210362,5
6,2,21,363,1,1715,1,5,2,2,3,single-choice,spatial-relational,2|3,7,2/3,210363,2
6,2,21,364,0,915,1,7,3,4,4,single-choice,spatial-relational,3|4,7,3/4,210364,3
6,2,21,365,1,989,1,13,6,6,7,single-choice,spatial-relational,6|7,7,6/7,210365,6
6,2,21,366,1,986,1,13,6,6,7,single-choice,spatial-relational,6|7,7,6/7,210366,6
6,2,21,367,1,1242,1,3,1,1,2,single-choice,spatial-relational,1|2,7,1/2,210367,1
6,2,21,368,1,943,1,11,5,5,6,single-choice,spatial-relational,5|6,7,5/6,210368,5
6,2,21,369,0,1358,1,3,1,2,2,single-choice,spatial-relational,1|2,7,1/2,210369,1
6,2,21,370,1,932,1,7,3,3,4,single-choice,spatial-relational,3|4,7,3/4,210370,3
6,2,21,371,1,1137,1,9,4,4,5,single-choice,spatial-relational,4|5,7,4/5,210371,4
6,2,21,372,1,1725,1,9,4,4,5,single-choice,spatial-relational,4|5,7,4/5,210372,4
6,2,21,373,1,1312,1,11,5,5,6,single-choice,spatial-relational,5|6,7,5/6,210373,5
6,2,21,374,0,1078,1,3,1,2,2,single-choice,spatial-relational,1|2,7,1/2,210374,1
6,2,21,375,1,716,1,7,3,3,4,single-choice,spatial-relational,3|4,7,3/4,210375,3
6,2,21,376,1,1210,1,3,1,1,2,single-choice,spatial-relational,1|2,7,1/2,210376,1
6,2,21,377,1,848,1,5,2,2,3,single-choice,spatial-relational,2|3,7,2/3,210377,2
6,2,21,378,1,960,1,13,6,6,7,single-choice,spatial-relational,6|7,7,6/7,210378,6
6,2,21,379,0,1233,1,11,5,6,6,single-choice,spatial-relational,5|6,7,5/6,210379,5
6,2,21,380,1,1326,1,9,4,4,5,single-choice,spatial-relational,4|5,7,4/5,210380,4
6,2,21,381,1,1297,1,5,2,2,3,single-choice,spatial-relational,2|3,7,2/3,210381,2
6,2,21,382,1,1091,1,9,4,4,5,single-choice,spatial-relational,4|5,7,4/5,210382,4
6,2,21,383,1,886,1,13,6,6,7,single-choice,spatial-relational,6|7,7,6/7,210383,6
6,2,21,384,1,1101,1,7,3,3,4,single-choice,spatial-relational,3|4,7,3/4,210384,3
6,2,21,385,1,1013,1,5,2,2,3,single-choice,spatial-relational,2|3,7,2/3,210385,2
6,2,21,386,1,1243,1,3,1,1,2,single-choice,spatial-relational,1|2,7,1/2,210386,1
6,2,21,387,1,858,1,13,6,6,7,single-choice,spatial-relational,6|7,7,6/7,210387,6
6,2,21,388,1,897,1,7,3,3,4,single-choice,spatial-relational,3|4,7,3/4,210388,3
6,2,21,389,1,1242,1,3,1,1,2,single-choice,spatial-relational,1|2,7,1/2,210389,1
6,2,21,390,1,912,1,9,4,4,5,single-choice,spatial-relational,4|5,7,4/5,210390,4
6,2,21,391,1,1255,1,5,2,2,3,single-choice,spatial-relational,2|3,7,2/3,210391,2
6,2,21,392,1,942,1,9,4,4,5,single-choice,spatial-relational,4|5,7,4/5,210392,4
6,2,21,393,1,897,1,13,6,6,7,single-choice,spatial-relational,6|7,7,6/7,210393,6
6,2,21,394,1,1470,1,11,5,5,6,single-choice,spatial-relational,5|6,7,5/6,210394,5
6,2,21,395,1,1428,1,11,5,5,6,single-choice,spatial-relational,5|6,7,5/6,210395,5
6,2,21,396,1,1079,1,7,3,3,4,single-choice,spatial-relational,3|4,7,3/4,210396,3
6,2,21,397,1,1507,1,13,6,6,7,single-choice,spatial-relational,6|7,7,6/7,210397,6
6,2,21,398,1,980,1,7,3,3,4,single-choice,spatial-relational,3|4,7,3/4,210398,3
6,2,21,399,1,1571,1,3,1,1,2,single-choice,spatial-relational,1|2,7,1/2,210399,1
6,2,21,400,1,1109,1,7,3,3,4,single-choice,spatial-relational,3|4,7,3/4,210400,3
6,2,21,401,1,1555,1,11,5,5,6,single-choice,spatial-relational,5|6,7,5/6,210401,5
6,2,21,402,1,1574,1,5,2,2,3,single-choice,spatial-relational,2|3,7,2/3,210402,2
6,2,21,403,1,1001,1,11,5,5,6,single-choice,spatial-relational,5|6,7,5/6,210403,5
6,2,21,404,1,1131,1,13,6,6,7,single-choice,spatial-relational,6|7,7,6/7,210404,6
6,2,21,405,1,899,1,5,2,2,3,single-choice,spatial-relational,2|3,7,2/3,210405,2
6,2,21,406,0,970,1,9,4,5,5,single-choice,spatial-relational,4|5,7,4/5,210406,4
6,2,21,407,1,945,1,3,1,1,2,single-choice,spatial-relational,1|2,7,1/2,210407,1
6,2,21,408,1,832,1,9,4,4,5,single-choice,spatial-relational,4|5,7,4/5,210408,4
6,2,21,409,1,1422,1,5,2,2,3,single-choice,spatial-relational,2|3,7,2/3,210409,2
6,2,21,410,1,1318,1,11,5,5,6,single-choice,spatial-relational,5|6,7,5/6,210410,5
6,2,21,411,1,1855,1,11,5,5,6,single-choice,spatial-relational,5|6,7,5/6,210411,5
6,2,21,412,1,917,1,13,6,6,7,single-choice,spatial-relational,6|7,7,6/7,210412,6
6,2,21,413,1,1323,1,9,4,4,5,single-choice,spatial-relational,4|5,7,4/5,210413,4
6,2,21,414,1,1068,1,5,2,2,3,single-choice,spatial-relational,2|3,7,2/3,210414,2
6,2,21,415,1,936,1,13,6,6,7,single-choice,spatial-relational,6|7,7,6/7,210415,6
6,2,21,416,1,1081,1,7,3,3,4,single-choice,spatial-relational,3|4,7,3/4,210416,3
6,2,21,417,0,1495,1,9,4,5,5,single-choice,spatial-relational,4|5,7,4/5,210417,4
6,2,21,418,1,840,1,7,3,3,4,single-choice,spatial-relational,3|4,7,3/4,210418,3
6,2,21,419,0,1411,1,3,1,2,2,single-choice,spatial-relational,1|2,7,1/2,210419,1
6,2,21,420,1,1471,1,3,1,1,2,single-choice,spatial-relational,1|2,7,1/2,210420,1
6,2,21,421,1,968,1,7,3,3,4,single-choice,spatial-relational,3|4,7,3/4,210421,3
6,2,21,422,1,975,1,13,6,6,7,single-choice,spatial-relational,6|7,7,6/7,210422,6
6,2,21,423,1,899,1,5,2,2,3,single-choice,spatial-relational,2|3,7,2/3,210423,2
6,2,21,424,1,1450,1,11,5,5,6,single-choice,spatial-relational,5|6,7,5/6,210424,5
6,2,21,425,1,1232,1,9,4,4,5,single-choice,spatial-relational,4|5,7,4/5,210425,4
6,2,21,426,1,1014,1,13,6,6,7,single-choice,spatial-relational,6|7,7,6/7,210426,6
6,2,21,427,1,1643,1,11,5,5,6,single-choice,spatial-relational,5|6,7,5/6,210427,5
6,2,21,428,0,1139,1,3,1,2,2,single-choice,spatial-relational,1|2,7,1/2,210428,1
6,2,21,429,0,820,1,3,1,2,2,single-choice,spatial-relational,1|2,7,1/2,210429,1
6,2,21,430,1,1004,1,5,2,2,3,single-choice,spatial-relational,2|3,7,2/3,210430,2
6,2,21,431,1,929,1,7,3,3,4,single-choice,spatial-relational,3|4,7,3/4,210431,3
6,2,21,432,1,1138,1,9,4,4,5,single-choice,spatial-relational,4|5,7,4/5,210432,4
6,2,21,433,0,786,1,5,2,3,3,single-choice,spatial-relational,2|3,7,2/3,210433,2
6,2,21,434,1,1423,1,13,6,6,7,single-choice,spatial-relational,6|7,7,6/7,210434,6
6,2,21,435,1,1296,1,7,3,3,4,single-choice,spatial-relational,3|4,7,3/4,210435,3
6,2,21,436,1,1674,1,11,5,5,6,single-choice,spatial-relational,5|6,7,5/6,210436,5
6,2,21,437,1,1093,1,7,3,3,4,single-choice,spatial-relational,3|4,7,3/4,210437,3
6,2,21,438,1,1192,1,11,5,5,6,single-choice,spatial-relational,5|6,7,5/6,210438,5
6,2,21,439,1,865,1,5,2,2,3,single-choice,spatial-relational,2|3,7,2/3,210439,2
6,2,21,440,0,1527,1,3,1,2,2,single-choice,spatial-relational,1|2,7,1/2,210440,1
6,2,21,441,1,698,1,9,4,4,5,single-choice,spatial-relational,4|5,7,4/5,210441,4
6,2,21,442,1,1023,1,9,4,4,5,single-choice,spatial-relational,4|5,7,4/5,210442,4
6,2,21,443,1,990,1,13,6,6,7,single-choice,spatial-relational,6|7,7,6/7,210443,6
6,2,21,444,1,1133,1,3,1,1,2,single-choice,spatial-relational,1|2,7,1/2,210444,1
6,2,21,445,1,739,1,13,6,6,7,single-choice,spatial-relational,6|7,7,6/7,210445,6
6,2,21,446,1,1197,1,9,4,4,5,single-choice,spatial-relational,4|5,7,4/5,210446,4
6,2,21,447,1,1373,1,5,2,2,3,single-choice,spatial-relational,2|3,7,2/3,210447,2
6,2,21,448,0,1217,1,9,4,5,5,single-choice,spatial-relational,4|5,7,4/5,210448,4
6,2,21,449,0,803,1,11,5,6,6,single-choice,spatial-relational,5|6,7,5/6,210449,5
6,2,21,450,1,762,1,7,3,3,4,single-choice,spatial-relational,3|4,7,3/4,210450,3
6,2,21,451,0,1695,1,5,2,3,3,single-choice,spatial-relational,2|3,7,2/3,210451,2
6,2,21,452,1,796,1,3,1,1,2,single-choice,spatial-relational,1|2,7,1/2,210452,1
6,2,21,453,1,1154,1,11,5,5,6,single-choice,spatial-relational,5|6,7,5/6,210453,5
6,2,21,454,1,134,1,13,6,6,7,single-choice,spatial-relational,6|7,7,6/7,210454,6
6,2,21,455,1,845,1,7,3,3,4,single-choice,spatial-relational,3|4,7,3/4,210455,3
6,2,21,456,1,1220,1,3,1,1,2,single-choice,spatial-relational,1|2,7,1/2,210456,1
6,2,21,457,1,820,1,13,6,6,7,single-choice,spatial-relational,6|7,7,6/7,210457,6
6,2,21,458,1,102,1,11,5,5,6,single-choice,spatial-relational,5|6,7,5/6,210458,5
6,2,21,459,1,1066,1,7,3,3,4,single-choice,spatial-relational,3|4,7,3/4,210459,3
6,2,21,460,1,1102,1,3,1,1,2,single-choice,spatial-relational,1|2,7,1/2,210460,1
6,2,21,461,1,1385,1,5,2,2,3,single-choice,spatial-relational,2|3,7,2/3,210461,2
6,2,21,462,1,1262,1,5,2,2,3,single-choice,spatial-relational,2|3,7,2/3,210462,2
6,2,21,463,1,837,1,7,3,3,4,single-choice,spatial-relational,3|4,7,3/4,210463,3
6,2,21,464,1,87,1,13,6,6,7,single-choice,spatial-relational,6|7,7,6/7,210464,6
6,2,21,465,1,1584,1,9,4,4,5,single-choice,spatial-relational,4|5,7,4/5,210465,4
6,2,21,466,1,1239,1,3,1,1,2,single-choice,spatial-relational,1|2,7,1/2,210466,1
6,2,21,467,1,742,1,9,4,4,5,single-choice,spatial-relational,4|5,7,4/5,210467,4
6,2,21,468,1,1435,1,11,5,5,6,single-choice,spatial-relational,5|6,7,5/6,210468,5
6,2,21,469,1,1081,1,13,6,6,7,single-choice,spatial-relational,6|7,7,6/7,210469,6
6,2,21,470,1,1201,1,9,4,4,5,single-choice,spatial-relational,4|5,7,4/5,210470,4
6,2,21,471,0,1515,1,11,5,6,6,single-choice,spatial-relational,5|6,7,5/6,210471,5
6,2,21,472,0,690,1,13,6,7,7,single-choice,spatial-relational,6|7,7,6/7,210472,6
6,2,21,473,1,1002,1,3,1,1,2,single-choice,spatial-relational,1|2,7,1/2,210473,1
6,2,21,474,1,1010,1,7,3,3,4,single-choice,spatial-relational,3|4,7,3/4,210474,3
6,2,21,475,1,1288,1,11,5,5,6,single-choice,spatial-relational,5|6,7,5/6,210475,5
6,2,21,476,1,1257,1,9,4,4,5,single-choice,spatial-relational,4|5,7,4/5,210476,4
6,2,21,477,1,1103,1,3,1,1,2,single-choice,spatial-relational,1|2,7,1/2,210477,1
6,2,21,478,1,749,1,7,3,3,4,single-choice,spatial-relational,3|4,7,3/4,210478,3
6,2,21,479,1,1145,1,5,2,2,3,single-choice,spatial-relational,2|3,7,2/3,210479,2
6,2,21,480,1,1125,1,5,2,2,3,single-choice,spatial-relational,2|3,7,2/3,210480,2
6,2,21,481,1,1022,1,13,6,6,7,single-choice,spatial-relational,6|7,7,6/7,210481,6
6,2,21,482,1,1169,1,7,3,3,4,single-choice,spatial-relational,3|4,7,3/4,210482,3
6,2,21,483,1,784,1,7,3,3,4,single-choice,spatial-relational,3|4,7,3/4,210483,3
6,2,21,484,1,1645,1,5,2,2,3,single-choice,spatial-relational,2|3,7,2/3,210484,2
6,2,21,485,1,1088,1,11,5,5,6,single-choice,spatial-relational,5|6,7,5/6,210485,5
6,2,21,486,1,1284,1,3,1,1,2,single-choice,spatial-relational,1|2,7,1/2,210486,1
6,2,21,487,1,1200,1,5,2,2,3,single-choice,spatial-relational,2|3,7,2/3,210487,2
6,2,21,488,1,877,1,11,5,5,6,single-choice,spatial-relational,5|6,7,5/6,210488,5
6,2,21,489,0,111,1,3,1,2,2,single-choice,spatial-relational,1|2,7,1/2,210489,1
6,2,21,490,1,897,1,9,4,4,5,single-choice,spatial-relational,4|5,7,4/5,210490,4
6,2,21,491,1,1085,1,9,4,4,5,single-choice,spatial-relational,4|5,7,4/5,210491,4
6,2,21,492,1,925,1,13,6,6,7,single-choice,spatial-relational,6|7,7,6/7,210492,6
6,2,21,493,1,993,1,13,6,6,7,single-choice,spatial-relational,6|7,7,6/7,210493,6
6,2,21,494,1,1007,1,5,2,2,3,single-choice,spatial-relational,2|3,7,2/3,210494,2
6,2,21,495,1,977,1,3,1,1,2,single-choice,spatial-relational,1|2,7,1/2,210495,1
6,2,21,496,1,668,1,11,5,5,6,single-choice,spatial-relational,5|6,7,5/6,210496,5
6,2,21,497,1,1209,1,11,5,5,6,single-choice,spatial-relational,5|6,7,5/6,210497,5
6,2,21,498,1,894,1,9,4,4,5,single-choice,spatial-relational,4|5,7,4/5,210498,4
6,2,21,499,1,1317,1,13,6,6,7,single-choice,spatial-relational,6|7,7,6/7,210499,6
6,2,21,500,1,1219,1,7,3,3,4,single-choice,spatial-relational,3|4,7,3/4,210500,3
6,2,21,501,1,1277,1,5,2,2,3,single-choice,spatial-relational,2|3,7,2/3,210501,2
6,2,21,502,1,1060,1,9,4,4,5,single-choice,spatial-relational,4|5,7,4/5,210502,4
6,2,21,503,1,1139,1,7,3,3,4,single-choice,spatial-relational,3|4,7,3/4,210503,3
6,2,21,504,0,1066,1,3,1,2,2,single-choice,spatial-relational,1|2,7,1/2,210504,1
6,2,21,505,0,688,1,5,2,3,3,single-choice,spatial-relational,2|3,7,2/3,210505,2
6,2,21,506,1,862,1,13,6,6,7,single-choice,spatial-relational,6|7,7,6/7,210506,6
6,2,21,507,1,1184,1,9,4,4,5,single-choice,spatial-relational,4|5,7,4/5,210507,4
6,2,21,508,1,909,1,9,4,4,5,single-choice,spatial-relational,4|5,7,4/5,210508,4
6,2,21,509,1,1420,1,7,3,3,4,single-choice,spatial-relational,3|4,7,3/4,210509,3
6,2,21,510,1,1438,1,3,1,1,2,single-choice,spatial-relational,1|2,7,1/2,210510,1
6,2,21,511,1,1417,1,3,1,1,2,single-choice,spatial-relational,1|2,7,1/2,210511,1
6,2,21,512,1,846,1,11,5,5,6,single-choice,spatial-relational,5|6,7,5/6,210512,5
6,2,21,513,1,1244,1,5,2,2,3,single-choice,spatial-relational,2|3,7,2/3,210513,2
6,2,21,514,1,891,1,7,3,3,4,single-choice,spatial-relational,3|4,7,3/4,210514,3
6,2,21,515,0,92,1,11,5,6,6,single-choice,spatial-relational,5|6,7,5/6,210515,5
6,2,21,516,1,913,1,13,6,6,7,single-choice,spatial-relational,6|7,7,6/7,210516,6
6,2,21,517,1,1014,1,9,4,4,5,single-choice,spatial-relational,4|5,7,4/5,210517,4
6,2,21,518,1,1431,1,11,5,5,6,single-choice,spatial-relational,5|6,7,5/6,210518,5
6,2,21,519,1,1169,1,7,3,3,4,single-choice,spatial-relational,3|4,7,3/4,210519,3
6,2,21,520,1,915,1,13,6,6,7,single-choice,spatial-relational,6|7,7,6/7,210520,6
6,2,21,521,1,1392,1,13,6,6,7,single-choice,spatial-relational,6|7,7,6/7,210521,6
6,2,21,522,1,1210,1,7,3,3,4,single-choice,spatial-relational,3|4,7,3/4,210522,3
6,2,21,523,1,1115,1,5,2,2,3,single-choice,spatial-relational,2|3,7,2/3,210523,2
6,2,21,524,1,1156,1,3,1,1,2,single-choice,spatial-relational,1|2,7,1/2,210524,1
6,2,21,525,1,936,1,9,4,4,5,single-choice,spatial-relational,4|5,7,4/5,210525,4
6,2,21,526,1,910,1,11,5,5,6,single-choice,spatial-relational,5|6,7,5/6,210526,5
6,2,21,527,1,1354,1,3,1,1,2,single-choice,spatial-relational,1|2,7,1/2,210527,1
6,2,21,528,1,885,1,5,2,2,3,single-choice,spatial-relational,2|3,7,2/3,210528,2
6,2,21,529,1,1118,1,5,2,2,3,single-choice,spatial-relational,2|3,7,2/3,210529,2
6,2,21,530,1,838,1,11,5,5,6,single-choice,spatial-relational,5|6,7,5/6,210530,5
6,2,21,531,1,859,1,9,4,4,5,single-choice,spatial-relational,4|5,7,4/5,210531,4
6,2,21,532,1,80,1,3,1,1,2,single-choice,spatial-relational,1|2,7,1/2,210532,1
6,2,21,533,1,731,1,5,2,2,3,single-choice,spatial-relational,2|3,7,2/3,210533,2
6,2,21,534,1,980,1,9,4,4,5,single-choice,spatial-relational,4|5,7,4/5,210534,4
6,2,21,535,1,1522,1,11,5,5,6,single-choice,spatial-relational,5|6,7,5/6,210535,5
6,2,21,536,1,1424,1,13,6,6,7,single-choice,spatial-relational,6|7,7,6/7,210536,6
6,2,21,537,1,1696,1,13,6,6,7,single-choice,spatial-relational,6|7,7,6/7,210537,6
6,2,21,538,1,1416,1,7,3,3,4,single-choice,spatial-relational,3|4,7,3/4,210538,3
6,2,21,539,1,1049,1,3,1,1,2,single-choice,spatial-relational,1|2,7,1/2,210539,1
6,2,21,540,1,913,1,7,3,3,4,single-choice,spatial-relational,3|4,7,3/4,210540,3
6,2,21,541,0,1491,1,3,1,2,2,single-choice,spatial-relational,1|2,7,1/2,210541,1
6,2,21,542,1,797,1,7,3,3,4,single-choice,spatial-relational,3|4,7,3/4,210542,3
6,2,21,543,1,845,1,7,3,3,4,single-choice,spatial-relational,3|4,7,3/4,210543,3
6,2,21,544,1,1384,1,5,2,2,3,single-choice,spatial-relational,2|3,7,2/3,210544,2
6,2,21,545,1,1246,1,9,4,4,5,single-choice,spatial-relational,4|5,7,4/5,210545,4
6,2,21,546,1,944,1,3,1,1,2,single-choice,spatial-relational,1|2,7,1/2,210546,1
6,2,21,547,1,888,1,11,5,5,6,single-choice,spatial-relational,5|6,7,5/6,210547,5
6,2,21,548,1,917,1,9,4,4,5,single-choice,spatial-relational,4|5,7,4/5,210548,4
6,2,21,549,1,985,1,13,6,6,7,single-choice,spatial-relational,6|7,7,6/7,210549,6
6,2,21,550,1,1421,1,11,5,5,6,single-choice,spatial-relational,5|6,7,5/6,210550,5
6,2,21,551,1,1291,1,13,6,6,7,single-choice,spatial-relational,6|7,7,6/7,210551,6
6,2,21,552,1,1593,1,5,2,2,3,single-choice,spatial-relational,2|3,7,2/3,210552,2
6,2,21,553,1,940,1,13,6,6,7,single-choice,spatial-relational,6|7,7,6/7,210553,6
6,2,21,554,1,1164,1,3,1,1,2,single-choice,spatial-relational,1|2,7,1/2,210554,1
6,2,21,555,1,644,1,11,5,5,6,single-choice,spatial-relational,5|6,7,5/6,210555,5
6,2,21,556,1,1148,1,5,2,2,3,single-choice,spatial-relational,2|3,7,2/3,210556,2
6,2,21,557,0,757,1,11,5,6,6,single-choice,spatial-relational,5|6,7,5/6,210557,5
6,2,21,558,1,1147,1,9,4,4,5,single-choice,spatial-relational,4|5,7,4/5,210558,4
6,2,21,559,1,1234,1,13,6,6,7,single-choice,spatial-relational,6|7,7,6/7,210559,6
6,2,21,560,1,1058,1,9,4,4,5,single-choice,spatial-relational,4|5,7,4/5,210560,4
6,2,21,561,1,932,1,7,3,3,4,single-choice,spatial-relational,3|4,7,3/4,210561,3
6,2,21,562,1,874,1,7,3,3,4,single-choice,spatial-relational,3|4,7,3/4,210562,3
6,2,21,563,1,874,1,3,1,1,2,single-choice,spatial-relational,1|2,7,1/2,210563,1
6,2,21,564,0,712,1,5,2,3,3,single-choice,spatial-relational,2|3,7,2/3,210564,2
6,2,21,565,0,889,1,5,2,3,3,single-choice,spatial-relational,2|3,7,2/3,210565,2
6,2,21,566,0,1165,1,11,5,6,6,single-choice,spatial-relational,5|6,7,5/6,210566,5
6,2,21,567,1,56,1,3,1,1,2,single-choice,spatial-relational,1|2,7,1/2,210567,1
6,2,21,568,1,904,1,13,6,6,7,single-choice,spatial-relational,6|7,7,6/7,210568,6
6,2,21,569,0,1242,1,5,2,3,3,single-choice,spatial-relational,2|3,7,2/3,210569,2
6,2,21,570,1,812,1,13,6,6,7,single-choice,spatial-relational,6|7,7,6/7,210570,6
6,2,21,571,1,1122,1,7,3,3,4,single-choice,spatial-relational,3|4,7,3/4,210571,3
6,2,21,572,1,1034,1,7,3,3,4,single-choice,spatial-relational,3|4,7,3/4,210572,3
6,2,21,573,0,1103,1,3,1,2,2,single-choice,spatial-relational,1|2,7,1/2,210573,1
6,2,21,574,1,1193,1,11,5,5,6,single-choice,spatial-relational,5|6,7,5/6,210574,5
6,2,21,575,1,851,1,9,4,4,5,single-choice,spatial-relational,4|5,7,4/5,210575,4
6,2,21,576,1,1692,1,9,4,4,5,single-choice,spatial-relational,4|5,7,4/5,210576,4
6,2,21,577,0,1559,1,9,4,5,5,single-choice,spatial-relational,4|5,7,4/5,210577,4
6,2,21,578,1,874,1,7,3,3,4,single-choice,spatial-relational,3|4,7,3/4,210578,3
6,2,21,579,1,1289,1,13,6,6,7,single-choice,spatial-relational,6|7,7,6/7,210579,6
6,2,21,580,1,1813,1,13,6,6,7,single-choice,spatial-relational,6|7,7,6/7,210580,6
6,2,21,581,0,961,1,3,1,2,2,single-choice,spatial-relational,1|2,7,1/2,210581,1
6,2,21,582,1,1310,1,5,2,2,3,single-choice,spatial-relational,2|3,7,2/3,210582,2
6,2,21,583,1,884,1,7,3,3,4,single-choice,spatial-relational,3|4,7,3/4,210583,3
6,2,21,584,1,1452,1,9,4,4,5,single-choice,spatial-relational,4|5,7,4/5,210584,4
6,2,21,585,1,1377,1,3,1,1,2,single-choice,spatial-relational,1|2,7,1/2,210585,1
6,2,21,586,1,1453,1,5,2,2,3,single-choice,spatial-relational,2|3,7,2/3,210586,2
6,2,21,587,1,1327,1,11,5,5,6,single-choice,spatial-relational,5|6,7,5/6,210587,5
6,2,21,588,1,141,1,11,5,5,6,single-choice,spatial-relational,5|6,7,5/6,210588,5
6,2,21,589,1,1123,1,5,2,2,3,single-choice,spatial-relational,2|3,7,2/3,210589,2
6,2,21,590,1,1202,1,11,5,5,6,single-choice,spatial-relational,5|6,7,5/6,210590,5
6,2,21,591,1,1025,1,13,6,6,7,single-choice,spatial-relational,6|7,7,6/7,210591,6
6,2,21,592,1,1084,1,7,3,3,4,single-choice,spatial-relational,3|4,7,3/4,210592,3
6,2,21,593,1,917,1,9,4,4,5,single-choice,spatial-relational,4|5,7,4/5,210593,4
6,2,21,594,1,889,1,9,4,4,5,single-choice,spatial-relational,4|5,7,4/5,210594,4
6,2,21,595,1,1278,1,13,6,6,7,single-choice,spatial-relational,6|7,7,6/7,210595,6
6,2,21,596,1,1058,1,5,2,2,3,single-choice,spatial-relational,2|3,7,2/3,210596,2
6,2,21,597,1,781,1,11,5,5,6,single-choice,spatial-relational,5|6,7,5/6,210597,5
6,2,21,598,0,914,1,7,3,4,4,single-choice,spatial-relational,3|4,7,3/4,210598,3
6,2,21,599,1,838,1,3,1,1,2,single-choice,spatial-relational,1|2,7,1/2,210599,1
6,2,21,600,1,1001,1,3,1,1,2,single-choice,spatial-relational,1|2,7,1/2,210600,1
7,2,21,1,0,1118,1,11,5,6,6,single-choice,spatial-relational,5|6,7,5/6,210001,5
7,2,21,2,0,550,1,3,1,2,2,single-choice,spatial-relational,1|2,7,1/2,210002,1
7,2,21,3,1,1007,1,13,6,6,7,single-choice,spatial-relational,6|7,7,6/7,210003,6
7,2,21,4,1,1529,1,13,6,6,7,single-choice,spatial-relational,6|7,7,6/7,210004,6
7,2,21,5,1,1070,1,3,1,1,2,single-choice,spatial-relational,1|2,7,1/2,210005,1
7,2,21,6,1,1117,1,7,3,3,4,single-choice,spatial-relational,3|4,7,3/4,210006,3
7,2,21,7,1,1459,1,7,3,3,4,single-choice,spatial-relational,3|4,7,3/4,210007,3
7,2,21,8,1,951,1,5,2,2,3,single-choice,spatial-relational,2|3,7,2/3,210008,2
7,2,21,9,1,1933,1,11,5,5,6,single-choice,spatial-relational,5|6,7,5/6,210009,5
7,2,21,10,0,1161,1,5,2,3,3,single-choice,spatial-relational,2|3,7,2/3,210010,2
7,2,21,11,1,1150,1,9,4,4,5,single-choice,spatial-relational,4|5,7,4/5,210011,4
7,2,21,12,1,2408,1,9,4,4,5,single-choice,spatial-relational,4|5,7,4/5,210012,4
7,2,21,13,1,1388,1,9,4,4,5,single-choice,spatial-relational,4|5,7,4/5,210013,4
7,2,21,14,1,1863,1,9,4,4,5,single-choice,spatial-relational,4|5,7,4/5,210014,4
7,2,21,15,1,1362,1,13,6,6,7,single-choice,spatial-relational,6|7,7,6/7,210015,6
7,2,21,16,1,3147,1,5,2,2,3,single-choice,spatial-relational,2|3,7,2/3,210016,2
7,2,21,17,1,1499,1,7,3,3,4,single-choice,spatial-relational,3|4,7,3/4,210017,3
7,2,21,18,1,1254,1,3,1,1,2,single-choice,spatial-relational,1|2,7,1/2,210018,1
7,2,21,19,1,1289,1,7,3,3,4,single-choice,spatial-relational,3|4,7,3/4,210019,3
7,2,21,20,1,1119,1,3,1,1,2,single-choice,spatial-relational,1|2,7,1/2,210020,1
7,2,21,21,1,1133,1,11,5,5,6,single-choice,spatial-relational,5|6,7,5/6,210021,5
7,2,21,22,1,1121,1,13,6,6,7,single-choice,spatial-relational,6|7,7,6/7,210022,6
7,2,21,23,1,1056,1,11,5,5,6,single-choice,spatial-relational,5|6,7,5/6,210023,5
7,2,21,24,1,2278,1,5,2,2,3,single-choice,spatial-relational,2|3,7,2/3,210024,2
7,2,21,25,1,117,1,9,4,4,5,single-choice,spatial-relational,4|5,7,4/5,210025,4
7,2,21,26,1,1986,1,7,3,3,4,single-choice,spatial-relational,3|4,7,3/4,210026,3
7,2,21,27,1,1279,1,7,3,3,4,single-choice,spatial-relational,3|4,7,3/4,210027,3
7,2,21,28,0,978,1,3,1,2,2,single-choice,spatial-relational,1|2,7,1/2,210028,1
7,2,21,29,1,823,1,11,5,5,6,single-choice,spatial-relational,5|6,7,5/6,210029,5
7,2,21,30,1,1180,1,11,5,5,6,single-choice,spatial-relational,5|6,7,5/6,210030,5
7,2,21,31,1,1027,1,9,4,4,5,single-choice,spatial-relational,4|5,7,4/5,210031,4
7,2,21,32,1,1199,1,13,6,6,7,single-choice,spatial-relational,6|7,7,6/7,210032,6
7,2,21,33,1,1255,1,13,6,6,7,single-choice,spatial-relational,6|7,7,6/7,210033,6
7,2,21,34,0,1485,1,5,2,3,3,single-choice,spatial-relational,2|3,7,2/3,210034,2
7,2,21,35,1,1151,1,3,1,1,2,single-choice,spatial-relational,1|2,7,1/2,210035,1
7,2,21,36,1,1472,1,5,2,2,3,single-choice,spatial-relational,2|3,7,2/3,210036,2
7,2,21,37,1,1064,1,9,4,4,5,single-choice,spatial-relational,4|5,7,4/5,210037,4
7,2,21,38,1,1529,1,7,3,3,4,single-choice,spatial-relational,3|4,7,3/4,210038,3
7,2,21,39,1,1494,1,11,5,5,6,single-choice,spatial-relational,5|6,7,5/6,210039,5
7,2,21,40,1,1612,1,5,2,2,3,single-choice,spatial-relational,2|3,7,2/3,210040,2
7,2,21,41,0,837,1,3,1,2,2,single-choice,spatial-relational,1|2,7,1/2,210041,1
7,2,21,42,1,734,1,9,4,4,5,single-choice,spatial-relational,4|5,7,4/5,210042,4
7,2,21,43,1,1303,1,13,6,6,7,single-choice,spatial-relational,6|7,7,6/7,210043,6
7,2,21,44,1,2073,1,5,2,2,3,single-choice,spatial-relational,2|3,7,2/3,210044,2
7,2,21,45,1,1130,1,7,3,3,4,single-choice,spatial-relational,3|4,7,3/4,210045,3
7,2,21,46,0,1318,1,3,1,2,2,single-choice,spatial-relational,1|2,7,1/2,210046,1
7,2,21,47,1,645,1,13,6,6,7,single-choice,spatial-relational,6|7,7,6/7,210047,6
7,2,21,48,1,1025,1,11,5,5,6,single-choice,spatial-relational,5|6,7,5/6,210048,5
7,2,21,49,1,1494,1,3,1,1,2,single-choice,spatial-relational,1|2,7,1/2,210049,1
7,2,21,50,1,864,1,13,6,6,7,single-choice,spatial-relational,6|7,7,6/7,210050,6
7,2,21,51,1,1281,1,7,3,3,4,single-choice,spatial-relational,3|4,7,3/4,210051,3
7,2,21,52,1,1007,1,13,6,6,7,single-choice,spatial-relational,6|7,7,6/7,210052,6
7,2,21,53,1,1295,1,3,1,1,2,single-choice,spatial-relational,1|2,7,1/2,210053,1
7,2,21,54,1,1039,1,11,5,5,6,single-choice,spatial-relational,5|6,7,5/6,210054,5
7,2,21,55,1,1144,1,9,4,4,5,single-choice,spatial-relational,4|5,7,4/5,210055,4
7,2,21,56,1,1239,1,11,5,5,6,single-choice,spatial-relational,5|6,7,5/6,210056,5
7,2,21,57,1,1235,1,9,4,4,5,single-choice,spatial-relational,4|5,7,4/5,210057,4
7,2,21,58,0,2264,1,5,2,3,3,single-choice,spatial-relational,2|3,7,2/3,210058,2
7,2,21,59,0,870,1,7,3,4,4,single-choice,spatial-relational,3|4,7,3/4,210059,3
7,2,21,60,1,949,1,5,2,2,3,single-choice,spatial-relational,2|3,7,2/3,210060,2
7,2,21,61,0,1168,1,7,3,4,4,single-choice,spatial-relational,3|4,7,3/4,210061,3
7,2,21,62,1,1403,1,5,2,2,3,single-choice,spatial-relational,2|3,7,2/3,210062,2
7,2,21,63,0,1038,1,7,3,4,4,single-choice,spatial-relational,3|4,7,3/4,210063,3
7,2,21,64,1,1252,1,11,5,5,6,single-choice,spatial-relational,5|6,7,5/6,210064,5
7,2,21,65,1,1177,1,3,1,1,2,single-choice,spatial-relational,1|2,7,1/2,210065,1
7,2,21,66,1,939,1,5,2,2,3,single-choice,spatial-relational,2|3,7,2/3,210066,2
7,2,21,67,1,981,1,13,6,6,7,single-choice,spatial-relational,6|7,7,6/7,210067,6
7,2,21,68,1,979,1,11,5,5,6,single-choice,spatial-relational,5|6,7,5/6,210068,5
7,2,21,69,1,1198,1,9,4,4,5,single-choice,spatial-relational,4|5,7,4/5,210069,4
7,2,21,70,1,1458,1,3,1,1,2,single-choice,spatial-relational,1|2,7,1/2,210070,1
7,2,21,71,1,1269,1,13,6,6,7,single-choice,spatial-relational,6|7,7,6/7,210071,6
7,2,21,72,0,952,1,9,4,5,5,single-choice,spatial-relational,4|5,7,4/5,210072,4
7,2,21,73,0,554,1,9,4,5,5,single-choice,spatial-relational,4|5,7,4/5,210073,4
7,2,21,74,1,876,1,13,6,6,7,single-choice,spatial-relational,6|7,7,6/7,210074,6
7,2,21,75,1,1558,1,7,3,3,4,single-choice,spatial-relational,3|4,7,3/4,210075,3
7,2,21,76,1,1331,1,13,6,6,7,single-choice,spatial-relational,6|7,7,6/7,210076,6
7,2,21,77,1,1139,1,5,2,2,3,single-choice,spatial-relational,2|3,7,2/3,210077,2
7,2,21,78,0,1361,1,3,1,2,2,single-choice,spatial-relational,1|2,7,1/2,210078,1
7,2,21,79,1,658,1,9,4,4,5,single-choice,spatial-relational,4|5,7,4/5,210079,4
7,2,21,80,1,1048,1,3,1,1,2,single-choice,spatial-relational,1|2,7,1/2,210080,1
7,2,21,81,1,818,1,11,5,5,6,single-choice,spatial-relational,5|6,7,5/6,210081,5
7,2,21,82,1,1412,1,7,3,3,4,single-choice,spatial-relational,3|4,7,3/4,210082,3
7,2,21,83,1,2707,1,11,5,5,6,single-choice,spatial-relational,5|6,7,5/6,210083,5
7,2,21,84,1,1191,1,5,2,2,3,single-choice,spatial-relational,2|3,7,2/3,210084,2
7,2,21,85,1,1061,1,3,1,1,2,single-choice,spatial-relational,1|2,7,1/2,210085,1
7,2,21,86,1,1257,1,7,3,3,4,single-choice,spatial-relational,3|4,7,3/4,210086,3
7,2,21,87,1,1463,1,9,4,4,5,single-choice,spatial-relational,4|5,7,4/5,210087,4
7,2,21,88,1,1084,1,11,5,5,6,single-choice,spatial-relational,5|6,7,5/6,210088,5
7,2,21,89,1,1502,1,5,2,2,3,single-choice,spatial-relational,2|3,7,2/3,210089,2
7,2,21,90,1,868,1,5,2,2,3,single-choice,spatial-relational,2|3,7,2/3,210090,2
7,2,21,91,1,1536,1,9,4,4,5,single-choice,spatial-relational,4|5,7,4/5,210091,4
7,2,21,92,1,1511,1,13,6,6,7,single-choice,spatial-relational,6|7,7,6/7,210092,6
7,2,21,93,1,1712,1,7,3,3,4,single-choice,spatial-relational,3|4,7,3/4,210093,3
7,2,21,94,0,1703,1,3,1,2,2,single-choice,spatial-relational,1|2,7,1/2,210094,1
7,2,21,95,1,1102,1,11,5,5,6,single-choice,spatial-relational,5|6,7,5/6,210095,5
7,2,21,96,1,1113,1,13,6,6,7,single-choice,spatial-relational,6|7,7,6/7,210096,6
7,2,21,97,1,984,1,13,6,6,7,single-choice,spatial-relational,6|7,7,6/7,210097,6
7,2,21,98,1,1081,1,13,6,6,7,single-choice,spatial-relational,6|7,7,6/7,210098,6
7,2,21,99,1,1586,1,5,2,2,3,single-choice,spatial-relational,2|3,7,2/3,210099,2
7,2,21,100,1,1920,1,5,2,2,3,single-choice,spatial-relational,2|3,7,2/3,210100,2
7,2,21,101,1,1091,1,7,3,3,4,single-choice,spatial-relational,3|4,7,3/4,210101,3
7,2,21,102,1,2709,1,9,4,4,5,single-choice,spatial-relational,4|5,7,4/5,210102,4
7,2,21,103,1,1322,1,7,3,3,4,single-choice,spatial-relational,3|4,7,3/4,210103,3
7,2,21,104,1,1449,1,11,5,5,6,single-choice,spatial-relational,5|6,7,5/6,210104,5
7,2,21,105,0,1185,1,3,1,2,2,single-choice,spatial-relational,1|2,7,1/2,210105,1
7,2,21,106,1,1073,1,3,1,1,2,single-choice,spatial-relational,1|2,7,1/2,210106,1
7,2,21,107,0,893,1,9,4,5,5,single-choice,spatial-relational,4|5,7,4/5,210107,4
7,2,21,108,1,117,1,11,5,5,6,single-choice,spatial-relational,5|6,7,5/6,210108,5
7,2,21,109,1,1054,1,3,1,1,2,single-choice,spatial-relational,1|2,7,1/2,210109,1
7,2,21,110,1,975,1,5,2,2,3,single-choice,spatial-relational,2|3,7,2/3,210110,2
7,2,21,111,1,1038,1,3,1,1,2,single-choice,spatial-relational,1|2,7,1/2,210111,1
7,2,21,112,1,899,1,11,5,5,6,single-choice,spatial-relational,5|6,7,5/6,210112,5
7,2,21,113,1,1099,1,11,5,5,6,single-choice,spatial-relational,5|6,7,5/6,210113,5
7,2,21,114,1,1232,1,13,6,6,7,single-choice,spatial-relational,6|7,7,6/7,210114,6
7,2,21,115,1,1567,1,9,4,4,5,single-choice,spatial-relational,4|5,7,4/5,210115,4
7,2,21,116,1,1011,1,13,6,6,7,single-choice,spatial-relational,6|7,7,6/7,210116,6
7,2,21,117,0,2006,1,9,4,5,5,single-choice,spatial-relational,4|5,7,4/5,210117,4
7,2,21,118,1,1001,1,7,3,3,4,single-choice,spatial-relational,3|4,7,3/4,210118,3
7,2,21,119,1,1784,1,7,3,3,4,single-choice,spatial-relational,3|4,7,3/4,210119,3
7,2,21,120,1,1299,1,5,2,2,3,single-choice,spatial-relational,2|3,7,2/3,210120,2
7,2,21,121,0,1368,1,9,4,5,5,single-choice,spatial-relational,4|5,7,4/5,210121,4
7,2,21,122,1,1254,1,7,3,3,4,single-choice,spatial-relational,3|4,7,3/4,210122,3
7,2,21,123,1,1090,1,9,4,4,5,single-choice,spatial-relational,4|5,7,4/5,210123,4
7,2,21,124,1,1092,1,7,3,3,4,single-choice,spatial-relational,3|4,7,3/4,210124,3
7,2,21,125,0,1929,1,11,5,6,6,single-choice,spatial-relational,5|6,7,5/6,210125,5
7,2,21,126,1,841,1,13,6,6,7,single-choice,spatial-relational,6|7,7,6/7,210126,6
7,2,21,127,1,1216,1,5,2,2,3,single-choice,spatial-relational,2|3,7,2/3,210127,2
7,2,21,128,1,1041,1,5,2,2,3,single-choice,spatial-relational,2|3,7,2/3,210128,2
7,2,21,129,1,1111,1,3,1,1,2,single-choice,spatial-relational,1|2,7,1/2,210129,1
7,2,21,130,1,945,1,11,5,5,6,single-choice,spatial-relational,5|6,7,5/6,210130,5
7,2,21,131,1,1104,1,13,6,6,7,single-choice,spatial-relational,6|7,7,6/7,210131,6
7,2,21,132,0,1579,1,3,1,2,2,single-choice,spatial-relational,1|2,7,1/2,210132,1
7,2,21,133,1,904,1,13,6,6,7,single-choice,spatial-relational,6|7,7,6/7,210133,6
7,2,21,134,1,1082,1,7,3,3,4,single-choice,spatial-relational,3|4,7,3/4,210134,3
7,2,21,135,0,1708,1,9,4,5,5,single-choice,spatial-relational,4|5,7,4/5,210135,4
7,2,21,136,1,882,1,13,6,6,7,single-choice,spatial-relational,6|7,7,6/7,210136,6
7,2,21,137,0,901,1,3,1,2,2,single-choice,spatial-relational,1|2,7,1/2,210137,1
7,2,21,138,0,515,1,11,5,6,6,single-choice,spatial-relational,5|6,7,5/6,210138,5
7,2,21,139,1,1147,1,7,3,3,4,single-choice,spatial-relational,3|4,7,3/4,210139,3
7,2,21,140,1,1429,1,9,4,4,5,single-choice,spatial-relational,4|5,7,4/5,210140,4
7,2,21,141,1,1179,1,11,5,5,6,single-choice,spatial-relational,5|6,7,5/6,210141,5
7,2,21,142,1,1189,1,3,1,1,2,single-choice,spatial-relational,1|2,7,1/2,210142,1
7,2,21,143,1,1561,1,5,2,2,3,single-choice,spatial-relational,2|3,7,2/3,210143,2
7,2,21,144,1,1010,1,5,2,2,3,single-choice,spatial-relational,2|3,7,2/3,210144,2
7,2,21,145,1,1165,1,9,4,4,5,single-choice,spatial-relational,4|5,7,4/5,210145,4
7,2,21,146,1,1554,1,5,2,2,3,single-choice,spatial-relational,2|3,7,2/3,210146,2
7,2,21,147,1,1945,1,9,4,4,5,single-choice,spatial-relational,4|5,7,4/5,210147,4
7,2,21,148,1,2275,1,11,5,5,6,single-choice,spatial-relational,5|6,7,5/6,210148,5
7,2,21,149,1,1192,1,3,1,1,2,single-choice,spatial-relational,1|2,7,1/2,210149,1
7,2,21,150,1,1020,1,5,2,2,3,single-choice,spatial-relational,2|3,7,2/3,210150,2
7,2,21,151,1,975,1,7,3,3,4,single-choice,spatial-relational,3|4,7,3/4,210151,3
7,2,21,152,1,1412,1,13,6,6,7,single-choice,spatial-relational,6|7,7,6/7,210152,6
7,2,21,153,1,1093,1,13,6,6,7,single-choice,spatial-relational,6|7,7,6/7,210153,6
7,2,21,154,1,2548,1,7,3,3,4,single-choice,spatial-relational,3|4,7,3/4,210154,3
7,2,21,155,1,1194,1,11,5,5,6,single-choice,spatial-relational,5|6,7,5/6,210155,5
7,2,21,156,1,1710,1,3,1,1,2,single-choice,spatial-relational,1|2,7,1/2,210156,1
7,2,21,157,1,946,1,7,3,3,4,single-choice,spatial-relational,3|4,7,3/4,210157,3
7,2,21,158,0,1605,1,9,4,5,5,single-choice,spatial-relational,4|5,7,4/5,210158,4
7,2,21,159,1,768,1,13,6,6,7,single-choice,spatial-relational,6|7,7,6/7,210159,6
7,2,21,160,1,2283,1,11,5,5,6,single-choice,spatial-relational,5|6,7,5/6,210160,5
7,2,21,161,1,1257,1,3,1,1,2,single-choice,spatial-relational,1|2,7,1/2,210161,1
7,2,21,162,1,873,1,3,1,1,2,single-choice,spatial-relational,1|2,7,1/2,210162,1
7,2,21,163,1,992,1,7,3,3,4,single-choice,spatial-relational,3|4,7,3/4,210163,3
7,2,21,164,0,1523,1,9,4,5,5,single-choice,spatial-relational,4|5,7,4/5,210164,4
7,2,21,165,1,1057,1,5,2,2,3,single-choice,spatial-relational,2|3,7,2/3,210165,2
7,2,21,166,1,938,1,13,6,6,7,single-choice,spatial-relational,6|7,7,6/7,210166,6
7,2,21,167,1,1382,1,11,5,5,6,single-choice,spatial-relational,5|6,7,5/6,210167,5
7,2,21,168,1,1374,1,5,2,2,3,single-choice,spatial-relational,2|3,7,2/3,210168,2
7,2,21,169,1,923,1,7,3,3,4,single-choice,spatial-relational,3|4,7,3/4,210169,3
7,2,21,170,0,2169,1,11,5,6,6,single-choice,spatial-relational,5|6,7,5/6,210170,5
7,2,21,171,1,1252,1,13,6,6,7,single-choice,spatial-relational,6|7,7,6/7,210171,6
7,2,21,172,1,1072,1,9,4,4,5,single-choice,spatial-relational,4|5,7,4/5,210172,4
7,2,21,173,1,1213,1,5,2,2,3,single-choice,spatial-relational,2|3,7,2/3,210173,2
7,2,21,174,1,884,1,5,2,2,3,single-choice,spatial-relational,2|3,7,2/3,210174,2
7,2,21,175,1,1218,1,3,1,1,2,single-choice,spatial-relational,1|2,7,1/2,210175,1
7,2,21,176,0,1439,1,3,1,2,2,single-choice,spatial-relational,1|2,7,1/2,210176,1
7,2,21,177,0,781,1,11,5,6,6,single-choice,spatial-relational,5|6,7,5/6,210177,5
7,2,21,178,1,665,1,7,3,3,4,single-choice,spatial-relational,3|4,7,3/4,210178,3
7,2,21,179,1,1154,1,13,6,6,7,single-choice,spatial-relational,6|7,7,6/7,210179,6
7,2,21,180,1,1321,1,9,4,4,5,single-choice,spatial-relational,4|5,7,4/5,210180,4
7,2,21,181,1,1671,1,11,5,5,6,single-choice,spatial-relational,5|6,7,5/6,210181,5
7,2,21,182,1,1528,1,3,1,1,2,single-choice,spatial-relational,1|2,7,1/2,210182,1
7,2,21,183,1,1065,1,7,3,3,4,single-choice,spatial-relational,3|4,7,3/4,210183,3
7,2,21,184,1,2282,1,13,6,6,7,single-choice,spatial-relational,6|7,7,6/7,210184,6
7,2,21,185,1,1922,1,5,2,2,3,single-choice,spatial-relational,2|3,7,2/3,210185,2
7,2,21,186,1,1549,1,9,4,4,5,single-choice,spatial-relational,4|5,7,4/5,210186,4
7,2,21,187,1,1327,1,3,1,1,2,single-choice,spatial-relational,1|2,7,1/2,210187,1
7,2,21,188,1,1177,1,5,2,2,3,single-choice,spatial-relational,2|3,7,2/3,210188,2
7,2,21,189,1,1393,1,7,3,3,4,single-choice,spatial-relational,3|4,7,3/4,210189,3
7,2,21,190,1,1262,1,13,6,6,7,single-choice,spatial-relational,6|7,7,6/7,210190,6
7,2,21,191,1,2190,1,9,4,4,5,single-choice,spatial-relational,4|5,7,4/5,210191,4
7,2,21,192,1,1690,1,11,5,5,6,single-choice,spatial-relational,5|6,7,5/6,210192,5
7,2,21,193,1,2726,1,7,3,3,4,single-choice,spatial-relational,3|4,7,3/4,210193,3
7,2,21,194,0,1047,1,9,4,5,5,single-choice,spatial-relational,4|5,7,4/5,210194,4
7,2,21,195,1,858,1,13,6,6,7,single-choice,spatial-relational,6|7,7,6/7,210195,6
7,2,21,196,1,1214,1,5,2,2,3,single-choice,spatial-relational,2|3,7,2/3,210196,2
7,2,21,197,0,913,1,3,1,2,2,single-choice,spatial-relational,1|2,7,1/2,210197,1
7,2,21,198,1,922,1,9,4,4,5,single-choice,spatial-relational,4|5,7,4/5,210198,4
7,2,21,199,1,1238,1,3,1,1,2,single-choice,spatial-relational,1|2,7,1/2,210199,1
7,2,21,200,1,1370,1,11,5,5,6,single-choice,spatial-relational,5|6,7,5/6,210200,5
7,2,21,201,1,1362,1,13,6,6,7,single-choice,spatial-relational,6|7,7,6/7,210201,6
7,2,21,202,1,2704,1,5,2,2,3,single-choice,spatial-relational,2|3,7,2/3,210202,2
7,2,21,203,1,1220,1,7,3,3,4,single-choice,spatial-relational,3|4,7,3/4,210203,3
7,2,21,204,1,1963,1,11,5,5,6,single-choice,spatial-relational,5|6,7,5/6,210204,5
7,2,21,205,1,1967,1,5,2,2,3,single-choice,spatial-relational,2|3,7,2/3,210205,2
7,2,21,206,1,1548,1,7,3,3,4,single-choice,spatial-relational,3|4,7,3/4,210206,3
7,2,21,207,0,1117,1,9,4,5,5,single-choice,spatial-relational,4|5,7,4/5,210207,4
7,2,21,208,1,964,1,3,1,1,2,single-choice,spatial-relational,1|2,7,1/2,210208,1
7,2,21,209,1,991,1,13,6,6,7,single-choice,spatial-relational,6|7,7,6/7,210209,6
7,2,21,210,1,1281,1,5,2,2,3,single-choice,spatial-relational,2|3,7,2/3,210210,2
7,2,21,211,1,978,1,3,1,1,2,single-choice,spatial-relational,1|2,7,1/2,210211,1
7,2,21,212,1,923,1,7,3,3,4,single-choice,spatial-relational,3|4,7,3/4,210212,3
7,2,21,213,1,2548,1,9,4,4,5,single-choice,spatial-relational,4|5,7,4/5,210213,4
7,2,21,214,1,1386,1,11,5,5,6,single-choice,spatial-relational,5|6,7,5/6,210214,5
7,2,21,215,1,1117,1,13,6,6,7,single-choice,spatial-relational,6|7,7,6/7,210215,6
7,2,21,216,1,1116,1,11,5,5,6,single-choice,spatial-relational,5|6,7,5/6,210216,5
7,2,21,217,0,935,1,13,6,7,7,single-choice,spatial-relational,6|7,7,6/7,210217,6
7,2,21,218,1,658,1,3,1,1,2,single-choice,spatial-relational,1|2,7,1/2,210218,1
7,2,21,219,0,936,1,7,3,4,4,single-choice,spatial-relational,3|4,7,3/4,210219,3
7,2,21,220,1,953,1,9,4,4,5,single-choice,spatial-relational,4|5,7,4/5,210220,4
7,2,21,221,1,1275,1,11,5,5,6,single-choice,spatial-relational,5|6,7,5/6,210221,5
7,2,21,222,1,957,1,9,4,4,5,single-choice,spatial-relational,4|5,7,4/5,210222,4
7,2,21,223,1,1985,1,11,5,5,6,single-choice,spatial-relational,5|6,7,5/6,210223,5
7,2,21,224,1,1529,1,5,2,2,3,single-choice,spatial-relational,2|3,7,2/3,210224,2
7,2,21,225,1,920,1,3,1,1,2,single-choice,spatial-relational,1|2,7,1/2,210225,1
7,2,21,226,1,801,1,13,6,6,7,single-choice,spatial-relational,6|7,7,6/7,210226,6
7,2,21,227,1,2108,1,5,2,2,3,single-choice,spatial-relational,2|3,7,2/3,210227,2
7,2,21,228,1,1079,1,7,3,3,4,single-choice,spatial-relational,3|4,7,3/4,210228,3
7,2,21,229,1,1609,1,5,2,2,3,single-choice,spatial-relational,2|3,7,2/3,210229,2
7,2,21,230,1,978,1,13,6,6,7,single-choice,spatial-relational,6|7,7,6/7,210230,6
7,2,21,231,1,2523,1,5,2,2,3,single-choice,spatial-relational,2|3,7,2/3,210231,2
7,2,21,232,1,1161,1,7,3,3,4,single-choice,spatial-relational,3|4,7,3/4,210232,3
7,2,21,233,0,1276,1,3,1,2,2,single-choice,spatial-relational,1|2,7,1/2,210233,1
7,2,21,234,1,1118,1,3,1,1,2,single-choice,spatial-relational,1|2,7,1/2,210234,1
7,2,21,235,1,1114,1,11,5,5,6,single-choice,spatial-relational,5|6,7,5/6,210235,5
7,2,21,236,1,790,1,9,4,4,5,single-choice,spatial-relational,4|5,7,4/5,210236,4
7,2,21,237,0,1048,1,9,4,5,5,single-choice,spatial-relational,4|5,7,4/5,210237,4
7,2,21,238,1,768,1,13,6,6,7,single-choice,spatial-relational,6|7,7,6/7,210238,6
7,2,21,239,1,1052,1,11,5,5,6,single-choice,spatial-relational,5|6,7,5/6,210239,5
7,2,21,240,1,2852,1,7,3,3,4,single-choice,spatial-relational,3|4,7,3/4,210240,3
7,2,21,241,1,1031,1,11,5,5,6,single-choice,spatial-relational,5|6,7,5/6,210241,5
7,2,21,242,1,970,1,11,5,5,6,single-choice,spatial-relational,5|6,7,5/6,210242,5
7,2,21,243,1,1356,1,9,4,4,5,single-choice,spatial-relational,4|5,7,4/5,210243,4
7,2,21,244,1,1171,1,5,2,2,3,single-choice,spatial-relational,2|3,7,2/3,210244,2
7,2,21,245,1,1197,1,9,4,4,5,single-choice,spatial-relational,4|5,7,4/5,210245,4
7,2,21,246,1,884,1,7,3,3,4,single-choice,spatial-relational,3|4,7,3/4,210246,3
7,2,21,247,1,870,1,7,3,3,4,single-choice,spatial-relational,3|4,7,3/4,210247,3
7,2,21,248,1,1189,1,5,2,2,3,single-choice,spatial-relational,2|3,7,2/3,210248,2
7,2,21,249,1,1018,1,13,6,6,7,single-choice,spatial-relational,6|7,7,6/7,210249,6
7,2,21,250,0,978,1,3,1,2,2,single-choice,spatial-relational,1|2,7,1/2,210250,1
7,2,21,251,0,681,1,3,1,2,2,single-choice,spatial-relational,1|2,7,1/2,210251,1
7,2,21,252,1,922,1,13,6,6,7,single-choice,spatial-relational,6|7,7,6/7,210252,6
7,2,21,253,1,1169,1,5,2,2,3,single-choice,spatial-relational,2|3,7,2/3,210253,2
7,2,21,254,1,1135,1,9,4,4,5,single-choice,spatial-relational,4|5,7,4/5,210254,4
7,2,21,255,1,1024,1,11,5,5,6,single-choice,spatial-relational,5|6,7,5/6,210255,5
7,2,21,256,1,1238,1,9,4,4,5,single-choice,spatial-relational,4|5,7,4/5,210256,4
7,2,21,257,0,1910,1,5,2,3,3,single-choice,spatial-relational,2|3,7,2/3,210257,2
7,2,21,258,1,991,1,13,6,6,7,single-choice,spatial-relational,6|7,7,6/7,210258,6
7,2,21,259,1,1091,1,7,3,3,4,single-choice,spatial-relational,3|4,7,3/4,210259,3
7,2,21,260,1,1231,1,3,1,1,2,single-choice,spatial-relational,1|2,7,1/2,210260,1
7,2,21,261,1,926,1,13,6,6,7,single-choice,spatial-relational,6|7,7,6/7,210261,6
7,2,21,262,1,2450,1,7,3,3,4,single-choice,spatial-relational,3|4,7,3/4,210262,3
7,2,21,263,1,1897,1,3,1,1,2,single-choice,spatial-relational,1|2,7,1/2,210263,1
7,2,21,264,1,1530,1,11,5,5,6,single-choice,spatial-relational,5|6,7,5/6,210264,5
7,2,21,265,1,900,1,11,5,5,6,single-choice,spatial-relational,5|6,7,5/6,210265,5
7,2,21,266,1,1330,1,11,5,5,6,single-choice,spatial-relational,5|6,7,5/6,210266,5
7,2,21,267,1,927,1,13,6,6,7,single-choice,spatial-relational,6|7,7,6/7,210267,6
7,2,21,268,1,1726,1,3,1,1,2,single-choice,spatial-relational,1|2,7,1/2,210268,1
7,2,21,269,1,1420,1,5,2,2,3,single-choice,spatial-relational,2|3,7,2/3,210269,2
7,2,21,270,1,923,1,7,3,3,4,single-choice,spatial-relational,3|4,7,3/4,210270,3
7,2,21,271,1,1366,1,3,1,1,2,single-choice,spatial-relational,1|2,7,1/2,210271,1
7,2,21,272,1,1083,1,5,2,2,3,single-choice,spatial-relational,2|3,7,2/3,210272,2
7,2,21,273,1,1010,1,9,4,4,5,single-choice,spatial-relational,4|5,7,4/5,210273,4
7,2,21,274,1,917,1,13,6,6,7,single-choice,spatial-relational,6|7,7,6/7,210274,6
7,2,21,275,1,2561,1,7,3,3,4,single-choice,spatial-relational,3|4,7,3/4,210275,3
7,2,21,276,0,815,1,9,4,5,5,single-choice,spatial-relational,4|5,7,4/5,210276,4
7,2,21,277,1,845,1,9,4,4,5,single-choice,spatial-relational,4|5,7,4/5,210277,4
7,2,21,278,1,1327,1,5,2,2,3,single-choice,spatial-relational,2|3,7,2/3,210278,2
7,2,21,279,1,966,1,13,6,6,7,single-choice,spatial-relational,6|7,7,6/7,210279,6
7,2,21,280,1,830,1,7,3,3,4,single-choice,spatial-relational,3|4,7,3/4,210280,3
7,2,21,281,0,2043,1,3,1,2,2,single-choice,spatial-relational,1|2,7,1/2,210281,1
7,2,21,282,1,1014,1,11,5,5,6,single-choice,spatial-relational,5|6,7,5/6,210282,5
7,2,21,283,1,1293,1,13,6,6,7,single-choice,spatial-relational,6|7,7,6/7,210283,6
7,2,21,284,1,943,1,5,2,2,3,single-choice,spatial-relational,2|3,7,2/3,210284,2
7,2,21,285,1,1253,1,7,3,3,4,single-choice,spatial-relational,3|4,7,3/4,210285,3
7,2,21,286,0,1033,1,3,1,2,2,single-choice,spatial-relational,1|2,7,1/2,210286,1
7,2,21,287,1,1053,1,11,5,5,6,single-choice,spatial-relational,5|6,7,5/6,210287,5
7,2,21,288,1,1319,1,9,4,4,5,single-choice,spatial-relational,4|5,7,4/5,210288,4
7,2,21,289,1,1189,1,11,5,5,6,single-choice,spatial-relational,5|6,7,5/6,210289,5
7,2,21,290,1,1210,1,5,2,2,3,single-choice,spatial-relational,2|3,7,2/3,210290,2
7,2,21,291,1,839,1,7,3,3,4,single-choice,spatial-relational,3|4,7,3/4,210291,3
7,2,21,292,1,1418,1,3,1,1,2,single-choice,spatial-relational,1|2,7,1/2,210292,1
7,2,21,293,1,937,1,11,5,5,6,single-choice,spatial-relational,5|6,7,5/6,210293,5
7,2,21,294,1,1460,1,9,4,4,5,single-choice,spatial-relational,4|5,7,4/5,210294,4
7,2,21,295,1,1303,1,13,6,6,7,single-choice,spatial-relational,6|7,7,6/7,210295,6
7,2,21,296,1,1508,1,3,1,1,2,single-choice,spatial-relational,1|2,7,1/2,210296,1
7,2,21,297,1,878,1,13,6,6,7,single-choice,spatial-relational,6|7,7,6/7,210297,6
7,2,21,298,0,1634,1,5,2,3,3,single-choice,spatial-relational,2|3,7,2/3,210298,2
7,2,21,299,1,860,1,7,3,3,4,single-choice,spatial-relational,3|4,7,3/4,210299,3
7,2,21,300,1,1258,1,9,4,4,5,single-choice,spatial-relational,4|5,7,4/5,210300,4
7,2,21,301,0,775,1,5,2,3,3,single-choice,spatial-relational,2|3,7,2/3,210301,2
7,2,21,302,0,491,1,11,5,6,6,single-choice,spatial-relational,5|6,7,5/6,210302,5
7,2,21,303,1,849,1,3,1,1,2,single-choice,spatial-relational,1|2,7,1/2,210303,1
7,2,21,304,1,990,1,7,3,3,4,single-choice,spatial-relational,3|4,7,3/4,210304,3
7,2,21,305,1,1727,1,9,4,4,5,single-choice,spatial-relational,4|5,7,4/5,210305,4
7,2,21,306,1,1383,1,5,2,2,3,single-choice,spatial-relational,2|3,7,2/3,210306,2
7,2,21,307,0,1143,1,11,5,6,6,single-choice,spatial-relational,5|6,7,5/6,210307,5
7,2,21,308,1,707,1,13,6,6,7,single-choice,spatial-relational,6|7,7,6/7,210308,6
7,2,21,309,1,1436,1,7,3,3,4,single-choice,spatial-relational,3|4,7,3/4,210309,3
7,2,21,310,0,1161,1,9,4,5,5,single-choice,spatial-relational,4|5,7,4/5,210310,4
7,2,21,311,1,731,1,3,1,1,2,single-choice,spatial-relational,1|2,7,1/2,210311,1
7,2,21,312,1,899,1,13,6,6,7,single-choice,spatial-relational,6|7,7,6/7,210312,6
7,2,21,313,0,1201,1,3,1,2,2,single-choice,spatial-relational,1|2,7,1/2,210313,1
7,2,21,314,1,803,1,3,1,1,2,single-choice,spatial-relational,1|2,7,1/2,210314,1
7,2,21,315,1,889,1,5,2,2,3,single-choice,spatial-relational,2|3,7,2/3,210315,2
7,2,21,316,1,1068,1,7,3,3,4,single-choice,spatial-relational,3|4,7,3/4,210316,3
7,2,21,317,1,1450,1,11,5,5,6,single-choice,spatial-relational,5|6,7,5/6,210317,5
7,2,21,318,1,1396,1,5,2,2,3,single-choice,spatial-relational,2|3,7,2/3,210318,2
7,2,21,319,1,1331,1,9,4,4,5,single-choice,spatial-relational,4|5,7,4/5,210319,4
7,2,21,320,0,1018,1,11,5,6,6,single-choice,spatial-relational,5|6,7,5/6,210320,5
7,2,21,321,0,546,1,7,3,4,4,single-choice,spatial-relational,3|4,7,3/4,210321,3
7,2,21,322,1,948,1,13,6,6,7,single-choice,spatial-relational,6|7,7,6/7,210322,6
7,2,21,323,1,1052,1,13,6,6,7,single-choice,spatial-relational,6|7,7,6/7,210323,6
7,2,21,324,1,1103,1,9,4,4,5,single-choice,spatial-relational,4|5,7,4/5,210324,4
7,2,21,325,1,1591,1,9,4,4,5,single-choice,spatial-relational,4|5,7,4/5,210325,4
7,2,21,326,1,1039,1,13,6,6,7,single-choice,spatial-relational,6|7,7,6/7,210326,6
7,2,21,327,0,1493,1,7,3,4,4,single-choice,spatial-relational,3|4,7,3/4,210327,3
7,2,21,328,1,1155,1,7,3,3,4,single-choice,spatial-relational,3|4,7,3/4,210328,3
7,2,21,329,1,1107,1,11,5,5,6,single-choice,spatial-relational,5|6,7,5/6,210329,5
7,2,21,330,1,1090,1,5,2,2,3,single-choice,spatial-relational,2|3,7,2/3,210330,2
7,2,21,331,1,2100,1,3,1,1,2,single-choice,spatial-relational,1|2,7,1/2,210331,1
7,2,21,332,0,1657,1,9,4,5,5,single-choice,spatial-relational,4|5,7,4/5,210332,4
7,2,21,333,1,926,1,13,6,6,7,single-choice,spatial-relational,6|7,7,6/7,210333,6
7,2,21,334,0,1792,1,5,2,3,3,single-choice,spatial-relational,2|3,7,2/3,210334,2
7,2,21,335,0,508,1,11,5,6,6,single-choice,spatial-relational,5|6,7,5/6,210335,5
7,2,21,336,0,1661,1,3,1,2,2,single-choice,spatial-relational,1|2,7,1/2,210336,1
7,2,21,337,1,793,1,9,4,4,5,single-choice,spatial-relational,4|5,7,4/5,210337,4
7,2,21,338,0,1913,1,5,2,3,3,single-choice,spatial-relational,2|3,7,2/3,210338,2
7,2,21,339,1,1069,1,5,2,2,3,single-choice,spatial-relational,2|3,7,2/3,210339,2
7,2,21,340,1,1087,1,7,3,3,4,single-choice,spatial-relational,3|4,7,3/4,210340,3
7,2,21,341,1,1170,1,3,1,1,2,single-choice,spatial-relational,1|2,7,1/2,210341,1
7,2,21,342,1,935,1,13,6,6,7,single-choice,spatial-relational,6|7,7,6/7,210342,6
7,2,21,343,1,2394,1,13,6,6,7,single-choice,spatial-relational,6|7,7,6/7,210343,6
7,2,21,344,1,2611,1,11,5,5,6,single-choice,spatial-relational,5|6,7,5/6,210344,5
7,2,21,345,1,1173,1,3,1,1,2,single-choice,spatial-relational,1|2,7,1/2,210345,1
7,2,21,346,1,1079,1,9,4,4,5,single-choice,spatial-relational,4|5,7,4/5,210346,4
7,2,21,347,1,1064,1,7,3,3,4,single-choice,spatial-relational,3|4,7,3/4,210347,3
7,2,21,348,0,1095,1,11,5,6,6,single-choice,spatial-relational,5|6,7,5/6,210348,5
7,2,21,349,1,882,1,7,3,3,4,single-choice,spatial-relational,3|4,7,3/4,210349,3
7,2,21,350,1,1299,1,11,5,5,6,single-choice,spatial-relational,5|6,7,5/6,210350,5
7,2,21,351,1,986,1,9,4,4,5,single-choice,spatial-relational,4|5,7,4/5,210351,4
7,2,21,352,0,79,1,3,1,2,2,single-choice,spatial-relational,1|2,7,1/2,210352,1
7,2,21,353,1,983,1,5,2,2,3,single-choice,spatial-relational,2|3,7,2/3,210353,2
7,2,21,354,1,986,1,5,2,2,3,single-choice,spatial-relational,2|3,7,2/3,210354,2
7,2,21,355,1,1432,1,7,3,3,4,single-choice,spatial-relational,3|4,7,3/4,210355,3
7,2,21,356,1,1163,1,11,5,5,6,single-choice,spatial-relational,5|6,7,5/6,210356,5
7,2,21,357,1,1030,1,13,6,6,7,single-choice,spatial-relational,6|7,7,6/7,210357,6
7,2,21,358,1,2554,1,9,4,4,5,single-choice,spatial-relational,4|5,7,4/5,210358,4
7,2,21,359,1,1687,1,3,1,1,2,single-choice,spatial-relational,1|2,7,1/2,210359,1
7,2,21,360,1,831,1,13,6,6,7,single-choice,spatial-relational,6|7,7,6/7,210360,6
7,2,21,361,1,1339,1,9,4,4,5,single-choice,spatial-relational,4|5,7,4/5,210361,4
7,2,21,362,1,2317,1,9,4,4,5,single-choice,spatial-relational,4|5,7,4/5,210362,4
7,2,21,363,1,1268,1,3,1,1,2,single-choice,spatial-relational,1|2,7,1/2,210363,1
7,2,21,364,1,951,1,5,2,2,3,single-choice,spatial-relational,2|3,7,2/3,210364,2
7,2,21,365,0,1719,1,5,2,3,3,single-choice,spatial-relational,2|3,7,2/3,210365,2
7,2,21,366,1,881,1,7,3,3,4,single-choice,spatial-relational,3|4,7,3/4,210366,3
7,2,21,367,1,1562,1,13,6,6,7,single-choice,spatial-relational,6|7,7,6/7,210367,6
7,2,21,368,1,1272,1,13,6,6,7,single-choice,spatial-relational,6|7,7,6/7,210368,6
7,2,21,369,1,1320,1,11,5,5,6,single-choice,spatial-relational,5|6,7,5/6,210369,5
7,2,21,370,0,1486,1,3,1,2,2,single-choice,spatial-relational,1|2,7,1/2,210370,1
7,2,21,371,1,765,1,11,5,5,6,single-choice,spatial-relational,5|6,7,5/6,210371,5
7,2,21,372,1,1672,1,7,3,3,4,single-choice,spatial-relational,3|4,7,3/4,210372,3
7,2,21,373,1,1028,1,11,5,5,6,single-choice,spatial-relational,5|6,7,5/6,210373,5
7,2,21,374,0,1170,1,3,1,2,2,single-choice,spatial-relational,1|2,7,1/2,210374,1
7,2,21,375,1,984,1,9,4,4,5,single-choice,spatial-relational,4|5,7,4/5,210375,4
7,2,21,376,1,1988,1,5,2,2,3,single-choice,spatial-relational,2|3,7,2/3,210376,2
7,2,21,377,1,791,1,11,5,5,6,single-choice,spatial-relational,5|6,7,5/6,210377,5
7,2,21,378,1,1488,1,5,2,2,3,single-choice,spatial-relational,2|3,7,2/3,210378,2
7,2,21,379,1,1031,1,9,4,4,5,single-choice,spatial-relational,4|5,7,4/5,210379,4
7,2,21,380,1,925,1,13,6,6,7,single-choice,spatial-relational,6|7,7,6/7,210380,6
7,2,21,381,1,1101,1,7,3,3,4,single-choice,spatial-relational,3|4,7,3/4,210381,3
7,2,21,382,1,1316,1,3,1,1,2,single-choice,spatial-relational,1|2,7,1/2,210382,1
7,2,21,383,1,736,1,7,3,3,4,single-choice,spatial-relational,3|4,7,3/4,210383,3
7,2,21,384,1,949,1,13,6,6,7,single-choice,spatial-relational,6|7,7,6/7,210384,6
7,2,21,385,1,2821,1,11,5,5,6,single-choice,spatial-relational,5|6,7,5/6,210385,5
7,2,21,386,1,2247,1,5,2,2,3,single-choice,spatial-relational,2|3,7,2/3,210386,2
7,2,21,387,1,1201,1,3,1,1,2,single-choice,spatial-relational,1|2,7,1/2,210387,1
7,2,21,388,1,879,1,13,6,6,7,single-choice,spatial-relational,6|7,7,6/7,210388,6
7,2,21,389,1,1766,1,7,3,3,4,single-choice,spatial-relational,3|4,7,3/4,210389,3
7,2,21,390,1,1758,1,9,4,4,5,single-choice,spatial-relational,4|5,7,4/5,210390,4
7,2,21,391,1,997,1,7,3,3,4,single-choice,spatial-relational,3|4,7,3/4,210391,3
7,2,21,392,1,1486,1,11,5,5,6,single-choice,spatial-relational,5|6,7,5/6,210392,5
7,2,21,393,1,1238,1,13,6,6,7,single-choice,spatial-relational,6|7,7,6/7,210393,6
7,2,21,394,1,1405,1,5,2,2,3,single-choice,spatial-relational,2|3,7,2/3,210394,2
7,2,21,395,0,1870,1,3,1,2,2,single-choice,spatial-relational,1|2,7,1/2,210395,1
7,2,21,396,1,977,1,9,4,4,5,single-choice,spatial-relational,4|5,7,4/5,210396,4
7,2,21,397,0,2099,1,9,4,5,5,single-choice,spatial-relational,4|5,7,4/5,210397,4
7,2,21,398,1,920,1,5,2,2,3,single-choice,spatial-relational,2|3,7,2/3,210398,2
7,2,21,399,1,1058,1,7,3,3,4,single-choice,spatial-relational,3|4,7,3/4,210399,3
7,2,21,400,1,1997,1,13,6,6,7,single-choice,spatial-relational,6|7,7,6/7,210400,6
7,2,21,401,1,881,1,7,3,3,4,single-choice,spatial-relational,3|4,7,3/4,210401,3
7,2,21,402,1,1671,1,9,4,4,5,single-choice,spatial-relational,4|5,7,4/5,210402,4
7,2,21,403,1,1032,1,13,6,6,7,single-choice,spatial-relational,6|7,7,6/7,210403,6
7,2,21,404,1,1522,1,3,1,1,2,single-choice,spatial-relational,1|2,7,1/2,210404,1
7,2,21,405,1,1542,1,11,5,5,6,single-choice,spatial-relational,5|6,7,5/6,210405,5
7,2,21,406,1,2624,1,5,2,2,3,single-choice,spatial-relational,2|3,7,2/3,210406,2
7,2,21,407,1,910,1,3,1,1,2,single-choice,spatial-relational,1|2,7,1/2,210407,1
7,2,21,408,1,776,1,11,5,5,6,single-choice,spatial-relational,5|6,7,5/6,210408,5
7,2,21,409,1,1083,1,7,3,3,4,single-choice,spatial-relational,3|4,7,3/4,210409,3
7,2,21,410,1,1344,1,13,6,6,7,single-choice,spatial-relational,6|7,7,6/7,210410,6
7,2,21,411,1,2096,1,5,2,2,3,single-choice,spatial-relational,2|3,7,2/3,210411,2
7,2,21,412,1,1892,1,9,4,4,5,single-choice,spatial-relational,4|5,7,4/5,210412,4
7,2,21,413,0,2212,1,11,5,6,6,single-choice,spatial-relational,5|6,7,5/6,210413,5
7,2,21,414,1,628,1,13,6,6,7,single-choice,spatial-relational,6|7,7,6/7,210414,6
7,2,21,415,1,1396,1,5,2,2,3,single-choice,spatial-relational,2|3,7,2/3,210415,2
7,2,21,416,1,1295,1,9,4,4,5,single-choice,spatial-relational,4|5,7,4/5,210416,4
7,2,21,417,0,1642,1,11,5,6,6,single-choice,spatial-relational,5|6,7,5/6,210417,5
7,2,21,418,1,902,1,3,1,1,2,single-choice,spatial-relational,1|2,7,1/2,210418,1
7,2,21,419,1,751,1,7,3,3,4,single-choice,spatial-relational,3|4,7,3/4,210419,3
7,2,21,420,1,1427,1,3,1,1,2,single-choice,spatial-relational,1|2,7,1/2,210420,1
7,2,21,421,1,899,1,7,3,3,4,single-choice,spatial-relational,3|4,7,3/4,210421,3
7,2,21,422,1,1137,1,9,4,4,5,single-choice,spatial-relational,4|5,7,4/5,210422,4
7,2,21,423,1,1195,1,13,6,6,7,single-choice,spatial-relational,6|7,7,6/7,210423,6
7,2,21,424,1,3298,1,5,2,2,3,single-choice,spatial-relational,2|3,7,2/3,210424,2
7,2,21,425,1,918,1,13,6,6,7,single-choice,spatial-relational,6|7,7,6/7,210425,6
7,2,21,426,1,1065,1,3,1,1,2,single-choice,spatial-relational,1|2,7,1/2,210426,1
7,2,21,427,1,1466,1,9,4,4,5,single-choice,spatial-relational,4|5,7,4/5,210427,4
7,2,21,428,1,1268,1,5,2,2,3,single-choice,spatial-relational,2|3,7,2/3,210428,2
7,2,21,429,1,1070,1,3,1,1,2,single-choice,spatial-relational,1|2,7,1/2,210429,1
7,2,21,430,1,1404,1,11,5,5,6,single-choice,spatial-relational,5|6,7,5/6,210430,5
7,2,21,431,1,1342,1,7,3,3,4,single-choice,spatial-relational,3|4,7,3/4,210431,3
7,2,21,432,1,912,1,11,5,5,6,single-choice,spatial-relational,5|6,7,5/6,210432,5
7,2,21,433,1,1482,1,13,6,6,7,single-choice,spatial-relational,6|7,7,6/7,210433,6
7,2,21,434,1,1315,1,9,4,4,5,single-choice,spatial-relational,4|5,7,4/5,210434,4
7,2,21,435,1,1037,1,13,6,6,7,single-choice,spatial-relational,6|7,7,6/7,210435,6
7,2,21,436,1,959,1,9,4,4,5,single-choice,spatial-relational,4|5,7,4/5,210436,4
7,2,21,437,1,1012,1,11,5,5,6,single-choice,spatial-relational,5|6,7,5/6,210437,5
7,2,21,438,1,1026,1,7,3,3,4,single-choice,spatial-relational,3|4,7,3/4,210438,3
7,2,21,439,1,803,1,7,3,3,4,single-choice,spatial-relational,3|4,7,3/4,210439,3
7,2,21,440,1,1157,1,3,1,1,2,single-choice,spatial-relational,1|2,7,1/2,210440,1
7,2,21,441,1,1221,1,5,2,2,3,single-choice,spatial-relational,2|3,7,2/3,210441,2
7,2,21,442,1,1359,1,5,2,2,3,single-choice,spatial-relational,2|3,7,2/3,210442,2
7,2,21,443,0,909,1,3,1,2,2,single-choice,spatial-relational,1|2,7,1/2,210443,1
7,2,21,444,0,942,1,11,5,6,6,single-choice,spatial-relational,5|6,7,5/6,210444,5
7,2,21,445,1,862,1,11,5,5,6,single-choice,spatial-relational,5|6,7,5/6,210445,5
7,2,21,446,1,1625,1,13,6,6,7,single-choice,spatial-relational,6|7,7,6/7,210446,6
7,2,21,447,1,966,1,7,3,3,4,single-choice,spatial-relational,3|4,7,3/4,210447,3
7,2,21,448,1,934,1,11,5,5,6,single-choice,spatial-relational,5|6,7,5/6,210448,5
7,2,21,449,1,2759,1,3,1,1,2,single-choice,spatial-relational,1|2,7,1/2,210449,1
7,2,21,450,0,560,1,5,2,3,3,single-choice,spatial-relational,2|3,7,2/3,210450,2
7,2,21,451,1,889,1,9,4,4,5,single-choice,spatial-relational,4|5,7,4/5,210451,4
7,2,21,452,1,1235,1,3,1,1,2,single-choice,spatial-relational,1|2,7,1/2,210452,1
7,2,21,453,1,970,1,13,6,6,7,single-choice,spatial-relational,6|7,7,6/7,210453,6
7,2,21,454,1,1032,1,7,3,3,4,single-choice,spatial-relational,3|4,7,3/4,210454,3
7,2,21,455,1,930,1,9,4,4,5,single-choice,spatial-relational,4|5,7,4/5,210455,4
7,2,21,456,1,1082,1,5,2,2,3,single-choice,spatial-relational,2|3,7,2/3,210456,2
7,2,21,457,1,952,1,13,6,6,7,single-choice,spatial-relational,6|7,7,6/7,210457,6
7,2,21,458,0,793,1,3,1,2,2,single-choice,spatial-relational,1|2,7,1/2,210458,1
7,2,21,459,1,894,1,7,3,3,4,single-choice,spatial-relational,3|4,7,3/4,210459,3
7,2,21,460,1,1317,1,9,4,4,5,single-choice,spatial-relational,4|5,7,4/5,210460,4
7,2,21,461,0,900,1,3,1,2,2,single-choice,spatial-relational,1|2,7,1/2,210461,1
7,2,21,462,1,816,1,11,5,5,6,single-choice,spatial-relational,5|6,7,5/6,210462,5
7,2,21,463,1,1073,1,13,6,6,7,single-choice,spatial-relational,6|7,7,6/7,210463,6
7,2,21,464,0,1525,1,5,2,3,3,single-choice,spatial-relational,2|3,7,2/3,210464,2
7,2,21,465,1,1035,1,9,4,4,5,single-choice,spatial-relational,4|5,7,4/5,210465,4
7,2,21,466,1,1498,1,7,3,3,4,single-choice,spatial-relational,3|4,7,3/4,210466,3
7,2,21,467,1,1220,1,5,2,2,3,single-choice,spatial-relational,2|3,7,2/3,210467,2
7,2,21,468,1,987,1,11,5,5,6,single-choice,spatial-relational,5|6,7,5/6,210468,5
7,2,21,469,1,1130,1,7,3,3,4,single-choice,spatial-relational,3|4,7,3/4,210469,3
7,2,21,470,1,1054,1,7,3,3,4,single-choice,spatial-relational,3|4,7,3/4,210470,3
7,2,21,471,1,1122,1,3,1,1,2,single-choice,spatial-relational,1|2,7,1/2,210471,1
7,2,21,472,1,895,1,11,5,5,6,single-choice,spatial-relational,5|6,7,5/6,210472,5
7,2,21,473,1,1041,1,13,6,6,7,single-choice,spatial-relational,6|7,7,6/7,210473,6
7,2,21,474,1,943,1,5,2,2,3,single-choice,spatial-relational,2|3,7,2/3,210474,2
7,2,21,475,1,1093,1,11,5,5,6,single-choice,spatial-relational,5|6,7,5/6,210475,5
7,2,21,476,1,1199,1,9,4,4,5,single-choice,spatial-relational,4|5,7,4/5,210476,4
7,2,21,477,1,962,1,13,6,6,7,single-choice,spatial-relational,6|7,7,6/7,210477,6
7,2,21,478,1,982,1,3,1,1,2,single-choice,spatial-relational,1|2,7,1/2,210478,1
7,2,21,479,0,1189,1,9,4,5,5,single-choice,spatial-relational,4|5,7,4/5,210479,4
7,2,21,480,1,1201,1,5,2,2,3,single-choice,spatial-relational,2|3,7,2/3,210480,2
7,2,21,481,1,865,1,5,2,2,3,single-choice,spatial-relational,2|3,7,2/3,210481,2
7,2,21,482,1,1067,1,11,5,5,6,single-choice,spatial-relational,5|6,7,5/6,210482,5
7,2,21,483,1,1730,1,9,4,4,5,single-choice,spatial-relational,4|5,7,4/5,210483,4
7,2,21,484,0,1018,1,3,1,2,2,single-choice,spatial-relational,1|2,7,1/2,210484,1
7,2,21,485,1,1099,1,7,3,3,4,single-choice,spatial-relational,3|4,7,3/4,210485,3
7,2,21,486,1,795,1,7,3,3,4,single-choice,spatial-relational,3|4,7,3/4,210486,3
7,2,21,487,1,1089,1,3,1,1,2,single-choice,spatial-relational,1|2,7,1/2,210487,1
7,2,21,488,1,1009,1,5,2,2,3,single-choice,spatial-relational,2|3,7,2/3,210488,2
7,2,21,489,1,790,1,11,5,5,6,single-choice,spatial-relational,5|6,7,5/6,210489,5
7,2,21,490,1,1208,1,13,6,6,7,single-choice,spatial-relational,6|7,7,6/7,210490,6
7,2,21,491,1,1307,1,13,6,6,7,single-choice,spatial-relational,6|7,7,6/7,210491,6
7,2,21,492,1,1223,1,9,4,4,5,single-choice,spatial-relational,4|5,7,4/5,210492,4
7,2,21,493,1,1210,1,13,6,6,7,single-choice,spatial-relational,6|7,7,6/7,210493,6
7,2,21,494,0,3152,1,9,4,5,5,single-choice,spatial-relational,4|5,7,4/5,210494,4
7,2,21,495,1,1711,1,3,1,1,2,single-choice,spatial-relational,1|2,7,1/2,210495,1
7,2,21,496,1,792,1,3,1,1,2,single-choice,spatial-relational,1|2,7,1/2,210496,1
7,2,21,497,1,884,1,13,6,6,7,single-choice,spatial-relational,6|7,7,6/7,210497,6
7,2,21,498,1,1827,1,11,5,5,6,single-choice,spatial-relational,5|6,7,5/6,210498,5
7,2,21,499,1,1307,1,9,4,4,5,single-choice,spatial-relational,4|5,7,4/5,210499,4
7,2,21,500,0,1692,1,11,5,6,6,single-choice,spatial-relational,5|6,7,5/6,210500,5
7,2,21,501,1,1199,1,7,3,3,4,single-choice,spatial-relational,3|4,7,3/4,210501,3
7,2,21,502,1,888,1,5,2,2,3,single-choice,spatial-relational,2|3,7,2/3,210502,2
7,2,21,503,1,837,1,5,2,2,3,single-choice,spatial-relational,2|3,7,2/3,210503,2
7,2,21,504,1,1141,1,7,3,3,4,single-choice,spatial-relational,3|4,7,3/4,210504,3
7,2,21,505,1,1428,1,5,2,2,3,single-choice,spatial-relational,2|3,7,2/3,210505,2
7,2,21,506,1,1087,1,3,1,1,2,single-choice,spatial-relational,1|2,7,1/2,210506,1
7,2,21,507,1,831,1,11,5,5,6,single-choice,spatial-relational,5|6,7,5/6,210507,5
7,2,21,508,1,1207,1,7,3,3,4,single-choice,spatial-relational,3|4,7,3/4,210508,3
7,2,21,509,1,1320,1,5,2,2,3,single-choice,spatial-relational,2|3,7,2/3,210509,2
7,2,21,510,0,1336,1,9,4,5,5,single-choice,spatial-relational,4|5,7,4/5,210510,4
7,2,21,511,1,1189,1,11,5,5,6,single-choice,spatial-relational,5|6,7,5/6,210511,5
7,2,21,512,0,1526,1,3,1,2,2,single-choice,spatial-relational,1|2,7,1/2,210512,1
7,2,21,513,1,871,1,9,4,4,5,single-choice,spatial-relational,4|5,7,4/5,210513,4
7,2,21,514,1,852,1,13,6,6,7,single-choice,spatial-relational,6|7,7,6/7,210514,6
7,2,21,515,1,1069,1,13,6,6,7,single-choice,spatial-relational,6|7,7,6/7,210515,6
7,2,21,516,1,823,1,7,3,3,4,single-choice,spatial-relational,3|4,7,3/4,210516,3
7,2,21,517,1,904,1,7,3,3,4,single-choice,spatial-relational,3|4,7,3/4,210517,3
7,2,21,518,1,834,1,13,6,6,7,single-choice,spatial-relational,6|7,7,6/7,210518,6
7,2,21,519,1,1010,1,11,5,5,6,single-choice,spatial-relational,5|6,7,5/6,210519,5
7,2,21,520,0,2073,1,3,1,2,2,single-choice,spatial-relational,1|2,7,1/2,210520,1
7,2,21,521,1,1181,1,13,6,6,7,single-choice,spatial-relational,6|7,7,6/7,210521,6
7,2,21,522,1,1024,1,7,3,3,4,single-choice,spatial-relational,3|4,7,3/4,210522,3
7,2,21,523,0,1231,1,5,2,3,3,single-choice,spatial-relational,2|3,7,2/3,210523,2
7,2,21,524,1,997,1,9,4,4,5,single-choice,spatial-relational,4|5,7,4/5,210524,4
7,2,21,525,1,1197,1,11,5,5,6,single-choice,spatial-relational,5|6,7,5/6,210525,5
7,2,21,526,1,1091,1,3,1,1,2,single-choice,spatial-relational,1|2,7,1/2,210526,1
7,2,21,527,1,1238,1,9,4,4,5,single-choice,spatial-relational,4|5,7,4/5,210527,4
7,2,21,528,0,719,1,5,2,3,3,single-choice,spatial-relational,2|3,7,2/3,210528,2
7,2,21,529,1,713,1,11,5,5,6,single-choice,spatial-relational,5|6,7,5/6,210529,5
7,2,21,530,1,1613,1,13,6,6,7,single-choice,spatial-relational,6|7,7,6/7,210530,6
7,2,21,531,0,1229,1,3,1,2,2,single-choice,spatial-relational,1|2,7,1/2,210531,1
7,2,21,532,1,732,1,13,6,6,7,single-choice,spatial-relational,6|7,7,6/7,210532,6
7,2,21,533,1,1130,1,11,5,5,6,single-choice,spatial-relational,5|6,7,5/6,210533,5
7,2,21,534,1,1338,1,7,3,3,4,single-choice,spatial-relational,3|4,7,3/4,210534,3
7,2,21,535,1,1344,1,9,4,4,5,single-choice,spatial-relational,4|5,7,4/5,210535,4
7,2,21,536,1,862,1,7,3,3,4,single-choice,spatial-relational,3|4,7,3/4,210536,3
7,2,21,537,1,1756,1,9,4,4,5,single-choice,spatial-relational,4|5,7,4/5,210537,4
7,2,21,538,0,998,1,3,1,2,2,single-choice,spatial-relational,1|2,7,1/2,210538,1
7,2,21,539,1,1160,1,5,2,2,3,single-choice,spatial-relational,2|3,7,2/3,210539,2
7,2,21,540,1,1083,1,5,2,2,3,single-choice,spatial-relational,2|3,7,2/3,210540,2
7,2,21,541,1,988,1,3,1,1,2,single-choice,spatial-relational,1|2,7,1/2,210541,1
7,2,21,542,0,1379,1,11,5,6,6,single-choice,spatial-relational,5|6,7,5/6,210542,5
7,2,21,543,1,1135,1,5,2,2,3,single-choice,spatial-relational,2|3,7,2/3,210543,2
7,2,21,544,1,922,1,7,3,3,4,single-choice,spatial-relational,3|4,7,3/4,210544,3
7,2,21,545,1,1176,1,9,4,4,5,single-choice,spatial-relational,4|5,7,4/5,210545,4
7,2,21,546,1,1111,1,11,5,5,6,single-choice,spatial-relational,5|6,7,5/6,210546,5
7,2,21,547,0,869,1,3,1,2,2,single-choice,spatial-relational,1|2,7,1/2,210547,1
7,2,21,548,1,1817,1,5,2,2,3,single-choice,spatial-relational,2|3,7,2/3,210548,2
7,2,21,549,1,1047,1,7,3,3,4,single-choice,spatial-relational,3|4,7,3/4,210549,3
7,2,21,550,0,1379,1,9,4,5,5,single-choice,spatial-relational,4|5,7,4/5,210550,4
7,2,21,551,1,818,1,13,6,6,7,single-choice,spatial-relational,6|7,7,6/7,210551,6
7,2,21,552,1,1238,1,13,6,6,7,single-choice,spatial-relational,6|7,7,6/7,210552,6
7,2,21,553,1,1290,1,9,4,4,5,single-choice,spatial-relational,4|5,7,4/5,210553,4
7,2,21,554,0,1633,1,5,2,3,3,single-choice,spatial-relational,2|3,7,2/3,210554,2
7,2,21,555,1,1027,1,5,2,2,3,single-choice,spatial-relational,2|3,7,2/3,210555,2
7,2,21,556,1,834,1,13,6,6,7,single-choice,spatial-relational,6|7,7,6/7,210556,6
7,2,21,557,1,1008,1,11,5,5,6,single-choice,spatial-relational,5|6,7,5/6,210557,5
7,2,21,558,1,1339,1,7,3,3,4,single-choice,spatial-relational,3|4,7,3/4,210558,3
7,2,21,559,1,1027,1,3,1,1,2,single-choice,spatial-relational,1|2,7,1/2,210559,1
7,2,21,560,1,725,1,7,3,3,4,single-choice,spatial-relational,3|4,7,3/4,210560,3
7,2,21,561,1,1085,1,3,1,1,2,single-choice,spatial-relational,1|2,7,1/2,210561,1
7,2,21,562,1,974,1,13,6,6,7,single-choice,spatial-relational,6|7,7,6/7,210562,6
7,2,21,563,1,2042,1,11,5,5,6,single-choice,spatial-relational,5|6,7,5/6,210563,5
7,2,21,564,0,1599,1,9,4,5,5,single-choice,spatial-relational,4|5,7,4/5,210564,4
7,2,21,565,1,1254,1,5,2,2,3,single-choice,spatial-relational,2|3,7,2/3,210565,2
7,2,21,566,1,1154,1,3,1,1,2,single-choice,spatial-relational,1|2,7,1/2,210566,1
7,2,21,567,1,1170,1,9,4,4,5,single-choice,spatial-relational,4|5,7,4/5,210567,4
7,2,21,568,1,1013,1,7,3,3,4,single-choice,spatial-relational,3|4,7,3/4,210568,3
7,2,21,569,1,1092,1,11,5,5,6,single-choice,spatial-relational,5|6,7,5/6,210569,5
7,2,21,570,1,1467,1,5,2,2,3,single-choice,spatial-relational,2|3,7,2/3,210570,2
7,2,21,571,1,925,1,11,5,5,6,single-choice,spatial-relational,5|6,7,5/6,210571,5
7,2,21,572,0,931,1,3,1,2,2,single-choice,spatial-relational,1|2,7,1/2,210572,1
7,2,21,573,1,1015,1,9,4,4,5,single-choice,spatial-relational,4|5,7,4/5,210573,4
7,2,21,574,1,1619,1,13,6,6,7,single-choice,spatial-relational,6|7,7,6/7,210574,6
7,2,21,575,1,923,1,7,3,3,4,single-choice,spatial-relational,3|4,7,3/4,210575,3
7,2,21,576,1,839,1,13,6,6,7,single-choice,spatial-relational,6|7,7,6/7,210576,6
7,2,21,577,1,1196,1,3,1,1,2,single-choice,spatial-relational,1|2,7,1/2,210577,1
7,2,21,578,1,1624,1,9,4,4,5,single-choice,spatial-relational,4|5,7,4/5,210578,4
7,2,21,579,1,842,1,3,1,1,2,single-choice,spatial-relational,1|2,7,1/2,210579,1
7,2,21,580,1,792,1,5,2,2,3,single-choice,spatial-relational,2|3,7,2/3,210580,2
7,2,21,581,1,799,1,7,3,3,4,single-choice,spatial-relational,3|4,7,3/4,210581,3
7,2,21,582,1,774,1,11,5,5,6,single-choice,spatial-relational,5|6,7,5/6,210582,5
7,2,21,583,0,936,1,11,5,6,6,single-choice,spatial-relational,5|6,7,5/6,210583,5
7,2,21,584,1,1426,1,5,2,2,3,single-choice,spatial-relational,2|3,7,2/3,210584,2
7,2,21,585,1,960,1,7,3,3,4,single-choice,spatial-relational,3|4,7,3/4,210585,3
7,2,21,586,1,1048,1,13,6,6,7,single-choice,spatial-relational,6|7,7,6/7,210586,6
7,2,21,587,1,1107,1,13,6,6,7,single-choice,spatial-relational,6|7,7,6/7,210587,6
7,2,21,588,0,1386,1,9,4,5,5,single-choice,spatial-relational,4|5,7,4/5,210588,4
7,2,21,589,0,981,1,3,1,2,2,single-choice,spatial-relational,1|2,7,1/2,210589,1
7,2,21,590,1,1467,1,5,2,2,3,single-choice,spatial-relational,2|3,7,2/3,210590,2
7,2,21,591,1,874,1,13,6,6,7,single-choice,spatial-relational,6|7,7,6/7,210591,6
7,2,21,592,1,1174,1,9,4,4,5,single-choice,spatial-relational,4|5,7,4/5,210592,4
7,2,21,593,1,912,1,7,3,3,4,single-choice,spatial-relational,3|4,7,3/4,210593,3
7,2,21,594,0,1463,1,9,4,5,5,single-choice,spatial-relational,4|5,7,4/5,210594,4
7,2,21,595,1,1647,1,11,5,5,6,single-choice,spatial-relational,5|6,7,5/6,210595,5
7,2,21,596,1,923,1,3,1,1,2,single-choice,spatial-relational,1|2,7,1/2,210596,1
7,2,21,597,1,1269,1,13,6,6,7,single-choice,spatial-relational,6|7,7,6/7,210597,6
7,2,21,598,1,732,1,7,3,3,4,single-choice,spatial-relational,3|4,7,3/4,210598,3
7,2,21,599,1,1168,1,5,2,2,3,single-choice,spatial-relational,2|3,7,2/3,210599,2
7,2,21,600,1,873,1,11,5,5,6,single-choice,spatial-relational,5|6,7,5/6,210600,5
1,2,22,1,0,962,1,11,5,6,6,single-choice,spatial-relational,5|6,7,5/6,220001,5
1,2,22,2,1,1512,2,12,5,5,7,single-choice,spatial-relational,5|7,7,5/7,220002,5
1,2,22,3,0,1724,2,6,2,4,4,single-choice,spatial-relational,2|4,7,2/4,220003,2
1,2,22,4,0,184,1,3,1,2,2,single-choice,spatial-relational,1|2,7,1/2,220004,1
1,2,22,5,1,1462,2,10,4,4,6,single-choice,spatial-relational,4|6,7,4/6,220005,4
1,2,22,6,1,1439,3,5,1,1,4,single-choice,spatial-relational,1|4,7,1/4,220006,1
1,2,22,7,1,1441,1,5,2,2,3,single-choice,spatial-relational,2|3,7,2/3,220007,2
1,2,22,8,1,1464,1,9,4,4,5,single-choice,spatial-relational,4|5,7,4/5,220008,4
1,2,22,9,0,1126,3,9,3,6,6,single-choice,spatial-relational,3|6,7,3/6,220009,3
1,2,22,10,1,1153,2,8,3,3,5,single-choice,spatial-relational,3|5,7,3/5,220010,3
1,2,22,11,1,1316,1,13,6,6,7,single-choice,spatial-relational,6|7,7,6/7,220011,6
1,2,22,12,0,1038,4,10,3,7,7,single-choice,spatial-relational,3|7,7,3/7,220012,3
1,2,22,13,1,990,2,12,5,5,7,single-choice,spatial-relational,5|7,7,5/7,220013,5
1,2,22,14,0,1298,4,6,1,5,5,single-choice,spatial-relational,1|5,7,1/5,220014,1
1,2,22,15,0,565,5,7,1,6,6,single-choice,spatial-relational,1|6,7,1/6,220015,1
1,2,22,16,1,723,1,9,4,4,5,single-choice,spatial-relational,4|5,7,4/5,220016,4
1,2,22,17,1,1344,4,10,3,3,7,single-choice,spatial-relational,3|7,7,3/7,220017,3
1,2,22,18,1,1132,1,5,2,2,3,single-choice,spatial-relational,2|3,7,2/3,220018,2
1,2,22,19,1,1092,3,9,3,3,6,single-choice,spatial-relational,3|6,7,3/6,220019,3
1,2,22,20,0,871,6,8,1,7,7,single-choice,spatial-relational,1|7,7,1/7,220020,1
1,2,22,21,0,556,3,7,2,5,5,single-choice,spatial-relational,2|5,7,2/5,220021,2
1,2,22,22,0,578,6,8,1,7,7,single-choice,spatial-relational,1|7,7,1/7,220022,1
1,2,22,23,0,606,4,8,2,6,6,single-choice,spatial-relational,2|6,7,2/6,220023,2
1,2,22,24,1,106,3,7,2,2,5,single-choice,spatial-relational,2|5,7,2/5,220024,2
1,2,22,25,0,971,3,5,1,4,4,single-choice,spatial-relational,1|4,7,1/4,220025,1
1,2,22,26,1,674,3,11,4,4,7,single-choice,spatial-relational,4|7,7,4/7,220026,4
1,2,22,27,0,862,5,7,1,6,6,single-choice,spatial-relational,1|6,7,1/6,220027,1
1,2,22,28,0,624,2,8,3,5,5,single-choice,spatial-relational,3|5,7,3/5,220028,3
1,2,22,29,1,1304,1,13,6,6,7,single-choice,spatial-relational,6|7,7,6/7,220029,6
1,2,22,30,1,1239,2,4,1,1,3,single-choice,spatial-relational,1|3,7,1/3,220030,1
1,2,22,31,1,1058,3,11,4,4,7,single-choice,spatial-relational,4|7,7,4/7,220031,4
1,2,22,32,1,1411,2,10,4,4,6,single-choice,spatial-relational,4|6,7,4/6,220032,4
1,2,22,33,1,1642,4,8,2,2,6,single-choice,spatial-relational,2|6,7,2/6,220033,2
1,2,22,34,1,1100,5,9,2,2,7,single-choice,spatial-relational,2|7,7,2/7,220034,2
1,2,22,35,0,1011,1,3,1,2,2,single-choice,spatial-relational,1|2,7,1/2,220035,1
1,2,22,36,1,891,1,7,3,3,4,single-choice,spatial-relational,3|4,7,3/4,220036,3
1,2,22,37,1,889,1,11,5,5,6,single-choice,spatial-relational,5|6,7,5/6,220037,5
1,2,22,38,1,1165,1,7,3,3,4,single-choice,spatial-relational,3|4,7,3/4,220038,3
1,2,22,39,0,1245,4,6,1,5,5,single-choice,spatial-relational,1|5,7,1/5,220039,1
1,2,22,40,0,573,2,4,1,3,3,single-choice,spatial-relational,1|3,7,1/3,220040,1
1,2,22,41,0,581,2,6,2,4,4,single-choice,spatial-relational,2|4,7,2/4,220041,2
1,2,22,42,1,1171,5,9,2,2,7,single-choice,spatial-relational,2|7,7,2/7,220042,2
1,2,22,43,1,1160,4,10,3,3,7,single-choice,spatial-relational,3|7,7,3/7,220043,3
1,2,22,44,1,1096,4,8,2,2,6,single-choice,spatial-relational,2|6,7,2/6,220044,2
1,2,22,45,1,1687,1,5,2,2,3,single-choice,spatial-relational,2|3,7,2/3,220045,2
1,2,22,46,1,1619,2,10,4,4,6,single-choice,spatial-relational,4|6,7,4/6,220046,4
1,2,22,47,1,1214,3,11,4,4,7,single-choice,spatial-relational,4|7,7,4/7,220047,4
1,2,22,48,1,1399,4,6,1,1,5,single-choice,spatial-relational,1|5,7,1/5,220048,1
1,2,22,49,1,897,1,13,6,6,7,single-choice,spatial-relational,6|7,7,6/7,220049,6
1,2,22,50,1,1176,4,8,2,2,6,single-choice,spatial-relational,2|6,7,2/6,220050,2
1,2,22,51,1,1482,2,12,5,5,7,single-choice,spatial-relational,5|7,7,5/7,220051,5
1,2,22,52,1,1324,1,9,4,4,5,single-choice,spatial-relational,4|5,7,4/5,220052,4
1,2,22,53,0,1114,4,6,1,5,5,single-choice,spatial-relational,1|5,7,1/5,220053,1
1,2,22,54,1,916,3,11,4,4,7,single-choice,spatial-relational,4|7,7,4/7,220054,4
1,2,22,55,1,844,2,8,3,3,5,single-choice,spatial-relational,3|5,7,3/5,220055,3
1,2,22,56,1,1379,1,7,3,3,4,single-choice,spatial-relational,3|4,7,3/4,220056,3
1,2,22,57,1,1127,3,5,1,1,4,single-choice,spatial-relational,1|4,7,1/4,220057,1
1,2,22,58,0,745,2,6,2,4,4,single-choice,spatial-relational,2|4,7,2/4,220058,2
1,2,22,59,1,837,2,8,3,3,5,single-choice,spatial-relational,3|5,7,3/5,220059,3
1,2,22,60,1,1120,3,7,2,2,5,single-choice,spatial-relational,2|5,7,2/5,220060,2
1,2,22,61,1,1420,5,7,1,1,6,single-choice,spatial-relational,1|6,7,1/6,220061,1
1,2,22,62,0,1092,1,3,1,2,2,single-choice,spatial-relational,1|2,7,1/2,220062,1
1,2,22,63,1,1010,3,7,2,2,5,single-choice,spatial-relational,2|5,7,2/5,220063,2
1,2,22,64,1,931,5,9,2,2,7,single-choice,spatial-relational,2|7,7,2/7,220064,2
1,2,22,65,1,1289,1,11,5,5,6,single-choice,spatial-relational,5|6,7,5/6,220065,5
1,2,22,66,1,1229,2,4,1,1,3,single-choice,spatial-relational,1|3,7,1/3,220066,1
1,2,22,67,1,1260,5,7,1,1,6,single-choice,spatial-relational,1|6,7,1/6,220067,1
1,2,22,68,1,1032,5,9,2,2,7,single-choice,spatial-relational,2|7,7,2/7,220068,2
1,2,22,69,0,1209,2,4,1,3,3,single-choice,spatial-relational,1|3,7,1/3,220069,1
1,2,22,70,0,604,6,8,1,7,7,single-choice,spatial-relational,1|7,7,1/7,220070,1
1,2,22,71,1,988,3,9,3,3,6,single-choice,spatial-relational,3|6,7,3/6,220071,3
1,2,22,72,1,950,4,10,3,3,7,single-choice,spatial-relational,3|7,7,3/7,220072,3
1,2,22,73,1,1178,3,9,3,3,6,single-choice,spatial-relational,3|6,7,3/6,220073,3
1,2,22,74,1,1363,1,7,3,3,4,single-choice,spatial-relational,3|4,7,3/4,220074,3
1,2,22,75,1,1058,1,9,4,4,5,single-choice,spatial-relational,4|5,7,4/5,220075,4
1,2,22,76,1,1457,1,11,5,5,6,single-choice,spatial-relational,5|6,7,5/6,220076,5
1,2,22,77,1,1139,2,12,5,5,7,single-choice,spatial-relational,5|7,7,5/7,220077,5
1,2,22,78,0,2059,3,5,1,4,4,single-choice,spatial-relational,1|4,7,1/4,220078,1
1,2,22,79,0,1134,1,3,1,2,2,single-choice,spatial-relational,1|2,7,1/2,220079,1
1,2,22,80,1,817,1,5,2,2,3,single-choice,spatial-relational,2|3,7,2/3,220080,2
1,2,22,81,1,1018,2,10,4,4,6,single-choice,spatial-relational,4|6,7,4/6,220081,4
1,2,22,82,1,1501,6,8,1,1,7,single-choice,spatial-relational,1|7,7,1/7,220082,1
1,2,22,83,1,814,1,13,6,6,7,single-choice,spatial-relational,6|7,7,6/7,220083,6
1,2,22,84,1,1021,2,6,2,2,4,single-choice,spatial-relational,2|4,7,2/4,220084,2
1,2,22,85,1,1106,2,8,3,3,5,single-choice,spatial-relational,3|5,7,3/5,220085,3
1,2,22,86,1,1185,3,5,1,1,4,single-choice,spatial-relational,1|4,7,1/4,220086,1
1,2,22,87,1,1170,3,9,3,3,6,single-choice,spatial-relational,3|6,7,3/6,220087,3
1,2,22,88,1,1589,5,7,1,1,6,single-choice,spatial-relational,1|6,7,1/6,220088,1
1,2,22,89,1,975,1,13,6,6,7,single-choice,spatial-relational,6|7,7,6/7,220089,6
1,2,22,90,1,1512,5,7,1,1,6,single-choice,spatial-relational,1|6,7,1/6,220090,1
1,2,22,91,0,861,4,8,2,6,6,single-choice,spatial-relational,2|6,7,2/6,220091,2
1,2,22,92,1,975,5,9,2,2,7,single-choice,spatial-relational,2|7,7,2/7,220092,2
1,2,22,93,1,1003,5,9,2,2,7,single-choice,spatial-relational,2|7,7,2/7,220093,2
1,2,22,94,1,1550,1,5,2,2,3,single-choice,spatial-relational,2|3,7,2/3,220094,2
1,2,22,95,1,1373,4,6,1,1,5,single-choice,spatial-relational,1|5,7,1/5,220095,1
1,2,22,96,1,1408,2,10,4,4,6,single-choice,spatial-relational,4|6,7,4/6,220096,4
1,2,22,97,1,1023,4,8,2,2,6,single-choice,spatial-relational,2|6,7,2/6,220097,2
1,2,22,98,1,1608,6,8,1,1,7,single-choice,spatial-relational,1|7,7,1/7,220098,1
1,2,22,99,1,925,1,9,4,4,5,single-choice,spatial-relational,4|5,7,4/5,220099,4
1,2,22,100,1,1435,3,11,4,4,7,single-choice,spatial-relational,4|7,7,4/7,220100,4
1,2,22,101,1,1283,2,8,3,3,5,single-choice,spatial-relational,3|5,7,3/5,220101,3
1,2,22,102,1,1115,3,7,2,2,5,single-choice,spatial-relational,2|5,7,2/5,220102,2
1,2,22,103,1,1430,2,4,1,1,3,single-choice,spatial-relational,1|3,7,1/3,220103,1
1,2,22,104,1,932,2,12,5,5,7,single-choice,spatial-relational,5|7,7,5/7,220104,5
1,2,22,105,1,1156,3,11,4,4,7,single-choice,spatial-relational,4|7,7,4/7,220105,4
1,2,22,106,1,1107,2,6,2,2,4,single-choice,spatial-relational,2|4,7,2/4,220106,2
1,2,22,107,1,2088,2,4,1,1,3,single-choice,spatial-relational,1|3,7,1/3,220107,1
1,2,22,108,1,1109,1,9,4,4,5,single-choice,spatial-relational,4|5,7,4/5,220108,4
1,2,22,109,1,1536,2,12,5,5,7,single-choice,spatial-relational,5|7,7,5/7,220109,5
1,2,22,110,1,1396,4,10,3,3,7,single-choice,spatial-relational,3|7,7,3/7,220110,3
1,2,22,111,1,1437,1,3,1,1,2,single-choice,spatial-relational,1|2,7,1/2,220111,1
1,2,22,112,1,990,1,11,5,5,6,single-choice,spatial-relational,5|6,7,5/6,220112,5
1,2,22,113,1,1227,6,8,1,1,7,single-choice,spatial-relational,1|7,7,1/7,220113,1
1,2,22,114,0,774,4,6,1,5,5,single-choice,spatial-relational,1|5,7,1/5,220114,1
1,2,22,115,1,874,1,7,3,3,4,single-choice,spatial-relational,3|4,7,3/4,220115,3
1,2,22,116,1,1351,3,9,3,3,6,single-choice,spatial-relational,3|6,7,3/6,220116,3
1,2,22,117,1,1033,2,6,2,2,4,single-choice,spatial-relational,2|4,7,2/4,220117,2
1,2,22,118,1,976,3,7,2,2,5,single-choice,spatial-relational,2|5,7,2/5,220118,2
1,2,22,119,1,1051,4,10,3,3,7,single-choice,spatial-relational,3|7,7,3/7,220119,3
1,2,22,120,1,1353,1,13,6,6,7,single-choice,spatial-relational,6|7,7,6/7,220120,6
1,2,22,121,1,1498,1,5,2,2,3,single-choice,spatial-relational,2|3,7,2/3,220121,2
1,2,22,122,1,1003,2,10,4,4,6,single-choice,spatial-relational,4|6,7,4/6,220122,4
1,2,22,123,1,1046,1,11,5,5,6,single-choice,spatial-relational,5|6,7,5/6,220123,5
1,2,22,124,1,1903,3,5,1,1,4,single-choice,spatial-relational,1|4,7,1/4,220124,1
1,2,22,125,0,851,1,3,1,2,2,single-choice,spatial-relational,1|2,7,1/2,220125,1
1,2,22,126,1,914,1,7,3,3,4,single-choice,spatial-relational,3|4,7,3/4,220126,3
1,2,22,127,1,1160,2,10,4,4,6,single-choice,spatial-relational,4|6,7,4/6,220127,4
1,2,22,128,1,1318,5,9,2,2,7,single-choice,spatial-relational,2|7,7,2/7,220128,2
1,2,22,129,1,1325,1,11,5,5,6,single-choice,spatial-relational,5|6,7,5/6,220129,5
1,2,22,130,1,1309,2,12,5,5,7,single-choice,spatial-relational,5|7,7,5/7,220130,5
1,2,22,131,1,1019,1,9,4,4,5,single-choice,spatial-relational,4|5,7,4/5,220131,4
1,2,22,132,1,1282,2,6,2,2,4,single-choice,spatial-relational,2|4,7,2/4,220132,2
1,2,22,133,1,1730,2,4,1,1,3,single-choice,spatial-relational,1|3,7,1/3,220133,1
1,2,22,134,0,888,2,8,3,5,5,single-choice,spatial-relational,3|5,7,3/5,220134,3
1,2,22,135,1,828,1,5,2,2,3,single-choice,spatial-relational,2|3,7,2/3,220135,2
1,2,22,136,1,923,5,9,2,2,7,single-choice,spatial-relational,2|7,7,2/7,220136,2
1,2,22,137,1,1279,2,4,1,1,3,single-choice,spatial-relational,1|3,7,1/3,220137,1
1,2,22,138,1,961,1,11,5,5,6,single-choice,spatial-relational,5|6,7,5/6,220138,5
1,2,22,139,1,1212,3,7,2,2,5,single-choice,spatial-relational,2|5,7,2/5,220139,2
1,2,22,140,1,1242,3,9,3,3,6,single-choice,spatial-relational,3|6,7,3/6,220140,3
1,2,22,141,1,1338,3,11,4,4,7,single-choice,spatial-relational,4|7,7,4/7,220141,4
1,2,22,142,1,1261,3,9,3,3,6,single-choice,spatial-relational,3|6,7,3/6,220142,3
1,2,22,143,1,1022,4,10,3,3,7,single-choice,spatial-relational,3|7,7,3/7,220143,3
1,2,22,144,1,1497,3,5,1,1,4,single-choice,spatial-relational,1|4,7,1/4,220144,1
1,2,22,145,1,793,1,7,3,3,4,single-choice,spatial-relational,3|4,7,3/4,220145,3
1,2,22,146,1,1482,1,13,6,6,7,single-choice,spatial-relational,6|7,7,6/7,220146,6
1,2,22,147,1,1627,4,8,2,2,6,single-choice,spatial-relational,2|6,7,2/6,220147,2
1,2,22,148,1,1068,1,3,1,1,2,single-choice,spatial-relational,1|2,7,1/2,220148,1
1,2,22,149,1,901,2,10,4,4,6,single-choice,spatial-relational,4|6,7,4/6,220149,4
1,2,22,150,1,1337,1,13,6,6,7,single-choice,spatial-relational,6|7,7,6/7,220150,6
1,2,22,151,1,1544,1,3,1,1,2,single-choice,spatial-relational,1|2,7,1/2,220151,1
1,2,22,152,1,1211,6,8,1,1,7,single-choice,spatial-relational,1|7,7,1/7,220152,1
1,2,22,153,1,1343,1,9,4,4,5,single-choice,spatial-relational,4|5,7,4/5,220153,4
1,2,22,154,0,855,3,5,1,4,4,single-choice,spatial-relational,1|4,7,1/4,220154,1
1,2,22,155,1,1713,1,5,2,2,3,single-choice,spatial-relational,2|3,7,2/3,220155,2
1,2,22,156,1,1299,3,7,2,2,5,single-choice,spatial-relational,2|5,7,2/5,220156,2
1,2,22,157,1,869,2,12,5,5,7,single-choice,spatial-relational,5|7,7,5/7,220157,5
1,2,22,158,1,1170,4,8,2,2,6,single-choice,spatial-relational,2|6,7,2/6,220158,2
1,2,22,159,1,1774,4,6,1,1,5,single-choice,spatial-relational,1|5,7,1/5,220159,1
1,2,22,160,1,1185,5,7,1,1,6,single-choice,spatial-relational,1|6,7,1/6,220160,1
1,2,22,161,1,1005,1,7,3,3,4,single-choice,spatial-relational,3|4,7,3/4,220161,3
1,2,22,162,0,169,4,10,3,7,7,single-choice,spatial-relational,3|7,7,3/7,220162,3
1,2,22,163,1,1016,2,6,2,2,4,single-choice,spatial-relational,2|4,7,2/4,220163,2
1,2,22,164,1,1182,6,8,1,1,7,single-choice,spatial-relational,1|7,7,1/7,220164,1
1,2,22,165,1,1854,5,7,1,1,6,single-choice,spatial-relational,1|6,7,1/6,220165,1
1,2,22,166,0,739,4,6,1,5,5,single-choice,spatial-relational,1|5,7,1/5,220166,1
1,2,22,167,1,975,3,11,4,4,7,single-choice,spatial-relational,4|7,7,4/7,220167,4
1,2,22,168,1,935,2,8,3,3,5,single-choice,spatial-relational,3|5,7,3/5,220168,3
1,2,22,169,1,2088,4,6,1,1,5,single-choice,spatial-relational,1|5,7,1/5,220169,1
1,2,22,170,1,1490,2,6,2,2,4,single-choice,spatial-relational,2|4,7,2/4,220170,2
1,2,22,171,1,983,1,13,6,6,7,single-choice,spatial-relational,6|7,7,6/7,220171,6
1,2,22,172,1,1359,2,10,4,4,6,single-choice,spatial-relational,4|6,7,4/6,220172,4
1,2,22,173,1,1894,4,8,2,2,6,single-choice,spatial-relational,2|6,7,2/6,220173,2
1,2,22,174,1,1294,6,8,1,1,7,single-choice,spatial-relational,1|7,7,1/7,220174,1
1,2,22,175,1,862,3,9,3,3,6,single-choice,spatial-relational,3|6,7,3/6,220175,3
1,2,22,176,0,1834,1,9,4,5,5,single-choice,spatial-relational,4|5,7,4/5,220176,4
1,2,22,177,1,1211,5,7,1,1,6,single-choice,spatial-relational,1|6,7,1/6,220177,1
1,2,22,178,1,960,3,7,2,2,5,single-choice,spatial-relational,2|5,7,2/5,220178,2
1,2,22,179,1,1049,4,10,3,3,7,single-choice,spatial-relational,3|7,7,3/7,220179,3
1,2,22,180,1,1453,2,12,5,5,7,single-choice,spatial-relational,5|7,7,5/7,220180,5
1,2,22,181,1,1308,5,7,1,1,6,single-choice,spatial-relational,1|6,7,1/6,220181,1
1,2,22,182,1,923,1,7,3,3,4,single-choice,spatial-relational,3|4,7,3/4,220182,3
1,2,22,183,1,1305,1,7,3,3,4,single-choice,spatial-relational,3|4,7,3/4,220183,3
1,2,22,184,1,1069,1,11,5,5,6,single-choice,spatial-relational,5|6,7,5/6,220184,5
1,2,22,185,1,1169,2,12,5,5,7,single-choice,spatial-relational,5|7,7,5/7,220185,5
1,2,22,186,1,1308,1,3,1,1,2,single-choice,spatial-relational,1|2,7,1/2,220186,1
1,2,22,187,1,1061,5,9,2,2,7,single-choice,spatial-relational,2|7,7,2/7,220187,2
1,2,22,188,1,1170,4,8,2,2,6,single-choice,spatial-relational,2|6,7,2/6,220188,2
1,2,22,189,1,1082,4,10,3,3,7,single-choice,spatial-relational,3|7,7,3/7,220189,3
1,2,22,190,1,1239,2,6,2,2,4,single-choice,spatial-relational,2|4,7,2/4,220190,2
1,2,22,191,1,1361,4,6,1,1,5,single-choice,spatial-relational,1|5,7,1/5,220191,1
1,2,22,192,1,1391,1,11,5,5,6,single-choice,spatial-relational,5|6,7,5/6,220192,5
1,2,22,193,0,945,3,5,1,4,4,single-choice,spatial-relational,1|4,7,1/4,220193,1
1,2,22,194,1,876,1,5,2,2,3,single-choice,spatial-relational,2|3,7,2/3,220194,2
1,2,22,195,1,1594,3,5,1,1,4,single-choice,spatial-relational,1|4,7,1/4,220195,1
1,2,22,196,1,1527,1,5,2,2,3,single-choice,spatial-relational,2|3,7,2/3,220196,2
1,2,22,197,1,1153,2,4,1,1,3,single-choice,spatial-relational,1|3,7,1/3,220197,1
1,2,22,198,0,721,2,4,1,3,3,single-choice,spatial-relational,1|3,7,1/3,220198,1
1,2,22,199,1,904,5,9,2,2,7,single-choice,spatial-relational,2|7,7,2/7,220199,2
1,2,22,200,1,943,2,10,4,4,6,single-choice,spatial-relational,4|6,7,4/6,220200,4
1,2,22,201,1,1321,1,13,6,6,7,single-choice,spatial-relational,6|7,7,6/7,220201,6
1,2,22,202,1,1704,6,8,1,1,7,single-choice,spatial-relational,1|7,7,1/7,220202,1
1,2,22,203,1,989,2,8,3,3,5,single-choice,spatial-relational,3|5,7,3/5,220203,3
1,2,22,204,1,1221,3,7,2,2,5,single-choice,spatial-relational,2|5,7,2/5,220204,2
1,2,22,205,1,1209,2,8,3,3,5,single-choice,spatial-relational,3|5,7,3/5,220205,3
1,2,22,206,1,1437,3,11,4,4,7,single-choice,spatial-relational,4|7,7,4/7,220206,4
1,2,22,207,1,1650,1,9,4,4,5,single-choice,spatial-relational,4|5,7,4/5,220207,4
1,2,22,208,1,1172,3,9,3,3,6,single-choice,spatial-relational,3|6,7,3/6,220208,3
1,2,22,209,1,1527,3,11,4,4,7,single-choice,spatial-relational,4|7,7,4/7,220209,4
1,2,22,210,0,1142,1,3,1,2,2,single-choice,spatial-relational,1|2,7,1/2,220210,1
1,2,22,211,1,918,3,9,3,3,6,single-choice,spatial-relational,3|6,7,3/6,220211,3
1,2,22,212,1,1434,5,7,1,1,6,single-choice,spatial-relational,1|6,7,1/6,220212,1
1,2,22,213,0,755,5,9,2,7,7,single-choice,spatial-relational,2|7,7,2/7,220213,2
1,2,22,214,1,1317,3,7,2,2,5,single-choice,spatial-relational,2|5,7,2/5,220214,2
1,2,22,215,0,698,4,6,1,5,5,single-choice,spatial-relational,1|5,7,1/5,220215,1
1,2,22,216,1,1085,3,5,1,1,4,single-choice,spatial-relational,1|4,7,1/4,220216,1
1,2,22,217,1,955,5,9,2,2,7,single-choice,spatial-relational,2|7,7,2/7,220217,2
1,2,22,218,1,1127,4,6,1,1,5,single-choice,spatial-relational,1|5,7,1/5,220218,1
1,2,22,219,1,1152,4,8,2,2,6,single-choice,spatial-relational,2|6,7,2/6,220219,2
1,2,22,220,1,1081,1,7,3,3,4,single-choice,spatial-relational,3|4,7,3/4,220220,3
1,2,22,221,1,2292,2,10,4,4,6,single-choice,spatial-relational,4|6,7,4/6,220221,4
1,2,22,222,1,1744,5,7,1,1,6,single-choice,spatial-relational,1|6,7,1/6,220222,1
1,2,22,223,1,1241,1,11,5,5,6,single-choice,spatial-relational,5|6,7,5/6,220223,5
1,2,22,224,1,1129,4,8,2,2,6,single-choice,spatial-relational,2|6,7,2/6,220224,2
1,2,22,225,1,1354,1,11,5,5,6,single-choice,spatial-relational,5|6,7,5/6,220225,5
1,2,22,226,1,1654,1,13,6,6,7,single-choice,spatial-relational,6|7,7,6/7,220226,6
1,2,22,227,1,1407,2,4,1,1,3,single-choice,spatial-relational,1|3,7,1/3,220227,1
1,2,22,228,1,928,1,9,4,4,5,single-choice,spatial-relational,4|5,7,4/5,220228,4
1,2,22,229,0,1169,2,4,1,3,3,single-choice,spatial-relational,1|3,7,1/3,220229,1
1,2,22,230,1,1087,3,7,2,2,5,single-choice,spatial-relational,2|5,7,2/5,220230,2
1,2,22,231,1,1040,1,5,2,2,3,single-choice,spatial-relational,2|3,7,2/3,220231,2
1,2,22,232,1,999,4,10,3,3,7,single-choice,spatial-relational,3|7,7,3/7,220232,3
1,2,22,233,1,1557,1,13,6,6,7,single-choice,spatial-relational,6|7,7,6/7,220233,6
1,2,22,234,1,1442,6,8,1,1,7,single-choice,spatial-relational,1|7,7,1/7,220234,1
1,2,22,235,1,914,4,10,3,3,7,single-choice,spatial-relational,3|7,7,3/7,220235,3
1,2,22,236,1,1270,3,11,4,4,7,single-choice,spatial-relational,4|7,7,4/7,220236,4
1,2,22,237,1,1162,2,6,2,2,4,single-choice,spatial-relational,2|4,7,2/4,220237,2
1,2,22,238,1,1210,3,9,3,3,6,single-choice,spatial-relational,3|6,7,3/6,220238,3
1,2,22,239,1,1267,3,5,1,1,4,single-choice,spatial-relational,1|4,7,1/4,220239,1
1,2,22,240,0,1551,1,3,1,2,2,single-choice,spatial-relational,1|2,7,1/2,220240,1
1,2,22,241,1,878,2,6,2,2,4,single-choice,spatial-relational,2|4,7,2/4,220241,2
1,2,22,242,1,893,2,10,4,4,6,single-choice,spatial-relational,4|6,7,4/6,220242,4
1,2,22,243,1,940,1,5,2,2,3,single-choice,spatial-relational,2|3,7,2/3,220243,2
1,2,22,244,1,1209,2,12,5,5,7,single-choice,spatial-relational,5|7,7,5/7,220244,5
1,2,22,245,1,975,3,11,4,4,7,single-choice,spatial-relational,4|7,7,4/7,220245,4
1,2,22,246,1,1248,2,12,5,5,7,single-choice,spatial-relational,5|7,7,5/7,220246,5
1,2,22,247,1,1559,2,8,3,3,5,single-choice,spatial-relational,3|5,7,3/5,220247,3
1,2,22,248,0,924,1,3,1,2,2,single-choice,spatial-relational,1|2,7,1/2,220248,1
1,2,22,249,1,1031,1,7,3,3,4,single-choice,spatial-relational,3|4,7,3/4,220249,3
1,2,22,250,1,877,2,8,3,3,5,single-choice,spatial-relational,3|5,7,3/5,220250,3
1,2,22,251,1,1092,1,9,4,4,5,single-choice,spatial-relational,4|5,7,4/5,220251,4
1,2,22,252,1,1722,6,8,1,1,7,single-choice,spatial-relational,1|7,7,1/7,220252,1
1,2,22,253,1,851,3,11,4,4,7,single-choice,spatial-relational,4|7,7,4/7,220253,4
1,2,22,254,1,1649,5,7,1,1,6,single-choice,spatial-relational,1|6,7,1/6,220254,1
1,2,22,255,0,780,2,4,1,3,3,single-choice,spatial-relational,1|3,7,1/3,220255,1
1,2,22,256,0,1522,1,3,1,2,2,single-choice,spatial-relational,1|2,7,1/2,220256,1
1,2,22,257,1,1104,3,9,3,3,6,single-choice,spatial-relational,3|6,7,3/6,220257,3
1,2,22,258,0,1180,3,7,2,5,5,single-choice,spatial-relational,2|5,7,2/5,220258,2
1,2,22,259,1,1542,2,12,5,5,7,single-choice,spatial-relational,5|7,7,5/7,220259,5
1,2,22,260,1,910,3,9,3,3,6,single-choice,spatial-relational,3|6,7,3/6,220260,3
1,2,22,261,1,1427,4,8,2,2,6,single-choice,spatial-relational,2|6,7,2/6,220261,2
1,2,22,262,0,826,3,5,1,4,4,single-choice,spatial-relational,1|4,7,1/4,220262,1
1,2,22,263,1,1113,5,7,1,1,6,single-choice,spatial-relational,1|6,7,1/6,220263,1
1,2,22,264,1,969,1,9,4,4,5,single-choice,spatial-relational,4|5,7,4/5,220264,4
1,2,22,265,1,2106,4,6,1,1,5,single-choice,spatial-relational,1|5,7,1/5,220265,1
1,2,22,266,1,1219,1,13,6,6,7,single-choice,spatial-relational,6|7,7,6/7,220266,6
1,2,22,267,0,885,2,4,1,3,3,single-choice,spatial-relational,1|3,7,1/3,220267,1
1,2,22,268,1,1245,1,3,1,1,2,single-choice,spatial-relational,1|2,7,1/2,220268,1
1,2,22,269,0,627,4,6,1,5,5,single-choice,spatial-relational,1|5,7,1/5,220269,1
1,2,22,270,1,899,3,11,4,4,7,single-choice,spatial-relational,4|7,7,4/7,220270,4
1,2,22,271,1,1110,3,7,2,2,5,single-choice,spatial-relational,2|5,7,2/5,220271,2
1,2,22,272,1,1027,2,10,4,4,6,single-choice,spatial-relational,4|6,7,4/6,220272,4
1,2,22,273,1,979,1,9,4,4,5,single-choice,spatial-relational,4|5,7,4/5,220273,4
1,2,22,274,1,1256,2,8,3,3,5,single-choice,spatial-relational,3|5,7,3/5,220274,3
1,2,22,275,1,930,1,5,2,2,3,single-choice,spatial-relational,2|3,7,2/3,220275,2
1,2,22,276,1,1277,6,8,1,1,7,single-choice,spatial-relational,1|7,7,1/7,220276,1
1,2,22,277,1,1249,5,9,2,2,7,single-choice,spatial-relational,2|7,7,2/7,220277,2
1,2,22,278,1,1233,2,6,2,2,4,single-choice,spatial-relational,2|4,7,2/4,220278,2
1,2,22,279,1,1604,1,5,2,2,3,single-choice,spatial-relational,2|3,7,2/3,220279,2
1,2,22,280,1,1239,5,9,2,2,7,single-choice,spatial-relational,2|7,7,2/7,220280,2
1,2,22,281,1,1090,4,8,2,2,6,single-choice,spatial-relational,2|6,7,2/6,220281,2
1,2,22,282,1,1177,4,10,3,3,7,single-choice,spatial-relational,3|7,7,3/7,220282,3
1,2,22,283,1,1238,1,7,3,3,4,single-choice,spatial-relational,3|4,7,3/4,220283,3
1,2,22,284,1,1322,4,10,3,3,7,single-choice,spatial-relational,3|7,7,3/7,220284,3
1,2,22,285,1,1552,3,5,1,1,4,single-choice,spatial-relational,1|4,7,1/4,220285,1
1,2,22,286,1,1466,1,13,6,6,7,single-choice,spatial-relational,6|7,7,6/7,220286,6
1,2,22,287,1,1748,6,8,1,1,7,single-choice,spatial-relational,1|7,7,1/7,220287,1
1,2,22,288,1,824,1,11,5,5,6,single-choice,spatial-relational,5|6,7,5/6,220288,5
1,2,22,289,1,1352,1,7,3,3,4,single-choice,spatial-relational,3|4,7,3/4,220289,3
1,2,22,290,1,1326,1,11,5,5,6,single-choice,spatial-relational,5|6,7,5/6,220290,5
1,2,22,291,1,1292,2,10,4,4,6,single-choice,spatial-relational,4|6,7,4/6,220291,4
1,2,22,292,0,1734,2,8,3,5,5,single-choice,spatial-relational,3|5,7,3/5,220292,3
1,2,22,293,1,839,2,12,5,5,7,single-choice,spatial-relational,5|7,7,5/7,220293,5
1,2,22,294,1,1414,2,6,2,2,4,single-choice,spatial-relational,2|4,7,2/4,220294,2
1,2,22,295,1,1632,3,5,1,1,4,single-choice,spatial-relational,1|4,7,1/4,220295,1
1,2,22,296,1,1373,1,3,1,1,2,single-choice,spatial-relational,1|2,7,1/2,220296,1
1,2,22,297,0,1040,1,3,1,2,2,single-choice,spatial-relational,1|2,7,1/2,220297,1
1,2,22,298,1,1014,1,5,2,2,3,single-choice,spatial-relational,2|3,7,2/3,220298,2
1,2,22,299,1,946,3,11,4,4,7,single-choice,spatial-relational,4|7,7,4/7,220299,4
1,2,22,300,1,1338,2,10,4,4,6,single-choice,spatial-relational,4|6,7,4/6,220300,4
1,2,22,301,1,1208,1,7,3,3,4,single-choice,spatial-relational,3|4,7,3/4,220301,3
1,2,22,302,1,1174,5,9,2,2,7,single-choice,spatial-relational,2|7,7,2/7,220302,2
1,2,22,303,1,1170,2,12,5,5,7,single-choice,spatial-relational,5|7,7,5/7,220303,5
1,2,22,304,1,1356,3,9,3,3,6,single-choice,spatial-relational,3|6,7,3/6,220304,3
1,2,22,305,1,764,1,13,6,6,7,single-choice,spatial-relational,6|7,7,6/7,220305,6
1,2,22,306,1,1467,4,10,3,3,7,single-choice,spatial-relational,3|7,7,3/7,220306,3
1,2,22,307,0,1676,4,6,1,5,5,single-choice,spatial-relational,1|5,7,1/5,220307,1
1,2,22,308,1,960,6,8,1,1,7,single-choice,spatial-relational,1|7,7,1/7,220308,1
1,2,22,309,1,1446,2,4,1,1,3,single-choice,spatial-relational,1|3,7,1/3,220309,1
1,2,22,310,1,1026,1,11,5,5,6,single-choice,spatial-relational,5|6,7,5/6,220310,5
1,2,22,311,1,1131,4,10,3,3,7,single-choice,spatial-relational,3|7,7,3/7,220311,3
1,2,22,312,1,982,2,8,3,3,5,single-choice,spatial-relational,3|5,7,3/5,220312,3
1,2,22,313,1,1002,2,10,4,4,6,single-choice,spatial-relational,4|6,7,4/6,220313,4
1,2,22,314,1,1221,3,7,2,2,5,single-choice,spatial-relational,2|5,7,2/5,220314,2
1,2,22,315,1,3057,1,9,4,4,5,single-choice,spatial-relational,4|5,7,4/5,220315,4
1,2,22,316,1,1186,3,5,1,1,4,single-choice,spatial-relational,1|4,7,1/4,220316,1
1,2,22,317,1,999,2,12,5,5,7,single-choice,spatial-relational,5|7,7,5/7,220317,5
1,2,22,318,1,3097,2,6,2,2,4,single-choice,spatial-relational,2|4,7,2/4,220318,2
1,2,22,319,1,2426,3,11,4,4,7,single-choice,spatial-relational,4|7,7,4/7,220319,4
1,2,22,320,1,2007,5,7,1,1,6,single-choice,spatial-relational,1|6,7,1/6,220320,1
1,2,22,321,1,1110,3,9,3,3,6,single-choice,spatial-relational,3|6,7,3/6,220321,3
1,2,22,322,1,1361,4,8,2,2,6,single-choice,spatial-relational,2|6,7,2/6,220322,2
1,2,22,323,0,627,3,7,2,5,5,single-choice,spatial-relational,2|5,7,2/5,220323,2
1,2,22,324,1,965,4,6,1,1,5,single-choice,spatial-relational,1|5,7,1/5,220324,1
1,2,22,325,1,929,5,9,2,2,7,single-choice,spatial-relational,2|7,7,2/7,220325,2
1,2,22,326,1,1031,1,5,2,2,3,single-choice,spatial-relational,2|3,7,2/3,220326,2
1,2,22,327,1,1526,1,7,3,3,4,single-choice,spatial-relational,3|4,7,3/4,220327,3
1,2,22,328,1,1288,1,13,6,6,7,single-choice,spatial-relational,6|7,7,6/7,220328,6
1,2,22,329,1,929,1,11,5,5,6,single-choice,spatial-relational,5|6,7,5/6,220329,5
1,2,22,330,1,1108,6,8,1,1,7,single-choice,spatial-relational,1|7,7,1/7,220330,1
1,2,22,331,1,1334,4,8,2,2,6,single-choice,spatial-relational,2|6,7,2/6,220331,2
1,2,22,332,1,1167,1,9,4,4,5,single-choice,spatial-relational,4|5,7,4/5,220332,4
1,2,22,333,0,2428,2,4,1,3,3,single-choice,spatial-relational,1|3,7,1/3,220333,1
1,2,22,334,1,1005,5,7,1,1,6,single-choice,spatial-relational,1|6,7,1/6,220334,1
1,2,22,335,1,1135,2,6,2,2,4,single-choice,spatial-relational,2|4,7,2/4,220335,2
1,2,22,336,1,1330,2,8,3,3,5,single-choice,spatial-relational,3|5,7,3/5,220336,3
1,2,22,337,1,1647,5,7,1,1,6,single-choice,spatial-relational,1|6,7,1/6,220337,1
1,2,22,338,1,896,5,9,2,2,7,single-choice,spatial-relational,2|7,7,2/7,220338,2
1,2,22,339,1,1953,1,7,3,3,4,single-choice,spatial-relational,3|4,7,3/4,220339,3
1,2,22,340,1,1657,3,9,3,3,6,single-choice,spatial-relational,3|6,7,3/6,220340,3
1,2,22,341,1,1179,1,9,4,4,5,single-choice,spatial-relational,4|5,7,4/5,220341,4
1,2,22,342,1,1258,2,10,4,4,6,single-choice,spatial-relational,4|6,7,4/6,220342,4
1,2,22,343,1,1111,4,10,3,3,7,single-choice,spatial-relational,3|7,7,3/7,220343,3
1,2,22,344,1,1424,6,8,1,1,7,single-choice,spatial-relational,1|7,7,1/7,220344,1
1,2,22,345,1,928,2,12,5,5,7,single-choice,spatial-relational,5|7,7,5/7,220345,5
1,2,22,346,1,1014,1,5,2,2,3,single-choice,spatial-relational,2|3,7,2/3,220346,2
1,2,22,347,1,1322,1,13,6,6,7,single-choice,spatial-relational,6|7,7,6/7,220347,6
1,2,22,348,1,1225,1,13,6,6,7,single-choice,spatial-relational,6|7,7,6/7,220348,6
1,2,22,349,0,814,4,6,1,5,5,single-choice,spatial-relational,1|5,7,1/5,220349,1
1,2,22,350,1,990,1,5,2,2,3,single-choice,spatial-relational,2|3,7,2/3,220350,2
1,2,22,351,1,914,3,11,4,4,7,single-choice,spatial-relational,4|7,7,4/7,220351,4
1,2,22,352,1,1263,1,3,1,1,2,single-choice,spatial-relational,1|2,7,1/2,220352,1
1,2,22,353,1,1325,2,10,4,4,6,single-choice,spatial-relational,4|6,7,4/6,220353,4
1,2,22,354,1,1920,3,11,4,4,7,single-choice,spatial-relational,4|7,7,4/7,220354,4
1,2,22,355,1,1477,4,6,1,1,5,single-choice,spatial-relational,1|5,7,1/5,220355,1
1,2,22,356,1,1067,2,8,3,3,5,single-choice,spatial-relational,3|5,7,3/5,220356,3
1,2,22,357,1,1672,3,7,2,2,5,single-choice,spatial-relational,2|5,7,2/5,220357,2
1,2,22,358,1,1483,1,11,5,5,6,single-choice,spatial-relational,5|6,7,5/6,220358,5
1,2,22,359,1,1131,1,11,5,5,6,single-choice,spatial-relational,5|6,7,5/6,220359,5
1,2,22,360,1,1188,2,6,2,2,4,single-choice,spatial-relational,2|4,7,2/4,220360,2
1,2,22,361,1,1545,4,8,2,2,6,single-choice,spatial-relational,2|6,7,2/6,220361,2
1,2,22,362,1,1375,5,7,1,1,6,single-choice,spatial-relational,1|6,7,1/6,220362,1
1,2,22,363,1,1289,2,8,3,3,5,single-choice,spatial-relational,3|5,7,3/5,220363,3
1,2,22,364,1,1301,3,9,3,3,6,single-choice,spatial-relational,3|6,7,3/6,220364,3
1,2,22,365,1,1646,2,4,1,1,3,single-choice,spatial-relational,1|3,7,1/3,220365,1
1,2,22,366,1,1622,3,5,1,1,4,single-choice,spatial-relational,1|4,7,1/4,220366,1
1,2,22,367,1,818,4,10,3,3,7,single-choice,spatial-relational,3|7,7,3/7,220367,3
1,2,22,368,1,1138,5,9,2,2,7,single-choice,spatial-relational,2|7,7,2/7,220368,2
1,2,22,369,1,978,2,12,5,5,7,single-choice,spatial-relational,5|7,7,5/7,220369,5
1,2,22,370,1,1195,2,6,2,2,4,single-choice,spatial-relational,2|4,7,2/4,220370,2
1,2,22,371,1,1144,1,7,3,3,4,single-choice,spatial-relational,3|4,7,3/4,220371,3
1,2,22,372,1,1430,3,5,1,1,4,single-choice,spatial-relational,1|4,7,1/4,220372,1
1,2,22,373,1,1259,2,4,1,1,3,single-choice,spatial-relational,1|3,7,1/3,220373,1
1,2,22,374,1,1116,6,8,1,1,7,single-choice,spatial-relational,1|7,7,1/7,220374,1
1,2,22,375,0,1068,1,3,1,2,2,single-choice,spatial-relational,1|2,7,1/2,220375,1
1,2,22,376,1,1018,1,9,4,4,5,single-choice,spatial-relational,4|5,7,4/5,220376,4
1,2,22,377,1,1368,3,7,2,2,5,single-choice,spatial-relational,2|5,7,2/5,220377,2
1,2,22,378,1,1434,4,8,2,2,6,single-choice,spatial-relational,2|6,7,2/6,220378,2
1,2,22,379,1,1221,1,11,5,5,6,single-choice,spatial-relational,5|6,7,5/6,220379,5
1,2,22,380,1,1447,3,9,3,3,6,single-choice,spatial-relational,3|6,7,3/6,220380,3
1,2,22,381,0,1457,3,5,1,4,4,single-choice,spatial-relational,1|4,7,1/4,220381,1
1,2,22,382,1,947,2,6,2,2,4,single-choice,spatial-relational,2|4,7,2/4,220382,2
1,2,22,383,1,1065,2,12,5,5,7,single-choice,spatial-relational,5|7,7,5/7,220383,5
1,2,22,384,1,1010,2,8,3,3,5,single-choice,spatial-relational,3|5,7,3/5,220384,3
1,2,22,385,1,1208,3,11,4,4,7,single-choice,spatial-relational,4|7,7,4/7,220385,4
1,2,22,386,1,1036,3,11,4,4,7,single-choice,spatial-relational,4|7,7,4/7,220386,4
1,2,22,387,1,1258,1,5,2,2,3,single-choice,spatial-relational,2|3,7,2/3,220387,2
1,2,22,388,1,946,1,13,6,6,7,single-choice,spatial-relational,6|7,7,6/7,220388,6
1,2,22,389,1,1448,5,7,1,1,6,single-choice,spatial-relational,1|6,7,1/6,220389,1
1,2,22,390,1,944,4,8,2,2,6,single-choice,spatial-relational,2|6,7,2/6,220390,2
1,2,22,391,1,1178,1,13,6,6,7,single-choice,spatial-relational,6|7,7,6/7,220391,6
1,2,22,392,1,1390,2,6,2,2,4,single-choice,spatial-relational,2|4,7,2/4,220392,2
1,2,22,393,1,1078,4,10,3,3,7,single-choice,spatial-relational,3|7,7,3/7,220393,3
1,2,22,394,1,1394,2,4,1,1,3,single-choice,spatial-relational,1|3,7,1/3,220394,1
1,2,22,395,1,1292,1,9,4,4,5,single-choice,spatial-relational,4|5,7,4/5,220395,4
1,2,22,396,0,2113,6,8,1,7,7,single-choice,spatial-relational,1|7,7,1/7,220396,1
1,2,22,397,1,933,1,7,3,3,4,single-choice,spatial-relational,3|4,7,3/4,220397,3
1,2,22,398,0,138,4,6,1,5,5,single-choice,spatial-relational,1|5,7,1/5,220398,1
1,2,22,399,1,905,5,9,2,2,7,single-choice,spatial-relational,2|7,7,2/7,220399,2
1,2,22,400,1,1206,2,10,4,4,6,single-choice,spatial-relational,4|6,7,4/6,220400,4
1,2,22,401,1,1065,3,7,2,2,5,single-choice,spatial-relational,2|5,7,2/5,220401,2
1,2,22,402,1,1439,1,3,1,1,2,single-choice,spatial-relational,1|2,7,1/2,220402,1
1,2,22,403,1,1143,5,9,2,2,7,single-choice,spatial-relational,2|7,7,2/7,220403,2
1,2,22,404,1,1220,2,10,4,4,6,single-choice,spatial-relational,4|6,7,4/6,220404,4
1,2,22,405,1,1015,1,7,3,3,4,single-choice,spatial-relational,3|4,7,3/4,220405,3
1,2,22,406,0,1765,1,9,4,5,5,single-choice,spatial-relational,4|5,7,4/5,220406,4
1,2,22,407,1,1071,2,8,3,3,5,single-choice,spatial-relational,3|5,7,3/5,220407,3
1,2,22,408,1,1241,6,8,1,1,7,single-choice,spatial-relational,1|7,7,1/7,220408,1
1,2,22,409,1,1150,3,7,2,2,5,single-choice,spatial-relational,2|5,7,2/5,220409,2
1,2,22,410,1,1620,2,4,1,1,3,single-choice,spatial-relational,1|3,7,1/3,220410,1
1,2,22,411,1,909,2,12,5,5,7,single-choice,spatial-relational,5|7,7,5/7,220411,5
1,2,22,412,1,1410,5,7,1,1,6,single-choice,spatial-relational,1|6,7,1/6,220412,1
1,2,22,413,1,1094,1,11,5,5,6,single-choice,spatial-relational,5|6,7,5/6,220413,5
1,2,22,414,1,1176,1,5,2,2,3,single-choice,spatial-relational,2|3,7,2/3,220414,2
1,2,22,415,1,1354,3,5,1,1,4,single-choice,spatial-relational,1|4,7,1/4,220415,1
1,2,22,416,1,963,4,10,3,3,7,single-choice,spatial-relational,3|7,7,3/7,220416,3
1,2,22,417,1,1228,3,9,3,3,6,single-choice,spatial-relational,3|6,7,3/6,220417,3
1,2,22,418,1,1080,4,6,1,1,5,single-choice,spatial-relational,1|5,7,1/5,220418,1
1,2,22,419,1,1174,4,8,2,2,6,single-choice,spatial-relational,2|6,7,2/6,220419,2
1,2,22,420,0,930,1,3,1,2,2,single-choice,spatial-relational,1|2,7,1/2,220420,1
1,2,22,421,1,808,2,6,2,2,4,single-choice,spatial-relational,2|4,7,2/4,220421,2
1,2,22,422,1,1186,3,7,2,2,5,single-choice,spatial-relational,2|5,7,2/5,220422,2
1,2,22,423,1,1423,3,9,3,3,6,single-choice,spatial-relational,3|6,7,3/6,220423,3
1,2,22,424,1,1057,1,7,3,3,4,single-choice,spatial-relational,3|4,7,3/4,220424,3
1,2,22,425,1,1146,3,9,3,3,6,single-choice,spatial-relational,3|6,7,3/6,220425,3
1,2,22,426,1,1298,2,4,1,1,3,single-choice,spatial-relational,1|3,7,1/3,220426,1
1,2,22,427,1,1191,3,5,1,1,4,single-choice,spatial-relational,1|4,7,1/4,220427,1
1,2,22,428,1,1391,3,5,1,1,4,single-choice,spatial-relational,1|4,7,1/4,220428,1
1,2,22,429,1,1046,1,5,2,2,3,single-choice,spatial-relational,2|3,7,2/3,220429,2
1,2,22,430,1,1029,1,5,2,2,3,single-choice,spatial-relational,2|3,7,2/3,220430,2
1,2,22,431,1,1006,4,10,3,3,7,single-choice,spatial-relational,3|7,7,3/7,220431,3
1,2,22,432,0,881,1,3,1,2,2,single-choice,spatial-relational,1|2,7,1/2,220432,1
1,2,22,433,0,801,5,9,2,7,7,single-choice,spatial-relational,2|7,7,2/7,220433,2
1,2,22,434,1,932,1,11,5,5,6,single-choice,spatial-relational,5|6,7,5/6,220434,5
1,2,22,435,1,1201,1,7,3,3,4,single-choice,spatial-relational,3|4,7,3/4,220435,3
1,2,22,436,1,1555,2,8,3,3,5,single-choice,spatial-relational,3|5,7,3/5,220436,3
1,2,22,437,1,1469,2,10,4,4,6,single-choice,spatial-relational,4|6,7,4/6,220437,4
1,2,22,438,1,1202,2,6,2,2,4,single-choice,spatial-relational,2|4,7,2/4,220438,2
1,2,22,439,1,1126,3,11,4,4,7,single-choice,spatial-relational,4|7,7,4/7,220439,4
1,2,22,440,1,1335,6,8,1,1,7,single-choice,spatial-relational,1|7,7,1/7,220440,1
1,2,22,441,1,1121,1,11,5,5,6,single-choice,spatial-relational,5|6,7,5/6,220441,5
1,2,22,442,1,1315,2,4,1,1,3,single-choice,spatial-relational,1|3,7,1/3,220442,1
1,2,22,443,1,781,1,13,6,6,7,single-choice,spatial-relational,6|7,7,6/7,220443,6
1,2,22,444,1,1046,2,12,5,5,7,single-choice,spatial-relational,5|7,7,5/7,220444,5
1,2,22,445,1,1624,2,10,4,4,6,single-choice,spatial-relational,4|6,7,4/6,220445,4
1,2,22,446,1,1542,3,7,2,2,5,single-choice,spatial-relational,2|5,7,2/5,220446,2
1,2,22,447,1,1158,4,8,2,2,6,single-choice,spatial-relational,2|6,7,2/6,220447,2
1,2,22,448,1,951,5,9,2,2,7,single-choice,spatial-relational,2|7,7,2/7,220448,2
1,2,22,449,1,1440,1,9,4,4,5,single-choice,spatial-relational,4|5,7,4/5,220449,4
1,2,22,450,1,1864,4,8,2,2,6,single-choice,spatial-relational,2|6,7,2/6,220450,2
1,2,22,451,1,923,1,13,6,6,7,single-choice,spatial-relational,6|7,7,6/7,220451,6
1,2,22,452,1,1133,4,10,3,3,7,single-choice,spatial-relational,3|7,7,3/7,220452,3
1,2,22,453,1,1109,3,11,4,4,7,single-choice,spatial-relational,4|7,7,4/7,220453,4
1,2,22,454,1,2048,1,3,1,1,2,single-choice,spatial-relational,1|2,7,1/2,220454,1
1,2,22,455,1,1181,5,7,1,1,6,single-choice,spatial-relational,1|6,7,1/6,220455,1
1,2,22,456,1,1055,5,7,1,1,6,single-choice,spatial-relational,1|6,7,1/6,220456,1
1,2,22,457,1,1094,1,9,4,4,5,single-choice,spatial-relational,4|5,7,4/5,220457,4
1,2,22,458,1,1184,6,8,1,1,7,single-choice,spatial-relational,1|7,7,1/7,220458,1
1,2,22,459,1,1240,2,8,3,3,5,single-choice,spatial-relational,3|5,7,3/5,220459,3
1,2,22,460,1,1021,2,12,5,5,7,single-choice,spatial-relational,5|7,7,5/7,220460,5
1,2,22,461,1,2084,4,6,1,1,5,single-choice,spatial-relational,1|5,7,1/5,220461,1
1,2,22,462,0,654,4,6,1,5,5,single-choice,spatial-relational,1|5,7,1/5,220462,1
1,2,22,463,1,938,3,9,3,3,6,single-choice,spatial-relational,3|6,7,3/6,220463,3
1,2,22,464,1,1263,2,4,1,1,3,single-choice,spatial-relational,1|3,7,1/3,220464,1
1,2,22,465,1,894,1,9,4,4,5,single-choice,spatial-relational,4|5,7,4/5,220465,4
1,2,22,466,1,1324,2,6,2,2,4,single-choice,spatial-relational,2|4,7,2/4,220466,2
1,2,22,467,1,1694,3,9,3,3,6,single-choice,spatial-relational,3|6,7,3/6,220467,3
1,2,22,468,1,1135,2,10,4,4,6,single-choice,spatial-relational,4|6,7,4/6,220468,4
1,2,22,469,1,1974,3,11,4,4,7,single-choice,spatial-relational,4|7,7,4/7,220469,4
1,2,22,470,1,1317,2,10,4,4,6,single-choice,spatial-relational,4|6,7,4/6,220470,4
1,2,22,471,1,1291,3,11,4,4,7,single-choice,spatial-relational,4|7,7,4/7,220471,4
1,2,22,472,1,1698,3,7,2,2,5,single-choice,spatial-relational,2|5,7,2/5,220472,2
1,2,22,473,1,1457,4,6,1,1,5,single-choice,spatial-relational,1|5,7,1/5,220473,1
1,2,22,474,1,1167,2,8,3,3,5,single-choice,spatial-relational,3|5,7,3/5,220474,3
1,2,22,475,1,1067,3,7,2,2,5,single-choice,spatial-relational,2|5,7,2/5,220475,2
1,2,22,476,1,1076,6,8,1,1,7,single-choice,spatial-relational,1|7,7,1/7,220476,1
1,2,22,477,0,735,5,7,1,6,6,single-choice,spatial-relational,1|6,7,1/6,220477,1
1,2,22,478,1,918,2,6,2,2,4,single-choice,spatial-relational,2|4,7,2/4,220478,2
1,2,22,479,1,1614,1,7,3,3,4,single-choice,spatial-relational,3|4,7,3/4,220479,3
1,2,22,480,1,1125,4,8,2,2,6,single-choice,spatial-relational,2|6,7,2/6,220480,2
1,2,22,481,1,1463,6,8,1,1,7,single-choice,spatial-relational,1|7,7,1/7,220481,1
1,2,22,482,1,877,4,10,3,3,7,single-choice,spatial-relational,3|7,7,3/7,220482,3
1,2,22,483,1,1031,2,12,5,5,7,single-choice,spatial-relational,5|7,7,5/7,220483,5
1,2,22,484,1,1184,1,11,5,5,6,single-choice,spatial-relational,5|6,7,5/6,220484,5
1,2,22,485,1,904,2,12,5,5,7,single-choice,spatial-relational,5|7,7,5/7,220485,5
1,2,22,486,1,1279,3,5,1,1,4,single-choice,spatial-relational,1|4,7,1/4,220486,1
1,2,22,487,1,861,1,13,6,6,7,single-choice,spatial-relational,6|7,7,6/7,220487,6
1,2,22,488,1,1539,2,8,3,3,5,single-choice,spatial-relational,3|5,7,3/5,220488,3
1,2,22,489,0,772,3,5,1,4,4,single-choice,spatial-relational,1|4,7,1/4,220489,1
1,2,22,490,1,1044,5,7,1,1,6,single-choice,spatial-relational,1|6,7,1/6,220490,1
1,2,22,491,1,1522,1,13,6,6,7,single-choice,spatial-relational,6|7,7,6/7,220491,6
1,2,22,492,0,2441,1,3,1,2,2,single-choice,spatial-relational,1|2,7,1/2,220492,1
1,2,22,493,1,1020,4,8,2,2,6,single-choice,spatial-relational,2|6,7,2/6,220493,2
1,2,22,494,1,895,1,7,3,3,4,single-choice,spatial-relational,3|4,7,3/4,220494,3
1,2,22,495,1,1160,1,5,2,2,3,single-choice,spatial-relational,2|3,7,2/3,220495,2
1,2,22,496,1,1149,1,3,1,1,2,single-choice,spatial-relational,1|2,7,1/2,220496,1
1,2,22,497,1,1038,1,11,5,5,6,single-choice,spatial-relational,5|6,7,5/6,220497,5
1,2,22,498,1,1825,5,9,2,2,7,single-choice,spatial-relational,2|7,7,2/7,220498,2
1,2,22,499,1,953,5,9,2,2,7,single-choice,spatial-relational,2|7,7,2/7,220499,2
1,2,22,500,1,1072,4,10,3,3,7,single-choice,spatial-relational,3|7,7,3/7,220500,3
1,2,22,501,1,940,1,5,2,2,3,single-choice,spatial-relational,2|3,7,2/3,220501,2
1,2,22,502,1,1395,4,6,1,1,5,single-choice,spatial-relational,1|5,7,1/5,220502,1
1,2,22,503,1,1284,2,4,1,1,3,single-choice,spatial-relational,1|3,7,1/3,220503,1
1,2,22,504,1,1082,1,9,4,4,5,single-choice,spatial-relational,4|5,7,4/5,220504,4
1,2,22,505,1,1789,6,8,1,1,7,single-choice,spatial-relational,1|7,7,1/7,220505,1
1,2,22,506,1,917,1,7,3,3,4,single-choice,spatial-relational,3|4,7,3/4,220506,3
1,2,22,507,1,1149,1,11,5,5,6,single-choice,spatial-relational,5|6,7,5/6,220507,5
1,2,22,508,1,1275,6,8,1,1,7,single-choice,spatial-relational,1|7,7,1/7,220508,1
1,2,22,509,0,668,2,4,1,3,3,single-choice,spatial-relational,1|3,7,1/3,220509,1
1,2,22,510,1,908,3,11,4,4,7,single-choice,spatial-relational,4|7,7,4/7,220510,4
1,2,22,511,1,1129,1,7,3,3,4,single-choice,spatial-relational,3|4,7,3/4,220511,3
1,2,22,512,1,1489,1,3,1,1,2,single-choice,spatial-relational,1|2,7,1/2,220512,1
1,2,22,513,1,1643,4,10,3,3,7,single-choice,spatial-relational,3|7,7,3/7,220513,3
1,2,22,514,1,935,3,11,4,4,7,single-choice,spatial-relational,4|7,7,4/7,220514,4
1,2,22,515,0,142,1,13,6,7,7,single-choice,spatial-relational,6|7,7,6/7,220515,6
1,2,22,516,1,780,1,11,5,5,6,single-choice,spatial-relational,5|6,7,5/6,220516,5
1,2,22,517,1,1368,2,6,2,2,4,single-choice,spatial-relational,2|4,7,2/4,220517,2
1,2,22,518,1,1579,3,7,2,2,5,single-choice,spatial-relational,2|5,7,2/5,220518,2
1,2,22,519,1,1658,5,9,2,2,7,single-choice,spatial-relational,2|7,7,2/7,220519,2
1,2,22,520,1,912,1,13,6,6,7,single-choice,spatial-relational,6|7,7,6/7,220520,6
1,2,22,521,1,1725,2,4,1,1,3,single-choice,spatial-relational,1|3,7,1/3,220521,1
1,2,22,522,1,1374,4,6,1,1,5,single-choice,spatial-relational,1|5,7,1/5,220522,1
1,2,22,523,1,1227,2,8,3,3,5,single-choice,spatial-relational,3|5,7,3/5,220523,3
1,2,22,524,1,1253,2,10,4,4,6,single-choice,spatial-relational,4|6,7,4/6,220524,4
1,2,22,525,1,1229,4,10,3,3,7,single-choice,spatial-relational,3|7,7,3/7,220525,3
1,2,22,526,1,2060,5,7,1,1,6,single-choice,spatial-relational,1|6,7,1/6,220526,1
1,2,22,527,1,1853,2,8,3,3,5,single-choice,spatial-relational,3|5,7,3/5,220527,3
1,2,22,528,1,1015,5,9,2,2,7,single-choice,spatial-relational,2|7,7,2/7,220528,2
1,2,22,529,1,927,2,12,5,5,7,single-choice,spatial-relational,5|7,7,5/7,220529,5
1,2,22,530,1,2086,1,5,2,2,3,single-choice,spatial-relational,2|3,7,2/3,220530,2
1,2,22,531,1,1124,5,7,1,1,6,single-choice,spatial-relational,1|6,7,1/6,220531,1
1,2,22,532,0,114,4,8,2,6,6,single-choice,spatial-relational,2|6,7,2/6,220532,2
1,2,22,533,1,1018,2,6,2,2,4,single-choice,spatial-relational,2|4,7,2/4,220533,2
1,2,22,534,1,991,1,9,4,4,5,single-choice,spatial-relational,4|5,7,4/5,220534,4
1,2,22,535,1,1038,2,12,5,5,7,single-choice,spatial-relational,5|7,7,5/7,220535,5
1,2,22,536,1,1166,4,8,2,2,6,single-choice,spatial-relational,2|6,7,2/6,220536,2
1,2,22,537,1,1380,4,6,1,1,5,single-choice,spatial-relational,1|5,7,1/5,220537,1
1,2,22,538,1,1082,3,7,2,2,5,single-choice,spatial-relational,2|5,7,2/5,220538,2
1,2,22,539,0,122,3,9,3,6,6,single-choice,spatial-relational,3|6,7,3/6,220539,3
1,2,22,540,1,1130,1,3,1,1,2,single-choice,spatial-relational,1|2,7,1/2,220540,1
1,2,22,541,1,901,2,10,4,4,6,single-choice,spatial-relational,4|6,7,4/6,220541,4
1,2,22,542,1,1223,3,5,1,1,4,single-choice,spatial-relational,1|4,7,1/4,220542,1
1,2,22,543,1,1116,1,9,4,4,5,single-choice,spatial-relational,4|5,7,4/5,220543,4
1,2,22,544,1,1250,3,5,1,1,4,single-choice,spatial-relational,1|4,7,1/4,220544,1
1,2,22,545,1,1297,1,5,2,2,3,single-choice,spatial-relational,2|3,7,2/3,220545,2
1,2,22,546,1,1572,3,9,3,3,6,single-choice,spatial-relational,3|6,7,3/6,220546,3
1,2,22,547,1,1154,5,9,2,2,7,single-choice,spatial-relational,2|7,7,2/7,220547,2
1,2,22,548,1,1099,4,8,2,2,6,single-choice,spatial-relational,2|6,7,2/6,220548,2
1,2,22,549,1,1034,3,11,4,4,7,single-choice,spatial-relational,4|7,7,4/7,220549,4
1,2,22,550,1,1060,3,11,4,4,7,single-choice,spatial-relational,4|7,7,4/7,220550,4
1,2,22,551,1,1127,2,12,5,5,7,single-choice,spatial-relational,5|7,7,5/7,220551,5
1,2,22,552,1,2020,3,9,3,3,6,single-choice,spatial-relational,3|6,7,3/6,220552,3
1,2,22,553,1,1385,2,10,4,4,6,single-choice,spatial-relational,4|6,7,4/6,220553,4
1,2,22,554,1,1795,3,9,3,3,6,single-choice,spatial-relational,3|6,7,3/6,220554,3
1,2,22,555,1,1166,2,6,2,2,4,single-choice,spatial-relational,2|4,7,2/4,220555,2
1,2,22,556,0,179,5,7,1,6,6,single-choice,spatial-relational,1|6,7,1/6,220556,1
1,2,22,557,1,1008,1,9,4,4,5,single-choice,spatial-relational,4|5,7,4/5,220557,4
1,2,22,558,1,1316,5,7,1,1,6,single-choice,spatial-relational,1|6,7,1/6,220558,1
1,2,22,559,1,686,1,11,5,5,6,single-choice,spatial-relational,5|6,7,5/6,220559,5
1,2,22,560,0,173,2,12,5,7,7,single-choice,spatial-relational,5|7,7,5/7,220560,5
1,2,22,561,1,1010,3,7,2,2,5,single-choice,spatial-relational,2|5,7,2/5,220561,2
1,2,22,562,1,1094,1,5,2,2,3,single-choice,spatial-relational,2|3,7,2/3,220562,2
1,2,22,563,1,988,1,9,4,4,5,single-choice,spatial-relational,4|5,7,4/5,220563,4
1,2,22,564,1,1055,1,11,5,5,6,single-choice,spatial-relational,5|6,7,5/6,220564,5
1,2,22,565,1,2738,1,3,1,1,2,single-choice,spatial-relational,1|2,7,1/2,220565,1
1,2,22,566,0,1052,1,5,2,3,3,single-choice,spatial-relational,2|3,7,2/3,220566,2
1,2,22,567,1,1029,2,4,1,1,3,single-choice,spatial-relational,1|3,7,1/3,220567,1
1,2,22,568,1,1116,3,5,1,1,4,single-choice,spatial-relational,1|4,7,1/4,220568,1
1,2,22,569,1,889,5,9,2,2,7,single-choice,spatial-relational,2|7,7,2/7,220569,2
1,2,22,570,1,1114,4,6,1,1,5,single-choice,spatial-relational,1|5,7,1/5,220570,1
1,2,22,571,1,1127,3,7,2,2,5,single-choice,spatial-relational,2|5,7,2/5,220571,2
1,2,22,572,1,1285,4,6,1,1,5,single-choice,spatial-relational,1|5,7,1/5,220572,1
1,2,22,573,1,1394,2,6,2,2,4,single-choice,spatial-relational,2|4,7,2/4,220573,2
1,2,22,574,1,2340,2,8,3,3,5,single-choice,spatial-relational,3|5,7,3/5,220574,3
1,2,22,575,1,87,1,13,6,6,7,single-choice,spatial-relational,6|7,7,6/7,220575,6
1,2,22,576,1,1441,1,13,6,6,7,single-choice,spatial-relational,6|7,7,6/7,220576,6
1,2,22,577,1,1514,6,8,1,1,7,single-choice,spatial-relational,1|7,7,1/7,220577,1
1,2,22,578,1,1083,1,7,3,3,4,single-choice,spatial-relational,3|4,7,3/4,220578,3
1,2,22,579,1,1693,1,3,1,1,2,single-choice,spatial-relational,1|2,7,1/2,220579,1
1,2,22,580,1,961,6,8,1,1,7,single-choice,spatial-relational,1|7,7,1/7,220580,1
1,2,22,581,1,800,1,7,3,3,4,single-choice,spatial-relational,3|4,7,3/4,220581,3
1,2,22,582,1,1608,2,4,1,1,3,single-choice,spatial-relational,1|3,7,1/3,220582,1
1,2,22,583,1,924,4,10,3,3,7,single-choice,spatial-relational,3|7,7,3/7,220583,3
1,2,22,584,1,1038,4,10,3,3,7,single-choice,spatial-relational,3|7,7,3/7,220584,3
1,2,22,585,1,1557,2,10,4,4,6,single-choice,spatial-relational,4|6,7,4/6,220585,4
1,2,22,586,1,971,4,8,2,2,6,single-choice,spatial-relational,2|6,7,2/6,220586,2
1,2,22,587,0,103,3,5,1,4,4,single-choice,spatial-relational,1|4,7,1/4,220587,1
1,2,22,588,1,1944,2,8,3,3,5,single-choice,spatial-relational,3|5,7,3/5,220588,3
1,2,22,589,1,1304,2,6,2,2,4,single-choice,spatial-relational,2|4,7,2/4,220589,2
1,2,22,590,1,1133,2,8,3,3,5,single-choice,spatial-relational,3|5,7,3/5,220590,3
1,2,22,591,1,1359,2,8,3,3,5,single-choice,spatial-relational,3|5,7,3/5,220591,3
1,2,22,592,1,1336,3,9,3,3,6,single-choice,spatial-relational,3|6,7,3/6,220592,3
1,2,22,593,1,974,5,9,2,2,7,single-choice,spatial-relational,2|7,7,2/7,220593,2
1,2,22,594,1,990,1,11,5,5,6,single-choice,spatial-relational,5|6,7,5/6,220594,5
1,2,22,595,1,903,1,13,6,6,7,single-choice,spatial-relational,6|7,7,6/7,220595,6
1,2,22,596,0,138,4,8,2,6,6,single-choice,spatial-relational,2|6,7,2/6,220596,2
1,2,22,597,1,1015,1,5,2,2,3,single-choice,spatial-relational,2|3,7,2/3,220597,2
1,2,22,598,1,1049,2,12,5,5,7,single-choice,spatial-relational,5|7,7,5/7,220598,5
1,2,22,599,1,1045,3,11,4,4,7,single-choice,spatial-relational,4|7,7,4/7,220599,4
1,2,22,600,1,1258,1,9,4,4,5,single-choice,spatial-relational,4|5,7,4/5,220600,4
2,2,22,1,1,834,1,13,6,6,7,single-choice,spatial-relational,6|7,7,6/7,220001,6
2,2,22,2,0,961,2,6,2,4,4,single-choice,spatial-relational,2|4,7,2/4,220002,2
2,2,22,3,0,542,5,9,2,7,7,single-choice,spatial-relational,2|7,7,2/7,220003,2
2,2,22,4,0,527,6,8,1,7,7,single-choice,spatial-relational,1|7,7,1/7,220004,1
2,2,22,5,1,1096,1,7,3,3,4,single-choice,spatial-relational,3|4,7,3/4,220005,3
2,2,22,6,0,1243,1,3,1,2,2,single-choice,spatial-relational,1|2,7,1/2,220006,1
2,2,22,7,0,902,3,9,3,6,6,single-choice,spatial-relational,3|6,7,3/6,220007,3
2,2,22,8,0,77,4,10,3,7,7,single-choice,spatial-relational,3|7,7,3/7,220008,3
2,2,22,9,0,665,5,7,1,6,6,single-choice,spatial-relational,1|6,7,1/6,220009,1
2,2,22,10,0,732,2,6,2,4,4,single-choice,spatial-relational,2|4,7,2/4,220010,2
2,2,22,11,0,132,1,5,2,3,3,single-choice,spatial-relational,2|3,7,2/3,220011,2
2,2,22,12,0,588,4,6,1,5,5,single-choice,spatial-relational,1|5,7,1/5,220012,1
2,2,22,13,0,541,3,5,1,4,4,single-choice,spatial-relational,1|4,7,1/4,220013,1
2,2,22,14,0,685,2,4,1,3,3,single-choice,spatial-relational,1|3,7,1/3,220014,1
2,2,22,15,1,944,1,11,5,5,6,single-choice,spatial-relational,5|6,7,5/6,220015,5
2,2,22,16,0,885,3,5,1,4,4,single-choice,spatial-relational,1|4,7,1/4,220016,1
2,2,22,17,1,1578,1,9,4,4,5,single-choice,spatial-relational,4|5,7,4/5,220017,4
2,2,22,18,0,1716,1,3,1,2,2,single-choice,spatial-relational,1|2,7,1/2,220018,1
2,2,22,19,1,1061,4,8,2,2,6,single-choice,spatial-relational,2|6,7,2/6,220019,2
2,2,22,20,1,1091,1,13,6,6,7,single-choice,spatial-relational,6|7,7,6/7,220020,6
2,2,22,21,1,1758,2,8,3,3,5,single-choice,spatial-relational,3|5,7,3/5,220021,3
2,2,22,22,0,846,2,4,1,3,3,single-choice,spatial-relational,1|3,7,1/3,220022,1
2,2,22,23,1,944,5,9,2,2,7,single-choice,spatial-relational,2|7,7,2/7,220023,2
2,2,22,24,1,2012,3,7,2,2,5,single-choice,spatial-relational,2|5,7,2/5,220024,2
2,2,22,25,0,1357,2,8,3,5,5,single-choice,spatial-relational,3|5,7,3/5,220025,3
2,2,22,26,1,715,3,11,4,4,7,single-choice,spatial-relational,4|7,7,4/7,220026,4
2,2,22,27,1,1316,2,12,5,5,7,single-choice,spatial-relational,5|7,7,5/7,220027,5
2,2,22,28,1,1290,1,5,2,2,3,single-choice,spatial-relational,2|3,7,2/3,220028,2
2,2,22,29,1,1714,3,7,2,2,5,single-choice,spatial-relational,2|5,7,2/5,220029,2
2,2,22,30,1,1668,2,10,4,4,6,single-choice,spatial-relational,4|6,7,4/6,220030,4
2,2,22,31,0,1326,4,6,1,5,5,single-choice,spatial-relational,1|5,7,1/5,220031,1
2,2,22,32,1,962,1,7,3,3,4,single-choice,spatial-relational,3|4,7,3/4,220032,3
2,2,22,33,1,1229,3,11,4,4,7,single-choice,spatial-relational,4|7,7,4/7,220033,4
2,2,22,34,1,910,1,11,5,5,6,single-choice,spatial-relational,5|6,7,5/6,220034,5
2,2,22,35,1,1160,2,10,4,4,6,single-choice,spatial-relational,4|6,7,4/6,220035,4
2,2,22,36,1,1031,2,12,5,5,7,single-choice,spatial-relational,5|7,7,5/7,220036,5
2,2,22,37,0,3248,5,7,1,6,6,single-choice,spatial-relational,1|6,7,1/6,220037,1
2,2,22,38,1,1151,6,8,1,1,7,single-choice,spatial-relational,1|7,7,1/7,220038,1
2,2,22,39,1,963,1,9,4,4,5,single-choice,spatial-relational,4|5,7,4/5,220039,4
2,2,22,40,1,1168,4,8,2,2,6,single-choice,spatial-relational,2|6,7,2/6,220040,2
2,2,22,41,1,900,4,10,3,3,7,single-choice,spatial-relational,3|7,7,3/7,220041,3
2,2,22,42,1,862,3,9,3,3,6,single-choice,spatial-relational,3|6,7,3/6,220042,3
2,2,22,43,1,830,4,10,3,3,7,single-choice,spatial-relational,3|7,7,3/7,220043,3
2,2,22,44,1,1027,3,9,3,3,6,single-choice,spatial-relational,3|6,7,3/6,220044,3
2,2,22,45,1,1382,2,8,3,3,5,single-choice,spatial-relational,3|5,7,3/5,220045,3
2,2,22,46,1,1033,1,7,3,3,4,single-choice,spatial-relational,3|4,7,3/4,220046,3
2,2,22,47,1,982,1,11,5,5,6,single-choice,spatial-relational,5|6,7,5/6,220047,5
2,2,22,48,1,3586,2,6,2,2,4,single-choice,spatial-relational,2|4,7,2/4,220048,2
2,2,22,49,0,846,1,3,1,2,2,single-choice,spatial-relational,1|2,7,1/2,220049,1
2,2,22,50,1,883,5,7,1,1,6,single-choice,spatial-relational,1|6,7,1/6,220050,1
2,2,22,51,1,935,5,9,2,2,7,single-choice,spatial-relational,2|7,7,2/7,220051,2
2,2,22,52,1,1331,4,8,2,2,6,single-choice,spatial-relational,2|6,7,2/6,220052,2
2,2,22,53,1,1592,5,7,1,1,6,single-choice,spatial-relational,1|6,7,1/6,220053,1
2,2,22,54,1,871,2,12,5,5,7,single-choice,spatial-relational,5|7,7,5/7,220054,5
2,2,22,55,1,1198,1,13,6,6,7,single-choice,spatial-relational,6|7,7,6/7,220055,6
2,2,22,56,1,1320,6,8,1,1,7,single-choice,spatial-relational,1|7,7,1/7,220056,1
2,2,22,57,0,733,2,4,1,3,3,single-choice,spatial-relational,1|3,7,1/3,220057,1
2,2,22,58,1,860,3,11,4,4,7,single-choice,spatial-relational,4|7,7,4/7,220058,4
2,2,22,59,1,972,5,9,2,2,7,single-choice,spatial-relational,2|7,7,2/7,220059,2
2,2,22,60,1,1001,3,11,4,4,7,single-choice,spatial-relational,4|7,7,4/7,220060,4
2,2,22,61,1,1275,2,4,1,1,3,single-choice,spatial-relational,1|3,7,1/3,220061,1
2,2,22,62,1,755,2,12,5,5,7,single-choice,spatial-relational,5|7,7,5/7,220062,5
2,2,22,63,1,1139,1,9,4,4,5,single-choice,spatial-relational,4|5,7,4/5,220063,4
2,2,22,64,1,1204,2,10,4,4,6,single-choice,spatial-relational,4|6,7,4/6,220064,4
2,2,22,65,1,960,4,8,2,2,6,single-choice,spatial-relational,2|6,7,2/6,220065,2
2,2,22,66,1,1378,1,13,6,6,7,single-choice,spatial-relational,6|7,7,6/7,220066,6
2,2,22,67,0,871,3,7,2,5,5,single-choice,spatial-relational,2|5,7,2/5,220067,2
2,2,22,68,1,984,6,8,1,1,7,single-choice,spatial-relational,1|7,7,1/7,220068,1
2,2,22,69,0,859,1,3,1,2,2,single-choice,spatial-relational,1|2,7,1/2,220069,1
2,2,22,70,1,771,4,10,3,3,7,single-choice,spatial-relational,3|7,7,3/7,220070,3
2,2,22,71,1,1184,3,5,1,1,4,single-choice,spatial-relational,1|4,7,1/4,220071,1
2,2,22,72,1,1024,1,5,2,2,3,single-choice,spatial-relational,2|3,7,2/3,220072,2
2,2,22,73,1,1108,1,5,2,2,3,single-choice,spatial-relational,2|3,7,2/3,220073,2
2,2,22,74,1,1530,2,8,3,3,5,single-choice,spatial-relational,3|5,7,3/5,220074,3
2,2,22,75,1,949,3,7,2,2,5,single-choice,spatial-relational,2|5,7,2/5,220075,2
2,2,22,76,1,936,1,11,5,5,6,single-choice,spatial-relational,5|6,7,5/6,220076,5
2,2,22,77,1,1469,4,6,1,1,5,single-choice,spatial-relational,1|5,7,1/5,220077,1
2,2,22,78,1,943,1,7,3,3,4,single-choice,spatial-relational,3|4,7,3/4,220078,3
2,2,22,79,1,947,1,9,4,4,5,single-choice,spatial-relational,4|5,7,4/5,220079,4
2,2,22,80,1,5506,2,6,2,2,4,single-choice,spatial-relational,2|4,7,2/4,220080,2
2,2,22,81,1,994,2,10,4,4,6,single-choice,spatial-relational,4|6,7,4/6,220081,4
2,2,22,82,1,2835,3,5,1,1,4,single-choice,spatial-relational,1|4,7,1/4,220082,1
2,2,22,83,1,1117,4,6,1,1,5,single-choice,spatial-relational,1|5,7,1/5,220083,1
2,2,22,84,1,1114,3,9,3,3,6,single-choice,spatial-relational,3|6,7,3/6,220084,3
2,2,22,85,1,1123,3,5,1,1,4,single-choice,spatial-relational,1|4,7,1/4,220085,1
2,2,22,86,1,914,5,9,2,2,7,single-choice,spatial-relational,2|7,7,2/7,220086,2
2,2,22,87,1,1096,1,5,2,2,3,single-choice,spatial-relational,2|3,7,2/3,220087,2
2,2,22,88,1,1128,3,7,2,2,5,single-choice,spatial-relational,2|5,7,2/5,220088,2
2,2,22,89,1,1714,5,7,1,1,6,single-choice,spatial-relational,1|6,7,1/6,220089,1
2,2,22,90,0,1289,1,3,1,2,2,single-choice,spatial-relational,1|2,7,1/2,220090,1
2,2,22,91,1,1388,2,4,1,1,3,single-choice,spatial-relational,1|3,7,1/3,220091,1
2,2,22,92,1,1157,6,8,1,1,7,single-choice,spatial-relational,1|7,7,1/7,220092,1
2,2,22,93,1,1285,3,7,2,2,5,single-choice,spatial-relational,2|5,7,2/5,220093,2
2,2,22,94,1,1221,4,8,2,2,6,single-choice,spatial-relational,2|6,7,2/6,220094,2
2,2,22,95,1,1033,1,3,1,1,2,single-choice,spatial-relational,1|2,7,1/2,220095,1
2,2,22,96,1,996,3,9,3,3,6,single-choice,spatial-relational,3|6,7,3/6,220096,3
2,2,22,97,1,1013,1,9,4,4,5,single-choice,spatial-relational,4|5,7,4/5,220097,4
2,2,22,98,1,1089,2,12,5,5,7,single-choice,spatial-relational,5|7,7,5/7,220098,5
2,2,22,99,1,1201,2,10,4,4,6,single-choice,spatial-relational,4|6,7,4/6,220099,4
2,2,22,100,1,1041,2,10,4,4,6,single-choice,spatial-relational,4|6,7,4/6,220100,4
2,2,22,101,1,1452,6,8,1,1,7,single-choice,spatial-relational,1|7,7,1/7,220101,1
2,2,22,102,1,866,1,11,5,5,6,single-choice,spatial-relational,5|6,7,5/6,220102,5
2,2,22,103,0,786,4,6,1,5,5,single-choice,spatial-relational,1|5,7,1/5,220103,1
2,2,22,104,1,912,4,8,2,2,6,single-choice,spatial-relational,2|6,7,2/6,220104,2
2,2,22,105,1,828,3,11,4,4,7,single-choice,spatial-relational,4|7,7,4/7,220105,4
2,2,22,106,1,1047,1,7,3,3,4,single-choice,spatial-relational,3|4,7,3/4,220106,3
2,2,22,107,1,1041,4,10,3,3,7,single-choice,spatial-relational,3|7,7,3/7,220107,3
2,2,22,108,1,1097,2,6,2,2,4,single-choice,spatial-relational,2|4,7,2/4,220108,2
2,2,22,109,1,1065,1,13,6,6,7,single-choice,spatial-relational,6|7,7,6/7,220109,6
2,2,22,110,1,1471,5,9,2,2,7,single-choice,spatial-relational,2|7,7,2/7,220110,2
2,2,22,111,1,896,1,5,2,2,3,single-choice,spatial-relational,2|3,7,2/3,220111,2
2,2,22,112,1,997,3,11,4,4,7,single-choice,spatial-relational,4|7,7,4/7,220112,4
2,2,22,113,1,1360,2,4,1,1,3,single-choice,spatial-relational,1|3,7,1/3,220113,1
2,2,22,114,1,1311,2,8,3,3,5,single-choice,spatial-relational,3|5,7,3/5,220114,3
2,2,22,115,1,967,2,12,5,5,7,single-choice,spatial-relational,5|7,7,5/7,220115,5
2,2,22,116,1,1118,1,11,5,5,6,single-choice,spatial-relational,5|6,7,5/6,220116,5
2,2,22,117,1,1282,5,7,1,1,6,single-choice,spatial-relational,1|6,7,1/6,220117,1
2,2,22,118,1,880,2,8,3,3,5,single-choice,spatial-relational,3|5,7,3/5,220118,3
2,2,22,119,1,1278,1,7,3,3,4,single-choice,spatial-relational,3|4,7,3/4,220119,3
2,2,22,120,1,1400,4,6,1,1,5,single-choice,spatial-relational,1|5,7,1/5,220120,1
2,2,22,121,1,811,4,10,3,3,7,single-choice,spatial-relational,3|7,7,3/7,220121,3
2,2,22,122,1,1071,3,9,3,3,6,single-choice,spatial-relational,3|6,7,3/6,220122,3
2,2,22,123,1,1121,2,6,2,2,4,single-choice,spatial-relational,2|4,7,2/4,220123,2
2,2,22,124,1,1239,1,13,6,6,7,single-choice,spatial-relational,6|7,7,6/7,220124,6
2,2,22,125,1,1812,1,9,4,4,5,single-choice,spatial-relational,4|5,7,4/5,220125,4
2,2,22,126,1,1677,3,5,1,1,4,single-choice,spatial-relational,1|4,7,1/4,220126,1
2,2,22,127,1,881,2,12,5,5,7,single-choice,spatial-relational,5|7,7,5/7,220127,5
2,2,22,128,1,1106,3,11,4,4,7,single-choice,spatial-relational,4|7,7,4/7,220128,4
2,2,22,129,1,990,1,5,2,2,3,single-choice,spatial-relational,2|3,7,2/3,220129,2
2,2,22,130,1,1467,2,10,4,4,6,single-choice,spatial-relational,4|6,7,4/6,220130,4
2,2,22,131,1,1224,4,6,1,1,5,single-choice,spatial-relational,1|5,7,1/5,220131,1
2,2,22,132,1,938,4,8,2,2,6,single-choice,spatial-relational,2|6,7,2/6,220132,2
2,2,22,133,1,1155,2,8,3,3,5,single-choice,spatial-relational,3|5,7,3/5,220133,3
2,2,22,134,1,915,1,7,3,3,4,single-choice,spatial-relational,3|4,7,3/4,220134,3
2,2,22,135,1,1336,2,4,1,1,3,single-choice,spatial-relational,1|3,7,1/3,220135,1
2,2,22,136,1,975,6,8,1,1,7,single-choice,spatial-relational,1|7,7,1/7,220136,1
2,2,22,137,1,821,2,10,4,4,6,single-choice,spatial-relational,4|6,7,4/6,220137,4
2,2,22,138,1,1384,2,8,3,3,5,single-choice,spatial-relational,3|5,7,3/5,220138,3
2,2,22,139,0,107,3,5,1,4,4,single-choice,spatial-relational,1|4,7,1/4,220139,1
2,2,22,140,1,1098,3,9,3,3,6,single-choice,spatial-relational,3|6,7,3/6,220140,3
2,2,22,141,1,971,5,9,2,2,7,single-choice,spatial-relational,2|7,7,2/7,220141,2
2,2,22,142,1,923,3,9,3,3,6,single-choice,spatial-relational,3|6,7,3/6,220142,3
2,2,22,143,1,1166,3,7,2,2,5,single-choice,spatial-relational,2|5,7,2/5,220143,2
2,2,22,144,1,846,3,11,4,4,7,single-choice,spatial-relational,4|7,7,4/7,220144,4
2,2,22,145,1,1165,2,6,2,2,4,single-choice,spatial-relational,2|4,7,2/4,220145,2
2,2,22,146,1,945,2,12,5,5,7,single-choice,spatial-relational,5|7,7,5/7,220146,5
2,2,22,147,1,1146,1,5,2,2,3,single-choice,spatial-relational,2|3,7,2/3,220147,2
2,2,22,148,1,1428,1,9,4,4,5,single-choice,spatial-relational,4|5,7,4/5,220148,4
2,2,22,149,1,983,4,8,2,2,6,single-choice,spatial-relational,2|6,7,2/6,220149,2
2,2,22,150,1,1310,4,6,1,1,5,single-choice,spatial-relational,1|5,7,1/5,220150,1
2,2,22,151,1,974,3,7,2,2,5,single-choice,spatial-relational,2|5,7,2/5,220151,2
2,2,22,152,0,850,1,3,1,2,2,single-choice,spatial-relational,1|2,7,1/2,220152,1
2,2,22,153,1,1133,2,6,2,2,4,single-choice,spatial-relational,2|4,7,2/4,220153,2
2,2,22,154,1,914,1,7,3,3,4,single-choice,spatial-relational,3|4,7,3/4,220154,3
2,2,22,155,1,1038,4,10,3,3,7,single-choice,spatial-relational,3|7,7,3/7,220155,3
2,2,22,156,1,1169,1,13,6,6,7,single-choice,spatial-relational,6|7,7,6/7,220156,6
2,2,22,157,1,1100,1,9,4,4,5,single-choice,spatial-relational,4|5,7,4/5,220157,4
2,2,22,158,1,1463,5,7,1,1,6,single-choice,spatial-relational,1|6,7,1/6,220158,1
2,2,22,159,0,686,2,4,1,3,3,single-choice,spatial-relational,1|3,7,1/3,220159,1
2,2,22,160,1,828,5,9,2,2,7,single-choice,spatial-relational,2|7,7,2/7,220160,2
2,2,22,161,1,1562,1,3,1,1,2,single-choice,spatial-relational,1|2,7,1/2,220161,1
2,2,22,162,1,1255,6,8,1,1,7,single-choice,spatial-relational,1|7,7,1/7,220162,1
2,2,22,163,1,894,1,13,6,6,7,single-choice,spatial-relational,6|7,7,6/7,220163,6
2,2,22,164,1,188,5,7,1,1,6,single-choice,spatial-relational,1|6,7,1/6,220164,1
2,2,22,165,1,1253,3,5,1,1,4,single-choice,spatial-relational,1|4,7,1/4,220165,1
2,2,22,166,1,963,4,10,3,3,7,single-choice,spatial-relational,3|7,7,3/7,220166,3
2,2,22,167,1,970,1,11,5,5,6,single-choice,spatial-relational,5|6,7,5/6,220167,5
2,2,22,168,1,1140,1,11,5,5,6,single-choice,spatial-relational,5|6,7,5/6,220168,5
2,2,22,169,1,1059,3,11,4,4,7,single-choice,spatial-relational,4|7,7,4/7,220169,4
2,2,22,170,1,1288,1,5,2,2,3,single-choice,spatial-relational,2|3,7,2/3,220170,2
2,2,22,171,1,868,1,7,3,3,4,single-choice,spatial-relational,3|4,7,3/4,220171,3
2,2,22,172,1,1212,3,5,1,1,4,single-choice,spatial-relational,1|4,7,1/4,220172,1
2,2,22,173,1,959,3,7,2,2,5,single-choice,spatial-relational,2|5,7,2/5,220173,2
2,2,22,174,1,964,3,9,3,3,6,single-choice,spatial-relational,3|6,7,3/6,220174,3
2,2,22,175,1,1115,3,9,3,3,6,single-choice,spatial-relational,3|6,7,3/6,220175,3
2,2,22,176,1,1195,1,11,5,5,6,single-choice,spatial-relational,5|6,7,5/6,220176,5
2,2,22,177,1,1273,5,9,2,2,7,single-choice,spatial-relational,2|7,7,2/7,220177,2
2,2,22,178,1,922,1,5,2,2,3,single-choice,spatial-relational,2|3,7,2/3,220178,2
2,2,22,179,1,988,2,12,5,5,7,single-choice,spatial-relational,5|7,7,5/7,220179,5
2,2,22,180,1,1095,1,13,6,6,7,single-choice,spatial-relational,6|7,7,6/7,220180,6
2,2,22,181,0,133,4,8,2,6,6,single-choice,spatial-relational,2|6,7,2/6,220181,2
2,2,22,182,1,1006,4,6,1,1,5,single-choice,spatial-relational,1|5,7,1/5,220182,1
2,2,22,183,1,888,4,10,3,3,7,single-choice,spatial-relational,3|7,7,3/7,220183,3
2,2,22,184,1,1301,2,8,3,3,5,single-choice,spatial-relational,3|5,7,3/5,220184,3
2,2,22,185,1,916,3,7,2,2,5,single-choice,spatial-relational,2|5,7,2/5,220185,2
2,2,22,186,1,1254,5,7,1,1,6,single-choice,spatial-relational,1|6,7,1/6,220186,1
2,2,22,187,1,941,1,13,6,6,7,single-choice,spatial-relational,6|7,7,6/7,220187,6
2,2,22,188,1,1446,6,8,1,1,7,single-choice,spatial-relational,1|7,7,1/7,220188,1
2,2,22,189,0,815,2,4,1,3,3,single-choice,spatial-relational,1|3,7,1/3,220189,1
2,2,22,190,1,922,2,6,2,2,4,single-choice,spatial-relational,2|4,7,2/4,220190,2
2,2,22,191,1,1010,1,3,1,1,2,single-choice,spatial-relational,1|2,7,1/2,220191,1
2,2,22,192,1,926,1,7,3,3,4,single-choice,spatial-relational,3|4,7,3/4,220192,3
2,2,22,193,0,1669,1,9,4,5,5,single-choice,spatial-relational,4|5,7,4/5,220193,4
2,2,22,194,1,878,1,11,5,5,6,single-choice,spatial-relational,5|6,7,5/6,220194,5
2,2,22,195,1,1115,4,8,2,2,6,single-choice,spatial-relational,2|6,7,2/6,220195,2
2,2,22,196,0,873,1,3,1,2,2,single-choice,spatial-relational,1|2,7,1/2,220196,1
2,2,22,197,1,805,2,10,4,4,6,single-choice,spatial-relational,4|6,7,4/6,220197,4
2,2,22,198,1,1527,6,8,1,1,7,single-choice,spatial-relational,1|7,7,1/7,220198,1
2,2,22,199,0,751,2,4,1,3,3,single-choice,spatial-relational,1|3,7,1/3,220199,1
2,2,22,200,1,747,2,12,5,5,7,single-choice,spatial-relational,5|7,7,5/7,220200,5
2,2,22,201,1,1741,3,5,1,1,4,single-choice,spatial-relational,1|4,7,1/4,220201,1
2,2,22,202,1,938,2,8,3,3,5,single-choice,spatial-relational,3|5,7,3/5,220202,3
2,2,22,203,1,1193,4,6,1,1,5,single-choice,spatial-relational,1|5,7,1/5,220203,1
2,2,22,204,1,920,5,9,2,2,7,single-choice,spatial-relational,2|7,7,2/7,220204,2
2,2,22,205,1,1001,3,11,4,4,7,single-choice,spatial-relational,4|7,7,4/7,220205,4
2,2,22,206,1,1064,4,10,3,3,7,single-choice,spatial-relational,3|7,7,3/7,220206,3
2,2,22,207,1,1329,2,10,4,4,6,single-choice,spatial-relational,4|6,7,4/6,220207,4
2,2,22,208,0,1050,1,9,4,5,5,single-choice,spatial-relational,4|5,7,4/5,220208,4
2,2,22,209,1,878,2,6,2,2,4,single-choice,spatial-relational,2|4,7,2/4,220209,2
2,2,22,210,1,1318,5,7,1,1,6,single-choice,spatial-relational,1|6,7,1/6,220210,1
2,2,22,211,1,1188,1,13,6,6,7,single-choice,spatial-relational,6|7,7,6/7,220211,6
2,2,22,212,1,1681,3,7,2,2,5,single-choice,spatial-relational,2|5,7,2/5,220212,2
2,2,22,213,1,1330,3,9,3,3,6,single-choice,spatial-relational,3|6,7,3/6,220213,3
2,2,22,214,1,1220,6,8,1,1,7,single-choice,spatial-relational,1|7,7,1/7,220214,1
2,2,22,215,1,1402,6,8,1,1,7,single-choice,spatial-relational,1|7,7,1/7,220215,1
2,2,22,216,1,986,2,10,4,4,6,single-choice,spatial-relational,4|6,7,4/6,220216,4
2,2,22,217,1,1343,2,4,1,1,3,single-choice,spatial-relational,1|3,7,1/3,220217,1
2,2,22,218,1,1035,3,9,3,3,6,single-choice,spatial-relational,3|6,7,3/6,220218,3
2,2,22,219,1,1413,1,3,1,1,2,single-choice,spatial-relational,1|2,7,1/2,220219,1
2,2,22,220,1,992,5,7,1,1,6,single-choice,spatial-relational,1|6,7,1/6,220220,1
2,2,22,221,1,1100,2,8,3,3,5,single-choice,spatial-relational,3|5,7,3/5,220221,3
2,2,22,222,1,998,2,12,5,5,7,single-choice,spatial-relational,5|7,7,5/7,220222,5
2,2,22,223,1,1352,5,7,1,1,6,single-choice,spatial-relational,1|6,7,1/6,220223,1
2,2,22,224,1,845,1,11,5,5,6,single-choice,spatial-relational,5|6,7,5/6,220224,5
2,2,22,225,1,1263,2,4,1,1,3,single-choice,spatial-relational,1|3,7,1/3,220225,1
2,2,22,226,0,1083,1,7,3,4,4,single-choice,spatial-relational,3|4,7,3/4,220226,3
2,2,22,227,1,745,3,11,4,4,7,single-choice,spatial-relational,4|7,7,4/7,220227,4
2,2,22,228,1,952,5,9,2,2,7,single-choice,spatial-relational,2|7,7,2/7,220228,2
2,2,22,229,1,56,3,5,1,1,4,single-choice,spatial-relational,1|4,7,1/4,220229,1
2,2,22,230,1,2875,1,9,4,4,5,single-choice,spatial-relational,4|5,7,4/5,220230,4
2,2,22,231,1,1282,3,5,1,1,4,single-choice,spatial-relational,1|4,7,1/4,220231,1
2,2,22,232,1,904,2,12,5,5,7,single-choice,spatial-relational,5|7,7,5/7,220232,5
2,2,22,233,1,1072,2,10,4,4,6,single-choice,spatial-relational,4|6,7,4/6,220233,4
2,2,22,234,1,984,4,8,2,2,6,single-choice,spatial-relational,2|6,7,2/6,220234,2
2,2,22,235,1,1100,4,10,3,3,7,single-choice,spatial-relational,3|7,7,3/7,220235,3
2,2,22,236,1,1703,2,6,2,2,4,single-choice,spatial-relational,2|4,7,2/4,220236,2
2,2,22,237,1,920,1,7,3,3,4,single-choice,spatial-relational,3|4,7,3/4,220237,3
2,2,22,238,1,1236,4,6,1,1,5,single-choice,spatial-relational,1|5,7,1/5,220238,1
2,2,22,239,1,954,5,9,2,2,7,single-choice,spatial-relational,2|7,7,2/7,220239,2
2,2,22,240,1,1508,2,6,2,2,4,single-choice,spatial-relational,2|4,7,2/4,220240,2
2,2,22,241,1,909,1,5,2,2,3,single-choice,spatial-relational,2|3,7,2/3,220241,2
2,2,22,242,1,1140,1,11,5,5,6,single-choice,spatial-relational,5|6,7,5/6,220242,5
2,2,22,243,1,2030,4,6,1,1,5,single-choice,spatial-relational,1|5,7,1/5,220243,1
2,2,22,244,1,902,1,9,4,4,5,single-choice,spatial-relational,4|5,7,4/5,220244,4
2,2,22,245,1,1070,2,8,3,3,5,single-choice,spatial-relational,3|5,7,3/5,220245,3
2,2,22,246,1,1056,1,5,2,2,3,single-choice,spatial-relational,2|3,7,2/3,220246,2
2,2,22,247,1,1097,4,10,3,3,7,single-choice,spatial-relational,3|7,7,3/7,220247,3
2,2,22,248,1,1045,3,11,4,4,7,single-choice,spatial-relational,4|7,7,4/7,220248,4
2,2,22,249,1,1181,4,8,2,2,6,single-choice,spatial-relational,2|6,7,2/6,220249,2
2,2,22,250,0,936,1,3,1,2,2,single-choice,spatial-relational,1|2,7,1/2,220250,1
2,2,22,251,1,971,1,13,6,6,7,single-choice,spatial-relational,6|7,7,6/7,220251,6
2,2,22,252,1,2947,3,7,2,2,5,single-choice,spatial-relational,2|5,7,2/5,220252,2
2,2,22,253,1,1030,3,7,2,2,5,single-choice,spatial-relational,2|5,7,2/5,220253,2
2,2,22,254,1,1050,3,11,4,4,7,single-choice,spatial-relational,4|7,7,4/7,220254,4
2,2,22,255,1,1087,1,5,2,2,3,single-choice,spatial-relational,2|3,7,2/3,220255,2
2,2,22,256,1,1595,3,5,1,1,4,single-choice,spatial-relational,1|4,7,1/4,220256,1
2,2,22,257,1,1330,4,6,1,1,5,single-choice,spatial-relational,1|5,7,1/5,220257,1
2,2,22,258,1,1313,6,8,1,1,7,single-choice,spatial-relational,1|7,7,1/7,220258,1
2,2,22,259,1,1148,3,7,2,2,5,single-choice,spatial-relational,2|5,7,2/5,220259,2
2,2,22,260,1,938,6,8,1,1,7,single-choice,spatial-relational,1|7,7,1/7,220260,1
2,2,22,261,1,858,1,13,6,6,7,single-choice,spatial-relational,6|7,7,6/7,220261,6
2,2,22,262,1,1629,4,8,2,2,6,single-choice,spatial-relational,2|6,7,2/6,220262,2
2,2,22,263,1,1010,4,10,3,3,7,single-choice,spatial-relational,3|7,7,3/7,220263,3
2,2,22,264,1,1047,2,12,5,5,7,single-choice,spatial-relational,5|7,7,5/7,220264,5
2,2,22,265,1,1086,1,11,5,5,6,single-choice,spatial-relational,5|6,7,5/6,220265,5
2,2,22,266,1,993,3,11,4,4,7,single-choice,spatial-relational,4|7,7,4/7,220266,4
2,2,22,267,1,1185,1,11,5,5,6,single-choice,spatial-relational,5|6,7,5/6,220267,5
2,2,22,268,1,1295,5,7,1,1,6,single-choice,spatial-relational,1|6,7,1/6,220268,1
2,2,22,269,1,766,2,12,5,5,7,single-choice,spatial-relational,5|7,7,5/7,220269,5
2,2,22,270,1,1278,3,5,1,1,4,single-choice,spatial-relational,1|4,7,1/4,220270,1
2,2,22,271,1,982,5,9,2,2,7,single-choice,spatial-relational,2|7,7,2/7,220271,2
2,2,22,272,1,1327,1,9,4,4,5,single-choice,spatial-relational,4|5,7,4/5,220272,4
2,2,22,273,1,1004,2,10,4,4,6,single-choice,spatial-relational,4|6,7,4/6,220273,4
2,2,22,274,1,1209,1,7,3,3,4,single-choice,spatial-relational,3|4,7,3/4,220274,3
2,2,22,275,1,1185,1,9,4,4,5,single-choice,spatial-relational,4|5,7,4/5,220275,4
2,2,22,276,1,1662,5,7,1,1,6,single-choice,spatial-relational,1|6,7,1/6,220276,1
2,2,22,277,1,978,1,5,2,2,3,single-choice,spatial-relational,2|3,7,2/3,220277,2
2,2,22,278,0,1229,1,3,1,2,2,single-choice,spatial-relational,1|2,7,1/2,220278,1
2,2,22,279,1,886,3,9,3,3,6,single-choice,spatial-relational,3|6,7,3/6,220279,3
2,2,22,280,1,1156,2,8,3,3,5,single-choice,spatial-relational,3|5,7,3/5,220280,3
2,2,22,281,1,1233,2,4,1,1,3,single-choice,spatial-relational,1|3,7,1/3,220281,1
2,2,22,282,1,930,3,9,3,3,6,single-choice,spatial-relational,3|6,7,3/6,220282,3
2,2,22,283,1,1080,2,10,4,4,6,single-choice,spatial-relational,4|6,7,4/6,220283,4
2,2,22,284,1,1539,1,7,3,3,4,single-choice,spatial-relational,3|4,7,3/4,220284,3
2,2,22,285,1,1460,2,6,2,2,4,single-choice,spatial-relational,2|4,7,2/4,220285,2
2,2,22,286,1,1196,4,8,2,2,6,single-choice,spatial-relational,2|6,7,2/6,220286,2
2,2,22,287,1,1054,2,8,3,3,5,single-choice,spatial-relational,3|5,7,3/5,220287,3
2,2,22,288,1,1141,5,9,2,2,7,single-choice,spatial-relational,2|7,7,2/7,220288,2
2,2,22,289,1,1131,1,13,6,6,7,single-choice,spatial-relational,6|7,7,6/7,220289,6
2,2,22,290,1,1168,2,6,2,2,4,single-choice,spatial-relational,2|4,7,2/4,220290,2
2,2,22,291,1,1347,4,6,1,1,5,single-choice,spatial-relational,1|5,7,1/5,220291,1
2,2,22,292,1,838,4,10,3,3,7,single-choice,spatial-relational,3|7,7,3/7,220292,3
2,2,22,293,0,874,1,3,1,2,2,single-choice,spatial-relational,1|2,7,1/2,220293,1
2,2,22,294,1,1053,2,4,1,1,3,single-choice,spatial-relational,1|3,7,1/3,220294,1
2,2,22,295,1,965,1,11,5,5,6,single-choice,spatial-relational,5|6,7,5/6,220295,5
2,2,22,296,0,1193,2,8,3,5,5,single-choice,spatial-relational,3|5,7,3/5,220296,3
2,2,22,297,0,612,4,6,1,5,5,single-choice,spatial-relational,1|5,7,1/5,220297,1
2,2,22,298,1,930,2,10,4,4,6,single-choice,spatial-relational,4|6,7,4/6,220298,4
2,2,22,299,1,1983,2,4,1,1,3,single-choice,spatial-relational,1|3,7,1/3,220299,1
2,2,22,300,1,933,3,7,2,2,5,single-choice,spatial-relational,2|5,7,2/5,220300,2
2,2,22,301,1,1454,1,9,4,4,5,single-choice,spatial-relational,4|5,7,4/5,220301,4
2,2,22,302,1,979,1,7,3,3,4,single-choice,spatial-relational,3|4,7,3/4,220302,3
2,2,22,303,1,1913,1,3,1,1,2,single-choice,spatial-relational,1|2,7,1/2,220303,1
2,2,22,304,1,979,1,13,6,6,7,single-choice,spatial-relational,6|7,7,6/7,220304,6
2,2,22,305,1,961,2,10,4,4,6,single-choice,spatial-relational,4|6,7,4/6,220305,4
2,2,22,306,1,928,1,13,6,6,7,single-choice,spatial-relational,6|7,7,6/7,220306,6
2,2,22,307,1,1392,1,3,1,1,2,single-choice,spatial-relational,1|2,7,1/2,220307,1
2,2,22,308,1,1160,4,6,1,1,5,single-choice,spatial-relational,1|5,7,1/5,220308,1
2,2,22,309,1,1096,5,7,1,1,6,single-choice,spatial-relational,1|6,7,1/6,220309,1
2,2,22,310,1,1170,1,11,5,5,6,single-choice,spatial-relational,5|6,7,5/6,220310,5
2,2,22,311,1,1105,4,10,3,3,7,single-choice,spatial-relational,3|7,7,3/7,220311,3
2,2,22,312,1,26506,3,7,2,2,5,single-choice,spatial-relational,2|5,7,2/5,220312,2
2,2,22,313,1,76,2,6,2,2,4,single-choice,spatial-relational,2|4,7,2/4,220313,2
2,2,22,314,1,1147,3,9,3,3,6,single-choice,spatial-relational,3|6,7,3/6,220314,3
2,2,22,315,1,884,2,12,5,5,7,single-choice,spatial-relational,5|7,7,5/7,220315,5
2,2,22,316,1,1101,4,8,2,2,6,single-choice,spatial-relational,2|6,7,2/6,220316,2
2,2,22,317,1,913,2,12,5,5,7,single-choice,spatial-relational,5|7,7,5/7,220317,5
2,2,22,318,1,1067,4,10,3,3,7,single-choice,spatial-relational,3|7,7,3/7,220318,3
2,2,22,319,1,1075,6,8,1,1,7,single-choice,spatial-relational,1|7,7,1/7,220319,1
2,2,22,320,1,1100,3,9,3,3,6,single-choice,spatial-relational,3|6,7,3/6,220320,3
2,2,22,321,1,955,6,8,1,1,7,single-choice,spatial-relational,1|7,7,1/7,220321,1
2,2,22,322,1,902,4,8,2,2,6,single-choice,spatial-relational,2|6,7,2/6,220322,2
2,2,22,323,1,854,3,5,1,1,4,single-choice,spatial-relational,1|4,7,1/4,220323,1
2,2,22,324,1,1327,2,6,2,2,4,single-choice,spatial-relational,2|4,7,2/4,220324,2
2,2,22,325,1,1151,1,5,2,2,3,single-choice,spatial-relational,2|3,7,2/3,220325,2
2,2,22,326,1,761,1,7,3,3,4,single-choice,spatial-relational,3|4,7,3/4,220326,3
2,2,22,327,1,5587,3,5,1,1,4,single-choice,spatial-relational,1|4,7,1/4,220327,1
2,2,22,328,1,1069,1,5,2,2,3,single-choice,spatial-relational,2|3,7,2/3,220328,2
2,2,22,329,1,932,5,9,2,2,7,single-choice,spatial-relational,2|7,7,2/7,220329,2
2,2,22,330,1,953,5,9,2,2,7,single-choice,spatial-relational,2|7,7,2/7,220330,2
2,2,22,331,1,1036,3,11,4,4,7,single-choice,spatial-relational,4|7,7,4/7,220331,4
2,2,22,332,1,976,3,11,4,4,7,single-choice,spatial-relational,4|7,7,4/7,220332,4
2,2,22,333,1,111,2,4,1,1,3,single-choice,spatial-relational,1|3,7,1/3,220333,1
2,2,22,334,1,1146,5,7,1,1,6,single-choice,spatial-relational,1|6,7,1/6,220334,1
2,2,22,335,1,853,2,8,3,3,5,single-choice,spatial-relational,3|5,7,3/5,220335,3
2,2,22,336,1,1005,1,9,4,4,5,single-choice,spatial-relational,4|5,7,4/5,220336,4
2,2,22,337,1,1005,2,12,5,5,7,single-choice,spatial-relational,5|7,7,5/7,220337,5
2,2,22,338,1,875,3,9,3,3,6,single-choice,spatial-relational,3|6,7,3/6,220338,3
2,2,22,339,1,1047,6,8,1,1,7,single-choice,spatial-relational,1|7,7,1/7,220339,1
2,2,22,340,1,1339,2,8,3,3,5,single-choice,spatial-relational,3|5,7,3/5,220340,3
2,2,22,341,1,761,4,10,3,3,7,single-choice,spatial-relational,3|7,7,3/7,220341,3
2,2,22,342,0,845,1,3,1,2,2,single-choice,spatial-relational,1|2,7,1/2,220342,1
2,2,22,343,1,999,3,7,2,2,5,single-choice,spatial-relational,2|5,7,2/5,220343,2
2,2,22,344,1,15962,1,11,5,5,6,single-choice,spatial-relational,5|6,7,5/6,220344,5
2,2,22,345,0,1586,3,7,2,5,5,single-choice,spatial-relational,2|5,7,2/5,220345,2
2,2,22,346,1,909,1,13,6,6,7,single-choice,spatial-relational,6|7,7,6/7,220346,6
2,2,22,347,1,955,5,9,2,2,7,single-choice,spatial-relational,2|7,7,2/7,220347,2
2,2,22,348,0,731,2,4,1,3,3,single-choice,spatial-relational,1|3,7,1/3,220348,1
2,2,22,349,0,815,1,3,1,2,2,single-choice,spatial-relational,1|2,7,1/2,220349,1
2,2,22,350,0,641,3,5,1,4,4,single-choice,spatial-relational,1|4,7,1/4,220350,1
2,2,22,351,1,1022,6,8,1,1,7,single-choice,spatial-relational,1|7,7,1/7,220351,1
2,2,22,352,1,983,1,9,4,4,5,single-choice,spatial-relational,4|5,7,4/5,220352,4
2,2,22,353,1,901,3,9,3,3,6,single-choice,spatial-relational,3|6,7,3/6,220353,3
2,2,22,354,1,979,2,12,5,5,7,single-choice,spatial-relational,5|7,7,5/7,220354,5
2,2,22,355,1,1044,1,7,3,3,4,single-choice,spatial-relational,3|4,7,3/4,220355,3
2,2,22,356,0,725,4,6,1,5,5,single-choice,spatial-relational,1|5,7,1/5,220356,1
2,2,22,357,1,1188,5,7,1,1,6,single-choice,spatial-relational,1|6,7,1/6,220357,1
2,2,22,358,1,903,4,8,2,2,6,single-choice,spatial-relational,2|6,7,2/6,220358,2
2,2,22,359,1,836,2,10,4,4,6,single-choice,spatial-relational,4|6,7,4/6,220359,4
2,2,22,360,1,897,4,10,3,3,7,single-choice,spatial-relational,3|7,7,3/7,220360,3
2,2,22,361,1,879,3,11,4,4,7,single-choice,spatial-relational,4|7,7,4/7,220361,4
2,2,22,362,1,1179,3,5,1,1,4,single-choice,spatial-relational,1|4,7,1/4,220362,1
2,2,22,363,1,946,2,6,2,2,4,single-choice,spatial-relational,2|4,7,2/4,220363,2
2,2,22,364,1,1111,1,5,2,2,3,single-choice,spatial-relational,2|3,7,2/3,220364,2
2,2,22,365,1,1933,4,6,1,1,5,single-choice,spatial-relational,1|5,7,1/5,220365,1
2,2,22,366,1,958,5,9,2,2,7,single-choice,spatial-relational,2|7,7,2/7,220366,2
2,2,22,367,1,1062,2,4,1,1,3,single-choice,spatial-relational,1|3,7,1/3,220367,1
2,2,22,368,1,1229,1,5,2,2,3,single-choice,spatial-relational,2|3,7,2/3,220368,2
2,2,22,369,1,1096,1,7,3,3,4,single-choice,spatial-relational,3|4,7,3/4,220369,3
2,2,22,370,1,1240,4,8,2,2,6,single-choice,spatial-relational,2|6,7,2/6,220370,2
2,2,22,371,1,1018,1,13,6,6,7,single-choice,spatial-relational,6|7,7,6/7,220371,6
2,2,22,372,0,5509,5,7,1,6,6,single-choice,spatial-relational,1|6,7,1/6,220372,1
2,2,22,373,1,1135,2,10,4,4,6,single-choice,spatial-relational,4|6,7,4/6,220373,4
2,2,22,374,1,918,1,9,4,4,5,single-choice,spatial-relational,4|5,7,4/5,220374,4
2,2,22,375,1,1063,2,6,2,2,4,single-choice,spatial-relational,2|4,7,2/4,220375,2
2,2,22,376,1,971,2,8,3,3,5,single-choice,spatial-relational,3|5,7,3/5,220376,3
2,2,22,377,1,875,1,11,5,5,6,single-choice,spatial-relational,5|6,7,5/6,220377,5
2,2,22,378,1,931,3,11,4,4,7,single-choice,spatial-relational,4|7,7,4/7,220378,4
2,2,22,379,1,970,1,13,6,6,7,single-choice,spatial-relational,6|7,7,6/7,220379,6
2,2,22,380,1,962,4,8,2,2,6,single-choice,spatial-relational,2|6,7,2/6,220380,2
2,2,22,381,1,887,4,10,3,3,7,single-choice,spatial-relational,3|7,7,3/7,220381,3
2,2,22,382,1,1204,2,8,3,3,5,single-choice,spatial-relational,3|5,7,3/5,220382,3
2,2,22,383,1,928,3,11,4,4,7,single-choice,spatial-relational,4|7,7,4/7,220383,4
2,2,22,384,1,1055,3,7,2,2,5,single-choice,spatial-relational,2|5,7,2/5,220384,2
2,2,22,385,1,985,3,5,1,1,4,single-choice,spatial-relational,1|4,7,1/4,220385,1
2,2,22,386,1,765,1,7,3,3,4,single-choice,spatial-relational,3|4,7,3/4,220386,3
2,2,22,387,1,1066,2,10,4,4,6,single-choice,spatial-relational,4|6,7,4/6,220387,4
2,2,22,388,1,1004,6,8,1,1,7,single-choice,spatial-relational,1|7,7,1/7,220388,1
2,2,22,389,1,715,3,9,3,3,6,single-choice,spatial-relational,3|6,7,3/6,220389,3
2,2,22,390,1,1077,4,8,2,2,6,single-choice,spatial-relational,2|6,7,2/6,220390,2
2,2,22,391,1,945,5,9,2,2,7,single-choice,spatial-relational,2|7,7,2/7,220391,2
2,2,22,392,1,3986,1,13,6,6,7,single-choice,spatial-relational,6|7,7,6/7,220392,6
2,2,22,393,1,1182,1,7,3,3,4,single-choice,spatial-relational,3|4,7,3/4,220393,3
2,2,22,394,1,863,1,9,4,4,5,single-choice,spatial-relational,4|5,7,4/5,220394,4
2,2,22,395,0,711,2,4,1,3,3,single-choice,spatial-relational,1|3,7,1/3,220395,1
2,2,22,396,1,1098,4,10,3,3,7,single-choice,spatial-relational,3|7,7,3/7,220396,3
2,2,22,397,0,1221,1,9,4,5,5,single-choice,spatial-relational,4|5,7,4/5,220397,4
2,2,22,398,1,760,1,11,5,5,6,single-choice,spatial-relational,5|6,7,5/6,220398,5
2,2,22,399,1,1121,5,7,1,1,6,single-choice,spatial-relational,1|6,7,1/6,220399,1
2,2,22,400,0,767,1,3,1,2,2,single-choice,spatial-relational,1|2,7,1/2,220400,1
2,2,22,401,1,1200,1,3,1,1,2,single-choice,spatial-relational,1|2,7,1/2,220401,1
2,2,22,402,1,1373,3,7,2,2,5,single-choice,spatial-relational,2|5,7,2/5,220402,2
2,2,22,403,1,1185,2,10,4,4,6,single-choice,spatial-relational,4|6,7,4/6,220403,4
2,2,22,404,1,1187,2,4,1,1,3,single-choice,spatial-relational,1|3,7,1/3,220404,1
2,2,22,405,1,950,2,12,5,5,7,single-choice,spatial-relational,5|7,7,5/7,220405,5
2,2,22,406,1,921,1,5,2,2,3,single-choice,spatial-relational,2|3,7,2/3,220406,2
2,2,22,407,1,1502,6,8,1,1,7,single-choice,spatial-relational,1|7,7,1/7,220407,1
2,2,22,408,1,931,4,6,1,1,5,single-choice,spatial-relational,1|5,7,1/5,220408,1
2,2,22,409,1,882,5,7,1,1,6,single-choice,spatial-relational,1|6,7,1/6,220409,1
2,2,22,410,1,1318,2,8,3,3,5,single-choice,spatial-relational,3|5,7,3/5,220410,3
2,2,22,411,1,1289,4,6,1,1,5,single-choice,spatial-relational,1|5,7,1/5,220411,1
2,2,22,412,1,886,5,9,2,2,7,single-choice,spatial-relational,2|7,7,2/7,220412,2
2,2,22,413,1,1191,3,9,3,3,6,single-choice,spatial-relational,3|6,7,3/6,220413,3
2,2,22,414,1,1380,1,5,2,2,3,single-choice,spatial-relational,2|3,7,2/3,220414,2
2,2,22,415,1,1164,3,5,1,1,4,single-choice,spatial-relational,1|4,7,1/4,220415,1
2,2,22,416,1,1364,1,11,5,5,6,single-choice,spatial-relational,5|6,7,5/6,220416,5
2,2,22,417,1,956,3,11,4,4,7,single-choice,spatial-relational,4|7,7,4/7,220417,4
2,2,22,418,1,1088,2,12,5,5,7,single-choice,spatial-relational,5|7,7,5/7,220418,5
2,2,22,419,1,1012,2,6,2,2,4,single-choice,spatial-relational,2|4,7,2/4,220419,2
2,2,22,420,1,1065,2,6,2,2,4,single-choice,spatial-relational,2|4,7,2/4,220420,2
2,2,22,421,1,1633,1,9,4,4,5,single-choice,spatial-relational,4|5,7,4/5,220421,4
2,2,22,422,1,1369,2,10,4,4,6,single-choice,spatial-relational,4|6,7,4/6,220422,4
2,2,22,423,1,959,3,11,4,4,7,single-choice,spatial-relational,4|7,7,4/7,220423,4
2,2,22,424,1,1237,4,8,2,2,6,single-choice,spatial-relational,2|6,7,2/6,220424,2
2,2,22,425,1,984,1,11,5,5,6,single-choice,spatial-relational,5|6,7,5/6,220425,5
2,2,22,426,1,1149,1,7,3,3,4,single-choice,spatial-relational,3|4,7,3/4,220426,3
2,2,22,427,1,928,2,12,5,5,7,single-choice,spatial-relational,5|7,7,5/7,220427,5
2,2,22,428,0,984,3,9,3,6,6,single-choice,spatial-relational,3|6,7,3/6,220428,3
2,2,22,429,1,908,5,9,2,2,7,single-choice,spatial-relational,2|7,7,2/7,220429,2
2,2,22,430,1,1419,2,8,3,3,5,single-choice,spatial-relational,3|5,7,3/5,220430,3
2,2,22,431,1,1118,1,5,2,2,3,single-choice,spatial-relational,2|3,7,2/3,220431,2
2,2,22,432,1,1006,2,6,2,2,4,single-choice,spatial-relational,2|4,7,2/4,220432,2
2,2,22,433,1,921,3,9,3,3,6,single-choice,spatial-relational,3|6,7,3/6,220433,3
2,2,22,434,1,1353,3,11,4,4,7,single-choice,spatial-relational,4|7,7,4/7,220434,4
2,2,22,435,1,779,1,7,3,3,4,single-choice,spatial-relational,3|4,7,3/4,220435,3
2,2,22,436,1,1630,5,7,1,1,6,single-choice,spatial-relational,1|6,7,1/6,220436,1
2,2,22,437,0,955,4,6,1,5,5,single-choice,spatial-relational,1|5,7,1/5,220437,1
2,2,22,438,1,943,1,5,2,2,3,single-choice,spatial-relational,2|3,7,2/3,220438,2
2,2,22,439,1,890,4,10,3,3,7,single-choice,spatial-relational,3|7,7,3/7,220439,3
2,2,22,440,1,1029,2,12,5,5,7,single-choice,spatial-relational,5|7,7,5/7,220440,5
2,2,22,441,1,1087,2,8,3,3,5,single-choice,spatial-relational,3|5,7,3/5,220441,3
2,2,22,442,1,979,4,8,2,2,6,single-choice,spatial-relational,2|6,7,2/6,220442,2
2,2,22,443,1,1010,3,5,1,1,4,single-choice,spatial-relational,1|4,7,1/4,220443,1
2,2,22,444,0,64302,1,3,1,2,2,single-choice,spatial-relational,1|2,7,1/2,220444,1
2,2,22,445,0,857,1,3,1,2,2,single-choice,spatial-relational,1|2,7,1/2,220445,1
2,2,22,446,0,664,4,6,1,5,5,single-choice,spatial-relational,1|5,7,1/5,220446,1
2,2,22,447,1,1708,2,4,1,1,3,single-choice,spatial-relational,1|3,7,1/3,220447,1
2,2,22,448,1,1212,3,5,1,1,4,single-choice,spatial-relational,1|4,7,1/4,220448,1
2,2,22,449,0,637,2,4,1,3,3,single-choice,spatial-relational,1|3,7,1/3,220449,1
2,2,22,450,1,996,6,8,1,1,7,single-choice,spatial-relational,1|7,7,1/7,220450,1
2,2,22,451,1,1293,5,7,1,1,6,single-choice,spatial-relational,1|6,7,1/6,220451,1
2,2,22,452,1,964,2,6,2,2,4,single-choice,spatial-relational,2|4,7,2/4,220452,2
2,2,22,453,1,1051,3,7,2,2,5,single-choice,spatial-relational,2|5,7,2/5,220453,2
2,2,22,454,1,918,4,10,3,3,7,single-choice,spatial-relational,3|7,7,3/7,220454,3
2,2,22,455,1,1050,1,9,4,4,5,single-choice,spatial-relational,4|5,7,4/5,220455,4
2,2,22,456,1,965,5,9,2,2,7,single-choice,spatial-relational,2|7,7,2/7,220456,2
2,2,22,457,1,967,6,8,1,1,7,single-choice,spatial-relational,1|7,7,1/7,220457,1
2,2,22,458,1,1802,2,10,4,4,6,single-choice,spatial-relational,4|6,7,4/6,220458,4
2,2,22,459,1,897,1,11,5,5,6,single-choice,spatial-relational,5|6,7,5/6,220459,5
2,2,22,460,1,1026,1,13,6,6,7,single-choice,spatial-relational,6|7,7,6/7,220460,6
2,2,22,461,1,916,3,7,2,2,5,single-choice,spatial-relational,2|5,7,2/5,220461,2
2,2,22,462,1,1068,1,13,6,6,7,single-choice,spatial-relational,6|7,7,6/7,220462,6
2,2,22,463,1,1234,3,5,1,1,4,single-choice,spatial-relational,1|4,7,1/4,220463,1
2,2,22,464,1,914,5,7,1,1,6,single-choice,spatial-relational,1|6,7,1/6,220464,1
2,2,22,465,1,830,4,10,3,3,7,single-choice,spatial-relational,3|7,7,3/7,220465,3
2,2,22,466,1,966,3,7,2,2,5,single-choice,spatial-relational,2|5,7,2/5,220466,2
2,2,22,467,1,1370,4,8,2,2,6,single-choice,spatial-relational,2|6,7,2/6,220467,2
2,2,22,468,1,854,4,8,2,2,6,single-choice,spatial-relational,2|6,7,2/6,220468,2
2,2,22,469,1,946,1,13,6,6,7,single-choice,spatial-relational,6|7,7,6/7,220469,6
2,2,22,470,0,127,1,5,2,3,3,single-choice,spatial-relational,2|3,7,2/3,220470,2
2,2,22,471,1,1071,4,6,1,1,5,single-choice,spatial-relational,1|5,7,1/5,220471,1
2,2,22,472,1,1057,1,11,5,5,6,single-choice,spatial-relational,5|6,7,5/6,220472,5
2,2,22,473,1,1010,1,11,5,5,6,single-choice,spatial-relational,5|6,7,5/6,220473,5
2,2,22,474,1,900,2,12,5,5,7,single-choice,spatial-relational,5|7,7,5/7,220474,5
2,2,22,475,1,1024,2,6,2,2,4,single-choice,spatial-relational,2|4,7,2/4,220475,2
2,2,22,476,1,922,3,9,3,3,6,single-choice,spatial-relational,3|6,7,3/6,220476,3
2,2,22,477,1,1238,2,10,4,4,6,single-choice,spatial-relational,4|6,7,4/6,220477,4
2,2,22,478,1,1178,2,10,4,4,6,single-choice,spatial-relational,4|6,7,4/6,220478,4
2,2,22,479,1,1019,2,6,2,2,4,single-choice,spatial-relational,2|4,7,2/4,220479,2
2,2,22,480,1,780,3,11,4,4,7,single-choice,spatial-relational,4|7,7,4/7,220480,4
2,2,22,481,1,1111,3,9,3,3,6,single-choice,spatial-relational,3|6,7,3/6,220481,3
2,2,22,482,1,1992,2,8,3,3,5,single-choice,spatial-relational,3|5,7,3/5,220482,3
2,2,22,483,1,969,1,9,4,4,5,single-choice,spatial-relational,4|5,7,4/5,220483,4
2,2,22,484,1,111624,5,9,2,2,7,single-choice,spatial-relational,2|7,7,2/7,220484,2
2,2,22,485,1,961,5,9,2,2,7,single-choice,spatial-relational,2|7,7,2/7,220485,2
2,2,22,486,1,932,1,7,3,3,4,single-choice,spatial-relational,3|4,7,3/4,220486,3
2,2,22,487,1,943,2,12,5,5,7,single-choice,spatial-relational,5|7,7,5/7,220487,5
2,2,22,488,1,1063,1,9,4,4,5,single-choice,spatial-relational,4|5,7,4/5,220488,4
2,2,22,489,0,122871,1,3,1,2,2,single-choice,spatial-relational,1|2,7,1/2,220489,1
2,2,22,490,1,1029,3,7,2,2,5,single-choice,spatial-relational,2|5,7,2/5,220490,2
2,2,22,491,1,1360,4,10,3,3,7,single-choice,spatial-relational,3|7,7,3/7,220491,3
2,2,22,492,1,1251,2,4,1,1,3,single-choice,spatial-relational,1|3,7,1/3,220492,1
2,2,22,493,1,1458,5,7,1,1,6,single-choice,spatial-relational,1|6,7,1/6,220493,1
2,2,22,494,1,961,6,8,1,1,7,single-choice,spatial-relational,1|7,7,1/7,220494,1
2,2,22,495,1,1126,2,4,1,1,3,single-choice,spatial-relational,1|3,7,1/3,220495,1
2,2,22,496,1,953,1,5,2,2,3,single-choice,spatial-relational,2|3,7,2/3,220496,2
2,2,22,497,1,1285,1,7,3,3,4,single-choice,spatial-relational,3|4,7,3/4,220497,3
2,2,22,498,1,2040,3,11,4,4,7,single-choice,spatial-relational,4|7,7,4/7,220498,4
2,2,22,499,1,1063,2,8,3,3,5,single-choice,spatial-relational,3|5,7,3/5,220499,3
2,2,22,500,1,1650,1,13,6,6,7,single-choice,spatial-relational,6|7,7,6/7,220500,6
2,2,22,501,1,1126,6,8,1,1,7,single-choice,spatial-relational,1|7,7,1/7,220501,1
2,2,22,502,0,875,1,3,1,2,2,single-choice,spatial-relational,1|2,7,1/2,220502,1
2,2,22,503,1,1122,4,6,1,1,5,single-choice,spatial-relational,1|5,7,1/5,220503,1
2,2,22,504,1,1049,3,5,1,1,4,single-choice,spatial-relational,1|4,7,1/4,220504,1
2,2,22,505,1,895,4,10,3,3,7,single-choice,spatial-relational,3|7,7,3/7,220505,3
2,2,22,506,1,1397,1,7,3,3,4,single-choice,spatial-relational,3|4,7,3/4,220506,3
2,2,22,507,1,1002,2,4,1,1,3,single-choice,spatial-relational,1|3,7,1/3,220507,1
2,2,22,508,1,915,1,5,2,2,3,single-choice,spatial-relational,2|3,7,2/3,220508,2
2,2,22,509,1,981,1,11,5,5,6,single-choice,spatial-relational,5|6,7,5/6,220509,5
2,2,22,510,1,1361,2,6,2,2,4,single-choice,spatial-relational,2|4,7,2/4,220510,2
2,2,22,511,1,907,2,10,4,4,6,single-choice,spatial-relational,4|6,7,4/6,220511,4
2,2,22,512,1,1159,5,7,1,1,6,single-choice,spatial-relational,1|6,7,1/6,220512,1
2,2,22,513,1,966,2,12,5,5,7,single-choice,spatial-relational,5|7,7,5/7,220513,5
2,2,22,514,1,806,3,9,3,3,6,single-choice,spatial-relational,3|6,7,3/6,220514,3
2,2,22,515,1,1195,6,8,1,1,7,single-choice,spatial-relational,1|7,7,1/7,220515,1
2,2,22,516,1,889,1,9,4,4,5,single-choice,spatial-relational,4|5,7,4/5,220516,4
2,2,22,517,1,1031,5,9,2,2,7,single-choice,spatial-relational,2|7,7,2/7,220517,2
2,2,22,518,1,920,4,8,2,2,6,single-choice,spatial-relational,2|6,7,2/6,220518,2
2,2,22,519,0,821,4,6,1,5,5,single-choice,spatial-relational,1|5,7,1/5,220519,1
2,2,22,520,1,1048,2,4,1,1,3,single-choice,spatial-relational,1|3,7,1/3,220520,1
2,2,22,521,1,1107,4,6,1,1,5,single-choice,spatial-relational,1|5,7,1/5,220521,1
2,2,22,522,1,986,3,9,3,3,6,single-choice,spatial-relational,3|6,7,3/6,220522,3
2,2,22,523,1,1290,1,7,3,3,4,single-choice,spatial-relational,3|4,7,3/4,220523,3
2,2,22,524,1,941,2,8,3,3,5,single-choice,spatial-relational,3|5,7,3/5,220524,3
2,2,22,525,1,964,6,8,1,1,7,single-choice,spatial-relational,1|7,7,1/7,220525,1
2,2,22,526,1,1146,5,7,1,1,6,single-choice,spatial-relational,1|6,7,1/6,220526,1
2,2,22,527,1,1059,3,5,1,1,4,single-choice,spatial-relational,1|4,7,1/4,220527,1
2,2,22,528,1,1015,1,5,2,2,3,single-choice,spatial-relational,2|3,7,2/3,220528,2
2,2,22,529,1,1201,1,13,6,6,7,single-choice,spatial-relational,6|7,7,6/7,220529,6
2,2,22,530,1,1446,2,6,2,2,4,single-choice,spatial-relational,2|4,7,2/4,220530,2
2,2,22,531,0,863,1,3,1,2,2,single-choice,spatial-relational,1|2,7,1/2,220531,1
2,2,22,532,1,1044,1,9,4,4,5,single-choice,spatial-relational,4|5,7,4/5,220532,4
2,2,22,533,1,1054,3,5,1,1,4,single-choice,spatial-relational,1|4,7,1/4,220533,1
2,2,22,534,1,843,5,9,2,2,7,single-choice,spatial-relational,2|7,7,2/7,220534,2
2,2,22,535,0,16834,1,3,1,2,2,single-choice,spatial-relational,1|2,7,1/2,220535,1
2,2,22,536,1,956,4,8,2,2,6,single-choice,spatial-relational,2|6,7,2/6,220536,2
2,2,22,537,1,817,2,12,5,5,7,single-choice,spatial-relational,5|7,7,5/7,220537,5
2,2,22,538,1,992,1,11,5,5,6,single-choice,spatial-relational,5|6,7,5/6,220538,5
2,2,22,539,1,958,3,7,2,2,5,single-choice,spatial-relational,2|5,7,2/5,220539,2
2,2,22,540,1,998,3,7,2,2,5,single-choice,spatial-relational,2|5,7,2/5,220540,2
2,2,22,541,1,867,1,13,6,6,7,single-choice,spatial-relational,6|7,7,6/7,220541,6
2,2,22,542,1,979,3,11,4,4,7,single-choice,spatial-relational,4|7,7,4/7,220542,4
2,2,22,543,1,1192,3,11,4,4,7,single-choice,spatial-relational,4|7,7,4/7,220543,4
2,2,22,544,1,854,4,10,3,3,7,single-choice,spatial-relational,3|7,7,3/7,220544,3
2,2,22,545,0,1146,2,10,4,6,6,single-choice,spatial-relational,4|6,7,4/6,220545,4
2,2,22,546,1,1040,2,8,3,3,5,single-choice,spatial-relational,3|5,7,3/5,220546,3
2,2,22,547,1,1367,2,10,4,4,6,single-choice,spatial-relational,4|6,7,4/6,220547,4
2,2,22,548,0,994,1,3,1,2,2,single-choice,spatial-relational,1|2,7,1/2,220548,1
2,2,22,549,1,893,3,11,4,4,7,single-choice,spatial-relational,4|7,7,4/7,220549,4
2,2,22,550,1,989,2,12,5,5,7,single-choice,spatial-relational,5|7,7,5/7,220550,5
2,2,22,551,1,941,3,7,2,2,5,single-choice,spatial-relational,2|5,7,2/5,220551,2
2,2,22,552,1,987,3,7,2,2,5,single-choice,spatial-relational,2|5,7,2/5,220552,2
2,2,22,553,1,1393,3,5,1,1,4,single-choice,spatial-relational,1|4,7,1/4,220553,1
2,2,22,554,1,908,4,8,2,2,6,single-choice,spatial-relational,2|6,7,2/6,220554,2
2,2,22,555,0,1073,1,9,4,5,5,single-choice,spatial-relational,4|5,7,4/5,220555,4
2,2,22,556,1,981,2,6,2,2,4,single-choice,spatial-relational,2|4,7,2/4,220556,2
2,2,22,557,1,1212,2,8,3,3,5,single-choice,spatial-relational,3|5,7,3/5,220557,3
2,2,22,558,1,874,2,8,3,3,5,single-choice,spatial-relational,3|5,7,3/5,220558,3
2,2,22,559,1,908,4,8,2,2,6,single-choice,spatial-relational,2|6,7,2/6,220559,2
2,2,22,560,1,885,4,10,3,3,7,single-choice,spatial-relational,3|7,7,3/7,220560,3
2,2,22,561,1,898,5,9,2,2,7,single-choice,spatial-relational,2|7,7,2/7,220561,2
2,2,22,562,1,1093,1,13,6,6,7,single-choice,spatial-relational,6|7,7,6/7,220562,6
2,2,22,563,1,961,1,11,5,5,6,single-choice,spatial-relational,5|6,7,5/6,220563,5
2,2,22,564,1,1239,4,6,1,1,5,single-choice,spatial-relational,1|5,7,1/5,220564,1
2,2,22,565,1,1268,3,5,1,1,4,single-choice,spatial-relational,1|4,7,1/4,220565,1
2,2,22,566,1,839,2,12,5,5,7,single-choice,spatial-relational,5|7,7,5/7,220566,5
2,2,22,567,1,885,1,7,3,3,4,single-choice,spatial-relational,3|4,7,3/4,220567,3
2,2,22,568,1,1291,4,6,1,1,5,single-choice,spatial-relational,1|5,7,1/5,220568,1
2,2,22,569,1,860,2,6,2,2,4,single-choice,spatial-relational,2|4,7,2/4,220569,2
2,2,22,570,1,1220,3,9,3,3,6,single-choice,spatial-relational,3|6,7,3/6,220570,3
2,2,22,571,0,1038,1,3,1,2,2,single-choice,spatial-relational,1|2,7,1/2,220571,1
2,2,22,572,1,873,1,5,2,2,3,single-choice,spatial-relational,2|3,7,2/3,220572,2
2,2,22,573,1,1009,1,9,4,4,5,single-choice,spatial-relational,4|5,7,4/5,220573,4
2,2,22,574,1,973,3,9,3,3,6,single-choice,spatial-relational,3|6,7,3/6,220574,3
2,2,22,575,1,1560,1,7,3,3,4,single-choice,spatial-relational,3|4,7,3/4,220575,3
2,2,22,576,1,1485,6,8,1,1,7,single-choice,spatial-relational,1|7,7,1/7,220576,1
2,2,22,577,0,741,2,4,1,3,3,single-choice,spatial-relational,1|3,7,1/3,220577,1
2,2,22,578,1,956,2,4,1,1,3,single-choice,spatial-relational,1|3,7,1/3,220578,1
2,2,22,579,1,804,1,13,6,6,7,single-choice,spatial-relational,6|7,7,6/7,220579,6
2,2,22,580,1,1198,2,10,4,4,6,single-choice,spatial-relational,4|6,7,4/6,220580,4
2,2,22,581,1,975,5,9,2,2,7,single-choice,spatial-relational,2|7,7,2/7,220581,2
2,2,22,582,1,896,4,10,3,3,7,single-choice,spatial-relational,3|7,7,3/7,220582,3
2,2,22,583,1,1062,5,7,1,1,6,single-choice,spatial-relational,1|6,7,1/6,220583,1
2,2,22,584,1,1107,5,7,1,1,6,single-choice,spatial-relational,1|6,7,1/6,220584,1
2,2,22,585,1,641,1,11,5,5,6,single-choice,spatial-relational,5|6,7,5/6,220585,5
2,2,22,586,1,928,6,8,1,1,7,single-choice,spatial-relational,1|7,7,1/7,220586,1
2,2,22,587,1,955,1,5,2,2,3,single-choice,spatial-relational,2|3,7,2/3,220587,2
2,2,22,588,1,1010,3,11,4,4,7,single-choice,spatial-relational,4|7,7,4/7,220588,4
2,2,22,589,0,681,6,8,1,7,7,single-choice,spatial-relational,1|7,7,1/7,220589,1
2,2,22,590,1,908,4,8,2,2,6,single-choice,spatial-relational,2|6,7,2/6,220590,2
2,2,22,591,1,979,1,13,6,6,7,single-choice,spatial-relational,6|7,7,6/7,220591,6
2,2,22,592,1,1181,4,8,2,2,6,single-choice,spatial-relational,2|6,7,2/6,220592,2
2,2,22,593,1,1100,5,9,2,2,7,single-choice,spatial-relational,2|7,7,2/7,220593,2
2,2,22,594,1,936,1,7,3,3,4,single-choice,spatial-relational,3|4,7,3/4,220594,3
2,2,22,595,1,1074,1,9,4,4,5,single-choice,spatial-relational,4|5,7,4/5,220595,4
2,2,22,596,1,1010,2,12,5,5,7,single-choice,spatial-relational,5|7,7,5/7,220596,5
2,2,22,597,1,1192,1,3,1,1,2,single-choice,spatial-relational,1|2,7,1/2,220597,1
2,2,22,598,1,1109,1,11,5,5,6,single-choice,spatial-relational,5|6,7,5/6,220598,5
2,2,22,599,0,652,5,7,1,6,6,single-choice,spatial-relational,1|6,7,1/6,220599,1
2,2,22,600,1,1005,1,11,5,5,6,single-choice,spatial-relational,5|6,7,5/6,220600,5
3,2,22,1,1,888,4,8,2,2,6,single-choice,spatial-relational,2|6,7,2/6,220001,2
3,2,22,2,1,1293,1,7,3,3,4,single-choice,spatial-relational,3|4,7,3/4,220002,3
3,2,22,3,0,764,3,5,1,4,4,single-choice,spatial-relational,1|4,7,1/4,220003,1
3,2,22,4,1,1108,2,12,5,5,7,single-choice,spatial-relational,5|7,7,5/7,220004,5
3,2,22,5,1,1360,1,5,2,2,3,single-choice,spatial-relational,2|3,7,2/3,220005,2
3,2,22,6,1,1813,3,11,4,4,7,single-choice,spatial-relational,4|7,7,4/7,220006,4
3,2,22,7,1,1237,1,11,5,5,6,single-choice,spatial-relational,5|6,7,5/6,220007,5
3,2,22,8,1,1659,5,7,1,1,6,single-choice,spatial-relational,1|6,7,1/6,220008,1
3,2,22,9,1,1684,6,8,1,1,7,single-choice,spatial-relational,1|7,7,1/7,220009,1
3,2,22,10,0,1190,2,6,2,4,4,single-choice,spatial-relational,2|4,7,2/4,220010,2
3,2,22,11,1,1419,1,13,6,6,7,single-choice,spatial-relational,6|7,7,6/7,220011,6
3,2,22,12,1,103,3,9,3,3,6,single-choice,spatial-relational,3|6,7,3/6,220012,3
3,2,22,13,1,1574,2,10,4,4,6,single-choice,spatial-relational,4|6,7,4/6,220013,4
3,2,22,14,1,1228,3,5,1,1,4,single-choice,spatial-relational,1|4,7,1/4,220014,1
3,2,22,15,1,1208,5,7,1,1,6,single-choice,spatial-relational,1|6,7,1/6,220015,1
3,2,22,16,1,939,3,7,2,2,5,single-choice,spatial-relational,2|5,7,2/5,220016,2
3,2,22,17,1,1009,1,5,2,2,3,single-choice,spatial-relational,2|3,7,2/3,220017,2
3,2,22,18,1,951,4,10,3,3,7,single-choice,spatial-relational,3|7,7,3/7,220018,3
3,2,22,19,0,2022,1,9,4,5,5,single-choice,spatial-relational,4|5,7,4/5,220019,4
3,2,22,20,1,803,1,7,3,3,4,single-choice,spatial-relational,3|4,7,3/4,220020,3
3,2,22,21,1,1625,2,8,3,3,5,single-choice,spatial-relational,3|5,7,3/5,220021,3
3,2,22,22,1,962,5,9,2,2,7,single-choice,spatial-relational,2|7,7,2/7,220022,2
3,2,22,23,1,1529,6,8,1,1,7,single-choice,spatial-relational,1|7,7,1/7,220023,1
3,2,22,24,1,880,2,6,2,2,4,single-choice,spatial-relational,2|4,7,2/4,220024,2
3,2,22,25,1,1218,4,6,1,1,5,single-choice,spatial-relational,1|5,7,1/5,220025,1
3,2,22,26,1,1049,3,11,4,4,7,single-choice,spatial-relational,4|7,7,4/7,220026,4
3,2,22,27,1,1173,4,10,3,3,7,single-choice,spatial-relational,3|7,7,3/7,220027,3
3,2,22,28,1,1432,2,10,4,4,6,single-choice,spatial-relational,4|6,7,4/6,220028,4
3,2,22,29,1,1118,1,13,6,6,7,single-choice,spatial-relational,6|7,7,6/7,220029,6
3,2,22,30,0,1488,4,6,1,5,5,single-choice,spatial-relational,1|5,7,1/5,220030,1
3,2,22,31,1,1067,2,8,3,3,5,single-choice,spatial-relational,3|5,7,3/5,220031,3
3,2,22,32,1,1697,2,4,1,1,3,single-choice,spatial-relational,1|3,7,1/3,220032,1
3,2,22,33,0,752,1,3,1,2,2,single-choice,spatial-relational,1|2,7,1/2,220033,1
3,2,22,34,1,1331,3,9,3,3,6,single-choice,spatial-relational,3|6,7,3/6,220034,3
3,2,22,35,1,1244,2,4,1,1,3,single-choice,spatial-relational,1|3,7,1/3,220035,1
3,2,22,36,1,877,3,7,2,2,5,single-choice,spatial-relational,2|5,7,2/5,220036,2
3,2,22,37,1,880,1,9,4,4,5,single-choice,spatial-relational,4|5,7,4/5,220037,4
3,2,22,38,1,1074,1,11,5,5,6,single-choice,spatial-relational,5|6,7,5/6,220038,5
3,2,22,39,1,1378,2,12,5,5,7,single-choice,spatial-relational,5|7,7,5/7,220039,5
3,2,22,40,1,1498,4,8,2,2,6,single-choice,spatial-relational,2|6,7,2/6,220040,2
3,2,22,41,1,2575,1,3,1,1,2,single-choice,spatial-relational,1|2,7,1/2,220041,1
3,2,22,42,1,984,5,9,2,2,7,single-choice,spatial-relational,2|7,7,2/7,220042,2
3,2,22,43,1,1116,2,8,3,3,5,single-choice,spatial-relational,3|5,7,3/5,220043,3
3,2,22,44,1,1039,5,9,2,2,7,single-choice,spatial-relational,2|7,7,2/7,220044,2
3,2,22,45,1,1128,2,10,4,4,6,single-choice,spatial-relational,4|6,7,4/6,220045,4
3,2,22,46,1,1202,4,10,3,3,7,single-choice,spatial-relational,3|7,7,3/7,220046,3
3,2,22,47,1,1992,4,6,1,1,5,single-choice,spatial-relational,1|5,7,1/5,220047,1
3,2,22,48,1,857,3,7,2,2,5,single-choice,spatial-relational,2|5,7,2/5,220048,2
3,2,22,49,1,1233,3,9,3,3,6,single-choice,spatial-relational,3|6,7,3/6,220049,3
3,2,22,50,1,1490,1,3,1,1,2,single-choice,spatial-relational,1|2,7,1/2,220050,1
3,2,22,51,1,224,5,7,1,1,6,single-choice,spatial-relational,1|6,7,1/6,220051,1
3,2,22,52,0,990,2,4,1,3,3,single-choice,spatial-relational,1|3,7,1/3,220052,1
3,2,22,53,1,922,2,12,5,5,7,single-choice,spatial-relational,5|7,7,5/7,220053,5
3,2,22,54,1,919,3,11,4,4,7,single-choice,spatial-relational,4|7,7,4/7,220054,4
3,2,22,55,1,1210,4,6,1,1,5,single-choice,spatial-relational,1|5,7,1/5,220055,1
3,2,22,56,1,1398,2,8,3,3,5,single-choice,spatial-relational,3|5,7,3/5,220056,3
3,2,22,57,1,1214,4,10,3,3,7,single-choice,spatial-relational,3|7,7,3/7,220057,3
3,2,22,58,1,1111,2,10,4,4,6,single-choice,spatial-relational,4|6,7,4/6,220058,4
3,2,22,59,1,1227,1,11,5,5,6,single-choice,spatial-relational,5|6,7,5/6,220059,5
3,2,22,60,1,1309,6,8,1,1,7,single-choice,spatial-relational,1|7,7,1/7,220060,1
3,2,22,61,1,821,2,12,5,5,7,single-choice,spatial-relational,5|7,7,5/7,220061,5
3,2,22,62,1,1546,3,5,1,1,4,single-choice,spatial-relational,1|4,7,1/4,220062,1
3,2,22,63,1,1238,2,6,2,2,4,single-choice,spatial-relational,2|4,7,2/4,220063,2
3,2,22,64,1,1410,2,4,1,1,3,single-choice,spatial-relational,1|3,7,1/3,220064,1
3,2,22,65,1,1026,1,5,2,2,3,single-choice,spatial-relational,2|3,7,2/3,220065,2
3,2,22,66,1,956,4,8,2,2,6,single-choice,spatial-relational,2|6,7,2/6,220066,2
3,2,22,67,1,1072,4,8,2,2,6,single-choice,spatial-relational,2|6,7,2/6,220067,2
3,2,22,68,1,1705,6,8,1,1,7,single-choice,spatial-relational,1|7,7,1/7,220068,1
3,2,22,69,1,1027,1,13,6,6,7,single-choice,spatial-relational,6|7,7,6/7,220069,6
3,2,22,70,1,1186,3,9,3,3,6,single-choice,spatial-relational,3|6,7,3/6,220070,3
3,2,22,71,1,1032,1,11,5,5,6,single-choice,spatial-relational,5|6,7,5/6,220071,5
3,2,22,72,1,1138,1,13,6,6,7,single-choice,spatial-relational,6|7,7,6/7,220072,6
3,2,22,73,1,1286,1,5,2,2,3,single-choice,spatial-relational,2|3,7,2/3,220073,2
3,2,22,74,1,1114,2,6,2,2,4,single-choice,spatial-relational,2|4,7,2/4,220074,2
3,2,22,75,1,1002,3,11,4,4,7,single-choice,spatial-relational,4|7,7,4/7,220075,4
3,2,22,76,1,1666,1,9,4,4,5,single-choice,spatial-relational,4|5,7,4/5,220076,4
3,2,22,77,1,1214,1,9,4,4,5,single-choice,spatial-relational,4|5,7,4/5,220077,4
3,2,22,78,1,1332,1,7,3,3,4,single-choice,spatial-relational,3|4,7,3/4,220078,3
3,2,22,79,1,1239,5,7,1,1,6,single-choice,spatial-relational,1|6,7,1/6,220079,1
3,2,22,80,1,917,3,7,2,2,5,single-choice,spatial-relational,2|5,7,2/5,220080,2
3,2,22,81,1,1681,1,3,1,1,2,single-choice,spatial-relational,1|2,7,1/2,220081,1
3,2,22,82,1,929,5,9,2,2,7,single-choice,spatial-relational,2|7,7,2/7,220082,2
3,2,22,83,1,1375,3,5,1,1,4,single-choice,spatial-relational,1|4,7,1/4,220083,1
3,2,22,84,1,1389,1,7,3,3,4,single-choice,spatial-relational,3|4,7,3/4,220084,3
3,2,22,85,1,2064,5,7,1,1,6,single-choice,spatial-relational,1|6,7,1/6,220085,1
3,2,22,86,1,943,1,7,3,3,4,single-choice,spatial-relational,3|4,7,3/4,220086,3
3,2,22,87,1,1425,2,8,3,3,5,single-choice,spatial-relational,3|5,7,3/5,220087,3
3,2,22,88,1,1037,2,6,2,2,4,single-choice,spatial-relational,2|4,7,2/4,220088,2
3,2,22,89,1,1167,6,8,1,1,7,single-choice,spatial-relational,1|7,7,1/7,220089,1
3,2,22,90,0,827,1,3,1,2,2,single-choice,spatial-relational,1|2,7,1/2,220090,1
3,2,22,91,1,1062,6,8,1,1,7,single-choice,spatial-relational,1|7,7,1/7,220091,1
3,2,22,92,1,956,3,9,3,3,6,single-choice,spatial-relational,3|6,7,3/6,220092,3
3,2,22,93,1,954,3,7,2,2,5,single-choice,spatial-relational,2|5,7,2/5,220093,2
3,2,22,94,1,1179,3,5,1,1,4,single-choice,spatial-relational,1|4,7,1/4,220094,1
3,2,22,95,0,946,5,7,1,6,6,single-choice,spatial-relational,1|6,7,1/6,220095,1
3,2,22,96,1,1181,2,10,4,4,6,single-choice,spatial-relational,4|6,7,4/6,220096,4
3,2,22,97,1,1268,4,6,1,1,5,single-choice,spatial-relational,1|5,7,1/5,220097,1
3,2,22,98,0,735,1,3,1,2,2,single-choice,spatial-relational,1|2,7,1/2,220098,1
3,2,22,99,1,111,2,10,4,4,6,single-choice,spatial-relational,4|6,7,4/6,220099,4
3,2,22,100,1,946,1,11,5,5,6,single-choice,spatial-relational,5|6,7,5/6,220100,5
3,2,22,101,1,1113,2,12,5,5,7,single-choice,spatial-relational,5|7,7,5/7,220101,5
3,2,22,102,1,1316,4,8,2,2,6,single-choice,spatial-relational,2|6,7,2/6,220102,2
3,2,22,103,1,1054,4,10,3,3,7,single-choice,spatial-relational,3|7,7,3/7,220103,3
3,2,22,104,1,1589,2,4,1,1,3,single-choice,spatial-relational,1|3,7,1/3,220104,1
3,2,22,105,0,1010,2,4,1,3,3,single-choice,spatial-relational,1|3,7,1/3,220105,1
3,2,22,106,1,974,3,7,2,2,5,single-choice,spatial-relational,2|5,7,2/5,220106,2
3,2,22,107,1,978,1,5,2,2,3,single-choice,spatial-relational,2|3,7,2/3,220107,2
3,2,22,108,0,1082,2,8,3,5,5,single-choice,spatial-relational,3|5,7,3/5,220108,3
3,2,22,109,1,1095,4,6,1,1,5,single-choice,spatial-relational,1|5,7,1/5,220109,1
3,2,22,110,1,951,2,12,5,5,7,single-choice,spatial-relational,5|7,7,5/7,220110,5
3,2,22,111,1,1085,1,9,4,4,5,single-choice,spatial-relational,4|5,7,4/5,220111,4
3,2,22,112,1,1232,3,11,4,4,7,single-choice,spatial-relational,4|7,7,4/7,220112,4
3,2,22,113,1,1041,1,7,3,3,4,single-choice,spatial-relational,3|4,7,3/4,220113,3
3,2,22,114,1,1189,1,11,5,5,6,single-choice,spatial-relational,5|6,7,5/6,220114,5
3,2,22,115,1,1344,5,9,2,2,7,single-choice,spatial-relational,2|7,7,2/7,220115,2
3,2,22,116,1,1524,1,5,2,2,3,single-choice,spatial-relational,2|3,7,2/3,220116,2
3,2,22,117,1,1170,4,10,3,3,7,single-choice,spatial-relational,3|7,7,3/7,220117,3
3,2,22,118,1,1297,2,6,2,2,4,single-choice,spatial-relational,2|4,7,2/4,220118,2
3,2,22,119,1,1200,1,13,6,6,7,single-choice,spatial-relational,6|7,7,6/7,220119,6
3,2,22,120,1,979,3,11,4,4,7,single-choice,spatial-relational,4|7,7,4/7,220120,4
3,2,22,121,1,1208,3,9,3,3,6,single-choice,spatial-relational,3|6,7,3/6,220121,3
3,2,22,122,1,1084,1,13,6,6,7,single-choice,spatial-relational,6|7,7,6/7,220122,6
3,2,22,123,1,1418,5,9,2,2,7,single-choice,spatial-relational,2|7,7,2/7,220123,2
3,2,22,124,1,887,4,8,2,2,6,single-choice,spatial-relational,2|6,7,2/6,220124,2
3,2,22,125,1,1321,3,5,1,1,4,single-choice,spatial-relational,1|4,7,1/4,220125,1
3,2,22,126,1,1026,1,9,4,4,5,single-choice,spatial-relational,4|5,7,4/5,220126,4
3,2,22,127,1,1290,4,6,1,1,5,single-choice,spatial-relational,1|5,7,1/5,220127,1
3,2,22,128,1,1224,5,7,1,1,6,single-choice,spatial-relational,1|6,7,1/6,220128,1
3,2,22,129,1,1002,5,9,2,2,7,single-choice,spatial-relational,2|7,7,2/7,220129,2
3,2,22,130,1,984,1,13,6,6,7,single-choice,spatial-relational,6|7,7,6/7,220130,6
3,2,22,131,1,1314,1,5,2,2,3,single-choice,spatial-relational,2|3,7,2/3,220131,2
3,2,22,132,1,1281,2,4,1,1,3,single-choice,spatial-relational,1|3,7,1/3,220132,1
3,2,22,133,1,1260,5,7,1,1,6,single-choice,spatial-relational,1|6,7,1/6,220133,1
3,2,22,134,1,1023,3,11,4,4,7,single-choice,spatial-relational,4|7,7,4/7,220134,4
3,2,22,135,1,1765,3,5,1,1,4,single-choice,spatial-relational,1|4,7,1/4,220135,1
3,2,22,136,1,947,2,8,3,3,5,single-choice,spatial-relational,3|5,7,3/5,220136,3
3,2,22,137,1,1606,1,11,5,5,6,single-choice,spatial-relational,5|6,7,5/6,220137,5
3,2,22,138,1,1297,2,12,5,5,7,single-choice,spatial-relational,5|7,7,5/7,220138,5
3,2,22,139,1,1008,1,7,3,3,4,single-choice,spatial-relational,3|4,7,3/4,220139,3
3,2,22,140,1,1065,4,8,2,2,6,single-choice,spatial-relational,2|6,7,2/6,220140,2
3,2,22,141,1,1173,3,9,3,3,6,single-choice,spatial-relational,3|6,7,3/6,220141,3
3,2,22,142,1,1141,3,5,1,1,4,single-choice,spatial-relational,1|4,7,1/4,220142,1
3,2,22,143,0,115,6,8,1,7,7,single-choice,spatial-relational,1|7,7,1/7,220143,1
3,2,22,144,1,1229,2,4,1,1,3,single-choice,spatial-relational,1|3,7,1/3,220144,1
3,2,22,145,1,980,1,9,4,4,5,single-choice,spatial-relational,4|5,7,4/5,220145,4
3,2,22,146,1,980,1,11,5,5,6,single-choice,spatial-relational,5|6,7,5/6,220146,5
3,2,22,147,1,1139,4,10,3,3,7,single-choice,spatial-relational,3|7,7,3/7,220147,3
3,2,22,148,1,1002,3,7,2,2,5,single-choice,spatial-relational,2|5,7,2/5,220148,2
3,2,22,149,1,940,2,6,2,2,4,single-choice,spatial-relational,2|4,7,2/4,220149,2
3,2,22,150,1,1052,2,8,3,3,5,single-choice,spatial-relational,3|5,7,3/5,220150,3
3,2,22,151,1,1235,4,10,3,3,7,single-choice,spatial-relational,3|7,7,3/7,220151,3
3,2,22,152,1,1092,3,11,4,4,7,single-choice,spatial-relational,4|7,7,4/7,220152,4
3,2,22,153,1,1310,2,12,5,5,7,single-choice,spatial-relational,5|7,7,5/7,220153,5
3,2,22,154,1,1943,1,9,4,4,5,single-choice,spatial-relational,4|5,7,4/5,220154,4
3,2,22,155,1,1480,1,13,6,6,7,single-choice,spatial-relational,6|7,7,6/7,220155,6
3,2,22,156,1,1109,1,7,3,3,4,single-choice,spatial-relational,3|4,7,3/4,220156,3
3,2,22,157,1,1268,2,6,2,2,4,single-choice,spatial-relational,2|4,7,2/4,220157,2
3,2,22,158,1,3554,1,3,1,1,2,single-choice,spatial-relational,1|2,7,1/2,220158,1
3,2,22,159,1,916,1,5,2,2,3,single-choice,spatial-relational,2|3,7,2/3,220159,2
3,2,22,160,1,1626,1,3,1,1,2,single-choice,spatial-relational,1|2,7,1/2,220160,1
3,2,22,161,1,1303,4,8,2,2,6,single-choice,spatial-relational,2|6,7,2/6,220161,2
3,2,22,162,1,1384,2,10,4,4,6,single-choice,spatial-relational,4|6,7,4/6,220162,4
3,2,22,163,1,1586,4,6,1,1,5,single-choice,spatial-relational,1|5,7,1/5,220163,1
3,2,22,164,1,962,2,10,4,4,6,single-choice,spatial-relational,4|6,7,4/6,220164,4
3,2,22,165,1,1269,3,7,2,2,5,single-choice,spatial-relational,2|5,7,2/5,220165,2
3,2,22,166,1,1233,6,8,1,1,7,single-choice,spatial-relational,1|7,7,1/7,220166,1
3,2,22,167,1,106,3,9,3,3,6,single-choice,spatial-relational,3|6,7,3/6,220167,3
3,2,22,168,1,1079,5,9,2,2,7,single-choice,spatial-relational,2|7,7,2/7,220168,2
3,2,22,169,1,1217,2,8,3,3,5,single-choice,spatial-relational,3|5,7,3/5,220169,3
3,2,22,170,1,1068,1,11,5,5,6,single-choice,spatial-relational,5|6,7,5/6,220170,5
3,2,22,171,1,1024,1,9,4,4,5,single-choice,spatial-relational,4|5,7,4/5,220171,4
3,2,22,172,1,1007,2,10,4,4,6,single-choice,spatial-relational,4|6,7,4/6,220172,4
3,2,22,173,1,1331,4,10,3,3,7,single-choice,spatial-relational,3|7,7,3/7,220173,3
3,2,22,174,1,1143,4,6,1,1,5,single-choice,spatial-relational,1|5,7,1/5,220174,1
3,2,22,175,1,980,2,10,4,4,6,single-choice,spatial-relational,4|6,7,4/6,220175,4
3,2,22,176,1,1446,1,7,3,3,4,single-choice,spatial-relational,3|4,7,3/4,220176,3
3,2,22,177,1,1230,1,11,5,5,6,single-choice,spatial-relational,5|6,7,5/6,220177,5
3,2,22,178,1,1059,2,12,5,5,7,single-choice,spatial-relational,5|7,7,5/7,220178,5
3,2,22,179,0,1068,1,3,1,2,2,single-choice,spatial-relational,1|2,7,1/2,220179,1
3,2,22,180,1,874,3,7,2,2,5,single-choice,spatial-relational,2|5,7,2/5,220180,2
3,2,22,181,1,1004,6,8,1,1,7,single-choice,spatial-relational,1|7,7,1/7,220181,1
3,2,22,182,1,1050,3,5,1,1,4,single-choice,spatial-relational,1|4,7,1/4,220182,1
3,2,22,183,1,1184,5,7,1,1,6,single-choice,spatial-relational,1|6,7,1/6,220183,1
3,2,22,184,1,834,3,11,4,4,7,single-choice,spatial-relational,4|7,7,4/7,220184,4
3,2,22,185,1,1618,6,8,1,1,7,single-choice,spatial-relational,1|7,7,1/7,220185,1
3,2,22,186,0,676,4,6,1,5,5,single-choice,spatial-relational,1|5,7,1/5,220186,1
3,2,22,187,1,902,3,9,3,3,6,single-choice,spatial-relational,3|6,7,3/6,220187,3
3,2,22,188,1,1115,4,10,3,3,7,single-choice,spatial-relational,3|7,7,3/7,220188,3
3,2,22,189,1,1221,2,6,2,2,4,single-choice,spatial-relational,2|4,7,2/4,220189,2
3,2,22,190,1,892,1,13,6,6,7,single-choice,spatial-relational,6|7,7,6/7,220190,6
3,2,22,191,1,1269,1,9,4,4,5,single-choice,spatial-relational,4|5,7,4/5,220191,4
3,2,22,192,1,1205,5,7,1,1,6,single-choice,spatial-relational,1|6,7,1/6,220192,1
3,2,22,193,0,123,2,6,2,4,4,single-choice,spatial-relational,2|4,7,2/4,220193,2
3,2,22,194,1,915,1,5,2,2,3,single-choice,spatial-relational,2|3,7,2/3,220194,2
3,2,22,195,1,950,5,9,2,2,7,single-choice,spatial-relational,2|7,7,2/7,220195,2
3,2,22,196,1,1606,2,4,1,1,3,single-choice,spatial-relational,1|3,7,1/3,220196,1
3,2,22,197,1,1488,4,8,2,2,6,single-choice,spatial-relational,2|6,7,2/6,220197,2
3,2,22,198,1,973,1,7,3,3,4,single-choice,spatial-relational,3|4,7,3/4,220198,3
3,2,22,199,1,1210,1,5,2,2,3,single-choice,spatial-relational,2|3,7,2/3,220199,2
3,2,22,200,1,996,4,8,2,2,6,single-choice,spatial-relational,2|6,7,2/6,220200,2
3,2,22,201,1,1064,5,9,2,2,7,single-choice,spatial-relational,2|7,7,2/7,220201,2
3,2,22,202,1,1188,2,4,1,1,3,single-choice,spatial-relational,1|3,7,1/3,220202,1
3,2,22,203,1,990,2,8,3,3,5,single-choice,spatial-relational,3|5,7,3/5,220203,3
3,2,22,204,1,966,2,12,5,5,7,single-choice,spatial-relational,5|7,7,5/7,220204,5
3,2,22,205,0,851,1,3,1,2,2,single-choice,spatial-relational,1|2,7,1/2,220205,1
3,2,22,206,1,773,3,11,4,4,7,single-choice,spatial-relational,4|7,7,4/7,220206,4
3,2,22,207,1,1287,3,5,1,1,4,single-choice,spatial-relational,1|4,7,1/4,220207,1
3,2,22,208,1,902,3,9,3,3,6,single-choice,spatial-relational,3|6,7,3/6,220208,3
3,2,22,209,1,968,1,13,6,6,7,single-choice,spatial-relational,6|7,7,6/7,220209,6
3,2,22,210,1,1424,3,7,2,2,5,single-choice,spatial-relational,2|5,7,2/5,220210,2
3,2,22,211,1,1268,2,8,3,3,5,single-choice,spatial-relational,3|5,7,3/5,220211,3
3,2,22,212,1,1137,2,8,3,3,5,single-choice,spatial-relational,3|5,7,3/5,220212,3
3,2,22,213,1,1021,2,12,5,5,7,single-choice,spatial-relational,5|7,7,5/7,220213,5
3,2,22,214,1,1276,3,11,4,4,7,single-choice,spatial-relational,4|7,7,4/7,220214,4
3,2,22,215,1,1831,2,4,1,1,3,single-choice,spatial-relational,1|3,7,1/3,220215,1
3,2,22,216,1,874,1,13,6,6,7,single-choice,spatial-relational,6|7,7,6/7,220216,6
3,2,22,217,1,1409,5,7,1,1,6,single-choice,spatial-relational,1|6,7,1/6,220217,1
3,2,22,218,1,926,2,10,4,4,6,single-choice,spatial-relational,4|6,7,4/6,220218,4
3,2,22,219,1,1315,4,8,2,2,6,single-choice,spatial-relational,2|6,7,2/6,220219,2
3,2,22,220,1,1205,2,10,4,4,6,single-choice,spatial-relational,4|6,7,4/6,220220,4
3,2,22,221,1,1358,6,8,1,1,7,single-choice,spatial-relational,1|7,7,1/7,220221,1
3,2,22,222,1,1201,3,5,1,1,4,single-choice,spatial-relational,1|4,7,1/4,220222,1
3,2,22,223,1,934,4,8,2,2,6,single-choice,spatial-relational,2|6,7,2/6,220223,2
3,2,22,224,1,1130,5,9,2,2,7,single-choice,spatial-relational,2|7,7,2/7,220224,2
3,2,22,225,1,982,5,9,2,2,7,single-choice,spatial-relational,2|7,7,2/7,220225,2
3,2,22,226,1,1373,2,4,1,1,3,single-choice,spatial-relational,1|3,7,1/3,220226,1
3,2,22,227,1,1210,6,8,1,1,7,single-choice,spatial-relational,1|7,7,1/7,220227,1
3,2,22,228,0,1075,1,3,1,2,2,single-choice,spatial-relational,1|2,7,1/2,220228,1
3,2,22,229,1,976,3,5,1,1,4,single-choice,spatial-relational,1|4,7,1/4,220229,1
3,2,22,230,0,876,1,3,1,2,2,single-choice,spatial-relational,1|2,7,1/2,220230,1
3,2,22,231,1,1077,4,6,1,1,5,single-choice,spatial-relational,1|5,7,1/5,220231,1
3,2,22,232,1,1265,1,11,5,5,6,single-choice,spatial-relational,5|6,7,5/6,220232,5
3,2,22,233,1,2832,5,7,1,1,6,single-choice,spatial-relational,1|6,7,1/6,220233,1
3,2,22,234,1,912,1,5,2,2,3,single-choice,spatial-relational,2|3,7,2/3,220234,2
3,2,22,235,1,2074,2,6,2,2,4,single-choice,spatial-relational,2|4,7,2/4,220235,2
3,2,22,236,0,891,1,9,4,5,5,single-choice,spatial-relational,4|5,7,4/5,220236,4
3,2,22,237,1,1032,4,10,3,3,7,single-choice,spatial-relational,3|7,7,3/7,220237,3
3,2,22,238,1,1269,3,11,4,4,7,single-choice,spatial-relational,4|7,7,4/7,220238,4
3,2,22,239,1,1727,2,12,5,5,7,single-choice,spatial-relational,5|7,7,5/7,220239,5
3,2,22,240,1,1283,1,5,2,2,3,single-choice,spatial-relational,2|3,7,2/3,220240,2
3,2,22,241,1,978,1,13,6,6,7,single-choice,spatial-relational,6|7,7,6/7,220241,6
3,2,22,242,1,1051,4,10,3,3,7,single-choice,spatial-relational,3|7,7,3/7,220242,3
3,2,22,243,1,1069,1,7,3,3,4,single-choice,spatial-relational,3|4,7,3/4,220243,3
3,2,22,244,1,1381,2,6,2,2,4,single-choice,spatial-relational,2|4,7,2/4,220244,2
3,2,22,245,1,1001,1,9,4,4,5,single-choice,spatial-relational,4|5,7,4/5,220245,4
3,2,22,246,1,87,3,9,3,3,6,single-choice,spatial-relational,3|6,7,3/6,220246,3
3,2,22,247,1,963,1,11,5,5,6,single-choice,spatial-relational,5|6,7,5/6,220247,5
3,2,22,248,1,1301,3,7,2,2,5,single-choice,spatial-relational,2|5,7,2/5,220248,2
3,2,22,249,1,1059,3,9,3,3,6,single-choice,spatial-relational,3|6,7,3/6,220249,3
3,2,22,250,1,1210,4,6,1,1,5,single-choice,spatial-relational,1|5,7,1/5,220250,1
3,2,22,251,1,1019,3,7,2,2,5,single-choice,spatial-relational,2|5,7,2/5,220251,2
3,2,22,252,1,1370,1,7,3,3,4,single-choice,spatial-relational,3|4,7,3/4,220252,3
3,2,22,253,1,1334,5,7,1,1,6,single-choice,spatial-relational,1|6,7,1/6,220253,1
3,2,22,254,0,67,3,5,1,4,4,single-choice,spatial-relational,1|4,7,1/4,220254,1
3,2,22,255,1,978,2,8,3,3,5,single-choice,spatial-relational,3|5,7,3/5,220255,3
3,2,22,256,1,1080,1,5,2,2,3,single-choice,spatial-relational,2|3,7,2/3,220256,2
3,2,22,257,1,1068,1,9,4,4,5,single-choice,spatial-relational,4|5,7,4/5,220257,4
3,2,22,258,1,1294,1,3,1,1,2,single-choice,spatial-relational,1|2,7,1/2,220258,1
3,2,22,259,1,1051,1,7,3,3,4,single-choice,spatial-relational,3|4,7,3/4,220259,3
3,2,22,260,1,1304,4,6,1,1,5,single-choice,spatial-relational,1|5,7,1/5,220260,1
3,2,22,261,1,1024,1,5,2,2,3,single-choice,spatial-relational,2|3,7,2/3,220261,2
3,2,22,262,1,1030,1,11,5,5,6,single-choice,spatial-relational,5|6,7,5/6,220262,5
3,2,22,263,1,1144,2,12,5,5,7,single-choice,spatial-relational,5|7,7,5/7,220263,5
3,2,22,264,1,1398,2,4,1,1,3,single-choice,spatial-relational,1|3,7,1/3,220264,1
3,2,22,265,1,1079,6,8,1,1,7,single-choice,spatial-relational,1|7,7,1/7,220265,1
3,2,22,266,1,889,4,8,2,2,6,single-choice,spatial-relational,2|6,7,2/6,220266,2
3,2,22,267,1,989,2,10,4,4,6,single-choice,spatial-relational,4|6,7,4/6,220267,4
3,2,22,268,1,991,1,13,6,6,7,single-choice,spatial-relational,6|7,7,6/7,220268,6
3,2,22,269,1,896,4,10,3,3,7,single-choice,spatial-relational,3|7,7,3/7,220269,3
3,2,22,270,1,1025,5,9,2,2,7,single-choice,spatial-relational,2|7,7,2/7,220270,2
3,2,22,271,1,1410,3,7,2,2,5,single-choice,spatial-relational,2|5,7,2/5,220271,2
3,2,22,272,1,1237,4,6,1,1,5,single-choice,spatial-relational,1|5,7,1/5,220272,1
3,2,22,273,1,732,3,9,3,3,6,single-choice,spatial-relational,3|6,7,3/6,220273,3
3,2,22,274,1,1545,2,10,4,4,6,single-choice,spatial-relational,4|6,7,4/6,220274,4
3,2,22,275,1,1193,3,11,4,4,7,single-choice,spatial-relational,4|7,7,4/7,220275,4
3,2,22,276,1,1071,2,6,2,2,4,single-choice,spatial-relational,2|4,7,2/4,220276,2
3,2,22,277,1,933,5,9,2,2,7,single-choice,spatial-relational,2|7,7,2/7,220277,2
3,2,22,278,0,38256,1,3,1,2,2,single-choice,spatial-relational,1|2,7,1/2,220278,1
3,2,22,279,0,448,1,9,4,5,5,single-choice,spatial-relational,4|5,7,4/5,220279,4
3,2,22,280,1,879,3,7,2,2,5,single-choice,spatial-relational,2|5,7,2/5,220280,2
3,2,22,281,1,1004,2,8,3,3,5,single-choice,spatial-relational,3|5,7,3/5,220281,3
3,2,22,282,1,1020,1,7,3,3,4,single-choice,spatial-relational,3|4,7,3/4,220282,3
3,2,22,283,1,1021,4,10,3,3,7,single-choice,spatial-relational,3|7,7,3/7,220283,3
3,2,22,284,1,1734,2,6,2,2,4,single-choice,spatial-relational,2|4,7,2/4,220284,2
3,2,22,285,1,1345,1,11,5,5,6,single-choice,spatial-relational,5|6,7,5/6,220285,5
3,2,22,286,1,918,2,12,5,5,7,single-choice,spatial-relational,5|7,7,5/7,220286,5
3,2,22,287,1,1093,3,9,3,3,6,single-choice,spatial-relational,3|6,7,3/6,220287,3
3,2,22,288,1,1108,1,13,6,6,7,single-choice,spatial-relational,6|7,7,6/7,220288,6
3,2,22,289,1,1178,4,8,2,2,6,single-choice,spatial-relational,2|6,7,2/6,220289,2
3,2,22,290,1,1216,6,8,1,1,7,single-choice,spatial-relational,1|7,7,1/7,220290,1
3,2,22,291,1,1044,3,11,4,4,7,single-choice,spatial-relational,4|7,7,4/7,220291,4
3,2,22,292,1,1305,2,4,1,1,3,single-choice,spatial-relational,1|3,7,1/3,220292,1
3,2,22,293,1,1024,5,7,1,1,6,single-choice,spatial-relational,1|6,7,1/6,220293,1
3,2,22,294,1,1189,3,5,1,1,4,single-choice,spatial-relational,1|4,7,1/4,220294,1
3,2,22,295,1,991,1,11,5,5,6,single-choice,spatial-relational,5|6,7,5/6,220295,5
3,2,22,296,1,1308,4,10,3,3,7,single-choice,spatial-relational,3|7,7,3/7,220296,3
3,2,22,297,1,1321,2,6,2,2,4,single-choice,spatial-relational,2|4,7,2/4,220297,2
3,2,22,298,1,1183,1,9,4,4,5,single-choice,spatial-relational,4|5,7,4/5,220298,4
3,2,22,299,0,142,3,9,3,6,6,single-choice,spatial-relational,3|6,7,3/6,220299,3
3,2,22,300,1,966,6,8,1,1,7,single-choice,spatial-relational,1|7,7,1/7,220300,1
3,2,22,301,1,996,3,5,1,1,4,single-choice,spatial-relational,1|4,7,1/4,220301,1
3,2,22,302,0,872,2,4,1,3,3,single-choice,spatial-relational,1|3,7,1/3,220302,1
3,2,22,303,1,983,1,5,2,2,3,single-choice,spatial-relational,2|3,7,2/3,220303,2
3,2,22,304,1,1045,2,6,2,2,4,single-choice,spatial-relational,2|4,7,2/4,220304,2
3,2,22,305,1,1038,4,6,1,1,5,single-choice,spatial-relational,1|5,7,1/5,220305,1
3,2,22,306,1,928,1,13,6,6,7,single-choice,spatial-relational,6|7,7,6/7,220306,6
3,2,22,307,1,1136,1,7,3,3,4,single-choice,spatial-relational,3|4,7,3/4,220307,3
3,2,22,308,1,1380,5,9,2,2,7,single-choice,spatial-relational,2|7,7,2/7,220308,2
3,2,22,309,1,892,1,5,2,2,3,single-choice,spatial-relational,2|3,7,2/3,220309,2
3,2,22,310,1,1496,1,11,5,5,6,single-choice,spatial-relational,5|6,7,5/6,220310,5
3,2,22,311,1,873,2,10,4,4,6,single-choice,spatial-relational,4|6,7,4/6,220311,4
3,2,22,312,1,1133,4,8,2,2,6,single-choice,spatial-relational,2|6,7,2/6,220312,2
3,2,22,313,1,1692,4,6,1,1,5,single-choice,spatial-relational,1|5,7,1/5,220313,1
3,2,22,314,1,875,4,10,3,3,7,single-choice,spatial-relational,3|7,7,3/7,220314,3
3,2,22,315,1,1098,2,8,3,3,5,single-choice,spatial-relational,3|5,7,3/5,220315,3
3,2,22,316,1,1225,5,7,1,1,6,single-choice,spatial-relational,1|6,7,1/6,220316,1
3,2,22,317,1,882,2,12,5,5,7,single-choice,spatial-relational,5|7,7,5/7,220317,5
3,2,22,318,1,995,1,9,4,4,5,single-choice,spatial-relational,4|5,7,4/5,220318,4
3,2,22,319,1,1481,2,4,1,1,3,single-choice,spatial-relational,1|3,7,1/3,220319,1
3,2,22,320,1,906,3,11,4,4,7,single-choice,spatial-relational,4|7,7,4/7,220320,4
3,2,22,321,1,992,3,11,4,4,7,single-choice,spatial-relational,4|7,7,4/7,220321,4
3,2,22,322,1,1112,2,12,5,5,7,single-choice,spatial-relational,5|7,7,5/7,220322,5
3,2,22,323,1,1133,6,8,1,1,7,single-choice,spatial-relational,1|7,7,1/7,220323,1
3,2,22,324,0,811,1,3,1,2,2,single-choice,spatial-relational,1|2,7,1/2,220324,1
3,2,22,325,1,1426,1,3,1,1,2,single-choice,spatial-relational,1|2,7,1/2,220325,1
3,2,22,326,1,1130,3,5,1,1,4,single-choice,spatial-relational,1|4,7,1/4,220326,1
3,2,22,327,1,1344,2,10,4,4,6,single-choice,spatial-relational,4|6,7,4/6,220327,4
3,2,22,328,1,1095,3,7,2,2,5,single-choice,spatial-relational,2|5,7,2/5,220328,2
3,2,22,329,1,1084,5,9,2,2,7,single-choice,spatial-relational,2|7,7,2/7,220329,2
3,2,22,330,1,948,3,9,3,3,6,single-choice,spatial-relational,3|6,7,3/6,220330,3
3,2,22,331,1,1114,1,13,6,6,7,single-choice,spatial-relational,6|7,7,6/7,220331,6
3,2,22,332,1,1252,1,7,3,3,4,single-choice,spatial-relational,3|4,7,3/4,220332,3
3,2,22,333,1,1058,5,7,1,1,6,single-choice,spatial-relational,1|6,7,1/6,220333,1
3,2,22,334,1,861,4,8,2,2,6,single-choice,spatial-relational,2|6,7,2/6,220334,2
3,2,22,335,1,1127,3,7,2,2,5,single-choice,spatial-relational,2|5,7,2/5,220335,2
3,2,22,336,1,1007,2,8,3,3,5,single-choice,spatial-relational,3|5,7,3/5,220336,3
3,2,22,337,1,1563,3,9,3,3,6,single-choice,spatial-relational,3|6,7,3/6,220337,3
3,2,22,338,0,901,5,7,1,6,6,single-choice,spatial-relational,1|6,7,1/6,220338,1
3,2,22,339,1,1084,1,9,4,4,5,single-choice,spatial-relational,4|5,7,4/5,220339,4
3,2,22,340,1,1332,6,8,1,1,7,single-choice,spatial-relational,1|7,7,1/7,220340,1
3,2,22,341,1,853,1,5,2,2,3,single-choice,spatial-relational,2|3,7,2/3,220341,2
3,2,22,342,1,979,3,7,2,2,5,single-choice,spatial-relational,2|5,7,2/5,220342,2
3,2,22,343,1,1101,3,11,4,4,7,single-choice,spatial-relational,4|7,7,4/7,220343,4
3,2,22,344,1,1024,4,8,2,2,6,single-choice,spatial-relational,2|6,7,2/6,220344,2
3,2,22,345,1,881,1,13,6,6,7,single-choice,spatial-relational,6|7,7,6/7,220345,6
3,2,22,346,1,1547,1,9,4,4,5,single-choice,spatial-relational,4|5,7,4/5,220346,4
3,2,22,347,1,1151,2,4,1,1,3,single-choice,spatial-relational,1|3,7,1/3,220347,1
3,2,22,348,1,1148,6,8,1,1,7,single-choice,spatial-relational,1|7,7,1/7,220348,1
3,2,22,349,1,1025,2,10,4,4,6,single-choice,spatial-relational,4|6,7,4/6,220349,4
3,2,22,350,1,1021,1,13,6,6,7,single-choice,spatial-relational,6|7,7,6/7,220350,6
3,2,22,351,1,1121,3,11,4,4,7,single-choice,spatial-relational,4|7,7,4/7,220351,4
3,2,22,352,1,978,2,6,2,2,4,single-choice,spatial-relational,2|4,7,2/4,220352,2
3,2,22,353,1,1048,1,11,5,5,6,single-choice,spatial-relational,5|6,7,5/6,220353,5
3,2,22,354,0,1298,2,10,4,6,6,single-choice,spatial-relational,4|6,7,4/6,220354,4
3,2,22,355,1,1451,1,11,5,5,6,single-choice,spatial-relational,5|6,7,5/6,220355,5
3,2,22,356,1,1099,2,12,5,5,7,single-choice,spatial-relational,5|7,7,5/7,220356,5
3,2,22,357,0,1063,1,3,1,2,2,single-choice,spatial-relational,1|2,7,1/2,220357,1
3,2,22,358,0,688,1,3,1,2,2,single-choice,spatial-relational,1|2,7,1/2,220358,1
3,2,22,359,1,988,3,5,1,1,4,single-choice,spatial-relational,1|4,7,1/4,220359,1
3,2,22,360,1,1041,1,5,2,2,3,single-choice,spatial-relational,2|3,7,2/3,220360,2
3,2,22,361,1,1667,4,6,1,1,5,single-choice,spatial-relational,1|5,7,1/5,220361,1
3,2,22,362,1,1258,3,9,3,3,6,single-choice,spatial-relational,3|6,7,3/6,220362,3
3,2,22,363,1,1080,4,8,2,2,6,single-choice,spatial-relational,2|6,7,2/6,220363,2
3,2,22,364,1,1133,2,8,3,3,5,single-choice,spatial-relational,3|5,7,3/5,220364,3
3,2,22,365,1,1373,4,6,1,1,5,single-choice,spatial-relational,1|5,7,1/5,220365,1
3,2,22,366,1,1068,4,10,3,3,7,single-choice,spatial-relational,3|7,7,3/7,220366,3
3,2,22,367,1,1131,1,7,3,3,4,single-choice,spatial-relational,3|4,7,3/4,220367,3
3,2,22,368,1,964,2,12,5,5,7,single-choice,spatial-relational,5|7,7,5/7,220368,5
3,2,22,369,0,1583,5,7,1,6,6,single-choice,spatial-relational,1|6,7,1/6,220369,1
3,2,22,370,1,818,1,7,3,3,4,single-choice,spatial-relational,3|4,7,3/4,220370,3
3,2,22,371,1,973,5,9,2,2,7,single-choice,spatial-relational,2|7,7,2/7,220371,2
3,2,22,372,1,1160,2,4,1,1,3,single-choice,spatial-relational,1|3,7,1/3,220372,1
3,2,22,373,1,1070,2,6,2,2,4,single-choice,spatial-relational,2|4,7,2/4,220373,2
3,2,22,374,1,1167,2,8,3,3,5,single-choice,spatial-relational,3|5,7,3/5,220374,3
3,2,22,375,1,1224,5,9,2,2,7,single-choice,spatial-relational,2|7,7,2/7,220375,2
3,2,22,376,1,1132,3,5,1,1,4,single-choice,spatial-relational,1|4,7,1/4,220376,1
3,2,22,377,1,976,3,7,2,2,5,single-choice,spatial-relational,2|5,7,2/5,220377,2
3,2,22,378,1,898,4,10,3,3,7,single-choice,spatial-relational,3|7,7,3/7,220378,3
3,2,22,379,0,788,2,8,3,5,5,single-choice,spatial-relational,3|5,7,3/5,220379,3
3,2,22,380,1,1105,1,7,3,3,4,single-choice,spatial-relational,3|4,7,3/4,220380,3
3,2,22,381,1,978,2,6,2,2,4,single-choice,spatial-relational,2|4,7,2/4,220381,2
3,2,22,382,1,1138,1,13,6,6,7,single-choice,spatial-relational,6|7,7,6/7,220382,6
3,2,22,383,1,908,1,5,2,2,3,single-choice,spatial-relational,2|3,7,2/3,220383,2
3,2,22,384,1,967,1,9,4,4,5,single-choice,spatial-relational,4|5,7,4/5,220384,4
3,2,22,385,1,4985,2,4,1,1,3,single-choice,spatial-relational,1|3,7,1/3,220385,1
3,2,22,386,1,1069,5,7,1,1,6,single-choice,spatial-relational,1|6,7,1/6,220386,1
3,2,22,387,1,1212,2,10,4,4,6,single-choice,spatial-relational,4|6,7,4/6,220387,4
3,2,22,388,1,1307,2,6,2,2,4,single-choice,spatial-relational,2|4,7,2/4,220388,2
3,2,22,389,1,1297,3,11,4,4,7,single-choice,spatial-relational,4|7,7,4/7,220389,4
3,2,22,390,1,817,1,11,5,5,6,single-choice,spatial-relational,5|6,7,5/6,220390,5
3,2,22,391,1,1989,3,7,2,2,5,single-choice,spatial-relational,2|5,7,2/5,220391,2
3,2,22,392,0,729,2,4,1,3,3,single-choice,spatial-relational,1|3,7,1/3,220392,1
3,2,22,393,1,845,4,10,3,3,7,single-choice,spatial-relational,3|7,7,3/7,220393,3
3,2,22,394,0,1182,1,3,1,2,2,single-choice,spatial-relational,1|2,7,1/2,220394,1
3,2,22,395,1,1032,4,6,1,1,5,single-choice,spatial-relational,1|5,7,1/5,220395,1
3,2,22,396,1,1399,1,9,4,4,5,single-choice,spatial-relational,4|5,7,4/5,220396,4
3,2,22,397,1,1029,2,12,5,5,7,single-choice,spatial-relational,5|7,7,5/7,220397,5
3,2,22,398,1,1079,3,7,2,2,5,single-choice,spatial-relational,2|5,7,2/5,220398,2
3,2,22,399,1,1131,4,6,1,1,5,single-choice,spatial-relational,1|5,7,1/5,220399,1
3,2,22,400,1,905,4,10,3,3,7,single-choice,spatial-relational,3|7,7,3/7,220400,3
3,2,22,401,1,970,1,13,6,6,7,single-choice,spatial-relational,6|7,7,6/7,220401,6
3,2,22,402,0,1013,1,3,1,2,2,single-choice,spatial-relational,1|2,7,1/2,220402,1
3,2,22,403,1,1172,2,10,4,4,6,single-choice,spatial-relational,4|6,7,4/6,220403,4
3,2,22,404,1,1133,5,7,1,1,6,single-choice,spatial-relational,1|6,7,1/6,220404,1
3,2,22,405,1,1183,6,8,1,1,7,single-choice,spatial-relational,1|7,7,1/7,220405,1
3,2,22,406,1,1100,6,8,1,1,7,single-choice,spatial-relational,1|7,7,1/7,220406,1
3,2,22,407,1,1707,1,5,2,2,3,single-choice,spatial-relational,2|3,7,2/3,220407,2
3,2,22,408,1,889,5,9,2,2,7,single-choice,spatial-relational,2|7,7,2/7,220408,2
3,2,22,409,1,1041,4,8,2,2,6,single-choice,spatial-relational,2|6,7,2/6,220409,2
3,2,22,410,1,1468,3,9,3,3,6,single-choice,spatial-relational,3|6,7,3/6,220410,3
3,2,22,411,1,1208,3,9,3,3,6,single-choice,spatial-relational,3|6,7,3/6,220411,3
3,2,22,412,1,1009,5,9,2,2,7,single-choice,spatial-relational,2|7,7,2/7,220412,2
3,2,22,413,1,126934,3,5,1,1,4,single-choice,spatial-relational,1|4,7,1/4,220413,1
3,2,22,414,1,1007,4,8,2,2,6,single-choice,spatial-relational,2|6,7,2/6,220414,2
3,2,22,415,1,775,1,11,5,5,6,single-choice,spatial-relational,5|6,7,5/6,220415,5
3,2,22,416,1,1032,3,11,4,4,7,single-choice,spatial-relational,4|7,7,4/7,220416,4
3,2,22,417,1,1214,3,5,1,1,4,single-choice,spatial-relational,1|4,7,1/4,220417,1
3,2,22,418,1,1006,2,8,3,3,5,single-choice,spatial-relational,3|5,7,3/5,220418,3
3,2,22,419,1,822,2,12,5,5,7,single-choice,spatial-relational,5|7,7,5/7,220419,5
3,2,22,420,1,969,1,7,3,3,4,single-choice,spatial-relational,3|4,7,3/4,220420,3
3,2,22,421,0,1166,1,3,1,2,2,single-choice,spatial-relational,1|2,7,1/2,220421,1
3,2,22,422,1,1134,3,9,3,3,6,single-choice,spatial-relational,3|6,7,3/6,220422,3
3,2,22,423,1,751,2,12,5,5,7,single-choice,spatial-relational,5|7,7,5/7,220423,5
3,2,22,424,1,1013,3,7,2,2,5,single-choice,spatial-relational,2|5,7,2/5,220424,2
3,2,22,425,0,875,3,5,1,4,4,single-choice,spatial-relational,1|4,7,1/4,220425,1
3,2,22,426,1,1027,3,7,2,2,5,single-choice,spatial-relational,2|5,7,2/5,220426,2
3,2,22,427,1,919,4,10,3,3,7,single-choice,spatial-relational,3|7,7,3/7,220427,3
3,2,22,428,1,990,2,8,3,3,5,single-choice,spatial-relational,3|5,7,3/5,220428,3
3,2,22,429,1,918,1,13,6,6,7,single-choice,spatial-relational,6|7,7,6/7,220429,6
3,2,22,430,1,1162,1,7,3,3,4,single-choice,spatial-relational,3|4,7,3/4,220430,3
3,2,22,431,0,950,1,7,3,4,4,single-choice,spatial-relational,3|4,7,3/4,220431,3
3,2,22,432,1,1076,6,8,1,1,7,single-choice,spatial-relational,1|7,7,1/7,220432,1
3,2,22,433,1,1193,5,7,1,1,6,single-choice,spatial-relational,1|6,7,1/6,220433,1
3,2,22,434,0,815,3,5,1,4,4,single-choice,spatial-relational,1|4,7,1/4,220434,1
3,2,22,435,1,927,4,10,3,3,7,single-choice,spatial-relational,3|7,7,3/7,220435,3
3,2,22,436,1,876,1,13,6,6,7,single-choice,spatial-relational,6|7,7,6/7,220436,6
3,2,22,437,1,920,3,11,4,4,7,single-choice,spatial-relational,4|7,7,4/7,220437,4
3,2,22,438,0,1202,1,9,4,5,5,single-choice,spatial-relational,4|5,7,4/5,220438,4
3,2,22,439,1,1110,3,11,4,4,7,single-choice,spatial-relational,4|7,7,4/7,220439,4
3,2,22,440,1,1101,4,6,1,1,5,single-choice,spatial-relational,1|5,7,1/5,220440,1
3,2,22,441,1,944,5,9,2,2,7,single-choice,spatial-relational,2|7,7,2/7,220441,2
3,2,22,442,1,1209,4,8,2,2,6,single-choice,spatial-relational,2|6,7,2/6,220442,2
3,2,22,443,1,870,1,9,4,4,5,single-choice,spatial-relational,4|5,7,4/5,220443,4
3,2,22,444,1,14990,1,5,2,2,3,single-choice,spatial-relational,2|3,7,2/3,220444,2
3,2,22,445,1,1105,2,10,4,4,6,single-choice,spatial-relational,4|6,7,4/6,220445,4
3,2,22,446,1,1148,2,8,3,3,5,single-choice,spatial-relational,3|5,7,3/5,220446,3
3,2,22,447,1,892,5,9,2,2,7,single-choice,spatial-relational,2|7,7,2/7,220447,2
3,2,22,448,1,1178,5,7,1,1,6,single-choice,spatial-relational,1|6,7,1/6,220448,1
3,2,22,449,0,1496,2,4,1,3,3,single-choice,spatial-relational,1|3,7,1/3,220449,1
3,2,22,450,1,981,1,11,5,5,6,single-choice,spatial-relational,5|6,7,5/6,220450,5
3,2,22,451,1,1335,2,4,1,1,3,single-choice,spatial-relational,1|3,7,1/3,220451,1
3,2,22,452,1,1106,6,8,1,1,7,single-choice,spatial-relational,1|7,7,1/7,220452,1
3,2,22,453,1,841,1,5,2,2,3,single-choice,spatial-relational,2|3,7,2/3,220453,2
3,2,22,454,1,933,4,8,2,2,6,single-choice,spatial-relational,2|6,7,2/6,220454,2
3,2,22,455,0,708,4,6,1,5,5,single-choice,spatial-relational,1|5,7,1/5,220455,1
3,2,22,456,1,876,2,6,2,2,4,single-choice,spatial-relational,2|4,7,2/4,220456,2
3,2,22,457,0,848,1,3,1,2,2,single-choice,spatial-relational,1|2,7,1/2,220457,1
3,2,22,458,1,994,2,6,2,2,4,single-choice,spatial-relational,2|4,7,2/4,220458,2
3,2,22,459,1,921,2,10,4,4,6,single-choice,spatial-relational,4|6,7,4/6,220459,4
3,2,22,460,1,945,1,11,5,5,6,single-choice,spatial-relational,5|6,7,5/6,220460,5
3,2,22,461,1,780452,2,12,5,5,7,single-choice,spatial-relational,5|7,7,5/7,220461,5
3,2,22,462,1,871,3,9,3,3,6,single-choice,spatial-relational,3|6,7,3/6,220462,3
3,2,22,463,1,1838,1,13,6,6,7,single-choice,spatial-relational,6|7,7,6/7,220463,6
3,2,22,464,1,975,2,12,5,5,7,single-choice,spatial-relational,5|7,7,5/7,220464,5
3,2,22,465,1,1224,2,10,4,4,6,single-choice,spatial-relational,4|6,7,4/6,220465,4
3,2,22,466,0,1003,3,5,1,4,4,single-choice,spatial-relational,1|4,7,1/4,220466,1
3,2,22,467,1,1221,2,8,3,3,5,single-choice,spatial-relational,3|5,7,3/5,220467,3
3,2,22,468,1,920,5,9,2,2,7,single-choice,spatial-relational,2|7,7,2/7,220468,2
3,2,22,469,1,849,2,12,5,5,7,single-choice,spatial-relational,5|7,7,5/7,220469,5
3,2,22,470,1,1110,3,9,3,3,6,single-choice,spatial-relational,3|6,7,3/6,220470,3
3,2,22,471,0,1053,1,9,4,5,5,single-choice,spatial-relational,4|5,7,4/5,220471,4
3,2,22,472,0,975,2,4,1,3,3,single-choice,spatial-relational,1|3,7,1/3,220472,1
3,2,22,473,1,1229,1,13,6,6,7,single-choice,spatial-relational,6|7,7,6/7,220473,6
3,2,22,474,1,1028,3,7,2,2,5,single-choice,spatial-relational,2|5,7,2/5,220474,2
3,2,22,475,1,894,3,11,4,4,7,single-choice,spatial-relational,4|7,7,4/7,220475,4
3,2,22,476,1,958,1,7,3,3,4,single-choice,spatial-relational,3|4,7,3/4,220476,3
3,2,22,477,1,1060,4,8,2,2,6,single-choice,spatial-relational,2|6,7,2/6,220477,2
3,2,22,478,1,820,1,5,2,2,3,single-choice,spatial-relational,2|3,7,2/3,220478,2
3,2,22,479,1,1298,2,8,3,3,5,single-choice,spatial-relational,3|5,7,3/5,220479,3
3,2,22,480,0,923,1,3,1,2,2,single-choice,spatial-relational,1|2,7,1/2,220480,1
3,2,22,481,1,907,3,9,3,3,6,single-choice,spatial-relational,3|6,7,3/6,220481,3
3,2,22,482,0,849,1,3,1,2,2,single-choice,spatial-relational,1|2,7,1/2,220482,1
3,2,22,483,1,920,2,10,4,4,6,single-choice,spatial-relational,4|6,7,4/6,220483,4
3,2,22,484,1,961,2,6,2,2,4,single-choice,spatial-relational,2|4,7,2/4,220484,2
3,2,22,485,1,834,1,5,2,2,3,single-choice,spatial-relational,2|3,7,2/3,220485,2
3,2,22,486,1,1162,4,6,1,1,5,single-choice,spatial-relational,1|5,7,1/5,220486,1
3,2,22,487,0,736,4,6,1,5,5,single-choice,spatial-relational,1|5,7,1/5,220487,1
3,2,22,488,1,1019,6,8,1,1,7,single-choice,spatial-relational,1|7,7,1/7,220488,1
3,2,22,489,1,748,1,11,5,5,6,single-choice,spatial-relational,5|6,7,5/6,220489,5
3,2,22,490,1,1105,5,7,1,1,6,single-choice,spatial-relational,1|6,7,1/6,220490,1
3,2,22,491,1,1019,3,11,4,4,7,single-choice,spatial-relational,4|7,7,4/7,220491,4
3,2,22,492,1,873,5,9,2,2,7,single-choice,spatial-relational,2|7,7,2/7,220492,2
3,2,22,493,1,768,4,10,3,3,7,single-choice,spatial-relational,3|7,7,3/7,220493,3
3,2,22,494,1,822,3,7,2,2,5,single-choice,spatial-relational,2|5,7,2/5,220494,2
3,2,22,495,1,1046,2,4,1,1,3,single-choice,spatial-relational,1|3,7,1/3,220495,1
3,2,22,496,1,1028,5,7,1,1,6,single-choice,spatial-relational,1|6,7,1/6,220496,1
3,2,22,497,1,782,4,10,3,3,7,single-choice,spatial-relational,3|7,7,3/7,220497,3
3,2,22,498,0,650,6,8,1,7,7,single-choice,spatial-relational,1|7,7,1/7,220498,1
3,2,22,499,1,1089,1,9,4,4,5,single-choice,spatial-relational,4|5,7,4/5,220499,4
3,2,22,500,1,1072,3,5,1,1,4,single-choice,spatial-relational,1|4,7,1/4,220500,1
3,2,22,501,1,700,1,7,3,3,4,single-choice,spatial-relational,3|4,7,3/4,220501,3
3,2,22,502,1,970,1,11,5,5,6,single-choice,spatial-relational,5|6,7,5/6,220502,5
3,2,22,503,1,887,2,6,2,2,4,single-choice,spatial-relational,2|4,7,2/4,220503,2
3,2,22,504,1,960,4,8,2,2,6,single-choice,spatial-relational,2|6,7,2/6,220504,2
3,2,22,505,1,810,1,13,6,6,7,single-choice,spatial-relational,6|7,7,6/7,220505,6
3,2,22,506,1,979,6,8,1,1,7,single-choice,spatial-relational,1|7,7,1/7,220506,1
1,2,23,1,1,1632,1,3,1,1,2,single-choice,spatial-relational,1|2,7,1/2,230001,1
1,2,23,2,1,24,1,7,3,3,4,single-choice,spatial-relational,3|4,7,3/4,230002,3
1,2,23,3,1,1071,1,13,6,6,7,single-choice,spatial-relational,6|7,7,6/7,230003,6
1,2,23,4,1,1574,1,11,5,5,6,single-choice,spatial-relational,5|6,7,5/6,230004,5
1,2,23,5,1,1024,1,13,6,6,7,single-choice,spatial-relational,6|7,7,6/7,230005,6
1,2,23,6,0,1164,1,7,3,4,4,single-choice,spatial-relational,3|4,7,3/4,230006,3
1,2,23,7,0,1677,1,5,2,3,3,single-choice,spatial-relational,2|3,7,2/3,230007,2
1,2,23,8,1,1712,1,3,1,1,2,single-choice,spatial-relational,1|2,7,1/2,230008,1
1,2,23,9,0,1017,1,9,4,5,5,single-choice,spatial-relational,4|5,7,4/5,230009,4
1,2,23,10,0,1886,1,11,5,6,6,single-choice,spatial-relational,5|6,7,5/6,230010,5
1,2,23,11,0,1552,1,9,4,5,5,single-choice,spatial-relational,4|5,7,4/5,230011,4
1,2,23,12,1,761,1,5,2,2,3,single-choice,spatial-relational,2|3,7,2/3,230012,2
1,2,23,13,1,826,1,3,1,1,2,single-choice,spatial-relational,1|2,7,1/2,230013,1
1,2,23,14,1,1320,1,3,1,1,2,single-choice,spatial-relational,1|2,7,1/2,230014,1
1,2,23,15,0,1312,1,11,5,6,6,single-choice,spatial-relational,5|6,7,5/6,230015,5
1,2,23,16,0,8183,1,11,5,6,6,single-choice,spatial-relational,5|6,7,5/6,230016,5
1,2,23,17,1,969,1,5,2,2,3,single-choice,spatial-relational,2|3,7,2/3,230017,2
1,2,23,18,0,991,1,7,3,4,4,single-choice,spatial-relational,3|4,7,3/4,230018,3
1,2,23,19,0,52,1,5,2,3,3,single-choice,spatial-relational,2|3,7,2/3,230019,2
1,2,23,20,0,40,1,9,4,5,5,single-choice,spatial-relational,4|5,7,4/5,230020,4
1,2,23,21,0,1136,1,13,6,7,7,single-choice,spatial-relational,6|7,7,6/7,230021,6
1,2,23,22,0,962,1,13,6,7,7,single-choice,spatial-relational,6|7,7,6/7,230022,6
1,2,23,23,1,2281,1,9,4,4,5,single-choice,spatial-relational,4|5,7,4/5,230023,4
1,2,23,24,0,1187,1,7,3,4,4,single-choice,spatial-relational,3|4,7,3/4,230024,3
1,2,23,25,1,1002,1,5,2,2,3,single-choice,spatial-relational,2|3,7,2/3,230025,2
1,2,23,26,0,2205,1,13,6,7,7,single-choice,spatial-relational,6|7,7,6/7,230026,6
1,2,23,27,0,1459,1,13,6,7,7,single-choice,spatial-relational,6|7,7,6/7,230027,6
1,2,23,28,1,2305,1,11,5,5,6,single-choice,spatial-relational,5|6,7,5/6,230028,5
1,2,23,29,0,1445,1,9,4,5,5,single-choice,spatial-relational,4|5,7,4/5,230029,4
1,2,23,30,1,1308,1,7,3,3,4,single-choice,spatial-relational,3|4,7,3/4,230030,3
1,2,23,31,0,1198,1,3,1,2,2,single-choice,spatial-relational,1|2,7,1/2,230031,1
1,2,23,32,0,1410,1,9,4,5,5,single-choice,spatial-relational,4|5,7,4/5,230032,4
1,2,23,33,1,1511,1,3,1,1,2,single-choice,spatial-relational,1|2,7,1/2,230033,1
1,2,23,34,1,1279,1,7,3,3,4,single-choice,spatial-relational,3|4,7,3/4,230034,3
1,2,23,35,0,2374,1,5,2,3,3,single-choice,spatial-relational,2|3,7,2/3,230035,2
1,2,23,36,1,1148,1,11,5,5,6,single-choice,spatial-relational,5|6,7,5/6,230036,5
1,2,23,37,0,2019,1,13,6,7,7,single-choice,spatial-relational,6|7,7,6/7,230037,6
1,2,23,38,0,1370,1,11,5,6,6,single-choice,spatial-relational,5|6,7,5/6,230038,5
1,2,23,39,0,121,1,7,3,4,4,single-choice,spatial-relational,3|4,7,3/4,230039,3
1,2,23,40,1,1089,1,5,2,2,3,single-choice,spatial-relational,2|3,7,2/3,230040,2
1,2,23,41,1,1738,1,7,3,3,4,single-choice,spatial-relational,3|4,7,3/4,230041,3
1,2,23,42,1,1283,1,13,6,6,7,single-choice,spatial-relational,6|7,7,6/7,230042,6
1,2,23,43,1,3256,1,3,1,1,2,single-choice,spatial-relational,1|2,7,1/2,230043,1
1,2,23,44,1,1749,1,9,4,4,5,single-choice,spatial-relational,4|5,7,4/5,230044,4
1,2,23,45,1,1774,1,3,1,1,2,single-choice,spatial-relational,1|2,7,1/2,230045,1
1,2,23,46,0,1125,1,9,4,5,5,single-choice,spatial-relational,4|5,7,4/5,230046,4
1,2,23,47,1,1089,1,5,2,2,3,single-choice,spatial-relational,2|3,7,2/3,230047,2
1,2,23,48,0,947,1,11,5,6,6,single-choice,spatial-relational,5|6,7,5/6,230048,5
1,2,23,49,1,1602,1,13,6,6,7,single-choice,spatial-relational,6|7,7,6/7,230049,6
1,2,23,50,0,1298,1,11,5,6,6,single-choice,spatial-relational,5|6,7,5/6,230050,5
1,2,23,51,0,925,1,11,5,6,6,single-choice,spatial-relational,5|6,7,5/6,230051,5
1,2,23,52,1,1366,1,3,1,1,2,single-choice,spatial-relational,1|2,7,1/2,230052,1
1,2,23,53,0,1032,1,5,2,3,3,single-choice,spatial-relational,2|3,7,2/3,230053,2
1,2,23,54,1,1279,1,3,1,1,2,single-choice,spatial-relational,1|2,7,1/2,230054,1
1,2,23,55,0,1413,1,7,3,4,4,single-choice,spatial-relational,3|4,7,3/4,230055,3
1,2,23,56,1,855,1,5,2,2,3,single-choice,spatial-relational,2|3,7,2/3,230056,2
1,2,23,57,1,1794,1,13,6,6,7,single-choice,spatial-relational,6|7,7,6/7,230057,6
1,2,23,58,1,1964,1,9,4,4,5,single-choice,spatial-relational,4|5,7,4/5,230058,4
1,2,23,59,0,1406,1,7,3,4,4,single-choice,spatial-relational,3|4,7,3/4,230059,3
1,2,23,60,0,1051,1,9,4,5,5,single-choice,spatial-relational,4|5,7,4/5,230060,4
1,2,23,61,1,1983,1,3,1,1,2,single-choice,spatial-relational,1|2,7,1/2,230061,1
1,2,23,62,1,1061,1,13,6,6,7,single-choice,spatial-relational,6|7,7,6/7,230062,6
1,2,23,63,0,1465,1,7,3,4,4,single-choice,spatial-relational,3|4,7,3/4,230063,3
1,2,23,64,1,1729,1,13,6,6,7,single-choice,spatial-relational,6|7,7,6/7,230064,6
1,2,23,65,0,1316,1,11,5,6,6,single-choice,spatial-relational,5|6,7,5/6,230065,5
1,2,23,66,1,1132,1,9,4,4,5,single-choice,spatial-relational,4|5,7,4/5,230066,4
1,2,23,67,1,1211,1,5,2,2,3,single-choice,spatial-relational,2|3,7,2/3,230067,2
1,2,23,68,0,1595,1,11,5,6,6,single-choice,spatial-relational,5|6,7,5/6,230068,5
1,2,23,69,1,892,1,5,2,2,3,single-choice,spatial-relational,2|3,7,2/3,230069,2
1,2,23,70,1,1587,1,3,1,1,2,single-choice,spatial-relational,1|2,7,1/2,230070,1
1,2,23,71,0,1344,1,7,3,4,4,single-choice,spatial-relational,3|4,7,3/4,230071,3
1,2,23,72,0,1388,1,9,4,5,5,single-choice,spatial-relational,4|5,7,4/5,230072,4
1,2,23,73,1,1011,1,3,1,1,2,single-choice,spatial-relational,1|2,7,1/2,230073,1
1,2,23,74,0,1131,1,11,5,6,6,single-choice,spatial-relational,5|6,7,5/6,230074,5
1,2,23,75,1,1231,1,13,6,6,7,single-choice,spatial-relational,6|7,7,6/7,230075,6
1,2,23,76,1,1768,1,13,6,6,7,single-choice,spatial-relational,6|7,7,6/7,230076,6
1,2,23,77,0,1612,1,7,3,4,4,single-choice,spatial-relational,3|4,7,3/4,230077,3
1,2,23,78,1,1152,1,7,3,3,4,single-choice,spatial-relational,3|4,7,3/4,230078,3
1,2,23,79,1,1008,1,5,2,2,3,single-choice,spatial-relational,2|3,7,2/3,230079,2
1,2,23,80,1,1248,1,3,1,1,2,single-choice,spatial-relational,1|2,7,1/2,230080,1
1,2,23,81,1,1431,1,5,2,2,3,single-choice,spatial-relational,2|3,7,2/3,230081,2
1,2,23,82,1,2290,1,9,4,4,5,single-choice,spatial-relational,4|5,7,4/5,230082,4
1,2,23,83,0,802,1,11,5,6,6,single-choice,spatial-relational,5|6,7,5/6,230083,5
1,2,23,84,1,58,1,9,4,4,5,single-choice,spatial-relational,4|5,7,4/5,230084,4
1,2,23,85,1,1256,1,9,4,4,5,single-choice,spatial-relational,4|5,7,4/5,230085,4
1,2,23,86,1,1084,1,13,6,6,7,single-choice,spatial-relational,6|7,7,6/7,230086,6
1,2,23,87,0,705,1,7,3,4,4,single-choice,spatial-relational,3|4,7,3/4,230087,3
1,2,23,88,1,849,1,3,1,1,2,single-choice,spatial-relational,1|2,7,1/2,230088,1
1,2,23,89,0,2224,1,11,5,6,6,single-choice,spatial-relational,5|6,7,5/6,230089,5
1,2,23,90,1,717,1,13,6,6,7,single-choice,spatial-relational,6|7,7,6/7,230090,6
1,2,23,91,1,1593,1,9,4,4,5,single-choice,spatial-relational,4|5,7,4/5,230091,4
1,2,23,92,1,837,1,5,2,2,3,single-choice,spatial-relational,2|3,7,2/3,230092,2
1,2,23,93,1,970,1,3,1,1,2,single-choice,spatial-relational,1|2,7,1/2,230093,1
1,2,23,94,0,1490,1,11,5,6,6,single-choice,spatial-relational,5|6,7,5/6,230094,5
1,2,23,95,1,973,1,5,2,2,3,single-choice,spatial-relational,2|3,7,2/3,230095,2
1,2,23,96,0,1632,1,7,3,4,4,single-choice,spatial-relational,3|4,7,3/4,230096,3
1,2,23,97,1,1247,1,7,3,3,4,single-choice,spatial-relational,3|4,7,3/4,230097,3
1,2,23,98,1,1006,1,5,2,2,3,single-choice,spatial-relational,2|3,7,2/3,230098,2
1,2,23,99,1,1665,1,11,5,5,6,single-choice,spatial-relational,5|6,7,5/6,230099,5
1,2,23,100,0,1441,1,11,5,6,6,single-choice,spatial-relational,5|6,7,5/6,230100,5
1,2,23,101,1,913,1,13,6,6,7,single-choice,spatial-relational,6|7,7,6/7,230101,6
1,2,23,102,0,1790,1,7,3,4,4,single-choice,spatial-relational,3|4,7,3/4,230102,3
1,2,23,103,1,1442,1,9,4,4,5,single-choice,spatial-relational,4|5,7,4/5,230103,4
1,2,23,104,1,1031,1,5,2,2,3,single-choice,spatial-relational,2|3,7,2/3,230104,2
1,2,23,105,1,1616,1,3,1,1,2,single-choice,spatial-relational,1|2,7,1/2,230105,1
1,2,23,106,1,1303,1,3,1,1,2,single-choice,spatial-relational,1|2,7,1/2,230106,1
1,2,23,107,1,1508,1,13,6,6,7,single-choice,spatial-relational,6|7,7,6/7,230107,6
1,2,23,108,0,1253,1,9,4,5,5,single-choice,spatial-relational,4|5,7,4/5,230108,4
1,2,23,109,1,1273,1,9,4,4,5,single-choice,spatial-relational,4|5,7,4/5,230109,4
1,2,23,110,1,1292,1,7,3,3,4,single-choice,spatial-relational,3|4,7,3/4,230110,3
1,2,23,111,0,1777,1,7,3,4,4,single-choice,spatial-relational,3|4,7,3/4,230111,3
1,2,23,112,1,809,1,5,2,2,3,single-choice,spatial-relational,2|3,7,2/3,230112,2
1,2,23,113,1,1441,1,13,6,6,7,single-choice,spatial-relational,6|7,7,6/7,230113,6
1,2,23,114,1,1045,1,3,1,1,2,single-choice,spatial-relational,1|2,7,1/2,230114,1
1,2,23,115,1,846,1,5,2,2,3,single-choice,spatial-relational,2|3,7,2/3,230115,2
1,2,23,116,1,1307,1,13,6,6,7,single-choice,spatial-relational,6|7,7,6/7,230116,6
1,2,23,117,0,1429,1,9,4,5,5,single-choice,spatial-relational,4|5,7,4/5,230117,4
1,2,23,118,0,942,1,11,5,6,6,single-choice,spatial-relational,5|6,7,5/6,230118,5
1,2,23,119,1,57,1,11,5,5,6,single-choice,spatial-relational,5|6,7,5/6,230119,5
1,2,23,120,0,1050,1,3,1,2,2,single-choice,spatial-relational,1|2,7,1/2,230120,1
1,2,23,121,0,1292,1,3,1,2,2,single-choice,spatial-relational,1|2,7,1/2,230121,1
1,2,23,122,1,1079,1,9,4,4,5,single-choice,spatial-relational,4|5,7,4/5,230122,4
1,2,23,123,1,1694,1,13,6,6,7,single-choice,spatial-relational,6|7,7,6/7,230123,6
1,2,23,124,0,1109,1,11,5,6,6,single-choice,spatial-relational,5|6,7,5/6,230124,5
1,2,23,125,0,905,1,11,5,6,6,single-choice,spatial-relational,5|6,7,5/6,230125,5
1,2,23,126,1,75,1,7,3,3,4,single-choice,spatial-relational,3|4,7,3/4,230126,3
1,2,23,127,1,1517,1,9,4,4,5,single-choice,spatial-relational,4|5,7,4/5,230127,4
1,2,23,128,0,1367,1,7,3,4,4,single-choice,spatial-relational,3|4,7,3/4,230128,3
1,2,23,129,1,1125,1,5,2,2,3,single-choice,spatial-relational,2|3,7,2/3,230129,2
1,2,23,130,1,1116,1,3,1,1,2,single-choice,spatial-relational,1|2,7,1/2,230130,1
1,2,23,131,1,891,1,5,2,2,3,single-choice,spatial-relational,2|3,7,2/3,230131,2
1,2,23,132,1,1676,1,13,6,6,7,single-choice,spatial-relational,6|7,7,6/7,230132,6
1,2,23,133,0,1682,1,11,5,6,6,single-choice,spatial-relational,5|6,7,5/6,230133,5
1,2,23,134,0,1580,1,5,2,3,3,single-choice,spatial-relational,2|3,7,2/3,230134,2
1,2,23,135,0,2315,1,7,3,4,4,single-choice,spatial-relational,3|4,7,3/4,230135,3
1,2,23,136,1,804,1,3,1,1,2,single-choice,spatial-relational,1|2,7,1/2,230136,1
1,2,23,137,0,1575,1,9,4,5,5,single-choice,spatial-relational,4|5,7,4/5,230137,4
1,2,23,138,0,1049,1,9,4,5,5,single-choice,spatial-relational,4|5,7,4/5,230138,4
1,2,23,139,1,36,1,11,5,5,6,single-choice,spatial-relational,5|6,7,5/6,230139,5
1,2,23,140,1,1331,1,5,2,2,3,single-choice,spatial-relational,2|3,7,2/3,230140,2
1,2,23,141,1,915,1,3,1,1,2,single-choice,spatial-relational,1|2,7,1/2,230141,1
1,2,23,142,1,1385,1,13,6,6,7,single-choice,spatial-relational,6|7,7,6/7,230142,6
1,2,23,143,0,1667,1,7,3,4,4,single-choice,spatial-relational,3|4,7,3/4,230143,3
1,2,23,144,1,1856,1,13,6,6,7,single-choice,spatial-relational,6|7,7,6/7,230144,6
1,2,23,145,1,1341,1,7,3,3,4,single-choice,spatial-relational,3|4,7,3/4,230145,3
1,2,23,146,1,1394,1,7,3,3,4,single-choice,spatial-relational,3|4,7,3/4,230146,3
1,2,23,147,1,1250,1,9,4,4,5,single-choice,spatial-relational,4|5,7,4/5,230147,4
1,2,23,148,1,896,1,5,2,2,3,single-choice,spatial-relational,2|3,7,2/3,230148,2
1,2,23,149,1,1530,1,13,6,6,7,single-choice,spatial-relational,6|7,7,6/7,230149,6
1,2,23,150,1,842,1,5,2,2,3,single-choice,spatial-relational,2|3,7,2/3,230150,2
1,2,23,151,1,1020,1,3,1,1,2,single-choice,spatial-relational,1|2,7,1/2,230151,1
1,2,23,152,1,1131,1,13,6,6,7,single-choice,spatial-relational,6|7,7,6/7,230152,6
1,2,23,153,0,984,1,11,5,6,6,single-choice,spatial-relational,5|6,7,5/6,230153,5
1,2,23,154,0,157,1,9,4,5,5,single-choice,spatial-relational,4|5,7,4/5,230154,4
1,2,23,155,0,898,1,11,5,6,6,single-choice,spatial-relational,5|6,7,5/6,230155,5
1,2,23,156,1,1132,1,3,1,1,2,single-choice,spatial-relational,1|2,7,1/2,230156,1
1,2,23,157,1,1035,1,7,3,3,4,single-choice,spatial-relational,3|4,7,3/4,230157,3
1,2,23,158,1,1566,1,7,3,3,4,single-choice,spatial-relational,3|4,7,3/4,230158,3
1,2,23,159,1,738,1,5,2,2,3,single-choice,spatial-relational,2|3,7,2/3,230159,2
1,2,23,160,0,1332,1,11,5,6,6,single-choice,spatial-relational,5|6,7,5/6,230160,5
1,2,23,161,1,766,1,5,2,2,3,single-choice,spatial-relational,2|3,7,2/3,230161,2
1,2,23,162,0,1164,1,11,5,6,6,single-choice,spatial-relational,5|6,7,5/6,230162,5
1,2,23,163,1,1370,1,13,6,6,7,single-choice,spatial-relational,6|7,7,6/7,230163,6
1,2,23,164,1,1295,1,9,4,4,5,single-choice,spatial-relational,4|5,7,4/5,230164,4
1,2,23,165,1,1320,1,13,6,6,7,single-choice,spatial-relational,6|7,7,6/7,230165,6
1,2,23,166,1,941,1,3,1,1,2,single-choice,spatial-relational,1|2,7,1/2,230166,1
1,2,23,167,0,731,1,3,1,2,2,single-choice,spatial-relational,1|2,7,1/2,230167,1
1,2,23,168,0,2221,1,9,4,5,5,single-choice,spatial-relational,4|5,7,4/5,230168,4
1,2,23,169,1,953,1,13,6,6,7,single-choice,spatial-relational,6|7,7,6/7,230169,6
1,2,23,170,0,1833,1,11,5,6,6,single-choice,spatial-relational,5|6,7,5/6,230170,5
1,2,23,171,1,824,1,7,3,3,4,single-choice,spatial-relational,3|4,7,3/4,230171,3
1,2,23,172,0,1201,1,5,2,3,3,single-choice,spatial-relational,2|3,7,2/3,230172,2
1,2,23,173,1,933,1,3,1,1,2,single-choice,spatial-relational,1|2,7,1/2,230173,1
1,2,23,174,1,1345,1,7,3,3,4,single-choice,spatial-relational,3|4,7,3/4,230174,3
1,2,23,175,1,1108,1,5,2,2,3,single-choice,spatial-relational,2|3,7,2/3,230175,2
1,2,23,176,1,1210,1,9,4,4,5,single-choice,spatial-relational,4|5,7,4/5,230176,4
1,2,23,177,0,1242,1,11,5,6,6,single-choice,spatial-relational,5|6,7,5/6,230177,5
1,2,23,178,1,1513,1,13,6,6,7,single-choice,spatial-relational,6|7,7,6/7,230178,6
1,2,23,179,1,1723,1,9,4,4,5,single-choice,spatial-relational,4|5,7,4/5,230179,4
1,2,23,180,1,1104,1,3,1,1,2,single-choice,spatial-relational,1|2,7,1/2,230180,1
1,2,23,181,0,1017,1,11,5,6,6,single-choice,spatial-relational,5|6,7,5/6,230181,5
1,2,23,182,1,930,1,13,6,6,7,single-choice,spatial-relational,6|7,7,6/7,230182,6
1,2,23,183,0,2268,1,3,1,2,2,single-choice,spatial-relational,1|2,7,1/2,230183,1
1,2,23,184,1,1002,1,9,4,4,5,single-choice,spatial-relational,4|5,7,4/5,230184,4
1,2,23,185,1,1030,1,7,3,3,4,single-choice,spatial-relational,3|4,7,3/4,230185,3
1,2,23,186,0,1138,1,5,2,3,3,single-choice,spatial-relational,2|3,7,2/3,230186,2
1,2,23,187,1,1168,1,5,2,2,3,single-choice,spatial-relational,2|3,7,2/3,230187,2
1,2,23,188,0,1001,1,11,5,6,6,single-choice,spatial-relational,5|6,7,5/6,230188,5
1,2,23,189,1,1339,1,13,6,6,7,single-choice,spatial-relational,6|7,7,6/7,230189,6
1,2,23,190,1,946,1,3,1,1,2,single-choice,spatial-relational,1|2,7,1/2,230190,1
1,2,23,191,1,1567,1,9,4,4,5,single-choice,spatial-relational,4|5,7,4/5,230191,4
1,2,23,192,1,1823,1,7,3,3,4,single-choice,spatial-relational,3|4,7,3/4,230192,3
1,2,23,193,0,1192,1,5,2,3,3,single-choice,spatial-relational,2|3,7,2/3,230193,2
1,2,23,194,1,914,1,9,4,4,5,single-choice,spatial-relational,4|5,7,4/5,230194,4
1,2,23,195,1,1083,1,9,4,4,5,single-choice,spatial-relational,4|5,7,4/5,230195,4
1,2,23,196,0,1497,1,5,2,3,3,single-choice,spatial-relational,2|3,7,2/3,230196,2
1,2,23,197,0,695,1,11,5,6,6,single-choice,spatial-relational,5|6,7,5/6,230197,5
1,2,23,198,1,868,1,3,1,1,2,single-choice,spatial-relational,1|2,7,1/2,230198,1
1,2,23,199,1,943,1,3,1,1,2,single-choice,spatial-relational,1|2,7,1/2,230199,1
1,2,23,200,0,1564,1,7,3,4,4,single-choice,spatial-relational,3|4,7,3/4,230200,3
1,2,23,201,1,699,1,13,6,6,7,single-choice,spatial-relational,6|7,7,6/7,230201,6
1,2,23,202,0,2264,1,7,3,4,4,single-choice,spatial-relational,3|4,7,3/4,230202,3
1,2,23,203,0,676,1,11,5,6,6,single-choice,spatial-relational,5|6,7,5/6,230203,5
1,2,23,204,0,793,1,13,6,7,7,single-choice,spatial-relational,6|7,7,6/7,230204,6
1,2,23,205,1,739,1,13,6,6,7,single-choice,spatial-relational,6|7,7,6/7,230205,6
1,2,23,206,1,1517,1,9,4,4,5,single-choice,spatial-relational,4|5,7,4/5,230206,4
1,2,23,207,1,1698,1,7,3,3,4,single-choice,spatial-relational,3|4,7,3/4,230207,3
1,2,23,208,0,1611,1,7,3,4,4,single-choice,spatial-relational,3|4,7,3/4,230208,3
1,2,23,209,0,764,1,11,5,6,6,single-choice,spatial-relational,5|6,7,5/6,230209,5
1,2,23,210,1,1344,1,13,6,6,7,single-choice,spatial-relational,6|7,7,6/7,230210,6
1,2,23,211,0,1312,1,11,5,6,6,single-choice,spatial-relational,5|6,7,5/6,230211,5
1,2,23,212,1,1064,1,9,4,4,5,single-choice,spatial-relational,4|5,7,4/5,230212,4
1,2,23,213,1,1476,1,5,2,2,3,single-choice,spatial-relational,2|3,7,2/3,230213,2
1,2,23,214,1,1345,1,3,1,1,2,single-choice,spatial-relational,1|2,7,1/2,230214,1
1,2,23,215,1,1347,1,5,2,2,3,single-choice,spatial-relational,2|3,7,2/3,230215,2
1,2,23,216,1,939,1,3,1,1,2,single-choice,spatial-relational,1|2,7,1/2,230216,1
1,2,23,217,1,1719,1,9,4,4,5,single-choice,spatial-relational,4|5,7,4/5,230217,4
1,2,23,218,1,1028,1,3,1,1,2,single-choice,spatial-relational,1|2,7,1/2,230218,1
1,2,23,219,0,1698,1,9,4,5,5,single-choice,spatial-relational,4|5,7,4/5,230219,4
1,2,23,220,0,969,1,11,5,6,6,single-choice,spatial-relational,5|6,7,5/6,230220,5
1,2,23,221,1,1197,1,5,2,2,3,single-choice,spatial-relational,2|3,7,2/3,230221,2
1,2,23,222,1,1705,1,7,3,3,4,single-choice,spatial-relational,3|4,7,3/4,230222,3
1,2,23,223,1,1840,1,13,6,6,7,single-choice,spatial-relational,6|7,7,6/7,230223,6
1,2,23,224,1,1880,1,11,5,5,6,single-choice,spatial-relational,5|6,7,5/6,230224,5
1,2,23,225,1,970,1,3,1,1,2,single-choice,spatial-relational,1|2,7,1/2,230225,1
1,2,23,226,1,1088,1,13,6,6,7,single-choice,spatial-relational,6|7,7,6/7,230226,6
1,2,23,227,1,1244,1,5,2,2,3,single-choice,spatial-relational,2|3,7,2/3,230227,2
1,2,23,228,1,1207,1,7,3,3,4,single-choice,spatial-relational,3|4,7,3/4,230228,3
1,2,23,229,0,1525,1,11,5,6,6,single-choice,spatial-relational,5|6,7,5/6,230229,5
1,2,23,230,0,2501,1,7,3,4,4,single-choice,spatial-relational,3|4,7,3/4,230230,3
1,2,23,231,1,873,1,5,2,2,3,single-choice,spatial-relational,2|3,7,2/3,230231,2
1,2,23,232,1,1651,1,9,4,4,5,single-choice,spatial-relational,4|5,7,4/5,230232,4
1,2,23,233,0,1680,1,13,6,7,7,single-choice,spatial-relational,6|7,7,6/7,230233,6
1,2,23,234,1,1330,1,9,4,4,5,single-choice,spatial-relational,4|5,7,4/5,230234,4
1,2,23,235,0,1469,1,11,5,6,6,single-choice,spatial-relational,5|6,7,5/6,230235,5
1,2,23,236,1,790,1,3,1,1,2,single-choice,spatial-relational,1|2,7,1/2,230236,1
1,2,23,237,1,801,1,3,1,1,2,single-choice,spatial-relational,1|2,7,1/2,230237,1
1,2,23,238,1,1329,1,7,3,3,4,single-choice,spatial-relational,3|4,7,3/4,230238,3
1,2,23,239,1,1202,1,5,2,2,3,single-choice,spatial-relational,2|3,7,2/3,230239,2
1,2,23,240,0,1090,1,13,6,7,7,single-choice,spatial-relational,6|7,7,6/7,230240,6
1,2,23,241,1,1323,1,9,4,4,5,single-choice,spatial-relational,4|5,7,4/5,230241,4
1,2,23,242,1,1289,1,9,4,4,5,single-choice,spatial-relational,4|5,7,4/5,230242,4
1,2,23,243,1,1437,1,11,5,5,6,single-choice,spatial-relational,5|6,7,5/6,230243,5
1,2,23,244,1,1602,1,13,6,6,7,single-choice,spatial-relational,6|7,7,6/7,230244,6
1,2,23,245,1,917,1,5,2,2,3,single-choice,spatial-relational,2|3,7,2/3,230245,2
1,2,23,246,1,962,1,3,1,1,2,single-choice,spatial-relational,1|2,7,1/2,230246,1
1,2,23,247,1,1028,1,13,6,6,7,single-choice,spatial-relational,6|7,7,6/7,230247,6
1,2,23,248,0,1107,1,3,1,2,2,single-choice,spatial-relational,1|2,7,1/2,230248,1
1,2,23,249,0,926,1,11,5,6,6,single-choice,spatial-relational,5|6,7,5/6,230249,5
1,2,23,250,0,1451,1,7,3,4,4,single-choice,spatial-relational,3|4,7,3/4,230250,3
1,2,23,251,1,876,1,5,2,2,3,single-choice,spatial-relational,2|3,7,2/3,230251,2
1,2,23,252,1,886,1,7,3,3,4,single-choice,spatial-relational,3|4,7,3/4,230252,3
1,2,23,253,1,1751,1,13,6,6,7,single-choice,spatial-relational,6|7,7,6/7,230253,6
1,2,23,254,1,1543,1,5,2,2,3,single-choice,spatial-relational,2|3,7,2/3,230254,2
1,2,23,255,1,1093,1,13,6,6,7,single-choice,spatial-relational,6|7,7,6/7,230255,6
1,2,23,256,1,1068,1,3,1,1,2,single-choice,spatial-relational,1|2,7,1/2,230256,1
1,2,23,257,1,1493,1,9,4,4,5,single-choice,spatial-relational,4|5,7,4/5,230257,4
1,2,23,258,1,1428,1,11,5,5,6,single-choice,spatial-relational,5|6,7,5/6,230258,5
1,2,23,259,1,1415,1,11,5,5,6,single-choice,spatial-relational,5|6,7,5/6,230259,5
1,2,23,260,1,1328,1,5,2,2,3,single-choice,spatial-relational,2|3,7,2/3,230260,2
1,2,23,261,0,1360,1,9,4,5,5,single-choice,spatial-relational,4|5,7,4/5,230261,4
1,2,23,262,1,928,1,7,3,3,4,single-choice,spatial-relational,3|4,7,3/4,230262,3
1,2,23,263,1,1327,1,7,3,3,4,single-choice,spatial-relational,3|4,7,3/4,230263,3
1,2,23,264,0,1193,1,3,1,2,2,single-choice,spatial-relational,1|2,7,1/2,230264,1
1,2,23,265,1,1283,1,9,4,4,5,single-choice,spatial-relational,4|5,7,4/5,230265,4
1,2,23,266,1,1524,1,9,4,4,5,single-choice,spatial-relational,4|5,7,4/5,230266,4
1,2,23,267,1,1054,1,7,3,3,4,single-choice,spatial-relational,3|4,7,3/4,230267,3
1,2,23,268,0,1788,1,11,5,6,6,single-choice,spatial-relational,5|6,7,5/6,230268,5
1,2,23,269,0,767,1,5,2,3,3,single-choice,spatial-relational,2|3,7,2/3,230269,2
1,2,23,270,0,1863,1,11,5,6,6,single-choice,spatial-relational,5|6,7,5/6,230270,5
1,2,23,271,1,983,1,3,1,1,2,single-choice,spatial-relational,1|2,7,1/2,230271,1
1,2,23,272,1,1142,1,7,3,3,4,single-choice,spatial-relational,3|4,7,3/4,230272,3
1,2,23,273,1,1247,1,3,1,1,2,single-choice,spatial-relational,1|2,7,1/2,230273,1
1,2,23,274,1,1100,1,13,6,6,7,single-choice,spatial-relational,6|7,7,6/7,230274,6
1,2,23,275,1,1430,1,13,6,6,7,single-choice,spatial-relational,6|7,7,6/7,230275,6
1,2,23,276,1,1026,1,5,2,2,3,single-choice,spatial-relational,2|3,7,2/3,230276,2
1,2,23,277,0,1078,1,5,2,3,3,single-choice,spatial-relational,2|3,7,2/3,230277,2
1,2,23,278,0,150,1,7,3,4,4,single-choice,spatial-relational,3|4,7,3/4,230278,3
1,2,23,279,1,915,1,9,4,4,5,single-choice,spatial-relational,4|5,7,4/5,230279,4
1,2,23,280,0,3485,1,11,5,6,6,single-choice,spatial-relational,5|6,7,5/6,230280,5
1,2,23,281,1,1221,1,9,4,4,5,single-choice,spatial-relational,4|5,7,4/5,230281,4
1,2,23,282,1,1359,1,13,6,6,7,single-choice,spatial-relational,6|7,7,6/7,230282,6
1,2,23,283,1,1448,1,11,5,5,6,single-choice,spatial-relational,5|6,7,5/6,230283,5
1,2,23,284,1,1041,1,3,1,1,2,single-choice,spatial-relational,1|2,7,1/2,230284,1
1,2,23,285,1,899,1,3,1,1,2,single-choice,spatial-relational,1|2,7,1/2,230285,1
1,2,23,286,0,967,1,5,2,3,3,single-choice,spatial-relational,2|3,7,2/3,230286,2
1,2,23,287,0,1043,1,7,3,4,4,single-choice,spatial-relational,3|4,7,3/4,230287,3
1,2,23,288,0,976,1,13,6,7,7,single-choice,spatial-relational,6|7,7,6/7,230288,6
1,2,23,289,1,1245,1,5,2,2,3,single-choice,spatial-relational,2|3,7,2/3,230289,2
1,2,23,290,1,904,1,5,2,2,3,single-choice,spatial-relational,2|3,7,2/3,230290,2
1,2,23,291,1,1267,1,13,6,6,7,single-choice,spatial-relational,6|7,7,6/7,230291,6
1,2,23,292,1,1394,1,11,5,5,6,single-choice,spatial-relational,5|6,7,5/6,230292,5
1,2,23,293,0,1423,1,3,1,2,2,single-choice,spatial-relational,1|2,7,1/2,230293,1
1,2,23,294,1,914,1,9,4,4,5,single-choice,spatial-relational,4|5,7,4/5,230294,4
1,2,23,295,1,2817,1,7,3,3,4,single-choice,spatial-relational,3|4,7,3/4,230295,3
1,2,23,296,0,1119,1,9,4,5,5,single-choice,spatial-relational,4|5,7,4/5,230296,4
1,2,23,297,1,1267,1,7,3,3,4,single-choice,spatial-relational,3|4,7,3/4,230297,3
1,2,23,298,1,1294,1,13,6,6,7,single-choice,spatial-relational,6|7,7,6/7,230298,6
1,2,23,299,0,1568,1,3,1,2,2,single-choice,spatial-relational,1|2,7,1/2,230299,1
1,2,23,300,0,1284,1,11,5,6,6,single-choice,spatial-relational,5|6,7,5/6,230300,5
1,2,23,301,0,2224,1,11,5,6,6,single-choice,spatial-relational,5|6,7,5/6,230301,5
1,2,23,302,1,1157,1,13,6,6,7,single-choice,spatial-relational,6|7,7,6/7,230302,6
1,2,23,303,0,1577,1,11,5,6,6,single-choice,spatial-relational,5|6,7,5/6,230303,5
1,2,23,304,1,1205,1,5,2,2,3,single-choice,spatial-relational,2|3,7,2/3,230304,2
1,2,23,305,1,1409,1,9,4,4,5,single-choice,spatial-relational,4|5,7,4/5,230305,4
1,2,23,306,1,1562,1,13,6,6,7,single-choice,spatial-relational,6|7,7,6/7,230306,6
1,2,23,307,1,1116,1,7,3,3,4,single-choice,spatial-relational,3|4,7,3/4,230307,3
1,2,23,308,1,1848,1,7,3,3,4,single-choice,spatial-relational,3|4,7,3/4,230308,3
1,2,23,309,1,1480,1,3,1,1,2,single-choice,spatial-relational,1|2,7,1/2,230309,1
1,2,23,310,1,992,1,3,1,1,2,single-choice,spatial-relational,1|2,7,1/2,230310,1
1,2,23,311,0,1321,1,5,2,3,3,single-choice,spatial-relational,2|3,7,2/3,230311,2
1,2,23,312,1,808,1,9,4,4,5,single-choice,spatial-relational,4|5,7,4/5,230312,4
1,2,23,313,1,1941,1,7,3,3,4,single-choice,spatial-relational,3|4,7,3/4,230313,3
1,2,23,314,0,1596,1,11,5,6,6,single-choice,spatial-relational,5|6,7,5/6,230314,5
1,2,23,315,1,797,1,5,2,2,3,single-choice,spatial-relational,2|3,7,2/3,230315,2
1,2,23,316,1,1354,1,13,6,6,7,single-choice,spatial-relational,6|7,7,6/7,230316,6
1,2,23,317,0,1381,1,7,3,4,4,single-choice,spatial-relational,3|4,7,3/4,230317,3
1,2,23,318,1,823,1,9,4,4,5,single-choice,spatial-relational,4|5,7,4/5,230318,4
1,2,23,319,0,1090,1,11,5,6,6,single-choice,spatial-relational,5|6,7,5/6,230319,5
1,2,23,320,1,1036,1,13,6,6,7,single-choice,spatial-relational,6|7,7,6/7,230320,6
1,2,23,321,1,1923,1,3,1,1,2,single-choice,spatial-relational,1|2,7,1/2,230321,1
1,2,23,322,1,1608,1,5,2,2,3,single-choice,spatial-relational,2|3,7,2/3,230322,2
1,2,23,323,0,1586,1,9,4,5,5,single-choice,spatial-relational,4|5,7,4/5,230323,4
1,2,23,324,1,1391,1,3,1,1,2,single-choice,spatial-relational,1|2,7,1/2,230324,1
1,2,23,325,1,762,1,5,2,2,3,single-choice,spatial-relational,2|3,7,2/3,230325,2
1,2,23,326,1,1266,1,3,1,1,2,single-choice,spatial-relational,1|2,7,1/2,230326,1
1,2,23,327,1,934,1,5,2,2,3,single-choice,spatial-relational,2|3,7,2/3,230327,2
1,2,23,328,1,1248,1,3,1,1,2,single-choice,spatial-relational,1|2,7,1/2,230328,1
1,2,23,329,1,783,1,9,4,4,5,single-choice,spatial-relational,4|5,7,4/5,230329,4
1,2,23,330,1,1594,1,9,4,4,5,single-choice,spatial-relational,4|5,7,4/5,230330,4
1,2,23,331,1,1253,1,7,3,3,4,single-choice,spatial-relational,3|4,7,3/4,230331,3
1,2,23,332,0,1461,1,7,3,4,4,single-choice,spatial-relational,3|4,7,3/4,230332,3
1,2,23,333,1,1429,1,13,6,6,7,single-choice,spatial-relational,6|7,7,6/7,230333,6
1,2,23,334,0,1218,1,11,5,6,6,single-choice,spatial-relational,5|6,7,5/6,230334,5
1,2,23,335,1,1242,1,13,6,6,7,single-choice,spatial-relational,6|7,7,6/7,230335,6
1,2,23,336,0,1423,1,11,5,6,6,single-choice,spatial-relational,5|6,7,5/6,230336,5
1,2,23,337,0,790,1,3,1,2,2,single-choice,spatial-relational,1|2,7,1/2,230337,1
1,2,23,338,1,874,1,5,2,2,3,single-choice,spatial-relational,2|3,7,2/3,230338,2
1,2,23,339,0,1429,1,11,5,6,6,single-choice,spatial-relational,5|6,7,5/6,230339,5
1,2,23,340,0,1223,1,11,5,6,6,single-choice,spatial-relational,5|6,7,5/6,230340,5
1,2,23,341,1,765,1,9,4,4,5,single-choice,spatial-relational,4|5,7,4/5,230341,4
1,2,23,342,1,1419,1,13,6,6,7,single-choice,spatial-relational,6|7,7,6/7,230342,6
1,2,23,343,1,1041,1,9,4,4,5,single-choice,spatial-relational,4|5,7,4/5,230343,4
1,2,23,344,1,1336,1,3,1,1,2,single-choice,spatial-relational,1|2,7,1/2,230344,1
1,2,23,345,1,1202,1,7,3,3,4,single-choice,spatial-relational,3|4,7,3/4,230345,3
1,2,23,346,0,2519,1,7,3,4,4,single-choice,spatial-relational,3|4,7,3/4,230346,3
1,2,23,347,1,855,1,5,2,2,3,single-choice,spatial-relational,2|3,7,2/3,230347,2
1,2,23,348,0,1024,1,13,6,7,7,single-choice,spatial-relational,6|7,7,6/7,230348,6
1,2,23,349,1,995,1,13,6,6,7,single-choice,spatial-relational,6|7,7,6/7,230349,6
1,2,23,350,0,1581,1,11,5,6,6,single-choice,spatial-relational,5|6,7,5/6,230350,5
1,2,23,351,1,1183,1,3,1,1,2,single-choice,spatial-relational,1|2,7,1/2,230351,1
1,2,23,352,1,756,1,9,4,4,5,single-choice,spatial-relational,4|5,7,4/5,230352,4
1,2,23,353,1,1432,1,3,1,1,2,single-choice,spatial-relational,1|2,7,1/2,230353,1
1,2,23,354,0,1429,1,5,2,3,3,single-choice,spatial-relational,2|3,7,2/3,230354,2
1,2,23,355,0,780,1,7,3,4,4,single-choice,spatial-relational,3|4,7,3/4,230355,3
1,2,23,356,0,1445,1,11,5,6,6,single-choice,spatial-relational,5|6,7,5/6,230356,5
1,2,23,357,1,994,1,9,4,4,5,single-choice,spatial-relational,4|5,7,4/5,230357,4
1,2,23,358,0,1285,1,7,3,4,4,single-choice,spatial-relational,3|4,7,3/4,230358,3
1,2,23,359,1,970,1,5,2,2,3,single-choice,spatial-relational,2|3,7,2/3,230359,2
1,2,23,360,1,1516,1,13,6,6,7,single-choice,spatial-relational,6|7,7,6/7,230360,6
1,2,23,361,1,2293,1,5,2,2,3,single-choice,spatial-relational,2|3,7,2/3,230361,2
1,2,23,362,1,1300,1,3,1,1,2,single-choice,spatial-relational,1|2,7,1/2,230362,1
1,2,23,363,1,1207,1,13,6,6,7,single-choice,spatial-relational,6|7,7,6/7,230363,6
1,2,23,364,1,1476,1,5,2,2,3,single-choice,spatial-relational,2|3,7,2/3,230364,2
1,2,23,365,0,1249,1,7,3,4,4,single-choice,spatial-relational,3|4,7,3/4,230365,3
1,2,23,366,1,1295,1,9,4,4,5,single-choice,spatial-relational,4|5,7,4/5,230366,4
1,2,23,367,1,868,1,9,4,4,5,single-choice,spatial-relational,4|5,7,4/5,230367,4
1,2,23,368,0,1009,1,11,5,6,6,single-choice,spatial-relational,5|6,7,5/6,230368,5
1,2,23,369,0,1092,1,13,6,7,7,single-choice,spatial-relational,6|7,7,6/7,230369,6
1,2,23,370,1,953,1,7,3,3,4,single-choice,spatial-relational,3|4,7,3/4,230370,3
1,2,23,371,1,3095,1,11,5,5,6,single-choice,spatial-relational,5|6,7,5/6,230371,5
1,2,23,372,0,1502,1,3,1,2,2,single-choice,spatial-relational,1|2,7,1/2,230372,1
1,2,23,373,1,954,1,9,4,4,5,single-choice,spatial-relational,4|5,7,4/5,230373,4
1,2,23,374,1,1358,1,5,2,2,3,single-choice,spatial-relational,2|3,7,2/3,230374,2
1,2,23,375,1,1103,1,3,1,1,2,single-choice,spatial-relational,1|2,7,1/2,230375,1
1,2,23,376,0,1369,1,11,5,6,6,single-choice,spatial-relational,5|6,7,5/6,230376,5
1,2,23,377,1,1141,1,11,5,5,6,single-choice,spatial-relational,5|6,7,5/6,230377,5
1,2,23,378,1,1380,1,7,3,3,4,single-choice,spatial-relational,3|4,7,3/4,230378,3
1,2,23,379,1,1715,1,13,6,6,7,single-choice,spatial-relational,6|7,7,6/7,230379,6
1,2,23,380,0,1131,1,7,3,4,4,single-choice,spatial-relational,3|4,7,3/4,230380,3
1,2,23,381,1,974,1,13,6,6,7,single-choice,spatial-relational,6|7,7,6/7,230381,6
1,2,23,382,1,1074,1,5,2,2,3,single-choice,spatial-relational,2|3,7,2/3,230382,2
1,2,23,383,0,1431,1,9,4,5,5,single-choice,spatial-relational,4|5,7,4/5,230383,4
1,2,23,384,1,814,1,3,1,1,2,single-choice,spatial-relational,1|2,7,1/2,230384,1
1,2,23,385,1,1123,1,5,2,2,3,single-choice,spatial-relational,2|3,7,2/3,230385,2
1,2,23,386,0,1507,1,11,5,6,6,single-choice,spatial-relational,5|6,7,5/6,230386,5
1,2,23,387,1,2323,1,7,3,3,4,single-choice,spatial-relational,3|4,7,3/4,230387,3
1,2,23,388,1,983,1,3,1,1,2,single-choice,spatial-relational,1|2,7,1/2,230388,1
1,2,23,389,0,800,1,7,3,4,4,single-choice,spatial-relational,3|4,7,3/4,230389,3
1,2,23,390,0,1255,1,11,5,6,6,single-choice,spatial-relational,5|6,7,5/6,230390,5
1,2,23,391,1,1344,1,9,4,4,5,single-choice,spatial-relational,4|5,7,4/5,230391,4
1,2,23,392,1,1667,1,13,6,6,7,single-choice,spatial-relational,6|7,7,6/7,230392,6
1,2,23,393,0,1290,1,3,1,2,2,single-choice,spatial-relational,1|2,7,1/2,230393,1
1,2,23,394,1,888,1,13,6,6,7,single-choice,spatial-relational,6|7,7,6/7,230394,6
1,2,23,395,1,947,1,5,2,2,3,single-choice,spatial-relational,2|3,7,2/3,230395,2
1,2,23,396,1,961,1,9,4,4,5,single-choice,spatial-relational,4|5,7,4/5,230396,4
1,2,23,397,1,1442,1,13,6,6,7,single-choice,spatial-relational,6|7,7,6/7,230397,6
1,2,23,398,0,1022,1,5,2,3,3,single-choice,spatial-relational,2|3,7,2/3,230398,2
1,2,23,399,0,1088,1,3,1,2,2,single-choice,spatial-relational,1|2,7,1/2,230399,1
1,2,23,400,0,800,1,11,5,6,6,single-choice,spatial-relational,5|6,7,5/6,230400,5
1,2,23,401,1,901,1,7,3,3,4,single-choice,spatial-relational,3|4,7,3/4,230401,3
1,2,23,402,1,1100,1,9,4,4,5,single-choice,spatial-relational,4|5,7,4/5,230402,4
1,2,23,403,1,1185,1,9,4,4,5,single-choice,spatial-relational,4|5,7,4/5,230403,4
1,2,23,404,1,1481,1,3,1,1,2,single-choice,spatial-relational,1|2,7,1/2,230404,1
1,2,23,405,0,2126,1,5,2,3,3,single-choice,spatial-relational,2|3,7,2/3,230405,2
1,2,23,406,0,863,1,7,3,4,4,single-choice,spatial-relational,3|4,7,3/4,230406,3
1,2,23,407,0,1072,1,11,5,6,6,single-choice,spatial-relational,5|6,7,5/6,230407,5
1,2,23,408,1,1231,1,13,6,6,7,single-choice,spatial-relational,6|7,7,6/7,230408,6
1,2,23,409,1,1011,1,9,4,4,5,single-choice,spatial-relational,4|5,7,4/5,230409,4
1,2,23,410,1,1243,1,9,4,4,5,single-choice,spatial-relational,4|5,7,4/5,230410,4
1,2,23,411,1,1386,1,13,6,6,7,single-choice,spatial-relational,6|7,7,6/7,230411,6
1,2,23,412,1,970,1,5,2,2,3,single-choice,spatial-relational,2|3,7,2/3,230412,2
1,2,23,413,0,1682,1,11,5,6,6,single-choice,spatial-relational,5|6,7,5/6,230413,5
1,2,23,414,0,2075,1,7,3,4,4,single-choice,spatial-relational,3|4,7,3/4,230414,3
1,2,23,415,1,951,1,7,3,3,4,single-choice,spatial-relational,3|4,7,3/4,230415,3
1,2,23,416,1,1146,1,13,6,6,7,single-choice,spatial-relational,6|7,7,6/7,230416,6
1,2,23,417,1,1010,1,3,1,1,2,single-choice,spatial-relational,1|2,7,1/2,230417,1
1,2,23,418,0,1266,1,11,5,6,6,single-choice,spatial-relational,5|6,7,5/6,230418,5
1,2,23,419,1,1037,1,5,2,2,3,single-choice,spatial-relational,2|3,7,2/3,230419,2
1,2,23,420,0,937,1,3,1,2,2,single-choice,spatial-relational,1|2,7,1/2,230420,1
1,2,23,421,1,1408,1,7,3,3,4,single-choice,spatial-relational,3|4,7,3/4,230421,3
1,2,23,422,1,2550,1,5,2,2,3,single-choice,spatial-relational,2|3,7,2/3,230422,2
1,2,23,423,0,1310,1,13,6,7,7,single-choice,spatial-relational,6|7,7,6/7,230423,6
1,2,23,424,1,865,1,5,2,2,3,single-choice,spatial-relational,2|3,7,2/3,230424,2
1,2,23,425,1,1023,1,3,1,1,2,single-choice,spatial-relational,1|2,7,1/2,230425,1
1,2,23,426,1,920,1,9,4,4,5,single-choice,spatial-relational,4|5,7,4/5,230426,4
1,2,23,427,1,1271,1,13,6,6,7,single-choice,spatial-relational,6|7,7,6/7,230427,6
1,2,23,428,0,3116,1,11,5,6,6,single-choice,spatial-relational,5|6,7,5/6,230428,5
1,2,23,429,1,904,1,3,1,1,2,single-choice,spatial-relational,1|2,7,1/2,230429,1
1,2,23,430,1,1440,1,11,5,5,6,single-choice,spatial-relational,5|6,7,5/6,230430,5
1,2,23,431,0,1144,1,7,3,4,4,single-choice,spatial-relational,3|4,7,3/4,230431,3
1,2,23,432,1,1024,1,9,4,4,5,single-choice,spatial-relational,4|5,7,4/5,230432,4
1,2,23,433,1,1012,1,3,1,1,2,single-choice,spatial-relational,1|2,7,1/2,230433,1
1,2,23,434,1,1370,1,13,6,6,7,single-choice,spatial-relational,6|7,7,6/7,230434,6
1,2,23,435,1,998,1,3,1,1,2,single-choice,spatial-relational,1|2,7,1/2,230435,1
1,2,23,436,0,868,1,5,2,3,3,single-choice,spatial-relational,2|3,7,2/3,230436,2
1,2,23,437,1,1059,1,7,3,3,4,single-choice,spatial-relational,3|4,7,3/4,230437,3
1,2,23,438,1,960,1,13,6,6,7,single-choice,spatial-relational,6|7,7,6/7,230438,6
1,2,23,439,1,1076,1,5,2,2,3,single-choice,spatial-relational,2|3,7,2/3,230439,2
1,2,23,440,1,993,1,9,4,4,5,single-choice,spatial-relational,4|5,7,4/5,230440,4
1,2,23,441,0,1660,1,7,3,4,4,single-choice,spatial-relational,3|4,7,3/4,230441,3
1,2,23,442,0,1176,1,11,5,6,6,single-choice,spatial-relational,5|6,7,5/6,230442,5
1,2,23,443,0,1174,1,11,5,6,6,single-choice,spatial-relational,5|6,7,5/6,230443,5
1,2,23,444,1,1194,1,9,4,4,5,single-choice,spatial-relational,4|5,7,4/5,230444,4
1,2,23,445,1,1107,1,3,1,1,2,single-choice,spatial-relational,1|2,7,1/2,230445,1
1,2,23,446,1,1091,1,5,2,2,3,single-choice,spatial-relational,2|3,7,2/3,230446,2
1,2,23,447,1,1480,1,7,3,3,4,single-choice,spatial-relational,3|4,7,3/4,230447,3
1,2,23,448,1,1010,1,3,1,1,2,single-choice,spatial-relational,1|2,7,1/2,230448,1
1,2,23,449,0,809,1,7,3,4,4,single-choice,spatial-relational,3|4,7,3/4,230449,3
1,2,23,450,1,1035,1,11,5,5,6,single-choice,spatial-relational,5|6,7,5/6,230450,5
1,2,23,451,1,988,1,9,4,4,5,single-choice,spatial-relational,4|5,7,4/5,230451,4
1,2,23,452,0,1761,1,11,5,6,6,single-choice,spatial-relational,5|6,7,5/6,230452,5
1,2,23,453,1,1209,1,13,6,6,7,single-choice,spatial-relational,6|7,7,6/7,230453,6
1,2,23,454,1,1457,1,13,6,6,7,single-choice,spatial-relational,6|7,7,6/7,230454,6
1,2,23,455,1,1887,1,9,4,4,5,single-choice,spatial-relational,4|5,7,4/5,230455,4
1,2,23,456,1,1873,1,5,2,2,3,single-choice,spatial-relational,2|3,7,2/3,230456,2
1,2,23,457,0,1201,1,7,3,4,4,single-choice,spatial-relational,3|4,7,3/4,230457,3
1,2,23,458,1,927,1,9,4,4,5,single-choice,spatial-relational,4|5,7,4/5,230458,4
1,2,23,459,1,132,1,3,1,1,2,single-choice,spatial-relational,1|2,7,1/2,230459,1
1,2,23,460,1,1688,1,11,5,5,6,single-choice,spatial-relational,5|6,7,5/6,230460,5
1,2,23,461,1,1292,1,13,6,6,7,single-choice,spatial-relational,6|7,7,6/7,230461,6
1,2,23,462,0,1746,1,11,5,6,6,single-choice,spatial-relational,5|6,7,5/6,230462,5
1,2,23,463,1,1180,1,9,4,4,5,single-choice,spatial-relational,4|5,7,4/5,230463,4
1,2,23,464,1,1425,1,5,2,2,3,single-choice,spatial-relational,2|3,7,2/3,230464,2
1,2,23,465,1,1200,1,13,6,6,7,single-choice,spatial-relational,6|7,7,6/7,230465,6
1,2,23,466,1,1193,1,3,1,1,2,single-choice,spatial-relational,1|2,7,1/2,230466,1
1,2,23,467,1,844,1,5,2,2,3,single-choice,spatial-relational,2|3,7,2/3,230467,2
1,2,23,468,0,961,1,7,3,4,4,single-choice,spatial-relational,3|4,7,3/4,230468,3
1,2,23,469,1,1189,1,13,6,6,7,single-choice,spatial-relational,6|7,7,6/7,230469,6
1,2,23,470,0,1917,1,9,4,5,5,single-choice,spatial-relational,4|5,7,4/5,230470,4
1,2,23,471,1,935,1,13,6,6,7,single-choice,spatial-relational,6|7,7,6/7,230471,6
1,2,23,472,0,2326,1,11,5,6,6,single-choice,spatial-relational,5|6,7,5/6,230472,5
1,2,23,473,1,891,1,7,3,3,4,single-choice,spatial-relational,3|4,7,3/4,230473,3
1,2,23,474,1,1055,1,5,2,2,3,single-choice,spatial-relational,2|3,7,2/3,230474,2
1,2,23,475,1,1724,1,9,4,4,5,single-choice,spatial-relational,4|5,7,4/5,230475,4
1,2,23,476,1,850,1,5,2,2,3,single-choice,spatial-relational,2|3,7,2/3,230476,2
1,2,23,477,1,1821,1,7,3,3,4,single-choice,spatial-relational,3|4,7,3/4,230477,3
1,2,23,478,1,2021,1,11,5,5,6,single-choice,spatial-relational,5|6,7,5/6,230478,5
1,2,23,479,0,990,1,3,1,2,2,single-choice,spatial-relational,1|2,7,1/2,230479,1
1,2,23,480,1,1001,1,3,1,1,2,single-choice,spatial-relational,1|2,7,1/2,230480,1
1,2,23,481,0,847,1,3,1,2,2,single-choice,spatial-relational,1|2,7,1/2,230481,1
1,2,23,482,1,863,1,7,3,3,4,single-choice,spatial-relational,3|4,7,3/4,230482,3
1,2,23,483,0,1309,1,5,2,3,3,single-choice,spatial-relational,2|3,7,2/3,230483,2
1,2,23,484,0,894,1,7,3,4,4,single-choice,spatial-relational,3|4,7,3/4,230484,3
1,2,23,485,1,755,1,3,1,1,2,single-choice,spatial-relational,1|2,7,1/2,230485,1
1,2,23,486,0,1151,1,5,2,3,3,single-choice,spatial-relational,2|3,7,2/3,230486,2
1,2,23,487,1,903,1,13,6,6,7,single-choice,spatial-relational,6|7,7,6/7,230487,6
1,2,23,488,0,2224,1,11,5,6,6,single-choice,spatial-relational,5|6,7,5/6,230488,5
1,2,23,489,1,1083,1,13,6,6,7,single-choice,spatial-relational,6|7,7,6/7,230489,6
1,2,23,490,1,1375,1,11,5,5,6,single-choice,spatial-relational,5|6,7,5/6,230490,5
1,2,23,491,1,1847,1,9,4,4,5,single-choice,spatial-relational,4|5,7,4/5,230491,4
1,2,23,492,1,952,1,9,4,4,5,single-choice,spatial-relational,4|5,7,4/5,230492,4
1,2,23,493,1,1185,1,5,2,2,3,single-choice,spatial-relational,2|3,7,2/3,230493,2
1,2,23,494,1,1182,1,9,4,4,5,single-choice,spatial-relational,4|5,7,4/5,230494,4
1,2,23,495,0,1727,1,7,3,4,4,single-choice,spatial-relational,3|4,7,3/4,230495,3
1,2,23,496,0,848,1,7,3,4,4,single-choice,spatial-relational,3|4,7,3/4,230496,3
1,2,23,497,1,919,1,13,6,6,7,single-choice,spatial-relational,6|7,7,6/7,230497,6
1,2,23,498,1,2000,1,11,5,5,6,single-choice,spatial-relational,5|6,7,5/6,230498,5
1,2,23,499,1,1407,1,5,2,2,3,single-choice,spatial-relational,2|3,7,2/3,230499,2
1,2,23,500,1,1038,1,13,6,6,7,single-choice,spatial-relational,6|7,7,6/7,230500,6
1,2,23,501,0,1534,1,3,1,2,2,single-choice,spatial-relational,1|2,7,1/2,230501,1
1,2,23,502,1,1816,1,9,4,4,5,single-choice,spatial-relational,4|5,7,4/5,230502,4
1,2,23,503,1,1168,1,3,1,1,2,single-choice,spatial-relational,1|2,7,1/2,230503,1
1,2,23,504,0,862,1,11,5,6,6,single-choice,spatial-relational,5|6,7,5/6,230504,5
1,2,23,505,1,1284,1,13,6,6,7,single-choice,spatial-relational,6|7,7,6/7,230505,6
1,2,23,506,1,1623,1,5,2,2,3,single-choice,spatial-relational,2|3,7,2/3,230506,2
1,2,23,507,0,2128,1,7,3,4,4,single-choice,spatial-relational,3|4,7,3/4,230507,3
1,2,23,508,1,2553,1,11,5,5,6,single-choice,spatial-relational,5|6,7,5/6,230508,5
1,2,23,509,1,1766,1,3,1,1,2,single-choice,spatial-relational,1|2,7,1/2,230509,1
1,2,23,510,0,1519,1,5,2,3,3,single-choice,spatial-relational,2|3,7,2/3,230510,2
1,2,23,511,1,897,1,3,1,1,2,single-choice,spatial-relational,1|2,7,1/2,230511,1
1,2,23,512,0,1336,1,7,3,4,4,single-choice,spatial-relational,3|4,7,3/4,230512,3
1,2,23,513,1,1023,1,13,6,6,7,single-choice,spatial-relational,6|7,7,6/7,230513,6
1,2,23,514,1,1737,1,11,5,5,6,single-choice,spatial-relational,5|6,7,5/6,230514,5
1,2,23,515,0,1226,1,9,4,5,5,single-choice,spatial-relational,4|5,7,4/5,230515,4
1,2,23,516,0,1216,1,9,4,5,5,single-choice,spatial-relational,4|5,7,4/5,230516,4
1,2,23,517,1,1123,1,3,1,1,2,single-choice,spatial-relational,1|2,7,1/2,230517,1
1,2,23,518,1,1114,1,5,2,2,3,single-choice,spatial-relational,2|3,7,2/3,230518,2
1,2,23,519,1,1228,1,13,6,6,7,single-choice,spatial-relational,6|7,7,6/7,230519,6
1,2,23,520,1,836,1,5,2,2,3,single-choice,spatial-relational,2|3,7,2/3,230520,2
1,2,23,521,0,1992,1,11,5,6,6,single-choice,spatial-relational,5|6,7,5/6,230521,5
1,2,23,522,1,972,1,13,6,6,7,single-choice,spatial-relational,6|7,7,6/7,230522,6
1,2,23,523,0,1880,1,9,4,5,5,single-choice,spatial-relational,4|5,7,4/5,230523,4
1,2,23,524,0,1124,1,9,4,5,5,single-choice,spatial-relational,4|5,7,4/5,230524,4
1,2,23,525,0,924,1,11,5,6,6,single-choice,spatial-relational,5|6,7,5/6,230525,5
1,2,23,526,1,1257,1,7,3,3,4,single-choice,spatial-relational,3|4,7,3/4,230526,3
1,2,23,527,0,1310,1,7,3,4,4,single-choice,spatial-relational,3|4,7,3/4,230527,3
1,2,23,528,0,892,1,3,1,2,2,single-choice,spatial-relational,1|2,7,1/2,230528,1
1,2,23,529,1,1361,1,13,6,6,7,single-choice,spatial-relational,6|7,7,6/7,230529,6
1,2,23,530,1,2577,1,11,5,5,6,single-choice,spatial-relational,5|6,7,5/6,230530,5
1,2,23,531,1,945,1,5,2,2,3,single-choice,spatial-relational,2|3,7,2/3,230531,2
1,2,23,532,0,1945,1,7,3,4,4,single-choice,spatial-relational,3|4,7,3/4,230532,3
1,2,23,533,1,1591,1,13,6,6,7,single-choice,spatial-relational,6|7,7,6/7,230533,6
1,2,23,534,0,1976,1,11,5,6,6,single-choice,spatial-relational,5|6,7,5/6,230534,5
1,2,23,535,1,1194,1,3,1,1,2,single-choice,spatial-relational,1|2,7,1/2,230535,1
1,2,23,536,1,1350,1,3,1,1,2,single-choice,spatial-relational,1|2,7,1/2,230536,1
1,2,23,537,0,1057,1,9,4,5,5,single-choice,spatial-relational,4|5,7,4/5,230537,4
1,2,23,538,1,1376,1,7,3,3,4,single-choice,spatial-relational,3|4,7,3/4,230538,3
1,2,23,539,1,1365,1,5,2,2,3,single-choice,spatial-relational,2|3,7,2/3,230539,2
1,2,23,540,1,1126,1,9,4,4,5,single-choice,spatial-relational,4|5,7,4/5,230540,4
1,2,23,541,1,1663,1,7,3,3,4,single-choice,spatial-relational,3|4,7,3/4,230541,3
1,2,23,542,1,1036,1,5,2,2,3,single-choice,spatial-relational,2|3,7,2/3,230542,2
1,2,23,543,1,1584,1,3,1,1,2,single-choice,spatial-relational,1|2,7,1/2,230543,1
1,2,23,544,1,992,1,13,6,6,7,single-choice,spatial-relational,6|7,7,6/7,230544,6
1,2,23,545,1,1273,1,7,3,3,4,single-choice,spatial-relational,3|4,7,3/4,230545,3
1,2,23,546,0,1112,1,11,5,6,6,single-choice,spatial-relational,5|6,7,5/6,230546,5
1,2,23,547,1,1285,1,9,4,4,5,single-choice,spatial-relational,4|5,7,4/5,230547,4
1,2,23,548,0,1869,1,11,5,6,6,single-choice,spatial-relational,5|6,7,5/6,230548,5
1,2,23,549,1,940,1,3,1,1,2,single-choice,spatial-relational,1|2,7,1/2,230549,1
1,2,23,550,1,1331,1,5,2,2,3,single-choice,spatial-relational,2|3,7,2/3,230550,2
1,2,23,551,1,983,1,9,4,4,5,single-choice,spatial-relational,4|5,7,4/5,230551,4
1,2,23,552,1,2576,1,13,6,6,7,single-choice,spatial-relational,6|7,7,6/7,230552,6
1,2,23,553,1,810,1,5,2,2,3,single-choice,spatial-relational,2|3,7,2/3,230553,2
1,2,23,554,1,1523,1,7,3,3,4,single-choice,spatial-relational,3|4,7,3/4,230554,3
1,2,23,555,0,1277,1,11,5,6,6,single-choice,spatial-relational,5|6,7,5/6,230555,5
1,2,23,556,1,1087,1,5,2,2,3,single-choice,spatial-relational,2|3,7,2/3,230556,2
1,2,23,557,0,1499,1,13,6,7,7,single-choice,spatial-relational,6|7,7,6/7,230557,6
1,2,23,558,1,1037,1,9,4,4,5,single-choice,spatial-relational,4|5,7,4/5,230558,4
1,2,23,559,0,1336,1,3,1,2,2,single-choice,spatial-relational,1|2,7,1/2,230559,1
1,2,23,560,1,707,1,3,1,1,2,single-choice,spatial-relational,1|2,7,1/2,230560,1
1,2,23,561,0,1088,1,11,5,6,6,single-choice,spatial-relational,5|6,7,5/6,230561,5
1,2,23,562,1,864,1,13,6,6,7,single-choice,spatial-relational,6|7,7,6/7,230562,6
1,2,23,563,1,1150,1,9,4,4,5,single-choice,spatial-relational,4|5,7,4/5,230563,4
1,2,23,564,1,1568,1,7,3,3,4,single-choice,spatial-relational,3|4,7,3/4,230564,3
1,2,23,565,1,979,1,3,1,1,2,single-choice,spatial-relational,1|2,7,1/2,230565,1
1,2,23,566,1,1367,1,5,2,2,3,single-choice,spatial-relational,2|3,7,2/3,230566,2
1,2,23,567,1,1277,1,13,6,6,7,single-choice,spatial-relational,6|7,7,6/7,230567,6
1,2,23,568,0,939,1,7,3,4,4,single-choice,spatial-relational,3|4,7,3/4,230568,3
1,2,23,569,1,1473,1,13,6,6,7,single-choice,spatial-relational,6|7,7,6/7,230569,6
1,2,23,570,1,1560,1,9,4,4,5,single-choice,spatial-relational,4|5,7,4/5,230570,4
1,2,23,571,1,1496,1,11,5,5,6,single-choice,spatial-relational,5|6,7,5/6,230571,5
1,2,23,572,0,1295,1,3,1,2,2,single-choice,spatial-relational,1|2,7,1/2,230572,1
1,2,23,573,1,1144,1,7,3,3,4,single-choice,spatial-relational,3|4,7,3/4,230573,3
1,2,23,574,1,1202,1,5,2,2,3,single-choice,spatial-relational,2|3,7,2/3,230574,2
1,2,23,575,0,1555,1,11,5,6,6,single-choice,spatial-relational,5|6,7,5/6,230575,5
1,2,23,576,1,1053,1,9,4,4,5,single-choice,spatial-relational,4|5,7,4/5,230576,4
1,2,23,577,1,1631,1,11,5,5,6,single-choice,spatial-relational,5|6,7,5/6,230577,5
1,2,23,578,1,1754,1,11,5,5,6,single-choice,spatial-relational,5|6,7,5/6,230578,5
1,2,23,579,1,1939,1,5,2,2,3,single-choice,spatial-relational,2|3,7,2/3,230579,2
1,2,23,580,1,947,1,5,2,2,3,single-choice,spatial-relational,2|3,7,2/3,230580,2
1,2,23,581,1,1140,1,13,6,6,7,single-choice,spatial-relational,6|7,7,6/7,230581,6
1,2,23,582,1,1259,1,13,6,6,7,single-choice,spatial-relational,6|7,7,6/7,230582,6
1,2,23,583,0,1044,1,3,1,2,2,single-choice,spatial-relational,1|2,7,1/2,230583,1
1,2,23,584,1,1233,1,7,3,3,4,single-choice,spatial-relational,3|4,7,3/4,230584,3
1,2,23,585,0,1141,1,3,1,2,2,single-choice,spatial-relational,1|2,7,1/2,230585,1
1,2,23,586,1,852,1,7,3,3,4,single-choice,spatial-relational,3|4,7,3/4,230586,3
1,2,23,587,1,1455,1,9,4,4,5,single-choice,spatial-relational,4|5,7,4/5,230587,4
1,2,23,588,1,966,1,9,4,4,5,single-choice,spatial-relational,4|5,7,4/5,230588,4
1,2,23,589,1,1306,1,13,6,6,7,single-choice,spatial-relational,6|7,7,6/7,230589,6
1,2,23,590,0,1577,1,11,5,6,6,single-choice,spatial-relational,5|6,7,5/6,230590,5
1,2,23,591,1,1119,1,5,2,2,3,single-choice,spatial-relational,2|3,7,2/3,230591,2
1,2,23,592,1,1036,1,3,1,1,2,single-choice,spatial-relational,1|2,7,1/2,230592,1
1,2,23,593,0,948,1,3,1,2,2,single-choice,spatial-relational,1|2,7,1/2,230593,1
1,2,23,594,0,715,1,11,5,6,6,single-choice,spatial-relational,5|6,7,5/6,230594,5
1,2,23,595,1,1040,1,13,6,6,7,single-choice,spatial-relational,6|7,7,6/7,230595,6
1,2,23,596,0,1338,1,7,3,4,4,single-choice,spatial-relational,3|4,7,3/4,230596,3
1,2,23,597,1,1855,1,9,4,4,5,single-choice,spatial-relational,4|5,7,4/5,230597,4
1,2,23,598,0,1202,1,5,2,3,3,single-choice,spatial-relational,2|3,7,2/3,230598,2
1,2,23,599,1,1133,1,7,3,3,4,single-choice,spatial-relational,3|4,7,3/4,230599,3
1,2,23,600,1,1908,1,9,4,4,5,single-choice,spatial-relational,4|5,7,4/5,230600,4
2,2,23,1,0,953,1,13,6,7,7,single-choice,spatial-relational,6|7,7,6/7,230001,6
2,2,23,2,0,1062,1,7,3,4,4,single-choice,spatial-relational,3|4,7,3/4,230002,3
2,2,23,3,0,907,1,11,5,6,6,single-choice,spatial-relational,5|6,7,5/6,230003,5
2,2,23,4,1,1289,1,3,1,1,2,single-choice,spatial-relational,1|2,7,1/2,230004,1
2,2,23,5,1,1869,1,13,6,6,7,single-choice,spatial-relational,6|7,7,6/7,230005,6
2,2,23,6,1,2922,1,3,1,1,2,single-choice,spatial-relational,1|2,7,1/2,230006,1
2,2,23,7,1,56,1,11,5,5,6,single-choice,spatial-relational,5|6,7,5/6,230007,5
2,2,23,8,1,2411,1,5,2,2,3,single-choice,spatial-relational,2|3,7,2/3,230008,2
2,2,23,9,1,1159,1,7,3,3,4,single-choice,spatial-relational,3|4,7,3/4,230009,3
2,2,23,10,1,1820,1,9,4,4,5,single-choice,spatial-relational,4|5,7,4/5,230010,4
2,2,23,11,1,1447,1,9,4,4,5,single-choice,spatial-relational,4|5,7,4/5,230011,4
2,2,23,12,1,990,1,5,2,2,3,single-choice,spatial-relational,2|3,7,2/3,230012,2
2,2,23,13,1,2214,1,3,1,1,2,single-choice,spatial-relational,1|2,7,1/2,230013,1
2,2,23,14,1,1262,1,9,4,4,5,single-choice,spatial-relational,4|5,7,4/5,230014,4
2,2,23,15,0,2575,1,7,3,4,4,single-choice,spatial-relational,3|4,7,3/4,230015,3
2,2,23,16,1,1101,1,7,3,3,4,single-choice,spatial-relational,3|4,7,3/4,230016,3
2,2,23,17,0,1595,1,11,5,6,6,single-choice,spatial-relational,5|6,7,5/6,230017,5
2,2,23,18,1,766,1,3,1,1,2,single-choice,spatial-relational,1|2,7,1/2,230018,1
2,2,23,19,1,920,1,9,4,4,5,single-choice,spatial-relational,4|5,7,4/5,230019,4
2,2,23,20,0,2215,1,11,5,6,6,single-choice,spatial-relational,5|6,7,5/6,230020,5
2,2,23,21,1,847,1,13,6,6,7,single-choice,spatial-relational,6|7,7,6/7,230021,6
2,2,23,22,1,1225,1,5,2,2,3,single-choice,spatial-relational,2|3,7,2/3,230022,2
2,2,23,23,0,2344,1,13,6,7,7,single-choice,spatial-relational,6|7,7,6/7,230023,6
2,2,23,24,1,995,1,5,2,2,3,single-choice,spatial-relational,2|3,7,2/3,230024,2
2,2,23,25,0,1692,1,11,5,6,6,single-choice,spatial-relational,5|6,7,5/6,230025,5
2,2,23,26,1,892,1,5,2,2,3,single-choice,spatial-relational,2|3,7,2/3,230026,2
2,2,23,27,1,2304,1,3,1,1,2,single-choice,spatial-relational,1|2,7,1/2,230027,1
2,2,23,28,1,993,1,13,6,6,7,single-choice,spatial-relational,6|7,7,6/7,230028,6
2,2,23,29,0,2068,1,13,6,7,7,single-choice,spatial-relational,6|7,7,6/7,230029,6
2,2,23,30,1,783,1,5,2,2,3,single-choice,spatial-relational,2|3,7,2/3,230030,2
2,2,23,31,1,1347,1,7,3,3,4,single-choice,spatial-relational,3|4,7,3/4,230031,3
2,2,23,32,0,1018,1,3,1,2,2,single-choice,spatial-relational,1|2,7,1/2,230032,1
2,2,23,33,1,1012,1,9,4,4,5,single-choice,spatial-relational,4|5,7,4/5,230033,4
2,2,23,34,1,2386,1,11,5,5,6,single-choice,spatial-relational,5|6,7,5/6,230034,5
2,2,23,35,1,1377,1,7,3,3,4,single-choice,spatial-relational,3|4,7,3/4,230035,3
2,2,23,36,1,1287,1,9,4,4,5,single-choice,spatial-relational,4|5,7,4/5,230036,4
2,2,23,37,1,1270,1,9,4,4,5,single-choice,spatial-relational,4|5,7,4/5,230037,4
2,2,23,38,1,1021,1,9,4,4,5,single-choice,spatial-relational,4|5,7,4/5,230038,4
2,2,23,39,1,1576,1,3,1,1,2,single-choice,spatial-relational,1|2,7,1/2,230039,1
2,2,23,40,0,807,1,7,3,4,4,single-choice,spatial-relational,3|4,7,3/4,230040,3
2,2,23,41,0,1405,1,11,5,6,6,single-choice,spatial-relational,5|6,7,5/6,230041,5
2,2,23,42,1,807,1,13,6,6,7,single-choice,spatial-relational,6|7,7,6/7,230042,6
2,2,23,43,1,1950,1,11,5,5,6,single-choice,spatial-relational,5|6,7,5/6,230043,5
2,2,23,44,1,989,1,3,1,1,2,single-choice,spatial-relational,1|2,7,1/2,230044,1
2,2,23,45,0,1238,1,5,2,3,3,single-choice,spatial-relational,2|3,7,2/3,230045,2
2,2,23,46,1,801,1,5,2,2,3,single-choice,spatial-relational,2|3,7,2/3,230046,2
2,2,23,47,0,975,1,7,3,4,4,single-choice,spatial-relational,3|4,7,3/4,230047,3
2,2,23,48,1,1060,1,13,6,6,7,single-choice,spatial-relational,6|7,7,6/7,230048,6
2,2,23,49,0,3281,1,13,6,7,7,single-choice,spatial-relational,6|7,7,6/7,230049,6
2,2,23,50,0,1041,1,3,1,2,2,single-choice,spatial-relational,1|2,7,1/2,230050,1
2,2,23,51,0,956,1,11,5,6,6,single-choice,spatial-relational,5|6,7,5/6,230051,5
2,2,23,52,1,915,1,9,4,4,5,single-choice,spatial-relational,4|5,7,4/5,230052,4
2,2,23,53,1,1883,1,13,6,6,7,single-choice,spatial-relational,6|7,7,6/7,230053,6
2,2,23,54,1,1697,1,11,5,5,6,single-choice,spatial-relational,5|6,7,5/6,230054,5
2,2,23,55,1,865,1,9,4,4,5,single-choice,spatial-relational,4|5,7,4/5,230055,4
2,2,23,56,1,922,1,7,3,3,4,single-choice,spatial-relational,3|4,7,3/4,230056,3
2,2,23,57,1,1240,1,7,3,3,4,single-choice,spatial-relational,3|4,7,3/4,230057,3
2,2,23,58,0,2233,1,5,2,3,3,single-choice,spatial-relational,2|3,7,2/3,230058,2
2,2,23,59,0,1096,1,5,2,3,3,single-choice,spatial-relational,2|3,7,2/3,230059,2
2,2,23,60,1,910,1,3,1,1,2,single-choice,spatial-relational,1|2,7,1/2,230060,1
2,2,23,61,1,885,1,9,4,4,5,single-choice,spatial-relational,4|5,7,4/5,230061,4
2,2,23,62,1,1227,1,11,5,5,6,single-choice,spatial-relational,5|6,7,5/6,230062,5
2,2,23,63,1,1144,1,3,1,1,2,single-choice,spatial-relational,1|2,7,1/2,230063,1
2,2,23,64,1,1009,1,3,1,1,2,single-choice,spatial-relational,1|2,7,1/2,230064,1
2,2,23,65,1,753,1,9,4,4,5,single-choice,spatial-relational,4|5,7,4/5,230065,4
2,2,23,66,0,1029,1,5,2,3,3,single-choice,spatial-relational,2|3,7,2/3,230066,2
2,2,23,67,0,166,1,13,6,7,7,single-choice,spatial-relational,6|7,7,6/7,230067,6
2,2,23,68,1,1281,1,13,6,6,7,single-choice,spatial-relational,6|7,7,6/7,230068,6
2,2,23,69,1,1499,1,11,5,5,6,single-choice,spatial-relational,5|6,7,5/6,230069,5
2,2,23,70,0,1175,1,7,3,4,4,single-choice,spatial-relational,3|4,7,3/4,230070,3
2,2,23,71,1,854,1,5,2,2,3,single-choice,spatial-relational,2|3,7,2/3,230071,2
2,2,23,72,1,1486,1,7,3,3,4,single-choice,spatial-relational,3|4,7,3/4,230072,3
2,2,23,73,1,1636,1,7,3,3,4,single-choice,spatial-relational,3|4,7,3/4,230073,3
2,2,23,74,1,1060,1,3,1,1,2,single-choice,spatial-relational,1|2,7,1/2,230074,1
2,2,23,75,1,723,1,9,4,4,5,single-choice,spatial-relational,4|5,7,4/5,230075,4
2,2,23,76,1,1169,1,3,1,1,2,single-choice,spatial-relational,1|2,7,1/2,230076,1
2,2,23,77,1,1428,1,5,2,2,3,single-choice,spatial-relational,2|3,7,2/3,230077,2
2,2,23,78,1,1267,1,13,6,6,7,single-choice,spatial-relational,6|7,7,6/7,230078,6
2,2,23,79,1,1356,1,7,3,3,4,single-choice,spatial-relational,3|4,7,3/4,230079,3
2,2,23,80,1,1222,1,11,5,5,6,single-choice,spatial-relational,5|6,7,5/6,230080,5
2,2,23,81,1,1127,1,13,6,6,7,single-choice,spatial-relational,6|7,7,6/7,230081,6
2,2,23,82,1,1354,1,11,5,5,6,single-choice,spatial-relational,5|6,7,5/6,230082,5
2,2,23,83,1,1817,1,5,2,2,3,single-choice,spatial-relational,2|3,7,2/3,230083,2
2,2,23,84,1,1775,1,9,4,4,5,single-choice,spatial-relational,4|5,7,4/5,230084,4
2,2,23,85,1,1134,1,3,1,1,2,single-choice,spatial-relational,1|2,7,1/2,230085,1
2,2,23,86,1,1126,1,9,4,4,5,single-choice,spatial-relational,4|5,7,4/5,230086,4
2,2,23,87,1,1160,1,3,1,1,2,single-choice,spatial-relational,1|2,7,1/2,230087,1
2,2,23,88,1,1097,1,11,5,5,6,single-choice,spatial-relational,5|6,7,5/6,230088,5
2,2,23,89,0,1039,1,7,3,4,4,single-choice,spatial-relational,3|4,7,3/4,230089,3
2,2,23,90,1,847,1,13,6,6,7,single-choice,spatial-relational,6|7,7,6/7,230090,6
2,2,23,91,0,2135,1,7,3,4,4,single-choice,spatial-relational,3|4,7,3/4,230091,3
2,2,23,92,1,1619,1,9,4,4,5,single-choice,spatial-relational,4|5,7,4/5,230092,4
2,2,23,93,0,1523,1,5,2,3,3,single-choice,spatial-relational,2|3,7,2/3,230093,2
2,2,23,94,0,766,1,11,5,6,6,single-choice,spatial-relational,5|6,7,5/6,230094,5
2,2,23,95,0,56,1,5,2,3,3,single-choice,spatial-relational,2|3,7,2/3,230095,2
2,2,23,96,1,747,1,13,6,6,7,single-choice,spatial-relational,6|7,7,6/7,230096,6
2,2,23,97,1,1396,1,5,2,2,3,single-choice,spatial-relational,2|3,7,2/3,230097,2
2,2,23,98,0,1280,1,7,3,4,4,single-choice,spatial-relational,3|4,7,3/4,230098,3
2,2,23,99,0,1937,1,11,5,6,6,single-choice,spatial-relational,5|6,7,5/6,230099,5
2,2,23,100,1,671,1,13,6,6,7,single-choice,spatial-relational,6|7,7,6/7,230100,6
2,2,23,101,1,943,1,11,5,5,6,single-choice,spatial-relational,5|6,7,5/6,230101,5
2,2,23,102,1,1185,1,3,1,1,2,single-choice,spatial-relational,1|2,7,1/2,230102,1
2,2,23,103,1,1224,1,7,3,3,4,single-choice,spatial-relational,3|4,7,3/4,230103,3
2,2,23,104,0,1172,1,9,4,5,5,single-choice,spatial-relational,4|5,7,4/5,230104,4
2,2,23,105,0,780,1,3,1,2,2,single-choice,spatial-relational,1|2,7,1/2,230105,1
2,2,23,106,1,788,1,13,6,6,7,single-choice,spatial-relational,6|7,7,6/7,230106,6
2,2,23,107,1,1777,1,9,4,4,5,single-choice,spatial-relational,4|5,7,4/5,230107,4
2,2,23,108,1,1563,1,5,2,2,3,single-choice,spatial-relational,2|3,7,2/3,230108,2
2,2,23,109,0,1589,1,5,2,3,3,single-choice,spatial-relational,2|3,7,2/3,230109,2
2,2,23,110,1,1087,1,3,1,1,2,single-choice,spatial-relational,1|2,7,1/2,230110,1
2,2,23,111,1,935,1,9,4,4,5,single-choice,spatial-relational,4|5,7,4/5,230111,4
2,2,23,112,1,1005,1,5,2,2,3,single-choice,spatial-relational,2|3,7,2/3,230112,2
2,2,23,113,0,1262,1,11,5,6,6,single-choice,spatial-relational,5|6,7,5/6,230113,5
2,2,23,114,0,674,1,11,5,6,6,single-choice,spatial-relational,5|6,7,5/6,230114,5
2,2,23,115,0,1463,1,7,3,4,4,single-choice,spatial-relational,3|4,7,3/4,230115,3
2,2,23,116,1,1563,1,13,6,6,7,single-choice,spatial-relational,6|7,7,6/7,230116,6
2,2,23,117,1,1877,1,7,3,3,4,single-choice,spatial-relational,3|4,7,3/4,230117,3
2,2,23,118,1,1088,1,3,1,1,2,single-choice,spatial-relational,1|2,7,1/2,230118,1
2,2,23,119,1,1460,1,9,4,4,5,single-choice,spatial-relational,4|5,7,4/5,230119,4
2,2,23,120,1,1030,1,13,6,6,7,single-choice,spatial-relational,6|7,7,6/7,230120,6
2,2,23,121,1,1180,1,3,1,1,2,single-choice,spatial-relational,1|2,7,1/2,230121,1
2,2,23,122,1,1356,1,13,6,6,7,single-choice,spatial-relational,6|7,7,6/7,230122,6
2,2,23,123,1,1227,1,11,5,5,6,single-choice,spatial-relational,5|6,7,5/6,230123,5
2,2,23,124,1,2269,1,5,2,2,3,single-choice,spatial-relational,2|3,7,2/3,230124,2
2,2,23,125,1,1525,1,9,4,4,5,single-choice,spatial-relational,4|5,7,4/5,230125,4
2,2,23,126,1,1913,1,7,3,3,4,single-choice,spatial-relational,3|4,7,3/4,230126,3
2,2,23,127,1,1515,1,11,5,5,6,single-choice,spatial-relational,5|6,7,5/6,230127,5
2,2,23,128,1,1370,1,9,4,4,5,single-choice,spatial-relational,4|5,7,4/5,230128,4
2,2,23,129,1,1290,1,13,6,6,7,single-choice,spatial-relational,6|7,7,6/7,230129,6
2,2,23,130,0,1012,1,3,1,2,2,single-choice,spatial-relational,1|2,7,1/2,230130,1
2,2,23,131,1,1178,1,5,2,2,3,single-choice,spatial-relational,2|3,7,2/3,230131,2
2,2,23,132,1,1204,1,7,3,3,4,single-choice,spatial-relational,3|4,7,3/4,230132,3
2,2,23,133,1,1541,1,11,5,5,6,single-choice,spatial-relational,5|6,7,5/6,230133,5
2,2,23,134,1,1343,1,3,1,1,2,single-choice,spatial-relational,1|2,7,1/2,230134,1
2,2,23,135,0,1575,1,11,5,6,6,single-choice,spatial-relational,5|6,7,5/6,230135,5
2,2,23,136,1,1487,1,7,3,3,4,single-choice,spatial-relational,3|4,7,3/4,230136,3
2,2,23,137,1,1359,1,3,1,1,2,single-choice,spatial-relational,1|2,7,1/2,230137,1
2,2,23,138,1,905,1,13,6,6,7,single-choice,spatial-relational,6|7,7,6/7,230138,6
2,2,23,139,1,1627,1,5,2,2,3,single-choice,spatial-relational,2|3,7,2/3,230139,2
2,2,23,140,1,1411,1,7,3,3,4,single-choice,spatial-relational,3|4,7,3/4,230140,3
2,2,23,141,1,2178,1,9,4,4,5,single-choice,spatial-relational,4|5,7,4/5,230141,4
2,2,23,142,1,2513,1,9,4,4,5,single-choice,spatial-relational,4|5,7,4/5,230142,4
2,2,23,143,1,1716,1,13,6,6,7,single-choice,spatial-relational,6|7,7,6/7,230143,6
2,2,23,144,0,2595,1,5,2,3,3,single-choice,spatial-relational,2|3,7,2/3,230144,2
2,2,23,145,1,1552,1,11,5,5,6,single-choice,spatial-relational,5|6,7,5/6,230145,5
2,2,23,146,0,1550,1,7,3,4,4,single-choice,spatial-relational,3|4,7,3/4,230146,3
2,2,23,147,1,1155,1,5,2,2,3,single-choice,spatial-relational,2|3,7,2/3,230147,2
2,2,23,148,1,1862,1,3,1,1,2,single-choice,spatial-relational,1|2,7,1/2,230148,1
2,2,23,149,1,2091,1,9,4,4,5,single-choice,spatial-relational,4|5,7,4/5,230149,4
2,2,23,150,1,1631,1,13,6,6,7,single-choice,spatial-relational,6|7,7,6/7,230150,6
2,2,23,151,1,1758,1,3,1,1,2,single-choice,spatial-relational,1|2,7,1/2,230151,1
2,2,23,152,1,1604,1,9,4,4,5,single-choice,spatial-relational,4|5,7,4/5,230152,4
2,2,23,153,1,1335,1,13,6,6,7,single-choice,spatial-relational,6|7,7,6/7,230153,6
2,2,23,154,0,1675,1,5,2,3,3,single-choice,spatial-relational,2|3,7,2/3,230154,2
2,2,23,155,1,1331,1,11,5,5,6,single-choice,spatial-relational,5|6,7,5/6,230155,5
2,2,23,156,0,998,1,7,3,4,4,single-choice,spatial-relational,3|4,7,3/4,230156,3
2,2,23,157,1,1237,1,9,4,4,5,single-choice,spatial-relational,4|5,7,4/5,230157,4
2,2,23,158,1,1371,1,5,2,2,3,single-choice,spatial-relational,2|3,7,2/3,230158,2
2,2,23,159,0,1285,1,7,3,4,4,single-choice,spatial-relational,3|4,7,3/4,230159,3
2,2,23,160,1,1063,1,7,3,3,4,single-choice,spatial-relational,3|4,7,3/4,230160,3
2,2,23,161,1,1126,1,3,1,1,2,single-choice,spatial-relational,1|2,7,1/2,230161,1
2,2,23,162,1,1360,1,13,6,6,7,single-choice,spatial-relational,6|7,7,6/7,230162,6
2,2,23,163,1,1212,1,11,5,5,6,single-choice,spatial-relational,5|6,7,5/6,230163,5
2,2,23,164,0,1738,1,9,4,5,5,single-choice,spatial-relational,4|5,7,4/5,230164,4
2,2,23,165,1,1116,1,13,6,6,7,single-choice,spatial-relational,6|7,7,6/7,230165,6
2,2,23,166,1,2184,1,5,2,2,3,single-choice,spatial-relational,2|3,7,2/3,230166,2
2,2,23,167,1,1548,1,11,5,5,6,single-choice,spatial-relational,5|6,7,5/6,230167,5
2,2,23,168,1,1436,1,3,1,1,2,single-choice,spatial-relational,1|2,7,1/2,230168,1
2,2,23,169,0,1468,1,5,2,3,3,single-choice,spatial-relational,2|3,7,2/3,230169,2
2,2,23,170,0,1079,1,9,4,5,5,single-choice,spatial-relational,4|5,7,4/5,230170,4
2,2,23,171,1,1576,1,11,5,5,6,single-choice,spatial-relational,5|6,7,5/6,230171,5
2,2,23,172,1,970,1,3,1,1,2,single-choice,spatial-relational,1|2,7,1/2,230172,1
2,2,23,173,1,1407,1,5,2,2,3,single-choice,spatial-relational,2|3,7,2/3,230173,2
2,2,23,174,1,1596,1,13,6,6,7,single-choice,spatial-relational,6|7,7,6/7,230174,6
2,2,23,175,1,1365,1,7,3,3,4,single-choice,spatial-relational,3|4,7,3/4,230175,3
2,2,23,176,1,1388,1,3,1,1,2,single-choice,spatial-relational,1|2,7,1/2,230176,1
2,2,23,177,0,977,1,11,5,6,6,single-choice,spatial-relational,5|6,7,5/6,230177,5
2,2,23,178,1,2554,1,9,4,4,5,single-choice,spatial-relational,4|5,7,4/5,230178,4
2,2,23,179,1,1765,1,13,6,6,7,single-choice,spatial-relational,6|7,7,6/7,230179,6
2,2,23,180,1,1695,1,7,3,3,4,single-choice,spatial-relational,3|4,7,3/4,230180,3
2,2,23,181,1,1677,1,9,4,4,5,single-choice,spatial-relational,4|5,7,4/5,230181,4
2,2,23,182,1,1679,1,13,6,6,7,single-choice,spatial-relational,6|7,7,6/7,230182,6
2,2,23,183,1,974,1,5,2,2,3,single-choice,spatial-relational,2|3,7,2/3,230183,2
2,2,23,184,1,1342,1,3,1,1,2,single-choice,spatial-relational,1|2,7,1/2,230184,1
2,2,23,185,1,882,1,13,6,6,7,single-choice,spatial-relational,6|7,7,6/7,230185,6
2,2,23,186,1,2073,1,5,2,2,3,single-choice,spatial-relational,2|3,7,2/3,230186,2
2,2,23,187,0,1558,1,9,4,5,5,single-choice,spatial-relational,4|5,7,4/5,230187,4
2,2,23,188,1,1313,1,11,5,5,6,single-choice,spatial-relational,5|6,7,5/6,230188,5
2,2,23,189,1,1360,1,7,3,3,4,single-choice,spatial-relational,3|4,7,3/4,230189,3
2,2,23,190,0,1532,1,7,3,4,4,single-choice,spatial-relational,3|4,7,3/4,230190,3
2,2,23,191,1,1372,1,3,1,1,2,single-choice,spatial-relational,1|2,7,1/2,230191,1
2,2,23,192,1,1096,1,11,5,5,6,single-choice,spatial-relational,5|6,7,5/6,230192,5
2,2,23,193,1,1408,1,11,5,5,6,single-choice,spatial-relational,5|6,7,5/6,230193,5
2,2,23,194,1,1589,1,11,5,5,6,single-choice,spatial-relational,5|6,7,5/6,230194,5
2,2,23,195,1,1667,1,3,1,1,2,single-choice,spatial-relational,1|2,7,1/2,230195,1
2,2,23,196,1,1109,1,7,3,3,4,single-choice,spatial-relational,3|4,7,3/4,230196,3
2,2,23,197,0,1517,1,5,2,3,3,single-choice,spatial-relational,2|3,7,2/3,230197,2
2,2,23,198,1,1670,1,3,1,1,2,single-choice,spatial-relational,1|2,7,1/2,230198,1
2,2,23,199,1,1284,1,7,3,3,4,single-choice,spatial-relational,3|4,7,3/4,230199,3
2,2,23,200,1,1560,1,9,4,4,5,single-choice,spatial-relational,4|5,7,4/5,230200,4
2,2,23,201,1,1424,1,13,6,6,7,single-choice,spatial-relational,6|7,7,6/7,230201,6
2,2,23,202,1,2351,1,5,2,2,3,single-choice,spatial-relational,2|3,7,2/3,230202,2
2,2,23,203,1,1647,1,9,4,4,5,single-choice,spatial-relational,4|5,7,4/5,230203,4
2,2,23,204,1,1212,1,13,6,6,7,single-choice,spatial-relational,6|7,7,6/7,230204,6
2,2,23,205,1,1933,1,11,5,5,6,single-choice,spatial-relational,5|6,7,5/6,230205,5
2,2,23,206,1,1170,1,13,6,6,7,single-choice,spatial-relational,6|7,7,6/7,230206,6
2,2,23,207,1,1706,1,9,4,4,5,single-choice,spatial-relational,4|5,7,4/5,230207,4
2,2,23,208,1,1798,1,13,6,6,7,single-choice,spatial-relational,6|7,7,6/7,230208,6
2,2,23,209,1,2105,1,7,3,3,4,single-choice,spatial-relational,3|4,7,3/4,230209,3
2,2,23,210,0,1138,1,11,5,6,6,single-choice,spatial-relational,5|6,7,5/6,230210,5
2,2,23,211,1,1095,1,5,2,2,3,single-choice,spatial-relational,2|3,7,2/3,230211,2
2,2,23,212,0,1084,1,3,1,2,2,single-choice,spatial-relational,1|2,7,1/2,230212,1
2,2,23,213,1,1179,1,5,2,2,3,single-choice,spatial-relational,2|3,7,2/3,230213,2
2,2,23,214,1,1418,1,3,1,1,2,single-choice,spatial-relational,1|2,7,1/2,230214,1
2,2,23,215,1,1075,1,7,3,3,4,single-choice,spatial-relational,3|4,7,3/4,230215,3
2,2,23,216,0,1330,1,9,4,5,5,single-choice,spatial-relational,4|5,7,4/5,230216,4
2,2,23,217,1,1798,1,11,5,5,6,single-choice,spatial-relational,5|6,7,5/6,230217,5
2,2,23,218,0,1854,1,5,2,3,3,single-choice,spatial-relational,2|3,7,2/3,230218,2
2,2,23,219,1,1165,1,7,3,3,4,single-choice,spatial-relational,3|4,7,3/4,230219,3
2,2,23,220,1,1475,1,13,6,6,7,single-choice,spatial-relational,6|7,7,6/7,230220,6
2,2,23,221,1,2745,1,11,5,5,6,single-choice,spatial-relational,5|6,7,5/6,230221,5
2,2,23,222,0,1378,1,7,3,4,4,single-choice,spatial-relational,3|4,7,3/4,230222,3
2,2,23,223,0,139,1,3,1,2,2,single-choice,spatial-relational,1|2,7,1/2,230223,1
2,2,23,224,1,1171,1,3,1,1,2,single-choice,spatial-relational,1|2,7,1/2,230224,1
2,2,23,225,1,1150,1,9,4,4,5,single-choice,spatial-relational,4|5,7,4/5,230225,4
2,2,23,226,0,1228,1,9,4,5,5,single-choice,spatial-relational,4|5,7,4/5,230226,4
2,2,23,227,1,828,1,13,6,6,7,single-choice,spatial-relational,6|7,7,6/7,230227,6
2,2,23,228,1,2254,1,5,2,2,3,single-choice,spatial-relational,2|3,7,2/3,230228,2
2,2,23,229,1,936,1,3,1,1,2,single-choice,spatial-relational,1|2,7,1/2,230229,1
2,2,23,230,1,959,1,3,1,1,2,single-choice,spatial-relational,1|2,7,1/2,230230,1
2,2,23,231,0,1885,1,5,2,3,3,single-choice,spatial-relational,2|3,7,2/3,230231,2
2,2,23,232,1,1726,1,5,2,2,3,single-choice,spatial-relational,2|3,7,2/3,230232,2
2,2,23,233,0,1586,1,11,5,6,6,single-choice,spatial-relational,5|6,7,5/6,230233,5
2,2,23,234,1,1065,1,7,3,3,4,single-choice,spatial-relational,3|4,7,3/4,230234,3
2,2,23,235,1,1636,1,9,4,4,5,single-choice,spatial-relational,4|5,7,4/5,230235,4
2,2,23,236,1,1523,1,11,5,5,6,single-choice,spatial-relational,5|6,7,5/6,230236,5
2,2,23,237,1,1355,1,7,3,3,4,single-choice,spatial-relational,3|4,7,3/4,230237,3
2,2,23,238,1,1149,1,13,6,6,7,single-choice,spatial-relational,6|7,7,6/7,230238,6
2,2,23,239,1,2839,1,9,4,4,5,single-choice,spatial-relational,4|5,7,4/5,230239,4
2,2,23,240,1,1214,1,13,6,6,7,single-choice,spatial-relational,6|7,7,6/7,230240,6
2,2,23,241,1,1784,1,11,5,5,6,single-choice,spatial-relational,5|6,7,5/6,230241,5
2,2,23,242,1,2015,1,3,1,1,2,single-choice,spatial-relational,1|2,7,1/2,230242,1
2,2,23,243,1,1098,1,7,3,3,4,single-choice,spatial-relational,3|4,7,3/4,230243,3
2,2,23,244,1,1298,1,5,2,2,3,single-choice,spatial-relational,2|3,7,2/3,230244,2
2,2,23,245,1,1041,1,13,6,6,7,single-choice,spatial-relational,6|7,7,6/7,230245,6
2,2,23,246,1,1427,1,9,4,4,5,single-choice,spatial-relational,4|5,7,4/5,230246,4
2,2,23,247,1,1563,1,13,6,6,7,single-choice,spatial-relational,6|7,7,6/7,230247,6
2,2,23,248,1,1776,1,5,2,2,3,single-choice,spatial-relational,2|3,7,2/3,230248,2
2,2,23,249,1,1353,1,9,4,4,5,single-choice,spatial-relational,4|5,7,4/5,230249,4
2,2,23,250,1,1394,1,3,1,1,2,single-choice,spatial-relational,1|2,7,1/2,230250,1
2,2,23,251,1,1215,1,7,3,3,4,single-choice,spatial-relational,3|4,7,3/4,230251,3
2,2,23,252,1,1817,1,11,5,5,6,single-choice,spatial-relational,5|6,7,5/6,230252,5
2,2,23,253,1,1072,1,3,1,1,2,single-choice,spatial-relational,1|2,7,1/2,230253,1
2,2,23,254,1,1218,1,7,3,3,4,single-choice,spatial-relational,3|4,7,3/4,230254,3
2,2,23,255,1,1031,1,9,4,4,5,single-choice,spatial-relational,4|5,7,4/5,230255,4
2,2,23,256,1,1468,1,5,2,2,3,single-choice,spatial-relational,2|3,7,2/3,230256,2
2,2,23,257,1,1066,1,7,3,3,4,single-choice,spatial-relational,3|4,7,3/4,230257,3
2,2,23,258,1,1276,1,11,5,5,6,single-choice,spatial-relational,5|6,7,5/6,230258,5
2,2,23,259,1,1507,1,11,5,5,6,single-choice,spatial-relational,5|6,7,5/6,230259,5
2,2,23,260,1,1180,1,13,6,6,7,single-choice,spatial-relational,6|7,7,6/7,230260,6
2,2,23,261,1,1860,1,9,4,4,5,single-choice,spatial-relational,4|5,7,4/5,230261,4
2,2,23,262,0,2139,1,5,2,3,3,single-choice,spatial-relational,2|3,7,2/3,230262,2
2,2,23,263,1,33,1,3,1,1,2,single-choice,spatial-relational,1|2,7,1/2,230263,1
2,2,23,264,1,1416,1,13,6,6,7,single-choice,spatial-relational,6|7,7,6/7,230264,6
2,2,23,265,1,2653,1,7,3,3,4,single-choice,spatial-relational,3|4,7,3/4,230265,3
2,2,23,266,1,1733,1,9,4,4,5,single-choice,spatial-relational,4|5,7,4/5,230266,4
2,2,23,267,1,1493,1,3,1,1,2,single-choice,spatial-relational,1|2,7,1/2,230267,1
2,2,23,268,1,1408,1,13,6,6,7,single-choice,spatial-relational,6|7,7,6/7,230268,6
2,2,23,269,1,1064,1,5,2,2,3,single-choice,spatial-relational,2|3,7,2/3,230269,2
2,2,23,270,0,1939,1,5,2,3,3,single-choice,spatial-relational,2|3,7,2/3,230270,2
2,2,23,271,1,879,1,13,6,6,7,single-choice,spatial-relational,6|7,7,6/7,230271,6
2,2,23,272,1,1613,1,7,3,3,4,single-choice,spatial-relational,3|4,7,3/4,230272,3
2,2,23,273,1,1340,1,9,4,4,5,single-choice,spatial-relational,4|5,7,4/5,230273,4
2,2,23,274,1,1742,1,11,5,5,6,single-choice,spatial-relational,5|6,7,5/6,230274,5
2,2,23,275,1,1685,1,11,5,5,6,single-choice,spatial-relational,5|6,7,5/6,230275,5
2,2,23,276,1,1581,1,3,1,1,2,single-choice,spatial-relational,1|2,7,1/2,230276,1
2,2,23,277,1,1201,1,7,3,3,4,single-choice,spatial-relational,3|4,7,3/4,230277,3
2,2,23,278,0,1492,1,7,3,4,4,single-choice,spatial-relational,3|4,7,3/4,230278,3
2,2,23,279,1,1104,1,5,2,2,3,single-choice,spatial-relational,2|3,7,2/3,230279,2
2,2,23,280,1,1505,1,13,6,6,7,single-choice,spatial-relational,6|7,7,6/7,230280,6
2,2,23,281,1,1031,1,13,6,6,7,single-choice,spatial-relational,6|7,7,6/7,230281,6
2,2,23,282,1,2288,1,5,2,2,3,single-choice,spatial-relational,2|3,7,2/3,230282,2
2,2,23,283,1,1947,1,11,5,5,6,single-choice,spatial-relational,5|6,7,5/6,230283,5
2,2,23,284,1,1800,1,3,1,1,2,single-choice,spatial-relational,1|2,7,1/2,230284,1
2,2,23,285,1,92,1,3,1,1,2,single-choice,spatial-relational,1|2,7,1/2,230285,1
2,2,23,286,1,1398,1,9,4,4,5,single-choice,spatial-relational,4|5,7,4/5,230286,4
2,2,23,287,1,1386,1,11,5,5,6,single-choice,spatial-relational,5|6,7,5/6,230287,5
2,2,23,288,1,1116,1,9,4,4,5,single-choice,spatial-relational,4|5,7,4/5,230288,4
2,2,23,289,1,1998,1,7,3,3,4,single-choice,spatial-relational,3|4,7,3/4,230289,3
2,2,23,290,1,1846,1,9,4,4,5,single-choice,spatial-relational,4|5,7,4/5,230290,4
2,2,23,291,1,2574,1,11,5,5,6,single-choice,spatial-relational,5|6,7,5/6,230291,5
2,2,23,292,0,2657,1,9,4,5,5,single-choice,spatial-relational,4|5,7,4/5,230292,4
2,2,23,293,0,999,1,5,2,3,3,single-choice,spatial-relational,2|3,7,2/3,230293,2
2,2,23,294,1,1506,1,11,5,5,6,single-choice,spatial-relational,5|6,7,5/6,230294,5
2,2,23,295,0,1314,1,5,2,3,3,single-choice,spatial-relational,2|3,7,2/3,230295,2
2,2,23,296,1,794,1,13,6,6,7,single-choice,spatial-relational,6|7,7,6/7,230296,6
2,2,23,297,1,1321,1,3,1,1,2,single-choice,spatial-relational,1|2,7,1/2,230297,1
2,2,23,298,1,956,1,3,1,1,2,single-choice,spatial-relational,1|2,7,1/2,230298,1
2,2,23,299,1,970,1,7,3,3,4,single-choice,spatial-relational,3|4,7,3/4,230299,3
2,2,23,300,1,1530,1,13,6,6,7,single-choice,spatial-relational,6|7,7,6/7,230300,6
2,2,23,301,0,2395,1,5,2,3,3,single-choice,spatial-relational,2|3,7,2/3,230301,2
2,2,23,302,0,917,1,3,1,2,2,single-choice,spatial-relational,1|2,7,1/2,230302,1
2,2,23,303,1,1212,1,7,3,3,4,single-choice,spatial-relational,3|4,7,3/4,230303,3
2,2,23,304,1,1394,1,11,5,5,6,single-choice,spatial-relational,5|6,7,5/6,230304,5
2,2,23,305,1,1815,1,7,3,3,4,single-choice,spatial-relational,3|4,7,3/4,230305,3
2,2,23,306,0,1682,1,9,4,5,5,single-choice,spatial-relational,4|5,7,4/5,230306,4
2,2,23,307,0,966,1,5,2,3,3,single-choice,spatial-relational,2|3,7,2/3,230307,2
2,2,23,308,1,1031,1,13,6,6,7,single-choice,spatial-relational,6|7,7,6/7,230308,6
2,2,23,309,1,1318,1,13,6,6,7,single-choice,spatial-relational,6|7,7,6/7,230309,6
2,2,23,310,1,1172,1,9,4,4,5,single-choice,spatial-relational,4|5,7,4/5,230310,4
2,2,23,311,1,2095,1,11,5,5,6,single-choice,spatial-relational,5|6,7,5/6,230311,5
2,2,23,312,1,931,1,3,1,1,2,single-choice,spatial-relational,1|2,7,1/2,230312,1
2,2,23,313,1,1258,1,3,1,1,2,single-choice,spatial-relational,1|2,7,1/2,230313,1
2,2,23,314,1,914,1,13,6,6,7,single-choice,spatial-relational,6|7,7,6/7,230314,6
2,2,23,315,1,1913,1,9,4,4,5,single-choice,spatial-relational,4|5,7,4/5,230315,4
2,2,23,316,0,2215,1,5,2,3,3,single-choice,spatial-relational,2|3,7,2/3,230316,2
2,2,23,317,0,1069,1,9,4,5,5,single-choice,spatial-relational,4|5,7,4/5,230317,4
2,2,23,318,1,1246,1,7,3,3,4,single-choice,spatial-relational,3|4,7,3/4,230318,3
2,2,23,319,1,1847,1,11,5,5,6,single-choice,spatial-relational,5|6,7,5/6,230319,5
2,2,23,320,1,1272,1,11,5,5,6,single-choice,spatial-relational,5|6,7,5/6,230320,5
2,2,23,321,1,2488,1,5,2,2,3,single-choice,spatial-relational,2|3,7,2/3,230321,2
2,2,23,322,0,870,1,7,3,4,4,single-choice,spatial-relational,3|4,7,3/4,230322,3
2,2,23,323,1,930,1,13,6,6,7,single-choice,spatial-relational,6|7,7,6/7,230323,6
2,2,23,324,1,1598,1,3,1,1,2,single-choice,spatial-relational,1|2,7,1/2,230324,1
2,2,23,325,1,1318,1,13,6,6,7,single-choice,spatial-relational,6|7,7,6/7,230325,6
2,2,23,326,0,1345,1,3,1,2,2,single-choice,spatial-relational,1|2,7,1/2,230326,1
2,2,23,327,1,1428,1,9,4,4,5,single-choice,spatial-relational,4|5,7,4/5,230327,4
2,2,23,328,0,3526,1,5,2,3,3,single-choice,spatial-relational,2|3,7,2/3,230328,2
2,2,23,329,1,1847,1,11,5,5,6,single-choice,spatial-relational,5|6,7,5/6,230329,5
2,2,23,330,1,2451,1,5,2,2,3,single-choice,spatial-relational,2|3,7,2/3,230330,2
2,2,23,331,0,1627,1,7,3,4,4,single-choice,spatial-relational,3|4,7,3/4,230331,3
2,2,23,332,1,1476,1,9,4,4,5,single-choice,spatial-relational,4|5,7,4/5,230332,4
2,2,23,333,1,3101,1,11,5,5,6,single-choice,spatial-relational,5|6,7,5/6,230333,5
2,2,23,334,1,1383,1,3,1,1,2,single-choice,spatial-relational,1|2,7,1/2,230334,1
2,2,23,335,1,954,1,13,6,6,7,single-choice,spatial-relational,6|7,7,6/7,230335,6
2,2,23,336,1,1179,1,7,3,3,4,single-choice,spatial-relational,3|4,7,3/4,230336,3
2,2,23,337,1,1734,1,11,5,5,6,single-choice,spatial-relational,5|6,7,5/6,230337,5
2,2,23,338,1,1110,1,3,1,1,2,single-choice,spatial-relational,1|2,7,1/2,230338,1
2,2,23,339,1,1074,1,7,3,3,4,single-choice,spatial-relational,3|4,7,3/4,230339,3
2,2,23,340,1,1266,1,3,1,1,2,single-choice,spatial-relational,1|2,7,1/2,230340,1
2,2,23,341,1,1335,1,13,6,6,7,single-choice,spatial-relational,6|7,7,6/7,230341,6
2,2,23,342,1,2030,1,5,2,2,3,single-choice,spatial-relational,2|3,7,2/3,230342,2
2,2,23,343,1,1158,1,11,5,5,6,single-choice,spatial-relational,5|6,7,5/6,230343,5
2,2,23,344,1,1532,1,5,2,2,3,single-choice,spatial-relational,2|3,7,2/3,230344,2
2,2,23,345,1,1107,1,13,6,6,7,single-choice,spatial-relational,6|7,7,6/7,230345,6
2,2,23,346,1,1363,1,9,4,4,5,single-choice,spatial-relational,4|5,7,4/5,230346,4
2,2,23,347,1,1380,1,7,3,3,4,single-choice,spatial-relational,3|4,7,3/4,230347,3
2,2,23,348,1,2136,1,9,4,4,5,single-choice,spatial-relational,4|5,7,4/5,230348,4
2,2,23,349,1,1543,1,9,4,4,5,single-choice,spatial-relational,4|5,7,4/5,230349,4
2,2,23,350,0,1461,1,7,3,4,4,single-choice,spatial-relational,3|4,7,3/4,230350,3
2,2,23,351,1,1250,1,5,2,2,3,single-choice,spatial-relational,2|3,7,2/3,230351,2
2,2,23,352,0,1599,1,9,4,5,5,single-choice,spatial-relational,4|5,7,4/5,230352,4
2,2,23,353,1,1163,1,7,3,3,4,single-choice,spatial-relational,3|4,7,3/4,230353,3
2,2,23,354,0,1391,1,5,2,3,3,single-choice,spatial-relational,2|3,7,2/3,230354,2
2,2,23,355,1,826,1,13,6,6,7,single-choice,spatial-relational,6|7,7,6/7,230355,6
2,2,23,356,1,2774,1,11,5,5,6,single-choice,spatial-relational,5|6,7,5/6,230356,5
2,2,23,357,1,1069,1,3,1,1,2,single-choice,spatial-relational,1|2,7,1/2,230357,1
2,2,23,358,1,1508,1,11,5,5,6,single-choice,spatial-relational,5|6,7,5/6,230358,5
2,2,23,359,1,1277,1,3,1,1,2,single-choice,spatial-relational,1|2,7,1/2,230359,1
2,2,23,360,1,1031,1,13,6,6,7,single-choice,spatial-relational,6|7,7,6/7,230360,6
2,2,23,361,1,1448,1,3,1,1,2,single-choice,spatial-relational,1|2,7,1/2,230361,1
2,2,23,362,1,1570,1,9,4,4,5,single-choice,spatial-relational,4|5,7,4/5,230362,4
2,2,23,363,1,1058,1,13,6,6,7,single-choice,spatial-relational,6|7,7,6/7,230363,6
2,2,23,364,0,2200,1,5,2,3,3,single-choice,spatial-relational,2|3,7,2/3,230364,2
2,2,23,365,1,1106,1,5,2,2,3,single-choice,spatial-relational,2|3,7,2/3,230365,2
2,2,23,366,1,1190,1,11,5,5,6,single-choice,spatial-relational,5|6,7,5/6,230366,5
2,2,23,367,1,1255,1,9,4,4,5,single-choice,spatial-relational,4|5,7,4/5,230367,4
2,2,23,368,1,1604,1,11,5,5,6,single-choice,spatial-relational,5|6,7,5/6,230368,5
2,2,23,369,0,1883,1,7,3,4,4,single-choice,spatial-relational,3|4,7,3/4,230369,3
2,2,23,370,1,1037,1,7,3,3,4,single-choice,spatial-relational,3|4,7,3/4,230370,3
2,2,23,371,1,1028,1,13,6,6,7,single-choice,spatial-relational,6|7,7,6/7,230371,6
2,2,23,372,1,1650,1,3,1,1,2,single-choice,spatial-relational,1|2,7,1/2,230372,1
2,2,23,373,1,806,1,13,6,6,7,single-choice,spatial-relational,6|7,7,6/7,230373,6
2,2,23,374,1,1315,1,7,3,3,4,single-choice,spatial-relational,3|4,7,3/4,230374,3
2,2,23,375,1,1771,1,5,2,2,3,single-choice,spatial-relational,2|3,7,2/3,230375,2
2,2,23,376,1,909,1,13,6,6,7,single-choice,spatial-relational,6|7,7,6/7,230376,6
2,2,23,377,0,1964,1,9,4,5,5,single-choice,spatial-relational,4|5,7,4/5,230377,4
2,2,23,378,1,1114,1,3,1,1,2,single-choice,spatial-relational,1|2,7,1/2,230378,1
2,2,23,379,0,1510,1,5,2,3,3,single-choice,spatial-relational,2|3,7,2/3,230379,2
2,2,23,380,1,1073,1,7,3,3,4,single-choice,spatial-relational,3|4,7,3/4,230380,3
2,2,23,381,1,1273,1,9,4,4,5,single-choice,spatial-relational,4|5,7,4/5,230381,4
2,2,23,382,1,1477,1,11,5,5,6,single-choice,spatial-relational,5|6,7,5/6,230382,5
2,2,23,383,1,1118,1,3,1,1,2,single-choice,spatial-relational,1|2,7,1/2,230383,1
2,2,23,384,1,1683,1,11,5,5,6,single-choice,spatial-relational,5|6,7,5/6,230384,5
2,2,23,385,1,1668,1,7,3,3,4,single-choice,spatial-relational,3|4,7,3/4,230385,3
2,2,23,386,1,1462,1,11,5,5,6,single-choice,spatial-relational,5|6,7,5/6,230386,5
2,2,23,387,1,1349,1,13,6,6,7,single-choice,spatial-relational,6|7,7,6/7,230387,6
2,2,23,388,1,1085,1,13,6,6,7,single-choice,spatial-relational,6|7,7,6/7,230388,6
2,2,23,389,1,1165,1,5,2,2,3,single-choice,spatial-relational,2|3,7,2/3,230389,2
2,2,23,390,1,1147,1,9,4,4,5,single-choice,spatial-relational,4|5,7,4/5,230390,4
2,2,23,391,1,2533,1,11,5,5,6,single-choice,spatial-relational,5|6,7,5/6,230391,5
2,2,23,392,1,1322,1,3,1,1,2,single-choice,spatial-relational,1|2,7,1/2,230392,1
2,2,23,393,1,1337,1,9,4,4,5,single-choice,spatial-relational,4|5,7,4/5,230393,4
2,2,23,394,0,1611,1,5,2,3,3,single-choice,spatial-relational,2|3,7,2/3,230394,2
2,2,23,395,1,1550,1,3,1,1,2,single-choice,spatial-relational,1|2,7,1/2,230395,1
2,2,23,396,1,1108,1,7,3,3,4,single-choice,spatial-relational,3|4,7,3/4,230396,3
2,2,23,397,1,1704,1,11,5,5,6,single-choice,spatial-relational,5|6,7,5/6,230397,5
2,2,23,398,1,1478,1,3,1,1,2,single-choice,spatial-relational,1|2,7,1/2,230398,1
2,2,23,399,0,1455,1,3,1,2,2,single-choice,spatial-relational,1|2,7,1/2,230399,1
2,2,23,400,1,1148,1,7,3,3,4,single-choice,spatial-relational,3|4,7,3/4,230400,3
2,2,23,401,1,1596,1,5,2,2,3,single-choice,spatial-relational,2|3,7,2/3,230401,2
2,2,23,402,1,1686,1,5,2,2,3,single-choice,spatial-relational,2|3,7,2/3,230402,2
2,2,23,403,1,1471,1,9,4,4,5,single-choice,spatial-relational,4|5,7,4/5,230403,4
2,2,23,404,1,1240,1,13,6,6,7,single-choice,spatial-relational,6|7,7,6/7,230404,6
2,2,23,405,1,1204,1,13,6,6,7,single-choice,spatial-relational,6|7,7,6/7,230405,6
2,2,23,406,0,1553,1,11,5,6,6,single-choice,spatial-relational,5|6,7,5/6,230406,5
2,2,23,407,1,1032,1,7,3,3,4,single-choice,spatial-relational,3|4,7,3/4,230407,3
2,2,23,408,1,1772,1,9,4,4,5,single-choice,spatial-relational,4|5,7,4/5,230408,4
2,2,23,409,0,1368,1,9,4,5,5,single-choice,spatial-relational,4|5,7,4/5,230409,4
2,2,23,410,1,813,1,7,3,3,4,single-choice,spatial-relational,3|4,7,3/4,230410,3
2,2,23,411,0,1502,1,11,5,6,6,single-choice,spatial-relational,5|6,7,5/6,230411,5
2,2,23,412,0,944,1,5,2,3,3,single-choice,spatial-relational,2|3,7,2/3,230412,2
2,2,23,413,1,1481,1,7,3,3,4,single-choice,spatial-relational,3|4,7,3/4,230413,3
2,2,23,414,1,1458,1,5,2,2,3,single-choice,spatial-relational,2|3,7,2/3,230414,2
2,2,23,415,1,1079,1,3,1,1,2,single-choice,spatial-relational,1|2,7,1/2,230415,1
2,2,23,416,1,1368,1,11,5,5,6,single-choice,spatial-relational,5|6,7,5/6,230416,5
2,2,23,417,1,906,1,13,6,6,7,single-choice,spatial-relational,6|7,7,6/7,230417,6
2,2,23,418,0,1389,1,3,1,2,2,single-choice,spatial-relational,1|2,7,1/2,230418,1
2,2,23,419,1,1357,1,9,4,4,5,single-choice,spatial-relational,4|5,7,4/5,230419,4
2,2,23,420,1,1089,1,13,6,6,7,single-choice,spatial-relational,6|7,7,6/7,230420,6
2,2,23,421,1,1320,1,3,1,1,2,single-choice,spatial-relational,1|2,7,1/2,230421,1
2,2,23,422,1,951,1,3,1,1,2,single-choice,spatial-relational,1|2,7,1/2,230422,1
2,2,23,423,0,1352,1,5,2,3,3,single-choice,spatial-relational,2|3,7,2/3,230423,2
2,2,23,424,0,1438,1,9,4,5,5,single-choice,spatial-relational,4|5,7,4/5,230424,4
2,2,23,425,1,1022,1,7,3,3,4,single-choice,spatial-relational,3|4,7,3/4,230425,3
2,2,23,426,1,1257,1,9,4,4,5,single-choice,spatial-relational,4|5,7,4/5,230426,4
2,2,23,427,1,1462,1,11,5,5,6,single-choice,spatial-relational,5|6,7,5/6,230427,5
2,2,23,428,0,1250,1,11,5,6,6,single-choice,spatial-relational,5|6,7,5/6,230428,5
2,2,23,429,1,1355,1,7,3,3,4,single-choice,spatial-relational,3|4,7,3/4,230429,3
2,2,23,430,1,1008,1,13,6,6,7,single-choice,spatial-relational,6|7,7,6/7,230430,6
2,2,23,431,0,2639,1,5,2,3,3,single-choice,spatial-relational,2|3,7,2/3,230431,2
2,2,23,432,1,846,1,13,6,6,7,single-choice,spatial-relational,6|7,7,6/7,230432,6
2,2,23,433,1,1681,1,5,2,2,3,single-choice,spatial-relational,2|3,7,2/3,230433,2
2,2,23,434,1,1818,1,7,3,3,4,single-choice,spatial-relational,3|4,7,3/4,230434,3
2,2,23,435,1,1277,1,13,6,6,7,single-choice,spatial-relational,6|7,7,6/7,230435,6
2,2,23,436,1,1035,1,13,6,6,7,single-choice,spatial-relational,6|7,7,6/7,230436,6
2,2,23,437,1,1300,1,3,1,1,2,single-choice,spatial-relational,1|2,7,1/2,230437,1
2,2,23,438,1,1475,1,9,4,4,5,single-choice,spatial-relational,4|5,7,4/5,230438,4
2,2,23,439,1,1788,1,11,5,5,6,single-choice,spatial-relational,5|6,7,5/6,230439,5
2,2,23,440,1,1681,1,3,1,1,2,single-choice,spatial-relational,1|2,7,1/2,230440,1
2,2,23,441,1,1044,1,7,3,3,4,single-choice,spatial-relational,3|4,7,3/4,230441,3
2,2,23,442,1,1777,1,5,2,2,3,single-choice,spatial-relational,2|3,7,2/3,230442,2
2,2,23,443,1,1377,1,11,5,5,6,single-choice,spatial-relational,5|6,7,5/6,230443,5
2,2,23,444,1,1515,1,9,4,4,5,single-choice,spatial-relational,4|5,7,4/5,230444,4
2,2,23,445,1,1551,1,11,5,5,6,single-choice,spatial-relational,5|6,7,5/6,230445,5
2,2,23,446,1,1448,1,5,2,2,3,single-choice,spatial-relational,2|3,7,2/3,230446,2
2,2,23,447,1,1238,1,13,6,6,7,single-choice,spatial-relational,6|7,7,6/7,230447,6
2,2,23,448,1,2002,1,7,3,3,4,single-choice,spatial-relational,3|4,7,3/4,230448,3
2,2,23,449,0,1087,1,3,1,2,2,single-choice,spatial-relational,1|2,7,1/2,230449,1
2,2,23,450,1,1190,1,7,3,3,4,single-choice,spatial-relational,3|4,7,3/4,230450,3
2,2,23,451,0,1598,1,9,4,5,5,single-choice,spatial-relational,4|5,7,4/5,230451,4
2,2,23,452,1,1669,1,3,1,1,2,single-choice,spatial-relational,1|2,7,1/2,230452,1
2,2,23,453,1,1221,1,11,5,5,6,single-choice,spatial-relational,5|6,7,5/6,230453,5
2,2,23,454,0,1396,1,5,2,3,3,single-choice,spatial-relational,2|3,7,2/3,230454,2
2,2,23,455,1,802,1,13,6,6,7,single-choice,spatial-relational,6|7,7,6/7,230455,6
2,2,23,456,1,1134,1,9,4,4,5,single-choice,spatial-relational,4|5,7,4/5,230456,4
2,2,23,457,1,1303,1,11,5,5,6,single-choice,spatial-relational,5|6,7,5/6,230457,5
2,2,23,458,1,1704,1,9,4,4,5,single-choice,spatial-relational,4|5,7,4/5,230458,4
2,2,23,459,1,1592,1,5,2,2,3,single-choice,spatial-relational,2|3,7,2/3,230459,2
2,2,23,460,1,886,1,5,2,2,3,single-choice,spatial-relational,2|3,7,2/3,230460,2
2,2,23,461,1,1364,1,7,3,3,4,single-choice,spatial-relational,3|4,7,3/4,230461,3
2,2,23,462,1,1267,1,9,4,4,5,single-choice,spatial-relational,4|5,7,4/5,230462,4
2,2,23,463,1,1911,1,7,3,3,4,single-choice,spatial-relational,3|4,7,3/4,230463,3
2,2,23,464,1,1060,1,13,6,6,7,single-choice,spatial-relational,6|7,7,6/7,230464,6
2,2,23,465,1,1176,1,3,1,1,2,single-choice,spatial-relational,1|2,7,1/2,230465,1
2,2,23,466,1,1517,1,11,5,5,6,single-choice,spatial-relational,5|6,7,5/6,230466,5
2,2,23,467,1,1196,1,3,1,1,2,single-choice,spatial-relational,1|2,7,1/2,230467,1
2,2,23,468,1,883,1,13,6,6,7,single-choice,spatial-relational,6|7,7,6/7,230468,6
2,2,23,469,1,1194,1,7,3,3,4,single-choice,spatial-relational,3|4,7,3/4,230469,3
2,2,23,470,1,1427,1,5,2,2,3,single-choice,spatial-relational,2|3,7,2/3,230470,2
2,2,23,471,1,1223,1,5,2,2,3,single-choice,spatial-relational,2|3,7,2/3,230471,2
2,2,23,472,1,1112,1,7,3,3,4,single-choice,spatial-relational,3|4,7,3/4,230472,3
2,2,23,473,1,936,1,3,1,1,2,single-choice,spatial-relational,1|2,7,1/2,230473,1
2,2,23,474,0,1064,1,9,4,5,5,single-choice,spatial-relational,4|5,7,4/5,230474,4
2,2,23,475,0,848,1,9,4,5,5,single-choice,spatial-relational,4|5,7,4/5,230475,4
2,2,23,476,1,854,1,13,6,6,7,single-choice,spatial-relational,6|7,7,6/7,230476,6
2,2,23,477,1,1710,1,13,6,6,7,single-choice,spatial-relational,6|7,7,6/7,230477,6
2,2,23,478,1,1048,1,3,1,1,2,single-choice,spatial-relational,1|2,7,1/2,230478,1
2,2,23,479,1,1518,1,11,5,5,6,single-choice,spatial-relational,5|6,7,5/6,230479,5
2,2,23,480,1,1181,1,11,5,5,6,single-choice,spatial-relational,5|6,7,5/6,230480,5
2,2,23,481,1,1427,1,3,1,1,2,single-choice,spatial-relational,1|2,7,1/2,230481,1
2,2,23,482,1,889,1,13,6,6,7,single-choice,spatial-relational,6|7,7,6/7,230482,6
2,2,23,483,1,951,1,13,6,6,7,single-choice,spatial-relational,6|7,7,6/7,230483,6
2,2,23,484,1,1155,1,11,5,5,6,single-choice,spatial-relational,5|6,7,5/6,230484,5
2,2,23,485,1,1467,1,11,5,5,6,single-choice,spatial-relational,5|6,7,5/6,230485,5
2,2,23,486,1,1451,1,9,4,4,5,single-choice,spatial-relational,4|5,7,4/5,230486,4
2,2,23,487,1,1550,1,9,4,4,5,single-choice,spatial-relational,4|5,7,4/5,230487,4
2,2,23,488,1,1336,1,7,3,3,4,single-choice,spatial-relational,3|4,7,3/4,230488,3
2,2,23,489,1,1480,1,7,3,3,4,single-choice,spatial-relational,3|4,7,3/4,230489,3
2,2,23,490,1,1308,1,5,2,2,3,single-choice,spatial-relational,2|3,7,2/3,230490,2
2,2,23,491,1,996,1,3,1,1,2,single-choice,spatial-relational,1|2,7,1/2,230491,1
2,2,23,492,1,1353,1,5,2,2,3,single-choice,spatial-relational,2|3,7,2/3,230492,2
2,2,23,493,1,1077,1,7,3,3,4,single-choice,spatial-relational,3|4,7,3/4,230493,3
2,2,23,494,1,1437,1,11,5,5,6,single-choice,spatial-relational,5|6,7,5/6,230494,5
2,2,23,495,1,1597,1,5,2,2,3,single-choice,spatial-relational,2|3,7,2/3,230495,2
2,2,23,496,1,925,1,13,6,6,7,single-choice,spatial-relational,6|7,7,6/7,230496,6
2,2,23,497,1,1243,1,5,2,2,3,single-choice,spatial-relational,2|3,7,2/3,230497,2
2,2,23,498,1,1847,1,7,3,3,4,single-choice,spatial-relational,3|4,7,3/4,230498,3
2,2,23,499,1,1410,1,9,4,4,5,single-choice,spatial-relational,4|5,7,4/5,230499,4
2,2,23,500,1,1249,1,9,4,4,5,single-choice,spatial-relational,4|5,7,4/5,230500,4
2,2,23,501,1,1502,1,11,5,5,6,single-choice,spatial-relational,5|6,7,5/6,230501,5
2,2,23,502,1,1083,1,3,1,1,2,single-choice,spatial-relational,1|2,7,1/2,230502,1
2,2,23,503,1,781,1,13,6,6,7,single-choice,spatial-relational,6|7,7,6/7,230503,6
2,2,23,504,1,1227,1,3,1,1,2,single-choice,spatial-relational,1|2,7,1/2,230504,1
2,2,23,505,1,988,1,13,6,6,7,single-choice,spatial-relational,6|7,7,6/7,230505,6
2,2,23,506,1,1695,1,9,4,4,5,single-choice,spatial-relational,4|5,7,4/5,230506,4
2,2,23,507,0,1475,1,9,4,5,5,single-choice,spatial-relational,4|5,7,4/5,230507,4
2,2,23,508,1,990,1,7,3,3,4,single-choice,spatial-relational,3|4,7,3/4,230508,3
2,2,23,509,1,1401,1,7,3,3,4,single-choice,spatial-relational,3|4,7,3/4,230509,3
2,2,23,510,0,76437,1,5,2,3,3,single-choice,spatial-relational,2|3,7,2/3,230510,2
2,2,23,511,1,1557,1,5,2,2,3,single-choice,spatial-relational,2|3,7,2/3,230511,2
2,2,23,512,1,966,1,3,1,1,2,single-choice,spatial-relational,1|2,7,1/2,230512,1
2,2,23,513,1,1432,1,11,5,5,6,single-choice,spatial-relational,5|6,7,5/6,230513,5
2,2,23,514,1,1397,1,11,5,5,6,single-choice,spatial-relational,5|6,7,5/6,230514,5
2,2,23,515,1,1068,1,3,1,1,2,single-choice,spatial-relational,1|2,7,1/2,230515,1
2,2,23,516,1,880,1,13,6,6,7,single-choice,spatial-relational,6|7,7,6/7,230516,6
2,2,23,517,0,910,1,9,4,5,5,single-choice,spatial-relational,4|5,7,4/5,230517,4
2,2,23,518,1,1480,1,5,2,2,3,single-choice,spatial-relational,2|3,7,2/3,230518,2
2,2,23,519,0,1102,1,7,3,4,4,single-choice,spatial-relational,3|4,7,3/4,230519,3
2,2,23,520,0,869,1,11,5,6,6,single-choice,spatial-relational,5|6,7,5/6,230520,5
2,2,23,521,0,51,1,5,2,3,3,single-choice,spatial-relational,2|3,7,2/3,230521,2
2,2,23,522,1,1030,1,11,5,5,6,single-choice,spatial-relational,5|6,7,5/6,230522,5
2,2,23,523,1,1513,1,13,6,6,7,single-choice,spatial-relational,6|7,7,6/7,230523,6
2,2,23,524,1,1488,1,3,1,1,2,single-choice,spatial-relational,1|2,7,1/2,230524,1
2,2,23,525,1,942,1,13,6,6,7,single-choice,spatial-relational,6|7,7,6/7,230525,6
2,2,23,526,1,966,1,3,1,1,2,single-choice,spatial-relational,1|2,7,1/2,230526,1
2,2,23,527,0,1177,1,9,4,5,5,single-choice,spatial-relational,4|5,7,4/5,230527,4
2,2,23,528,1,930,1,7,3,3,4,single-choice,spatial-relational,3|4,7,3/4,230528,3
2,2,23,529,1,1102,1,9,4,4,5,single-choice,spatial-relational,4|5,7,4/5,230529,4
2,2,23,530,1,1003,1,13,6,6,7,single-choice,spatial-relational,6|7,7,6/7,230530,6
2,2,23,531,1,1344,1,11,5,5,6,single-choice,spatial-relational,5|6,7,5/6,230531,5
2,2,23,532,1,1516,1,7,3,3,4,single-choice,spatial-relational,3|4,7,3/4,230532,3
2,2,23,533,1,1447,1,9,4,4,5,single-choice,spatial-relational,4|5,7,4/5,230533,4
2,2,23,534,0,1295,1,3,1,2,2,single-choice,spatial-relational,1|2,7,1/2,230534,1
2,2,23,535,1,949,1,7,3,3,4,single-choice,spatial-relational,3|4,7,3/4,230535,3
2,2,23,536,0,1263,1,5,2,3,3,single-choice,spatial-relational,2|3,7,2/3,230536,2
2,2,23,537,0,968,1,11,5,6,6,single-choice,spatial-relational,5|6,7,5/6,230537,5
2,2,23,538,1,1008,1,13,6,6,7,single-choice,spatial-relational,6|7,7,6/7,230538,6
2,2,23,539,0,1702,1,5,2,3,3,single-choice,spatial-relational,2|3,7,2/3,230539,2
2,2,23,540,1,1291,1,3,1,1,2,single-choice,spatial-relational,1|2,7,1/2,230540,1
2,2,23,541,1,855,1,13,6,6,7,single-choice,spatial-relational,6|7,7,6/7,230541,6
2,2,23,542,1,1394,1,9,4,4,5,single-choice,spatial-relational,4|5,7,4/5,230542,4
2,2,23,543,0,1544,1,9,4,5,5,single-choice,spatial-relational,4|5,7,4/5,230543,4
2,2,23,544,1,954,1,3,1,1,2,single-choice,spatial-relational,1|2,7,1/2,230544,1
2,2,23,545,1,1068,1,7,3,3,4,single-choice,spatial-relational,3|4,7,3/4,230545,3
2,2,23,546,1,849,1,13,6,6,7,single-choice,spatial-relational,6|7,7,6/7,230546,6
2,2,23,547,1,1056,1,5,2,2,3,single-choice,spatial-relational,2|3,7,2/3,230547,2
2,2,23,548,1,1029,1,11,5,5,6,single-choice,spatial-relational,5|6,7,5/6,230548,5
2,2,23,549,1,1002,1,3,1,1,2,single-choice,spatial-relational,1|2,7,1/2,230549,1
2,2,23,550,1,1831,1,7,3,3,4,single-choice,spatial-relational,3|4,7,3/4,230550,3
2,2,23,551,0,1540,1,5,2,3,3,single-choice,spatial-relational,2|3,7,2/3,230551,2
2,2,23,552,0,1094,1,11,5,6,6,single-choice,spatial-relational,5|6,7,5/6,230552,5
2,2,23,553,1,813,1,13,6,6,7,single-choice,spatial-relational,6|7,7,6/7,230553,6
2,2,23,554,1,1492,1,7,3,3,4,single-choice,spatial-relational,3|4,7,3/4,230554,3
2,2,23,555,1,1133,1,3,1,1,2,single-choice,spatial-relational,1|2,7,1/2,230555,1
2,2,23,556,1,1621,1,9,4,4,5,single-choice,spatial-relational,4|5,7,4/5,230556,4
2,2,23,557,0,1532,1,7,3,4,4,single-choice,spatial-relational,3|4,7,3/4,230557,3
3,2,23,1,1,1442,1,3,1,1,2,single-choice,spatial-relational,1|2,7,1/2,230001,1
3,2,23,2,0,16,1,11,5,6,6,single-choice,spatial-relational,5|6,7,5/6,230002,5
3,2,23,3,1,1273,1,9,4,4,5,single-choice,spatial-relational,4|5,7,4/5,230003,4
3,2,23,4,1,1132,1,11,5,5,6,single-choice,spatial-relational,5|6,7,5/6,230004,5
3,2,23,5,0,1235,1,5,2,3,3,single-choice,spatial-relational,2|3,7,2/3,230005,2
3,2,23,6,1,56,1,9,4,4,5,single-choice,spatial-relational,4|5,7,4/5,230006,4
3,2,23,7,1,1370,1,5,2,2,3,single-choice,spatial-relational,2|3,7,2/3,230007,2
3,2,23,8,1,1345,1,3,1,1,2,single-choice,spatial-relational,1|2,7,1/2,230008,1
3,2,23,9,0,1234,1,7,3,4,4,single-choice,spatial-relational,3|4,7,3/4,230009,3
3,2,23,10,1,1260,1,13,6,6,7,single-choice,spatial-relational,6|7,7,6/7,230010,6
3,2,23,11,1,1799,1,7,3,3,4,single-choice,spatial-relational,3|4,7,3/4,230011,3
3,2,23,12,1,1317,1,13,6,6,7,single-choice,spatial-relational,6|7,7,6/7,230012,6
3,2,23,13,0,1901,1,7,3,4,4,single-choice,spatial-relational,3|4,7,3/4,230013,3
3,2,23,14,1,784,1,11,5,5,6,single-choice,spatial-relational,5|6,7,5/6,230014,5
3,2,23,15,0,1935,1,5,2,3,3,single-choice,spatial-relational,2|3,7,2/3,230015,2
3,2,23,16,0,612,1,13,6,7,7,single-choice,spatial-relational,6|7,7,6/7,230016,6
3,2,23,17,1,853,1,9,4,4,5,single-choice,spatial-relational,4|5,7,4/5,230017,4
3,2,23,18,1,1170,1,3,1,1,2,single-choice,spatial-relational,1|2,7,1/2,230018,1
3,2,23,19,1,1065,1,3,1,1,2,single-choice,spatial-relational,1|2,7,1/2,230019,1
3,2,23,20,0,1193,1,7,3,4,4,single-choice,spatial-relational,3|4,7,3/4,230020,3
3,2,23,21,1,885,1,13,6,6,7,single-choice,spatial-relational,6|7,7,6/7,230021,6
3,2,23,22,0,1658,1,9,4,5,5,single-choice,spatial-relational,4|5,7,4/5,230022,4
3,2,23,23,1,950,1,5,2,2,3,single-choice,spatial-relational,2|3,7,2/3,230023,2
3,2,23,24,1,1657,1,11,5,5,6,single-choice,spatial-relational,5|6,7,5/6,230024,5
3,2,23,25,1,2264,1,9,4,4,5,single-choice,spatial-relational,4|5,7,4/5,230025,4
3,2,23,26,1,1371,1,5,2,2,3,single-choice,spatial-relational,2|3,7,2/3,230026,2
3,2,23,27,1,1558,1,11,5,5,6,single-choice,spatial-relational,5|6,7,5/6,230027,5
3,2,23,28,0,1374,1,7,3,4,4,single-choice,spatial-relational,3|4,7,3/4,230028,3
3,2,23,29,1,1170,1,3,1,1,2,single-choice,spatial-relational,1|2,7,1/2,230029,1
3,2,23,30,1,1103,1,7,3,3,4,single-choice,spatial-relational,3|4,7,3/4,230030,3
3,2,23,31,1,961,1,13,6,6,7,single-choice,spatial-relational,6|7,7,6/7,230031,6
3,2,23,32,0,1974,1,9,4,5,5,single-choice,spatial-relational,4|5,7,4/5,230032,4
3,2,23,33,0,1566,1,5,2,3,3,single-choice,spatial-relational,2|3,7,2/3,230033,2
3,2,23,34,1,1039,1,3,1,1,2,single-choice,spatial-relational,1|2,7,1/2,230034,1
3,2,23,35,1,1079,1,11,5,5,6,single-choice,spatial-relational,5|6,7,5/6,230035,5
3,2,23,36,1,2002,1,13,6,6,7,single-choice,spatial-relational,6|7,7,6/7,230036,6
3,2,23,37,1,1430,1,5,2,2,3,single-choice,spatial-relational,2|3,7,2/3,230037,2
3,2,23,38,1,1354,1,5,2,2,3,single-choice,spatial-relational,2|3,7,2/3,230038,2
3,2,23,39,1,1247,1,11,5,5,6,single-choice,spatial-relational,5|6,7,5/6,230039,5
3,2,23,40,0,2356,1,9,4,5,5,single-choice,spatial-relational,4|5,7,4/5,230040,4
3,2,23,41,1,912,1,7,3,3,4,single-choice,spatial-relational,3|4,7,3/4,230041,3
3,2,23,42,0,1427,1,11,5,6,6,single-choice,spatial-relational,5|6,7,5/6,230042,5
3,2,23,43,1,1110,1,9,4,4,5,single-choice,spatial-relational,4|5,7,4/5,230043,4
3,2,23,44,1,1573,1,7,3,3,4,single-choice,spatial-relational,3|4,7,3/4,230044,3
3,2,23,45,1,1086,1,13,6,6,7,single-choice,spatial-relational,6|7,7,6/7,230045,6
3,2,23,46,1,1271,1,3,1,1,2,single-choice,spatial-relational,1|2,7,1/2,230046,1
3,2,23,47,1,811,1,13,6,6,7,single-choice,spatial-relational,6|7,7,6/7,230047,6
3,2,23,48,1,1894,1,3,1,1,2,single-choice,spatial-relational,1|2,7,1/2,230048,1
3,2,23,49,0,1390,1,5,2,3,3,single-choice,spatial-relational,2|3,7,2/3,230049,2
3,2,23,50,1,768,1,13,6,6,7,single-choice,spatial-relational,6|7,7,6/7,230050,6
3,2,23,51,1,1654,1,11,5,5,6,single-choice,spatial-relational,5|6,7,5/6,230051,5
3,2,23,52,1,1546,1,5,2,2,3,single-choice,spatial-relational,2|3,7,2/3,230052,2
3,2,23,53,1,1583,1,3,1,1,2,single-choice,spatial-relational,1|2,7,1/2,230053,1
3,2,23,54,1,765,1,13,6,6,7,single-choice,spatial-relational,6|7,7,6/7,230054,6
3,2,23,55,1,2033,1,7,3,3,4,single-choice,spatial-relational,3|4,7,3/4,230055,3
3,2,23,56,1,1496,1,3,1,1,2,single-choice,spatial-relational,1|2,7,1/2,230056,1
3,2,23,57,1,644,1,9,4,4,5,single-choice,spatial-relational,4|5,7,4/5,230057,4
3,2,23,58,1,3296,1,11,5,5,6,single-choice,spatial-relational,5|6,7,5/6,230058,5
3,2,23,59,1,3443,1,7,3,3,4,single-choice,spatial-relational,3|4,7,3/4,230059,3
3,2,23,60,0,1146,1,9,4,5,5,single-choice,spatial-relational,4|5,7,4/5,230060,4
3,2,23,61,0,44,1,3,1,2,2,single-choice,spatial-relational,1|2,7,1/2,230061,1
3,2,23,62,1,1163,1,5,2,2,3,single-choice,spatial-relational,2|3,7,2/3,230062,2
3,2,23,63,1,1408,1,11,5,5,6,single-choice,spatial-relational,5|6,7,5/6,230063,5
3,2,23,64,1,1120,1,13,6,6,7,single-choice,spatial-relational,6|7,7,6/7,230064,6
3,2,23,65,1,1808,1,9,4,4,5,single-choice,spatial-relational,4|5,7,4/5,230065,4
3,2,23,66,1,1176,1,13,6,6,7,single-choice,spatial-relational,6|7,7,6/7,230066,6
3,2,23,67,1,1142,1,5,2,2,3,single-choice,spatial-relational,2|3,7,2/3,230067,2
3,2,23,68,0,889,1,9,4,5,5,single-choice,spatial-relational,4|5,7,4/5,230068,4
3,2,23,69,1,1349,1,11,5,5,6,single-choice,spatial-relational,5|6,7,5/6,230069,5
3,2,23,70,1,1000,1,3,1,1,2,single-choice,spatial-relational,1|2,7,1/2,230070,1
3,2,23,71,1,1188,1,7,3,3,4,single-choice,spatial-relational,3|4,7,3/4,230071,3
3,2,23,72,1,1292,1,7,3,3,4,single-choice,spatial-relational,3|4,7,3/4,230072,3
3,2,23,73,1,1387,1,13,6,6,7,single-choice,spatial-relational,6|7,7,6/7,230073,6
3,2,23,74,1,1319,1,3,1,1,2,single-choice,spatial-relational,1|2,7,1/2,230074,1
3,2,23,75,1,1046,1,7,3,3,4,single-choice,spatial-relational,3|4,7,3/4,230075,3
3,2,23,76,1,920,1,11,5,5,6,single-choice,spatial-relational,5|6,7,5/6,230076,5
3,2,23,77,1,9214,1,3,1,1,2,single-choice,spatial-relational,1|2,7,1/2,230077,1
3,2,23,78,0,1240,1,5,2,3,3,single-choice,spatial-relational,2|3,7,2/3,230078,2
3,2,23,79,1,1443,1,5,2,2,3,single-choice,spatial-relational,2|3,7,2/3,230079,2
3,2,23,80,1,1696,1,7,3,3,4,single-choice,spatial-relational,3|4,7,3/4,230080,3
3,2,23,81,1,1398,1,9,4,4,5,single-choice,spatial-relational,4|5,7,4/5,230081,4
3,2,23,82,1,1467,1,13,6,6,7,single-choice,spatial-relational,6|7,7,6/7,230082,6
3,2,23,83,1,1554,1,11,5,5,6,single-choice,spatial-relational,5|6,7,5/6,230083,5
3,2,23,84,1,1804,1,9,4,4,5,single-choice,spatial-relational,4|5,7,4/5,230084,4
3,2,23,85,1,1144,1,5,2,2,3,single-choice,spatial-relational,2|3,7,2/3,230085,2
3,2,23,86,1,950,1,3,1,1,2,single-choice,spatial-relational,1|2,7,1/2,230086,1
3,2,23,87,0,880,1,9,4,5,5,single-choice,spatial-relational,4|5,7,4/5,230087,4
3,2,23,88,0,925,1,11,5,6,6,single-choice,spatial-relational,5|6,7,5/6,230088,5
3,2,23,89,1,1178,1,11,5,5,6,single-choice,spatial-relational,5|6,7,5/6,230089,5
3,2,23,90,1,1293,1,9,4,4,5,single-choice,spatial-relational,4|5,7,4/5,230090,4
3,2,23,91,1,984,1,5,2,2,3,single-choice,spatial-relational,2|3,7,2/3,230091,2
3,2,23,92,1,1052,1,3,1,1,2,single-choice,spatial-relational,1|2,7,1/2,230092,1
3,2,23,93,1,952,1,13,6,6,7,single-choice,spatial-relational,6|7,7,6/7,230093,6
3,2,23,94,0,1821,1,7,3,4,4,single-choice,spatial-relational,3|4,7,3/4,230094,3
3,2,23,95,1,4327,1,13,6,6,7,single-choice,spatial-relational,6|7,7,6/7,230095,6
3,2,23,96,0,1816,1,7,3,4,4,single-choice,spatial-relational,3|4,7,3/4,230096,3
3,2,23,97,0,985,1,5,2,3,3,single-choice,spatial-relational,2|3,7,2/3,230097,2
3,2,23,98,1,2014,1,11,5,5,6,single-choice,spatial-relational,5|6,7,5/6,230098,5
3,2,23,99,1,2200,1,7,3,3,4,single-choice,spatial-relational,3|4,7,3/4,230099,3
3,2,23,100,1,1819,1,11,5,5,6,single-choice,spatial-relational,5|6,7,5/6,230100,5
3,2,23,101,0,1324,1,7,3,4,4,single-choice,spatial-relational,3|4,7,3/4,230101,3
3,2,23,102,1,997,1,5,2,2,3,single-choice,spatial-relational,2|3,7,2/3,230102,2
3,2,23,103,1,848,1,13,6,6,7,single-choice,spatial-relational,6|7,7,6/7,230103,6
3,2,23,104,1,1078,1,3,1,1,2,single-choice,spatial-relational,1|2,7,1/2,230104,1
3,2,23,105,0,1419,1,9,4,5,5,single-choice,spatial-relational,4|5,7,4/5,230105,4
3,2,23,106,1,887,1,13,6,6,7,single-choice,spatial-relational,6|7,7,6/7,230106,6
3,2,23,107,0,1972,1,9,4,5,5,single-choice,spatial-relational,4|5,7,4/5,230107,4
3,2,23,108,1,1096,1,3,1,1,2,single-choice,spatial-relational,1|2,7,1/2,230108,1
3,2,23,109,1,1442,1,13,6,6,7,single-choice,spatial-relational,6|7,7,6/7,230109,6
3,2,23,110,1,2487,1,5,2,2,3,single-choice,spatial-relational,2|3,7,2/3,230110,2
3,2,23,111,1,1100,1,7,3,3,4,single-choice,spatial-relational,3|4,7,3/4,230111,3
3,2,23,112,1,968,1,13,6,6,7,single-choice,spatial-relational,6|7,7,6/7,230112,6
3,2,23,113,1,1128,1,3,1,1,2,single-choice,spatial-relational,1|2,7,1/2,230113,1
3,2,23,114,1,1168,1,7,3,3,4,single-choice,spatial-relational,3|4,7,3/4,230114,3
3,2,23,115,1,1450,1,9,4,4,5,single-choice,spatial-relational,4|5,7,4/5,230115,4
3,2,23,116,1,1190,1,3,1,1,2,single-choice,spatial-relational,1|2,7,1/2,230116,1
3,2,23,117,1,943,1,9,4,4,5,single-choice,spatial-relational,4|5,7,4/5,230117,4
3,2,23,118,1,1771,1,11,5,5,6,single-choice,spatial-relational,5|6,7,5/6,230118,5
3,2,23,119,1,1876,1,11,5,5,6,single-choice,spatial-relational,5|6,7,5/6,230119,5
3,2,23,120,1,1173,1,5,2,2,3,single-choice,spatial-relational,2|3,7,2/3,230120,2
3,2,23,121,1,2043,1,11,5,5,6,single-choice,spatial-relational,5|6,7,5/6,230121,5
3,2,23,122,1,1422,1,11,5,5,6,single-choice,spatial-relational,5|6,7,5/6,230122,5
3,2,23,123,1,1099,1,3,1,1,2,single-choice,spatial-relational,1|2,7,1/2,230123,1
3,2,23,124,1,952,1,3,1,1,2,single-choice,spatial-relational,1|2,7,1/2,230124,1
3,2,23,125,1,832,1,13,6,6,7,single-choice,spatial-relational,6|7,7,6/7,230125,6
3,2,23,126,1,2034,1,9,4,4,5,single-choice,spatial-relational,4|5,7,4/5,230126,4
3,2,23,127,1,2112,1,5,2,2,3,single-choice,spatial-relational,2|3,7,2/3,230127,2
3,2,23,128,1,1264,1,13,6,6,7,single-choice,spatial-relational,6|7,7,6/7,230128,6
3,2,23,129,1,1343,1,7,3,3,4,single-choice,spatial-relational,3|4,7,3/4,230129,3
3,2,23,130,1,1528,1,9,4,4,5,single-choice,spatial-relational,4|5,7,4/5,230130,4
3,2,23,131,1,1310,1,7,3,3,4,single-choice,spatial-relational,3|4,7,3/4,230131,3
3,2,23,132,1,1472,1,5,2,2,3,single-choice,spatial-relational,2|3,7,2/3,230132,2
3,2,23,133,1,1009,1,11,5,5,6,single-choice,spatial-relational,5|6,7,5/6,230133,5
3,2,23,134,1,1129,1,3,1,1,2,single-choice,spatial-relational,1|2,7,1/2,230134,1
3,2,23,135,1,752,1,13,6,6,7,single-choice,spatial-relational,6|7,7,6/7,230135,6
3,2,23,136,1,1663,1,3,1,1,2,single-choice,spatial-relational,1|2,7,1/2,230136,1
3,2,23,137,1,980,1,9,4,4,5,single-choice,spatial-relational,4|5,7,4/5,230137,4
3,2,23,138,1,1488,1,13,6,6,7,single-choice,spatial-relational,6|7,7,6/7,230138,6
3,2,23,139,1,2423,1,9,4,4,5,single-choice,spatial-relational,4|5,7,4/5,230139,4
3,2,23,140,0,2828,1,7,3,4,4,single-choice,spatial-relational,3|4,7,3/4,230140,3
3,2,23,141,1,1121,1,5,2,2,3,single-choice,spatial-relational,2|3,7,2/3,230141,2
3,2,23,142,1,1688,1,5,2,2,3,single-choice,spatial-relational,2|3,7,2/3,230142,2
3,2,23,143,0,158399,1,11,5,6,6,single-choice,spatial-relational,5|6,7,5/6,230143,5
3,2,23,144,0,957,1,7,3,4,4,single-choice,spatial-relational,3|4,7,3/4,230144,3
3,2,23,145,1,1299,1,7,3,3,4,single-choice,spatial-relational,3|4,7,3/4,230145,3
3,2,23,146,0,1577,1,5,2,3,3,single-choice,spatial-relational,2|3,7,2/3,230146,2
3,2,23,147,1,1325,1,3,1,1,2,single-choice,spatial-relational,1|2,7,1/2,230147,1
3,2,23,148,1,1479,1,7,3,3,4,single-choice,spatial-relational,3|4,7,3/4,230148,3
3,2,23,149,1,1427,1,5,2,2,3,single-choice,spatial-relational,2|3,7,2/3,230149,2
3,2,23,150,0,1197,1,9,4,5,5,single-choice,spatial-relational,4|5,7,4/5,230150,4
3,2,23,151,1,1011,1,9,4,4,5,single-choice,spatial-relational,4|5,7,4/5,230151,4
3,2,23,152,1,1289,1,13,6,6,7,single-choice,spatial-relational,6|7,7,6/7,230152,6
3,2,23,153,1,1335,1,11,5,5,6,single-choice,spatial-relational,5|6,7,5/6,230153,5
3,2,23,154,1,1228,1,11,5,5,6,single-choice,spatial-relational,5|6,7,5/6,230154,5
3,2,23,155,1,1953,1,3,1,1,2,single-choice,spatial-relational,1|2,7,1/2,230155,1
3,2,23,156,1,1056,1,13,6,6,7,single-choice,spatial-relational,6|7,7,6/7,230156,6
3,2,23,157,1,1431,1,11,5,5,6,single-choice,spatial-relational,5|6,7,5/6,230157,5
3,2,23,158,1,1079,1,3,1,1,2,single-choice,spatial-relational,1|2,7,1/2,230158,1
3,2,23,159,1,820,1,13,6,6,7,single-choice,spatial-relational,6|7,7,6/7,230159,6
3,2,23,160,1,1918,1,7,3,3,4,single-choice,spatial-relational,3|4,7,3/4,230160,3
3,2,23,161,0,1341,1,9,4,5,5,single-choice,spatial-relational,4|5,7,4/5,230161,4
3,2,23,162,1,794,1,13,6,6,7,single-choice,spatial-relational,6|7,7,6/7,230162,6
3,2,23,163,1,1288,1,5,2,2,3,single-choice,spatial-relational,2|3,7,2/3,230163,2
3,2,23,164,1,1571,1,7,3,3,4,single-choice,spatial-relational,3|4,7,3/4,230164,3
3,2,23,165,1,1234,1,9,4,4,5,single-choice,spatial-relational,4|5,7,4/5,230165,4
3,2,23,166,1,1043,1,5,2,2,3,single-choice,spatial-relational,2|3,7,2/3,230166,2
3,2,23,167,1,1418,1,11,5,5,6,single-choice,spatial-relational,5|6,7,5/6,230167,5
3,2,23,168,1,1698,1,3,1,1,2,single-choice,spatial-relational,1|2,7,1/2,230168,1
3,2,23,169,1,1255,1,9,4,4,5,single-choice,spatial-relational,4|5,7,4/5,230169,4
3,2,23,170,1,1595,1,5,2,2,3,single-choice,spatial-relational,2|3,7,2/3,230170,2
3,2,23,171,1,1075,1,9,4,4,5,single-choice,spatial-relational,4|5,7,4/5,230171,4
3,2,23,172,1,1735,1,7,3,3,4,single-choice,spatial-relational,3|4,7,3/4,230172,3
3,2,23,173,1,1041,1,13,6,6,7,single-choice,spatial-relational,6|7,7,6/7,230173,6
3,2,23,174,1,1757,1,7,3,3,4,single-choice,spatial-relational,3|4,7,3/4,230174,3
3,2,23,175,1,1442,1,11,5,5,6,single-choice,spatial-relational,5|6,7,5/6,230175,5
3,2,23,176,1,1340,1,5,2,2,3,single-choice,spatial-relational,2|3,7,2/3,230176,2
3,2,23,177,1,1439,1,11,5,5,6,single-choice,spatial-relational,5|6,7,5/6,230177,5
3,2,23,178,1,1051,1,3,1,1,2,single-choice,spatial-relational,1|2,7,1/2,230178,1
3,2,23,179,1,1176,1,3,1,1,2,single-choice,spatial-relational,1|2,7,1/2,230179,1
3,2,23,180,1,768,1,13,6,6,7,single-choice,spatial-relational,6|7,7,6/7,230180,6
3,2,23,181,1,1008,1,3,1,1,2,single-choice,spatial-relational,1|2,7,1/2,230181,1
3,2,23,182,1,930,1,9,4,4,5,single-choice,spatial-relational,4|5,7,4/5,230182,4
3,2,23,183,0,991,1,7,3,4,4,single-choice,spatial-relational,3|4,7,3/4,230183,3
3,2,23,184,1,770,1,13,6,6,7,single-choice,spatial-relational,6|7,7,6/7,230184,6
3,2,23,185,1,1377,1,13,6,6,7,single-choice,spatial-relational,6|7,7,6/7,230185,6
3,2,23,186,1,1734,1,9,4,4,5,single-choice,spatial-relational,4|5,7,4/5,230186,4
3,2,23,187,1,1488,1,5,2,2,3,single-choice,spatial-relational,2|3,7,2/3,230187,2
3,2,23,188,1,1338,1,11,5,5,6,single-choice,spatial-relational,5|6,7,5/6,230188,5
3,2,23,189,1,1470,1,3,1,1,2,single-choice,spatial-relational,1|2,7,1/2,230189,1
3,2,23,190,1,1295,1,5,2,2,3,single-choice,spatial-relational,2|3,7,2/3,230190,2
3,2,23,191,1,1368,1,7,3,3,4,single-choice,spatial-relational,3|4,7,3/4,230191,3
3,2,23,192,1,1281,1,11,5,5,6,single-choice,spatial-relational,5|6,7,5/6,230192,5
3,2,23,193,1,1672,1,7,3,3,4,single-choice,spatial-relational,3|4,7,3/4,230193,3
3,2,23,194,1,1086,1,13,6,6,7,single-choice,spatial-relational,6|7,7,6/7,230194,6
3,2,23,195,1,2240,1,7,3,3,4,single-choice,spatial-relational,3|4,7,3/4,230195,3
3,2,23,196,1,994,1,13,6,6,7,single-choice,spatial-relational,6|7,7,6/7,230196,6
3,2,23,197,0,1462,1,3,1,2,2,single-choice,spatial-relational,1|2,7,1/2,230197,1
3,2,23,198,1,1202,1,3,1,1,2,single-choice,spatial-relational,1|2,7,1/2,230198,1
3,2,23,199,1,1079,1,11,5,5,6,single-choice,spatial-relational,5|6,7,5/6,230199,5
3,2,23,200,1,1100,1,11,5,5,6,single-choice,spatial-relational,5|6,7,5/6,230200,5
3,2,23,201,1,1577,1,9,4,4,5,single-choice,spatial-relational,4|5,7,4/5,230201,4
3,2,23,202,0,1752,1,5,2,3,3,single-choice,spatial-relational,2|3,7,2/3,230202,2
3,2,23,203,1,1585,1,9,4,4,5,single-choice,spatial-relational,4|5,7,4/5,230203,4
3,2,23,204,1,1689,1,5,2,2,3,single-choice,spatial-relational,2|3,7,2/3,230204,2
3,2,23,205,1,786,1,13,6,6,7,single-choice,spatial-relational,6|7,7,6/7,230205,6
3,2,23,206,1,2038,1,11,5,5,6,single-choice,spatial-relational,5|6,7,5/6,230206,5
3,2,23,207,1,1306,1,9,4,4,5,single-choice,spatial-relational,4|5,7,4/5,230207,4
3,2,23,208,1,2503,1,7,3,3,4,single-choice,spatial-relational,3|4,7,3/4,230208,3
3,2,23,209,1,929,1,11,5,5,6,single-choice,spatial-relational,5|6,7,5/6,230209,5
3,2,23,210,1,1379,1,9,4,4,5,single-choice,spatial-relational,4|5,7,4/5,230210,4
3,2,23,211,1,1096,1,13,6,6,7,single-choice,spatial-relational,6|7,7,6/7,230211,6
3,2,23,212,1,1449,1,3,1,1,2,single-choice,spatial-relational,1|2,7,1/2,230212,1
3,2,23,213,1,1022,1,7,3,3,4,single-choice,spatial-relational,3|4,7,3/4,230213,3
3,2,23,214,1,1004,1,5,2,2,3,single-choice,spatial-relational,2|3,7,2/3,230214,2
3,2,23,215,1,1348,1,5,2,2,3,single-choice,spatial-relational,2|3,7,2/3,230215,2
3,2,23,216,1,1053,1,3,1,1,2,single-choice,spatial-relational,1|2,7,1/2,230216,1
3,2,23,217,1,1106,1,3,1,1,2,single-choice,spatial-relational,1|2,7,1/2,230217,1
3,2,23,218,0,1003,1,9,4,5,5,single-choice,spatial-relational,4|5,7,4/5,230218,4
3,2,23,219,1,1200,1,13,6,6,7,single-choice,spatial-relational,6|7,7,6/7,230219,6
3,2,23,220,1,1913,1,7,3,3,4,single-choice,spatial-relational,3|4,7,3/4,230220,3
3,2,23,221,1,1278,1,3,1,1,2,single-choice,spatial-relational,1|2,7,1/2,230221,1
3,2,23,222,1,1459,1,11,5,5,6,single-choice,spatial-relational,5|6,7,5/6,230222,5
3,2,23,223,1,959,1,11,5,5,6,single-choice,spatial-relational,5|6,7,5/6,230223,5
3,2,23,224,1,1266,1,13,6,6,7,single-choice,spatial-relational,6|7,7,6/7,230224,6
3,2,23,225,1,1173,1,9,4,4,5,single-choice,spatial-relational,4|5,7,4/5,230225,4
3,2,23,226,1,1508,1,5,2,2,3,single-choice,spatial-relational,2|3,7,2/3,230226,2
3,2,23,227,1,1412,1,7,3,3,4,single-choice,spatial-relational,3|4,7,3/4,230227,3
3,2,23,228,1,1551,1,5,2,2,3,single-choice,spatial-relational,2|3,7,2/3,230228,2
3,2,23,229,1,881,1,13,6,6,7,single-choice,spatial-relational,6|7,7,6/7,230229,6
3,2,23,230,0,934,1,11,5,6,6,single-choice,spatial-relational,5|6,7,5/6,230230,5
3,2,23,231,1,1509,1,11,5,5,6,single-choice,spatial-relational,5|6,7,5/6,230231,5
3,2,23,232,1,1362,1,3,1,1,2,single-choice,spatial-relational,1|2,7,1/2,230232,1
3,2,23,233,1,1460,1,9,4,4,5,single-choice,spatial-relational,4|5,7,4/5,230233,4
3,2,23,234,1,1047,1,13,6,6,7,single-choice,spatial-relational,6|7,7,6/7,230234,6
3,2,23,235,1,1279,1,3,1,1,2,single-choice,spatial-relational,1|2,7,1/2,230235,1
3,2,23,236,1,1245,1,7,3,3,4,single-choice,spatial-relational,3|4,7,3/4,230236,3
3,2,23,237,1,1158,1,7,3,3,4,single-choice,spatial-relational,3|4,7,3/4,230237,3
3,2,23,238,1,1025,1,5,2,2,3,single-choice,spatial-relational,2|3,7,2/3,230238,2
3,2,23,239,1,853,1,9,4,4,5,single-choice,spatial-relational,4|5,7,4/5,230239,4
3,2,23,240,1,1288,1,5,2,2,3,single-choice,spatial-relational,2|3,7,2/3,230240,2
3,2,23,241,1,1170,1,13,6,6,7,single-choice,spatial-relational,6|7,7,6/7,230241,6
3,2,23,242,1,1569,1,3,1,1,2,single-choice,spatial-relational,1|2,7,1/2,230242,1
3,2,23,243,1,1138,1,9,4,4,5,single-choice,spatial-relational,4|5,7,4/5,230243,4
3,2,23,244,1,1364,1,11,5,5,6,single-choice,spatial-relational,5|6,7,5/6,230244,5
3,2,23,245,1,1422,1,5,2,2,3,single-choice,spatial-relational,2|3,7,2/3,230245,2
3,2,23,246,1,1487,1,5,2,2,3,single-choice,spatial-relational,2|3,7,2/3,230246,2
3,2,23,247,1,1003,1,9,4,4,5,single-choice,spatial-relational,4|5,7,4/5,230247,4
3,2,23,248,1,1130,1,7,3,3,4,single-choice,spatial-relational,3|4,7,3/4,230248,3
3,2,23,249,1,1252,1,13,6,6,7,single-choice,spatial-relational,6|7,7,6/7,230249,6
3,2,23,250,1,1097,1,11,5,5,6,single-choice,spatial-relational,5|6,7,5/6,230250,5
3,2,23,251,1,1301,1,3,1,1,2,single-choice,spatial-relational,1|2,7,1/2,230251,1
3,2,23,252,1,1002,1,7,3,3,4,single-choice,spatial-relational,3|4,7,3/4,230252,3
3,2,23,253,1,1821,1,7,3,3,4,single-choice,spatial-relational,3|4,7,3/4,230253,3
3,2,23,254,1,1374,1,11,5,5,6,single-choice,spatial-relational,5|6,7,5/6,230254,5
3,2,23,255,1,873,1,13,6,6,7,single-choice,spatial-relational,6|7,7,6/7,230255,6
3,2,23,256,1,1637,1,11,5,5,6,single-choice,spatial-relational,5|6,7,5/6,230256,5
3,2,23,257,0,886,1,3,1,2,2,single-choice,spatial-relational,1|2,7,1/2,230257,1
3,2,23,258,1,1253,1,7,3,3,4,single-choice,spatial-relational,3|4,7,3/4,230258,3
3,2,23,259,1,1168,1,5,2,2,3,single-choice,spatial-relational,2|3,7,2/3,230259,2
3,2,23,260,1,931,1,13,6,6,7,single-choice,spatial-relational,6|7,7,6/7,230260,6
3,2,23,261,1,2405,1,9,4,4,5,single-choice,spatial-relational,4|5,7,4/5,230261,4
3,2,23,262,1,1098,1,5,2,2,3,single-choice,spatial-relational,2|3,7,2/3,230262,2
3,2,23,263,1,1267,1,3,1,1,2,single-choice,spatial-relational,1|2,7,1/2,230263,1
3,2,23,264,0,1086,1,9,4,5,5,single-choice,spatial-relational,4|5,7,4/5,230264,4
3,2,23,265,1,1179,1,5,2,2,3,single-choice,spatial-relational,2|3,7,2/3,230265,2
3,2,23,266,1,1203,1,11,5,5,6,single-choice,spatial-relational,5|6,7,5/6,230266,5
3,2,23,267,1,1150,1,11,5,5,6,single-choice,spatial-relational,5|6,7,5/6,230267,5
3,2,23,268,0,1567,1,5,2,3,3,single-choice,spatial-relational,2|3,7,2/3,230268,2
3,2,23,269,1,918,1,7,3,3,4,single-choice,spatial-relational,3|4,7,3/4,230269,3
3,2,23,270,1,1580,1,9,4,4,5,single-choice,spatial-relational,4|5,7,4/5,230270,4
3,2,23,271,1,2585,1,3,1,1,2,single-choice,spatial-relational,1|2,7,1/2,230271,1
3,2,23,272,1,1069,1,9,4,4,5,single-choice,spatial-relational,4|5,7,4/5,230272,4
3,2,23,273,1,1253,1,13,6,6,7,single-choice,spatial-relational,6|7,7,6/7,230273,6
3,2,23,274,1,1336,1,7,3,3,4,single-choice,spatial-relational,3|4,7,3/4,230274,3
3,2,23,275,1,1997,1,3,1,1,2,single-choice,spatial-relational,1|2,7,1/2,230275,1
3,2,23,276,1,876,1,13,6,6,7,single-choice,spatial-relational,6|7,7,6/7,230276,6
3,2,23,277,1,1464,1,5,2,2,3,single-choice,spatial-relational,2|3,7,2/3,230277,2
3,2,23,278,1,1066,1,9,4,4,5,single-choice,spatial-relational,4|5,7,4/5,230278,4
3,2,23,279,1,1147,1,3,1,1,2,single-choice,spatial-relational,1|2,7,1/2,230279,1
3,2,23,280,0,902,1,3,1,2,2,single-choice,spatial-relational,1|2,7,1/2,230280,1
3,2,23,281,1,940,1,7,3,3,4,single-choice,spatial-relational,3|4,7,3/4,230281,3
3,2,23,282,1,1201,1,11,5,5,6,single-choice,spatial-relational,5|6,7,5/6,230282,5
3,2,23,283,1,1048,1,13,6,6,7,single-choice,spatial-relational,6|7,7,6/7,230283,6
3,2,23,284,1,1984,1,5,2,2,3,single-choice,spatial-relational,2|3,7,2/3,230284,2
3,2,23,285,1,1377,1,11,5,5,6,single-choice,spatial-relational,5|6,7,5/6,230285,5
3,2,23,286,1,1052,1,13,6,6,7,single-choice,spatial-relational,6|7,7,6/7,230286,6
3,2,23,287,0,1139,1,9,4,5,5,single-choice,spatial-relational,4|5,7,4/5,230287,4
3,2,23,288,1,1116,1,7,3,3,4,single-choice,spatial-relational,3|4,7,3/4,230288,3
3,2,23,289,1,1059,1,13,6,6,7,single-choice,spatial-relational,6|7,7,6/7,230289,6
3,2,23,290,1,1542,1,7,3,3,4,single-choice,spatial-relational,3|4,7,3/4,230290,3
3,2,23,291,1,1259,1,11,5,5,6,single-choice,spatial-relational,5|6,7,5/6,230291,5
3,2,23,292,1,948,1,13,6,6,7,single-choice,spatial-relational,6|7,7,6/7,230292,6
3,2,23,293,1,1264,1,5,2,2,3,single-choice,spatial-relational,2|3,7,2/3,230293,2
3,2,23,294,1,1161,1,3,1,1,2,single-choice,spatial-relational,1|2,7,1/2,230294,1
3,2,23,295,0,890,1,5,2,3,3,single-choice,spatial-relational,2|3,7,2/3,230295,2
3,2,23,296,1,1541,1,3,1,1,2,single-choice,spatial-relational,1|2,7,1/2,230296,1
3,2,23,297,1,1594,1,9,4,4,5,single-choice,spatial-relational,4|5,7,4/5,230297,4
3,2,23,298,1,1592,1,7,3,3,4,single-choice,spatial-relational,3|4,7,3/4,230298,3
3,2,23,299,0,1686,1,9,4,5,5,single-choice,spatial-relational,4|5,7,4/5,230299,4
3,2,23,300,1,1557,1,11,5,5,6,single-choice,spatial-relational,5|6,7,5/6,230300,5
3,2,23,301,1,1217,1,13,6,6,7,single-choice,spatial-relational,6|7,7,6/7,230301,6
3,2,23,302,1,1290,1,11,5,5,6,single-choice,spatial-relational,5|6,7,5/6,230302,5
3,2,23,303,0,1436,1,7,3,4,4,single-choice,spatial-relational,3|4,7,3/4,230303,3
3,2,23,304,1,1201,1,9,4,4,5,single-choice,spatial-relational,4|5,7,4/5,230304,4
3,2,23,305,0,1584,1,3,1,2,2,single-choice,spatial-relational,1|2,7,1/2,230305,1
3,2,23,306,0,44,1,13,6,7,7,single-choice,spatial-relational,6|7,7,6/7,230306,6
3,2,23,307,0,1040,1,5,2,3,3,single-choice,spatial-relational,2|3,7,2/3,230307,2
3,2,23,308,1,1213,1,9,4,4,5,single-choice,spatial-relational,4|5,7,4/5,230308,4
3,2,23,309,0,1168,1,5,2,3,3,single-choice,spatial-relational,2|3,7,2/3,230309,2
3,2,23,310,1,491,1,3,1,1,2,single-choice,spatial-relational,1|2,7,1/2,230310,1
3,2,23,311,1,2054,1,7,3,3,4,single-choice,spatial-relational,3|4,7,3/4,230311,3
3,2,23,312,1,1376,1,11,5,5,6,single-choice,spatial-relational,5|6,7,5/6,230312,5
3,2,23,313,1,1987,1,7,3,3,4,single-choice,spatial-relational,3|4,7,3/4,230313,3
3,2,23,314,1,1211,1,3,1,1,2,single-choice,spatial-relational,1|2,7,1/2,230314,1
3,2,23,315,1,1464,1,3,1,1,2,single-choice,spatial-relational,1|2,7,1/2,230315,1
3,2,23,316,1,1173,1,5,2,2,3,single-choice,spatial-relational,2|3,7,2/3,230316,2
3,2,23,317,1,1046,1,13,6,6,7,single-choice,spatial-relational,6|7,7,6/7,230317,6
3,2,23,318,1,1692,1,11,5,5,6,single-choice,spatial-relational,5|6,7,5/6,230318,5
3,2,23,319,1,1836,1,11,5,5,6,single-choice,spatial-relational,5|6,7,5/6,230319,5
3,2,23,320,1,808,1,13,6,6,7,single-choice,spatial-relational,6|7,7,6/7,230320,6
3,2,23,321,0,1329,1,7,3,4,4,single-choice,spatial-relational,3|4,7,3/4,230321,3
3,2,23,322,0,909,1,5,2,3,3,single-choice,spatial-relational,2|3,7,2/3,230322,2
3,2,23,323,0,1772,1,9,4,5,5,single-choice,spatial-relational,4|5,7,4/5,230323,4
3,2,23,324,1,1243,1,9,4,4,5,single-choice,spatial-relational,4|5,7,4/5,230324,4
3,2,23,325,1,1516,1,5,2,2,3,single-choice,spatial-relational,2|3,7,2/3,230325,2
3,2,23,326,1,1287,1,3,1,1,2,single-choice,spatial-relational,1|2,7,1/2,230326,1
3,2,23,327,1,1702,1,5,2,2,3,single-choice,spatial-relational,2|3,7,2/3,230327,2
3,2,23,328,1,1443,1,9,4,4,5,single-choice,spatial-relational,4|5,7,4/5,230328,4
3,2,23,329,1,940,1,7,3,3,4,single-choice,spatial-relational,3|4,7,3/4,230329,3
3,2,23,330,1,1134,1,13,6,6,7,single-choice,spatial-relational,6|7,7,6/7,230330,6
3,2,23,331,1,1184,1,11,5,5,6,single-choice,spatial-relational,5|6,7,5/6,230331,5
3,2,23,332,1,1103,1,13,6,6,7,single-choice,spatial-relational,6|7,7,6/7,230332,6
3,2,23,333,1,1026,1,3,1,1,2,single-choice,spatial-relational,1|2,7,1/2,230333,1
3,2,23,334,1,1503,1,11,5,5,6,single-choice,spatial-relational,5|6,7,5/6,230334,5
3,2,23,335,1,1954,1,7,3,3,4,single-choice,spatial-relational,3|4,7,3/4,230335,3
3,2,23,336,1,2342,1,9,4,4,5,single-choice,spatial-relational,4|5,7,4/5,230336,4
3,2,23,337,1,950,1,13,6,6,7,single-choice,spatial-relational,6|7,7,6/7,230337,6
3,2,23,338,1,1007,1,7,3,3,4,single-choice,spatial-relational,3|4,7,3/4,230338,3
3,2,23,339,1,1566,1,11,5,5,6,single-choice,spatial-relational,5|6,7,5/6,230339,5
3,2,23,340,1,1009,1,5,2,2,3,single-choice,spatial-relational,2|3,7,2/3,230340,2
3,2,23,341,0,1658,1,9,4,5,5,single-choice,spatial-relational,4|5,7,4/5,230341,4
3,2,23,342,0,40,1,9,4,5,5,single-choice,spatial-relational,4|5,7,4/5,230342,4
3,2,23,343,1,44,1,3,1,1,2,single-choice,spatial-relational,1|2,7,1/2,230343,1
3,2,23,344,1,1577,1,7,3,3,4,single-choice,spatial-relational,3|4,7,3/4,230344,3
3,2,23,345,1,1151,1,13,6,6,7,single-choice,spatial-relational,6|7,7,6/7,230345,6
3,2,23,346,1,1185,1,5,2,2,3,single-choice,spatial-relational,2|3,7,2/3,230346,2
3,2,23,347,1,1671,1,11,5,5,6,single-choice,spatial-relational,5|6,7,5/6,230347,5
3,2,23,348,0,973,1,3,1,2,2,single-choice,spatial-relational,1|2,7,1/2,230348,1
3,2,23,349,1,3429,1,11,5,5,6,single-choice,spatial-relational,5|6,7,5/6,230349,5
3,2,23,350,1,1932,1,3,1,1,2,single-choice,spatial-relational,1|2,7,1/2,230350,1
3,2,23,351,0,1064,1,9,4,5,5,single-choice,spatial-relational,4|5,7,4/5,230351,4
3,2,23,352,1,1058,1,11,5,5,6,single-choice,spatial-relational,5|6,7,5/6,230352,5
3,2,23,353,1,974,1,13,6,6,7,single-choice,spatial-relational,6|7,7,6/7,230353,6
3,2,23,354,1,879,1,13,6,6,7,single-choice,spatial-relational,6|7,7,6/7,230354,6
3,2,23,355,1,1057,1,3,1,1,2,single-choice,spatial-relational,1|2,7,1/2,230355,1
3,2,23,356,0,905,1,5,2,3,3,single-choice,spatial-relational,2|3,7,2/3,230356,2
3,2,23,357,1,1479,1,7,3,3,4,single-choice,spatial-relational,3|4,7,3/4,230357,3
3,2,23,358,1,1555,1,5,2,2,3,single-choice,spatial-relational,2|3,7,2/3,230358,2
3,2,23,359,0,1731,1,7,3,4,4,single-choice,spatial-relational,3|4,7,3/4,230359,3
3,2,23,360,1,1368,1,9,4,4,5,single-choice,spatial-relational,4|5,7,4/5,230360,4
3,2,23,361,1,948,1,13,6,6,7,single-choice,spatial-relational,6|7,7,6/7,230361,6
3,2,23,362,0,1432,1,9,4,5,5,single-choice,spatial-relational,4|5,7,4/5,230362,4
3,2,23,363,1,1171,1,11,5,5,6,single-choice,spatial-relational,5|6,7,5/6,230363,5
3,2,23,364,0,1427,1,3,1,2,2,single-choice,spatial-relational,1|2,7,1/2,230364,1
3,2,23,365,1,1364,1,5,2,2,3,single-choice,spatial-relational,2|3,7,2/3,230365,2
3,2,23,366,1,1565,1,7,3,3,4,single-choice,spatial-relational,3|4,7,3/4,230366,3
3,2,23,367,1,864,1,3,1,1,2,single-choice,spatial-relational,1|2,7,1/2,230367,1
3,2,23,368,1,1421,1,5,2,2,3,single-choice,spatial-relational,2|3,7,2/3,230368,2
3,2,23,369,0,1325,1,9,4,5,5,single-choice,spatial-relational,4|5,7,4/5,230369,4
3,2,23,370,1,1072,1,13,6,6,7,single-choice,spatial-relational,6|7,7,6/7,230370,6
3,2,23,371,1,2589,1,11,5,5,6,single-choice,spatial-relational,5|6,7,5/6,230371,5
3,2,23,372,1,1146,1,7,3,3,4,single-choice,spatial-relational,3|4,7,3/4,230372,3
3,2,23,373,1,1538,1,3,1,1,2,single-choice,spatial-relational,1|2,7,1/2,230373,1
3,2,23,374,1,1019,1,7,3,3,4,single-choice,spatial-relational,3|4,7,3/4,230374,3
3,2,23,375,1,1720,1,9,4,4,5,single-choice,spatial-relational,4|5,7,4/5,230375,4
3,2,23,376,1,1068,1,5,2,2,3,single-choice,spatial-relational,2|3,7,2/3,230376,2
3,2,23,377,1,782,1,13,6,6,7,single-choice,spatial-relational,6|7,7,6/7,230377,6
3,2,23,378,1,1298,1,9,4,4,5,single-choice,spatial-relational,4|5,7,4/5,230378,4
3,2,23,379,1,997,1,13,6,6,7,single-choice,spatial-relational,6|7,7,6/7,230379,6
3,2,23,380,1,1287,1,11,5,5,6,single-choice,spatial-relational,5|6,7,5/6,230380,5
3,2,23,381,1,1549,1,5,2,2,3,single-choice,spatial-relational,2|3,7,2/3,230381,2
3,2,23,382,1,959,1,3,1,1,2,single-choice,spatial-relational,1|2,7,1/2,230382,1
3,2,23,383,0,1009,1,7,3,4,4,single-choice,spatial-relational,3|4,7,3/4,230383,3
3,2,23,384,1,1209,1,11,5,5,6,single-choice,spatial-relational,5|6,7,5/6,230384,5
3,2,23,385,1,1012,1,11,5,5,6,single-choice,spatial-relational,5|6,7,5/6,230385,5
3,2,23,386,1,1187,1,9,4,4,5,single-choice,spatial-relational,4|5,7,4/5,230386,4
3,2,23,387,1,1496,1,11,5,5,6,single-choice,spatial-relational,5|6,7,5/6,230387,5
3,2,23,388,1,1063,1,7,3,3,4,single-choice,spatial-relational,3|4,7,3/4,230388,3
3,2,23,389,1,1566,1,9,4,4,5,single-choice,spatial-relational,4|5,7,4/5,230389,4
3,2,23,390,1,1193,1,5,2,2,3,single-choice,spatial-relational,2|3,7,2/3,230390,2
3,2,23,391,0,743,1,7,3,4,4,single-choice,spatial-relational,3|4,7,3/4,230391,3
3,2,23,392,1,4912,1,3,1,1,2,single-choice,spatial-relational,1|2,7,1/2,230392,1
3,2,23,393,1,940,1,5,2,2,3,single-choice,spatial-relational,2|3,7,2/3,230393,2
3,2,23,394,1,969,1,13,6,6,7,single-choice,spatial-relational,6|7,7,6/7,230394,6
3,2,23,395,0,885,1,3,1,2,2,single-choice,spatial-relational,1|2,7,1/2,230395,1
3,2,23,396,1,805,1,13,6,6,7,single-choice,spatial-relational,6|7,7,6/7,230396,6
3,2,23,397,1,1673,1,9,4,4,5,single-choice,spatial-relational,4|5,7,4/5,230397,4
3,2,23,398,1,1250,1,7,3,3,4,single-choice,spatial-relational,3|4,7,3/4,230398,3
3,2,23,399,1,879,1,13,6,6,7,single-choice,spatial-relational,6|7,7,6/7,230399,6
3,2,23,400,0,1416,1,3,1,2,2,single-choice,spatial-relational,1|2,7,1/2,230400,1
3,2,23,401,1,1402,1,5,2,2,3,single-choice,spatial-relational,2|3,7,2/3,230401,2
3,2,23,402,1,951,1,13,6,6,7,single-choice,spatial-relational,6|7,7,6/7,230402,6
3,2,23,403,1,1374,1,7,3,3,4,single-choice,spatial-relational,3|4,7,3/4,230403,3
3,2,23,404,1,1235,1,11,5,5,6,single-choice,spatial-relational,5|6,7,5/6,230404,5
3,2,23,405,0,965,1,9,4,5,5,single-choice,spatial-relational,4|5,7,4/5,230405,4
3,2,23,406,0,927,1,5,2,3,3,single-choice,spatial-relational,2|3,7,2/3,230406,2
3,2,23,407,1,1416,1,11,5,5,6,single-choice,spatial-relational,5|6,7,5/6,230407,5
3,2,23,408,1,1176,1,3,1,1,2,single-choice,spatial-relational,1|2,7,1/2,230408,1
3,2,23,409,1,1466,1,5,2,2,3,single-choice,spatial-relational,2|3,7,2/3,230409,2
3,2,23,410,1,1119,1,11,5,5,6,single-choice,spatial-relational,5|6,7,5/6,230410,5
3,2,23,411,1,894,1,13,6,6,7,single-choice,spatial-relational,6|7,7,6/7,230411,6
3,2,23,412,0,1119,1,3,1,2,2,single-choice,spatial-relational,1|2,7,1/2,230412,1
3,2,23,413,0,1124,1,5,2,3,3,single-choice,spatial-relational,2|3,7,2/3,230413,2
3,2,23,414,1,960,1,7,3,3,4,single-choice,spatial-relational,3|4,7,3/4,230414,3
3,2,23,415,1,992,1,13,6,6,7,single-choice,spatial-relational,6|7,7,6/7,230415,6
3,2,23,416,1,1347,1,11,5,5,6,single-choice,spatial-relational,5|6,7,5/6,230416,5
3,2,23,417,0,1983,1,7,3,4,4,single-choice,spatial-relational,3|4,7,3/4,230417,3
3,2,23,418,1,1232,1,3,1,1,2,single-choice,spatial-relational,1|2,7,1/2,230418,1
3,2,23,419,1,1275,1,9,4,4,5,single-choice,spatial-relational,4|5,7,4/5,230419,4
3,2,23,420,1,1468,1,9,4,4,5,single-choice,spatial-relational,4|5,7,4/5,230420,4
3,2,23,421,1,1410,1,7,3,3,4,single-choice,spatial-relational,3|4,7,3/4,230421,3
3,2,23,422,1,970,1,7,3,3,4,single-choice,spatial-relational,3|4,7,3/4,230422,3
3,2,23,423,1,1302,1,13,6,6,7,single-choice,spatial-relational,6|7,7,6/7,230423,6
3,2,23,424,1,1061,1,13,6,6,7,single-choice,spatial-relational,6|7,7,6/7,230424,6
3,2,23,425,1,1107,1,3,1,1,2,single-choice,spatial-relational,1|2,7,1/2,230425,1
3,2,23,426,1,1391,1,11,5,5,6,single-choice,spatial-relational,5|6,7,5/6,230426,5
3,2,23,427,0,1173,1,9,4,5,5,single-choice,spatial-relational,4|5,7,4/5,230427,4
3,2,23,428,1,40,1,11,5,5,6,single-choice,spatial-relational,5|6,7,5/6,230428,5
3,2,23,429,1,1784,1,9,4,4,5,single-choice,spatial-relational,4|5,7,4/5,230429,4
3,2,23,430,1,1190,1,5,2,2,3,single-choice,spatial-relational,2|3,7,2/3,230430,2
3,2,23,431,1,1063,1,3,1,1,2,single-choice,spatial-relational,1|2,7,1/2,230431,1
3,2,23,432,0,1561,1,5,2,3,3,single-choice,spatial-relational,2|3,7,2/3,230432,2
3,2,23,433,1,1523,1,3,1,1,2,single-choice,spatial-relational,1|2,7,1/2,230433,1
3,2,23,434,1,1106,1,7,3,3,4,single-choice,spatial-relational,3|4,7,3/4,230434,3
3,2,23,435,1,1711,1,11,5,5,6,single-choice,spatial-relational,5|6,7,5/6,230435,5
3,2,23,436,1,1020,1,11,5,5,6,single-choice,spatial-relational,5|6,7,5/6,230436,5
3,2,23,437,1,1038,1,3,1,1,2,single-choice,spatial-relational,1|2,7,1/2,230437,1
3,2,23,438,1,1027,1,5,2,2,3,single-choice,spatial-relational,2|3,7,2/3,230438,2
3,2,23,439,1,1028,1,13,6,6,7,single-choice,spatial-relational,6|7,7,6/7,230439,6
3,2,23,440,1,1214,1,9,4,4,5,single-choice,spatial-relational,4|5,7,4/5,230440,4
3,2,23,441,0,154,1,9,4,5,5,single-choice,spatial-relational,4|5,7,4/5,230441,4
3,2,23,442,1,881,1,7,3,3,4,single-choice,spatial-relational,3|4,7,3/4,230442,3
3,2,23,443,1,1300,1,13,6,6,7,single-choice,spatial-relational,6|7,7,6/7,230443,6
3,2,23,444,1,1385,1,5,2,2,3,single-choice,spatial-relational,2|3,7,2/3,230444,2
3,2,23,445,0,1519,1,7,3,4,4,single-choice,spatial-relational,3|4,7,3/4,230445,3
3,2,23,446,1,1149,1,9,4,4,5,single-choice,spatial-relational,4|5,7,4/5,230446,4
3,2,23,447,1,1272,1,11,5,5,6,single-choice,spatial-relational,5|6,7,5/6,230447,5
3,2,23,448,1,2106,1,9,4,4,5,single-choice,spatial-relational,4|5,7,4/5,230448,4
3,2,23,449,1,987,1,3,1,1,2,single-choice,spatial-relational,1|2,7,1/2,230449,1
3,2,23,450,1,931,1,13,6,6,7,single-choice,spatial-relational,6|7,7,6/7,230450,6
3,2,23,451,1,1140,1,7,3,3,4,single-choice,spatial-relational,3|4,7,3/4,230451,3
3,2,23,452,1,962,1,11,5,5,6,single-choice,spatial-relational,5|6,7,5/6,230452,5
3,2,23,453,1,1270,1,3,1,1,2,single-choice,spatial-relational,1|2,7,1/2,230453,1
3,2,23,454,1,1270,1,5,2,2,3,single-choice,spatial-relational,2|3,7,2/3,230454,2
3,2,23,455,1,982,1,13,6,6,7,single-choice,spatial-relational,6|7,7,6/7,230455,6
3,2,23,456,1,1345,1,5,2,2,3,single-choice,spatial-relational,2|3,7,2/3,230456,2
3,2,23,457,1,1201,1,3,1,1,2,single-choice,spatial-relational,1|2,7,1/2,230457,1
3,2,23,458,1,1734,1,9,4,4,5,single-choice,spatial-relational,4|5,7,4/5,230458,4
3,2,23,459,0,993,1,3,1,2,2,single-choice,spatial-relational,1|2,7,1/2,230459,1
3,2,23,460,1,1072,1,7,3,3,4,single-choice,spatial-relational,3|4,7,3/4,230460,3
3,2,23,461,1,980,1,11,5,5,6,single-choice,spatial-relational,5|6,7,5/6,230461,5
3,2,23,462,1,1088,1,11,5,5,6,single-choice,spatial-relational,5|6,7,5/6,230462,5
3,2,23,463,1,992,1,13,6,6,7,single-choice,spatial-relational,6|7,7,6/7,230463,6
3,2,23,464,1,942,1,5,2,2,3,single-choice,spatial-relational,2|3,7,2/3,230464,2
3,2,23,465,0,913,1,5,2,3,3,single-choice,spatial-relational,2|3,7,2/3,230465,2
3,2,23,466,1,709,1,13,6,6,7,single-choice,spatial-relational,6|7,7,6/7,230466,6
3,2,23,467,1,1214,1,7,3,3,4,single-choice,spatial-relational,3|4,7,3/4,230467,3
3,2,23,468,1,1722,1,9,4,4,5,single-choice,spatial-relational,4|5,7,4/5,230468,4
3,2,23,469,1,1196,1,11,5,5,6,single-choice,spatial-relational,5|6,7,5/6,230469,5
3,2,23,470,1,1157,1,5,2,2,3,single-choice,spatial-relational,2|3,7,2/3,230470,2
3,2,23,471,1,810,1,3,1,1,2,single-choice,spatial-relational,1|2,7,1/2,230471,1
3,2,23,472,1,1431,1,13,6,6,7,single-choice,spatial-relational,6|7,7,6/7,230472,6
3,2,23,473,1,986,1,5,2,2,3,single-choice,spatial-relational,2|3,7,2/3,230473,2
3,2,23,474,0,967,1,9,4,5,5,single-choice,spatial-relational,4|5,7,4/5,230474,4
3,2,23,475,0,1114,1,11,5,6,6,single-choice,spatial-relational,5|6,7,5/6,230475,5
3,2,23,476,1,991,1,7,3,3,4,single-choice,spatial-relational,3|4,7,3/4,230476,3
3,2,23,477,1,1509,1,9,4,4,5,single-choice,spatial-relational,4|5,7,4/5,230477,4
3,2,23,478,1,1064,1,3,1,1,2,single-choice,spatial-relational,1|2,7,1/2,230478,1
3,2,23,479,1,876,1,13,6,6,7,single-choice,spatial-relational,6|7,7,6/7,230479,6
3,2,23,480,0,765,1,7,3,4,4,single-choice,spatial-relational,3|4,7,3/4,230480,3
3,2,23,481,1,851,1,11,5,5,6,single-choice,spatial-relational,5|6,7,5/6,230481,5
3,2,23,482,1,983,1,11,5,5,6,single-choice,spatial-relational,5|6,7,5/6,230482,5
3,2,23,483,0,1034,1,5,2,3,3,single-choice,spatial-relational,2|3,7,2/3,230483,2
3,2,23,484,1,908,1,7,3,3,4,single-choice,spatial-relational,3|4,7,3/4,230484,3
3,2,23,485,1,1104,1,13,6,6,7,single-choice,spatial-relational,6|7,7,6/7,230485,6
3,2,23,486,0,1006,1,9,4,5,5,single-choice,spatial-relational,4|5,7,4/5,230486,4
3,2,23,487,1,1114,1,9,4,4,5,single-choice,spatial-relational,4|5,7,4/5,230487,4
3,2,23,488,1,935,1,3,1,1,2,single-choice,spatial-relational,1|2,7,1/2,230488,1
3,2,23,489,1,848,1,3,1,1,2,single-choice,spatial-relational,1|2,7,1/2,230489,1
3,2,23,490,1,772,1,13,6,6,7,single-choice,spatial-relational,6|7,7,6/7,230490,6
3,2,23,491,1,785,1,5,2,2,3,single-choice,spatial-relational,2|3,7,2/3,230491,2
3,2,23,492,1,1662,1,7,3,3,4,single-choice,spatial-relational,3|4,7,3/4,230492,3
3,2,23,493,0,882,1,11,5,6,6,single-choice,spatial-relational,5|6,7,5/6,230493,5
3,2,23,494,1,1493,1,7,3,3,4,single-choice,spatial-relational,3|4,7,3/4,230494,3
3,2,23,495,1,1810,1,5,2,2,3,single-choice,spatial-relational,2|3,7,2/3,230495,2
3,2,23,496,1,1641,1,3,1,1,2,single-choice,spatial-relational,1|2,7,1/2,230496,1
3,2,23,497,1,705,1,13,6,6,7,single-choice,spatial-relational,6|7,7,6/7,230497,6
3,2,23,498,1,923,1,13,6,6,7,single-choice,spatial-relational,6|7,7,6/7,230498,6
3,2,23,499,0,1015,1,9,4,5,5,single-choice,spatial-relational,4|5,7,4/5,230499,4
3,2,23,500,0,57,1,11,5,6,6,single-choice,spatial-relational,5|6,7,5/6,230500,5
3,2,23,501,0,1074,1,5,2,3,3,single-choice,spatial-relational,2|3,7,2/3,230501,2
3,2,23,502,0,48,1,7,3,4,4,single-choice,spatial-relational,3|4,7,3/4,230502,3
3,2,23,503,1,1323,1,3,1,1,2,single-choice,spatial-relational,1|2,7,1/2,230503,1
3,2,23,504,1,1287,1,9,4,4,5,single-choice,spatial-relational,4|5,7,4/5,230504,4
3,2,23,505,1,1034,1,3,1,1,2,single-choice,spatial-relational,1|2,7,1/2,230505,1
3,2,23,506,1,1572,1,3,1,1,2,single-choice,spatial-relational,1|2,7,1/2,230506,1
3,2,23,507,0,858,1,9,4,5,5,single-choice,spatial-relational,4|5,7,4/5,230507,4
3,2,23,508,1,1149,1,13,6,6,7,single-choice,spatial-relational,6|7,7,6/7,230508,6
3,2,23,509,1,1377,1,7,3,3,4,single-choice,spatial-relational,3|4,7,3/4,230509,3
3,2,23,510,1,1253,1,9,4,4,5,single-choice,spatial-relational,4|5,7,4/5,230510,4
3,2,23,511,1,885,1,5,2,2,3,single-choice,spatial-relational,2|3,7,2/3,230511,2
3,2,23,512,1,844,1,11,5,5,6,single-choice,spatial-relational,5|6,7,5/6,230512,5
3,2,23,513,1,846,1,5,2,2,3,single-choice,spatial-relational,2|3,7,2/3,230513,2
3,2,23,514,1,1392,1,7,3,3,4,single-choice,spatial-relational,3|4,7,3/4,230514,3
3,2,23,515,1,832,1,13,6,6,7,single-choice,spatial-relational,6|7,7,6/7,230515,6
3,2,23,516,1,1160,1,11,5,5,6,single-choice,spatial-relational,5|6,7,5/6,230516,5
3,2,23,517,1,1149,1,7,3,3,4,single-choice,spatial-relational,3|4,7,3/4,230517,3
3,2,23,518,1,1351,1,11,5,5,6,single-choice,spatial-relational,5|6,7,5/6,230518,5
3,2,23,519,1,1042,1,11,5,5,6,single-choice,spatial-relational,5|6,7,5/6,230519,5
3,2,23,520,1,1147,1,9,4,4,5,single-choice,spatial-relational,4|5,7,4/5,230520,4
3,2,23,521,0,822,1,5,2,3,3,single-choice,spatial-relational,2|3,7,2/3,230521,2
3,2,23,522,1,57,1,7,3,3,4,single-choice,spatial-relational,3|4,7,3/4,230522,3
3,2,23,523,1,1169,1,3,1,1,2,single-choice,spatial-relational,1|2,7,1/2,230523,1
3,2,23,524,1,1220,1,5,2,2,3,single-choice,spatial-relational,2|3,7,2/3,230524,2
3,2,23,525,1,861,1,13,6,6,7,single-choice,spatial-relational,6|7,7,6/7,230525,6
3,2,23,526,0,1029,1,9,4,5,5,single-choice,spatial-relational,4|5,7,4/5,230526,4
3,2,23,527,1,1094,1,13,6,6,7,single-choice,spatial-relational,6|7,7,6/7,230527,6
3,2,23,528,1,1450,1,3,1,1,2,single-choice,spatial-relational,1|2,7,1/2,230528,1
3,2,23,529,0,1170,1,3,1,2,2,single-choice,spatial-relational,1|2,7,1/2,230529,1
3,2,23,530,0,44,1,5,2,3,3,single-choice,spatial-relational,2|3,7,2/3,230530,2
3,2,23,531,1,901,1,9,4,4,5,single-choice,spatial-relational,4|5,7,4/5,230531,4
3,2,23,532,1,1656,1,7,3,3,4,single-choice,spatial-relational,3|4,7,3/4,230532,3
3,2,23,533,1,1252,1,9,4,4,5,single-choice,spatial-relational,4|5,7,4/5,230533,4
3,2,23,534,1,907,1,13,6,6,7,single-choice,spatial-relational,6|7,7,6/7,230534,6
3,2,23,535,1,1585,1,11,5,5,6,single-choice,spatial-relational,5|6,7,5/6,230535,5
3,2,23,536,1,1323,1,7,3,3,4,single-choice,spatial-relational,3|4,7,3/4,230536,3
3,2,23,537,1,1138,1,13,6,6,7,single-choice,spatial-relational,6|7,7,6/7,230537,6
3,2,23,538,1,1478,1,11,5,5,6,single-choice,spatial-relational,5|6,7,5/6,230538,5
3,2,23,539,1,1291,1,5,2,2,3,single-choice,spatial-relational,2|3,7,2/3,230539,2
3,2,23,540,1,1278,1,3,1,1,2,single-choice,spatial-relational,1|2,7,1/2,230540,1
3,2,23,541,1,680,1,5,2,2,3,single-choice,spatial-relational,2|3,7,2/3,230541,2
3,2,23,542,1,1339,1,9,4,4,5,single-choice,spatial-relational,4|5,7,4/5,230542,4
3,2,23,543,0,953,1,3,1,2,2,single-choice,spatial-relational,1|2,7,1/2,230543,1
3,2,23,544,1,1164,1,3,1,1,2,single-choice,spatial-relational,1|2,7,1/2,230544,1
3,2,23,545,1,1167,1,5,2,2,3,single-choice,spatial-relational,2|3,7,2/3,230545,2
3,2,23,546,1,1099,1,9,4,4,5,single-choice,spatial-relational,4|5,7,4/5,230546,4
3,2,23,547,1,1202,1,7,3,3,4,single-choice,spatial-relational,3|4,7,3/4,230547,3
3,2,23,548,1,1060,1,13,6,6,7,single-choice,spatial-relational,6|7,7,6/7,230548,6
3,2,23,549,1,1120,1,7,3,3,4,single-choice,spatial-relational,3|4,7,3/4,230549,3
3,2,23,550,1,1193,1,13,6,6,7,single-choice,spatial-relational,6|7,7,6/7,230550,6
3,2,23,551,0,642,1,11,5,6,6,single-choice,spatial-relational,5|6,7,5/6,230551,5
3,2,23,552,1,981,1,11,5,5,6,single-choice,spatial-relational,5|6,7,5/6,230552,5
3,2,23,553,1,1294,1,5,2,2,3,single-choice,spatial-relational,2|3,7,2/3,230553,2
3,2,23,554,1,1060,1,7,3,3,4,single-choice,spatial-relational,3|4,7,3/4,230554,3
3,2,23,555,1,880,1,13,6,6,7,single-choice,spatial-relational,6|7,7,6/7,230555,6
3,2,23,556,0,867,1,3,1,2,2,single-choice,spatial-relational,1|2,7,1/2,230556,1
3,2,23,557,1,1424,1,7,3,3,4,single-choice,spatial-relational,3|4,7,3/4,230557,3
3,2,23,558,0,1066,1,13,6,7,7,single-choice,spatial-relational,6|7,7,6/7,230558,6
4,2,23,1,0,1187,1,5,2,3,3,single-choice,spatial-relational,2|3,7,2/3,230001,2
4,2,23,2,0,745,1,9,4,5,5,single-choice,spatial-relational,4|5,7,4/5,230002,4
4,2,23,3,1,880,1,7,3,3,4,single-choice,spatial-relational,3|4,7,3/4,230003,3
4,2,23,4,1,2159,1,13,6,6,7,single-choice,spatial-relational,6|7,7,6/7,230004,6
4,2,23,5,1,1948,1,11,5,5,6,single-choice,spatial-relational,5|6,7,5/6,230005,5
4,2,23,6,1,1722,1,3,1,1,2,single-choice,spatial-relational,1|2,7,1/2,230006,1
4,2,23,7,1,1255,1,9,4,4,5,single-choice,spatial-relational,4|5,7,4/5,230007,4
4,2,23,8,1,1048,1,7,3,3,4,single-choice,spatial-relational,3|4,7,3/4,230008,3
4,2,23,9,1,939,1,5,2,2,3,single-choice,spatial-relational,2|3,7,2/3,230009,2
4,2,23,10,1,892,1,13,6,6,7,single-choice,spatial-relational,6|7,7,6/7,230010,6
4,2,23,11,1,1181,1,11,5,5,6,single-choice,spatial-relational,5|6,7,5/6,230011,5
4,2,23,12,1,1760,1,3,1,1,2,single-choice,spatial-relational,1|2,7,1/2,230012,1
4,2,23,13,1,1074,1,7,3,3,4,single-choice,spatial-relational,3|4,7,3/4,230013,3
4,2,23,14,1,2197,1,3,1,1,2,single-choice,spatial-relational,1|2,7,1/2,230014,1
4,2,23,15,1,952,1,9,4,4,5,single-choice,spatial-relational,4|5,7,4/5,230015,4
4,2,23,16,1,877,1,13,6,6,7,single-choice,spatial-relational,6|7,7,6/7,230016,6
4,2,23,17,0,902,1,5,2,3,3,single-choice,spatial-relational,2|3,7,2/3,230017,2
4,2,23,18,0,1211,1,11,5,6,6,single-choice,spatial-relational,5|6,7,5/6,230018,5
4,2,23,19,1,995,1,11,5,5,6,single-choice,spatial-relational,5|6,7,5/6,230019,5
4,2,23,20,1,1389,1,5,2,2,3,single-choice,spatial-relational,2|3,7,2/3,230020,2
4,2,23,21,1,969,1,13,6,6,7,single-choice,spatial-relational,6|7,7,6/7,230021,6
4,2,23,22,1,7139,1,3,1,1,2,single-choice,spatial-relational,1|2,7,1/2,230022,1
4,2,23,23,0,837,1,9,4,5,5,single-choice,spatial-relational,4|5,7,4/5,230023,4
4,2,23,24,1,1000,1,7,3,3,4,single-choice,spatial-relational,3|4,7,3/4,230024,3
4,2,23,25,1,1379,1,11,5,5,6,single-choice,spatial-relational,5|6,7,5/6,230025,5
4,2,23,26,1,1216,1,9,4,4,5,single-choice,spatial-relational,4|5,7,4/5,230026,4
4,2,23,27,1,1354,1,7,3,3,4,single-choice,spatial-relational,3|4,7,3/4,230027,3
4,2,23,28,1,1208,1,11,5,5,6,single-choice,spatial-relational,5|6,7,5/6,230028,5
4,2,23,29,1,1934,1,3,1,1,2,single-choice,spatial-relational,1|2,7,1/2,230029,1
4,2,23,30,1,1153,1,7,3,3,4,single-choice,spatial-relational,3|4,7,3/4,230030,3
4,2,23,31,0,884,1,3,1,2,2,single-choice,spatial-relational,1|2,7,1/2,230031,1
4,2,23,32,0,69,1,13,6,7,7,single-choice,spatial-relational,6|7,7,6/7,230032,6
4,2,23,33,1,1344,1,5,2,2,3,single-choice,spatial-relational,2|3,7,2/3,230033,2
4,2,23,34,1,1217,1,9,4,4,5,single-choice,spatial-relational,4|5,7,4/5,230034,4
4,2,23,35,1,2374,1,5,2,2,3,single-choice,spatial-relational,2|3,7,2/3,230035,2
4,2,23,36,1,824,1,13,6,6,7,single-choice,spatial-relational,6|7,7,6/7,230036,6
4,2,23,37,1,1637,1,9,4,4,5,single-choice,spatial-relational,4|5,7,4/5,230037,4
4,2,23,38,1,969,1,13,6,6,7,single-choice,spatial-relational,6|7,7,6/7,230038,6
4,2,23,39,1,1477,1,11,5,5,6,single-choice,spatial-relational,5|6,7,5/6,230039,5
4,2,23,40,1,3539,1,5,2,2,3,single-choice,spatial-relational,2|3,7,2/3,230040,2
4,2,23,41,1,1005,1,5,2,2,3,single-choice,spatial-relational,2|3,7,2/3,230041,2
4,2,23,42,1,1230,1,9,4,4,5,single-choice,spatial-relational,4|5,7,4/5,230042,4
4,2,23,43,1,1654,1,7,3,3,4,single-choice,spatial-relational,3|4,7,3/4,230043,3
4,2,23,44,0,202,1,7,3,4,4,single-choice,spatial-relational,3|4,7,3/4,230044,3
4,2,23,45,0,40,1,13,6,7,7,single-choice,spatial-relational,6|7,7,6/7,230045,6
4,2,23,46,0,962,1,11,5,6,6,single-choice,spatial-relational,5|6,7,5/6,230046,5
4,2,23,47,1,1457,1,3,1,1,2,single-choice,spatial-relational,1|2,7,1/2,230047,1
4,2,23,48,1,1270,1,3,1,1,2,single-choice,spatial-relational,1|2,7,1/2,230048,1
4,2,23,49,1,793,1,13,6,6,7,single-choice,spatial-relational,6|7,7,6/7,230049,6
4,2,23,50,1,1295,1,3,1,1,2,single-choice,spatial-relational,1|2,7,1/2,230050,1
4,2,23,51,1,811,1,9,4,4,5,single-choice,spatial-relational,4|5,7,4/5,230051,4
4,2,23,52,1,1381,1,5,2,2,3,single-choice,spatial-relational,2|3,7,2/3,230052,2
4,2,23,53,1,2445,1,9,4,4,5,single-choice,spatial-relational,4|5,7,4/5,230053,4
4,2,23,54,1,1236,1,13,6,6,7,single-choice,spatial-relational,6|7,7,6/7,230054,6
4,2,23,55,1,2167,1,7,3,3,4,single-choice,spatial-relational,3|4,7,3/4,230055,3
4,2,23,56,1,1162,1,7,3,3,4,single-choice,spatial-relational,3|4,7,3/4,230056,3
4,2,23,57,1,1331,1,3,1,1,2,single-choice,spatial-relational,1|2,7,1/2,230057,1
4,2,23,58,1,1259,1,11,5,5,6,single-choice,spatial-relational,5|6,7,5/6,230058,5
4,2,23,59,1,1576,1,11,5,5,6,single-choice,spatial-relational,5|6,7,5/6,230059,5
4,2,23,60,0,1618,1,5,2,3,3,single-choice,spatial-relational,2|3,7,2/3,230060,2
4,2,23,61,0,926,1,7,3,4,4,single-choice,spatial-relational,3|4,7,3/4,230061,3
4,2,23,62,0,56,1,3,1,2,2,single-choice,spatial-relational,1|2,7,1/2,230062,1
4,2,23,63,1,889,1,9,4,4,5,single-choice,spatial-relational,4|5,7,4/5,230063,4
4,2,23,64,1,2125,1,9,4,4,5,single-choice,spatial-relational,4|5,7,4/5,230064,4
4,2,23,65,1,1153,1,3,1,1,2,single-choice,spatial-relational,1|2,7,1/2,230065,1
4,2,23,66,1,1304,1,11,5,5,6,single-choice,spatial-relational,5|6,7,5/6,230066,5
4,2,23,67,1,1139,1,5,2,2,3,single-choice,spatial-relational,2|3,7,2/3,230067,2
4,2,23,68,1,1147,1,7,3,3,4,single-choice,spatial-relational,3|4,7,3/4,230068,3
4,2,23,69,1,1009,1,5,2,2,3,single-choice,spatial-relational,2|3,7,2/3,230069,2
4,2,23,70,1,2264,1,11,5,5,6,single-choice,spatial-relational,5|6,7,5/6,230070,5
4,2,23,71,1,1307,1,13,6,6,7,single-choice,spatial-relational,6|7,7,6/7,230071,6
4,2,23,72,1,1112,1,13,6,6,7,single-choice,spatial-relational,6|7,7,6/7,230072,6
4,2,23,73,1,1186,1,9,4,4,5,single-choice,spatial-relational,4|5,7,4/5,230073,4
4,2,23,74,0,1389,1,7,3,4,4,single-choice,spatial-relational,3|4,7,3/4,230074,3
4,2,23,75,1,1337,1,5,2,2,3,single-choice,spatial-relational,2|3,7,2/3,230075,2
4,2,23,76,1,1271,1,7,3,3,4,single-choice,spatial-relational,3|4,7,3/4,230076,3
4,2,23,77,1,1100,1,13,6,6,7,single-choice,spatial-relational,6|7,7,6/7,230077,6
4,2,23,78,1,1502,1,5,2,2,3,single-choice,spatial-relational,2|3,7,2/3,230078,2
4,2,23,79,1,1286,1,11,5,5,6,single-choice,spatial-relational,5|6,7,5/6,230079,5
4,2,23,80,1,1719,1,11,5,5,6,single-choice,spatial-relational,5|6,7,5/6,230080,5
4,2,23,81,1,1208,1,3,1,1,2,single-choice,spatial-relational,1|2,7,1/2,230081,1
4,2,23,82,1,1334,1,3,1,1,2,single-choice,spatial-relational,1|2,7,1/2,230082,1
4,2,23,83,1,780,1,13,6,6,7,single-choice,spatial-relational,6|7,7,6/7,230083,6
4,2,23,84,0,1445,1,9,4,5,5,single-choice,spatial-relational,4|5,7,4/5,230084,4
4,2,23,85,1,945,1,3,1,1,2,single-choice,spatial-relational,1|2,7,1/2,230085,1
4,2,23,86,1,954,1,9,4,4,5,single-choice,spatial-relational,4|5,7,4/5,230086,4
4,2,23,87,1,1623,1,7,3,3,4,single-choice,spatial-relational,3|4,7,3/4,230087,3
4,2,23,88,1,852,1,13,6,6,7,single-choice,spatial-relational,6|7,7,6/7,230088,6
4,2,23,89,1,1408,1,11,5,5,6,single-choice,spatial-relational,5|6,7,5/6,230089,5
4,2,23,90,1,1346,1,3,1,1,2,single-choice,spatial-relational,1|2,7,1/2,230090,1
4,2,23,91,1,861,1,13,6,6,7,single-choice,spatial-relational,6|7,7,6/7,230091,6
4,2,23,92,1,1449,1,5,2,2,3,single-choice,spatial-relational,2|3,7,2/3,230092,2
4,2,23,93,1,1050,1,7,3,3,4,single-choice,spatial-relational,3|4,7,3/4,230093,3
4,2,23,94,1,2435,1,5,2,2,3,single-choice,spatial-relational,2|3,7,2/3,230094,2
4,2,23,95,1,1287,1,11,5,5,6,single-choice,spatial-relational,5|6,7,5/6,230095,5
4,2,23,96,1,1492,1,9,4,4,5,single-choice,spatial-relational,4|5,7,4/5,230096,4
4,2,23,97,1,1576,1,9,4,4,5,single-choice,spatial-relational,4|5,7,4/5,230097,4
4,2,23,98,1,1321,1,3,1,1,2,single-choice,spatial-relational,1|2,7,1/2,230098,1
4,2,23,99,1,2059,1,11,5,5,6,single-choice,spatial-relational,5|6,7,5/6,230099,5
4,2,23,100,1,1385,1,5,2,2,3,single-choice,spatial-relational,2|3,7,2/3,230100,2
4,2,23,101,1,1741,1,11,5,5,6,single-choice,spatial-relational,5|6,7,5/6,230101,5
4,2,23,102,1,954,1,7,3,3,4,single-choice,spatial-relational,3|4,7,3/4,230102,3
4,2,23,103,1,1338,1,13,6,6,7,single-choice,spatial-relational,6|7,7,6/7,230103,6
4,2,23,104,1,1234,1,3,1,1,2,single-choice,spatial-relational,1|2,7,1/2,230104,1
4,2,23,105,1,974,1,7,3,3,4,single-choice,spatial-relational,3|4,7,3/4,230105,3
4,2,23,106,0,1145,1,9,4,5,5,single-choice,spatial-relational,4|5,7,4/5,230106,4
4,2,23,107,0,109,1,13,6,7,7,single-choice,spatial-relational,6|7,7,6/7,230107,6
4,2,23,108,1,1023,1,5,2,2,3,single-choice,spatial-relational,2|3,7,2/3,230108,2
4,2,23,109,1,1041,1,7,3,3,4,single-choice,spatial-relational,3|4,7,3/4,230109,3
4,2,23,110,1,974,1,3,1,1,2,single-choice,spatial-relational,1|2,7,1/2,230110,1
4,2,23,111,1,1253,1,11,5,5,6,single-choice,spatial-relational,5|6,7,5/6,230111,5
4,2,23,112,1,1398,1,5,2,2,3,single-choice,spatial-relational,2|3,7,2/3,230112,2
4,2,23,113,1,1012,1,13,6,6,7,single-choice,spatial-relational,6|7,7,6/7,230113,6
4,2,23,114,1,1129,1,3,1,1,2,single-choice,spatial-relational,1|2,7,1/2,230114,1
4,2,23,115,1,791,1,5,2,2,3,single-choice,spatial-relational,2|3,7,2/3,230115,2
4,2,23,116,1,1360,1,9,4,4,5,single-choice,spatial-relational,4|5,7,4/5,230116,4
4,2,23,117,1,896,1,13,6,6,7,single-choice,spatial-relational,6|7,7,6/7,230117,6
4,2,23,118,1,2279,1,11,5,5,6,single-choice,spatial-relational,5|6,7,5/6,230118,5
4,2,23,119,1,961,1,9,4,4,5,single-choice,spatial-relational,4|5,7,4/5,230119,4
4,2,23,120,1,1326,1,7,3,3,4,single-choice,spatial-relational,3|4,7,3/4,230120,3
4,2,23,121,1,1198,1,13,6,6,7,single-choice,spatial-relational,6|7,7,6/7,230121,6
4,2,23,122,1,951,1,5,2,2,3,single-choice,spatial-relational,2|3,7,2/3,230122,2
4,2,23,123,1,1327,1,11,5,5,6,single-choice,spatial-relational,5|6,7,5/6,230123,5
4,2,23,124,0,1157,1,3,1,2,2,single-choice,spatial-relational,1|2,7,1/2,230124,1
4,2,23,125,0,1131,1,11,5,6,6,single-choice,spatial-relational,5|6,7,5/6,230125,5
4,2,23,126,1,877,1,5,2,2,3,single-choice,spatial-relational,2|3,7,2/3,230126,2
4,2,23,127,1,1109,1,9,4,4,5,single-choice,spatial-relational,4|5,7,4/5,230127,4
4,2,23,128,1,977,1,7,3,3,4,single-choice,spatial-relational,3|4,7,3/4,230128,3
4,2,23,129,0,908,1,3,1,2,2,single-choice,spatial-relational,1|2,7,1/2,230129,1
4,2,23,130,1,751,1,9,4,4,5,single-choice,spatial-relational,4|5,7,4/5,230130,4
4,2,23,131,1,1548,1,7,3,3,4,single-choice,spatial-relational,3|4,7,3/4,230131,3
4,2,23,132,1,918,1,13,6,6,7,single-choice,spatial-relational,6|7,7,6/7,230132,6
4,2,23,133,1,1137,1,9,4,4,5,single-choice,spatial-relational,4|5,7,4/5,230133,4
4,2,23,134,1,1231,1,11,5,5,6,single-choice,spatial-relational,5|6,7,5/6,230134,5
4,2,23,135,1,1218,1,13,6,6,7,single-choice,spatial-relational,6|7,7,6/7,230135,6
4,2,23,136,1,1193,1,3,1,1,2,single-choice,spatial-relational,1|2,7,1/2,230136,1
4,2,23,137,1,1523,1,9,4,4,5,single-choice,spatial-relational,4|5,7,4/5,230137,4
4,2,23,138,1,1838,1,5,2,2,3,single-choice,spatial-relational,2|3,7,2/3,230138,2
4,2,23,139,1,1031,1,7,3,3,4,single-choice,spatial-relational,3|4,7,3/4,230139,3
4,2,23,140,1,1655,1,7,3,3,4,single-choice,spatial-relational,3|4,7,3/4,230140,3
4,2,23,141,1,1236,1,11,5,5,6,single-choice,spatial-relational,5|6,7,5/6,230141,5
4,2,23,142,0,951,1,3,1,2,2,single-choice,spatial-relational,1|2,7,1/2,230142,1
4,2,23,143,0,702,1,13,6,7,7,single-choice,spatial-relational,6|7,7,6/7,230143,6
4,2,23,144,0,53,1,5,2,3,3,single-choice,spatial-relational,2|3,7,2/3,230144,2
4,2,23,145,1,1014,1,7,3,3,4,single-choice,spatial-relational,3|4,7,3/4,230145,3
4,2,23,146,1,1269,1,5,2,2,3,single-choice,spatial-relational,2|3,7,2/3,230146,2
4,2,23,147,1,1393,1,3,1,1,2,single-choice,spatial-relational,1|2,7,1/2,230147,1
4,2,23,148,1,778,1,13,6,6,7,single-choice,spatial-relational,6|7,7,6/7,230148,6
4,2,23,149,0,1828,1,5,2,3,3,single-choice,spatial-relational,2|3,7,2/3,230149,2
4,2,23,150,0,774,1,7,3,4,4,single-choice,spatial-relational,3|4,7,3/4,230150,3
4,2,23,151,1,726,1,13,6,6,7,single-choice,spatial-relational,6|7,7,6/7,230151,6
4,2,23,152,1,1192,1,11,5,5,6,single-choice,spatial-relational,5|6,7,5/6,230152,5
4,2,23,153,1,2127,1,11,5,5,6,single-choice,spatial-relational,5|6,7,5/6,230153,5
4,2,23,154,1,1042,1,9,4,4,5,single-choice,spatial-relational,4|5,7,4/5,230154,4
4,2,23,155,1,1356,1,3,1,1,2,single-choice,spatial-relational,1|2,7,1/2,230155,1
4,2,23,156,1,746,1,9,4,4,5,single-choice,spatial-relational,4|5,7,4/5,230156,4
4,2,23,157,1,1181,1,3,1,1,2,single-choice,spatial-relational,1|2,7,1/2,230157,1
4,2,23,158,1,951,1,5,2,2,3,single-choice,spatial-relational,2|3,7,2/3,230158,2
4,2,23,159,0,1675,1,5,2,3,3,single-choice,spatial-relational,2|3,7,2/3,230159,2
4,2,23,160,1,738,1,13,6,6,7,single-choice,spatial-relational,6|7,7,6/7,230160,6
4,2,23,161,0,1159,1,11,5,6,6,single-choice,spatial-relational,5|6,7,5/6,230161,5
4,2,23,162,1,1512,1,7,3,3,4,single-choice,spatial-relational,3|4,7,3/4,230162,3
4,2,23,163,0,1223,1,3,1,2,2,single-choice,spatial-relational,1|2,7,1/2,230163,1
4,2,23,164,1,1211,1,9,4,4,5,single-choice,spatial-relational,4|5,7,4/5,230164,4
4,2,23,165,1,1297,1,11,5,5,6,single-choice,spatial-relational,5|6,7,5/6,230165,5
4,2,23,166,1,796,1,9,4,4,5,single-choice,spatial-relational,4|5,7,4/5,230166,4
4,2,23,167,1,1040,1,7,3,3,4,single-choice,spatial-relational,3|4,7,3/4,230167,3
4,2,23,168,1,932,1,13,6,6,7,single-choice,spatial-relational,6|7,7,6/7,230168,6
4,2,23,169,1,1599,1,7,3,3,4,single-choice,spatial-relational,3|4,7,3/4,230169,3
4,2,23,170,0,1084,1,3,1,2,2,single-choice,spatial-relational,1|2,7,1/2,230170,1
4,2,23,171,1,900,1,13,6,6,7,single-choice,spatial-relational,6|7,7,6/7,230171,6
4,2,23,172,1,1686,1,5,2,2,3,single-choice,spatial-relational,2|3,7,2/3,230172,2
4,2,23,173,1,1220,1,3,1,1,2,single-choice,spatial-relational,1|2,7,1/2,230173,1
4,2,23,174,1,1130,1,11,5,5,6,single-choice,spatial-relational,5|6,7,5/6,230174,5
4,2,23,175,1,900,1,9,4,4,5,single-choice,spatial-relational,4|5,7,4/5,230175,4
4,2,23,176,1,1704,1,7,3,3,4,single-choice,spatial-relational,3|4,7,3/4,230176,3
4,2,23,177,1,733,1,13,6,6,7,single-choice,spatial-relational,6|7,7,6/7,230177,6
4,2,23,178,1,1874,1,9,4,4,5,single-choice,spatial-relational,4|5,7,4/5,230178,4
4,2,23,179,1,1130,1,11,5,5,6,single-choice,spatial-relational,5|6,7,5/6,230179,5
4,2,23,180,0,1640,1,5,2,3,3,single-choice,spatial-relational,2|3,7,2/3,230180,2
4,2,23,181,1,669,1,13,6,6,7,single-choice,spatial-relational,6|7,7,6/7,230181,6
4,2,23,182,1,1573,1,5,2,2,3,single-choice,spatial-relational,2|3,7,2/3,230182,2
4,2,23,183,1,1362,1,5,2,2,3,single-choice,spatial-relational,2|3,7,2/3,230183,2
4,2,23,184,0,1292,1,7,3,4,4,single-choice,spatial-relational,3|4,7,3/4,230184,3
4,2,23,185,1,1217,1,9,4,4,5,single-choice,spatial-relational,4|5,7,4/5,230185,4
4,2,23,186,1,770,1,9,4,4,5,single-choice,spatial-relational,4|5,7,4/5,230186,4
4,2,23,187,1,1099,1,7,3,3,4,single-choice,spatial-relational,3|4,7,3/4,230187,3
4,2,23,188,1,916,1,13,6,6,7,single-choice,spatial-relational,6|7,7,6/7,230188,6
4,2,23,189,1,1299,1,3,1,1,2,single-choice,spatial-relational,1|2,7,1/2,230189,1
4,2,23,190,1,1187,1,11,5,5,6,single-choice,spatial-relational,5|6,7,5/6,230190,5
4,2,23,191,1,1641,1,11,5,5,6,single-choice,spatial-relational,5|6,7,5/6,230191,5
4,2,23,192,1,1440,1,3,1,1,2,single-choice,spatial-relational,1|2,7,1/2,230192,1
4,2,23,193,1,610,1,9,4,4,5,single-choice,spatial-relational,4|5,7,4/5,230193,4
4,2,23,194,1,1260,1,11,5,5,6,single-choice,spatial-relational,5|6,7,5/6,230194,5
4,2,23,195,1,1752,1,5,2,2,3,single-choice,spatial-relational,2|3,7,2/3,230195,2
4,2,23,196,1,1311,1,9,4,4,5,single-choice,spatial-relational,4|5,7,4/5,230196,4
4,2,23,197,1,2331,1,5,2,2,3,single-choice,spatial-relational,2|3,7,2/3,230197,2
4,2,23,198,1,1504,1,3,1,1,2,single-choice,spatial-relational,1|2,7,1/2,230198,1
4,2,23,199,1,986,1,7,3,3,4,single-choice,spatial-relational,3|4,7,3/4,230199,3
4,2,23,200,1,992,1,7,3,3,4,single-choice,spatial-relational,3|4,7,3/4,230200,3
4,2,23,201,1,1253,1,3,1,1,2,single-choice,spatial-relational,1|2,7,1/2,230201,1
4,2,23,202,1,670,1,13,6,6,7,single-choice,spatial-relational,6|7,7,6/7,230202,6
4,2,23,203,1,863,1,13,6,6,7,single-choice,spatial-relational,6|7,7,6/7,230203,6
4,2,23,204,1,1234,1,11,5,5,6,single-choice,spatial-relational,5|6,7,5/6,230204,5
4,2,23,205,0,1079,1,5,2,3,3,single-choice,spatial-relational,2|3,7,2/3,230205,2
4,2,23,206,1,1206,1,7,3,3,4,single-choice,spatial-relational,3|4,7,3/4,230206,3
4,2,23,207,1,1795,1,7,3,3,4,single-choice,spatial-relational,3|4,7,3/4,230207,3
4,2,23,208,1,833,1,13,6,6,7,single-choice,spatial-relational,6|7,7,6/7,230208,6
4,2,23,209,1,790,1,13,6,6,7,single-choice,spatial-relational,6|7,7,6/7,230209,6
4,2,23,210,1,1263,1,9,4,4,5,single-choice,spatial-relational,4|5,7,4/5,230210,4
4,2,23,211,1,1432,1,11,5,5,6,single-choice,spatial-relational,5|6,7,5/6,230211,5
4,2,23,212,1,1444,1,3,1,1,2,single-choice,spatial-relational,1|2,7,1/2,230212,1
4,2,23,213,1,1654,1,11,5,5,6,single-choice,spatial-relational,5|6,7,5/6,230213,5
4,2,23,214,1,1218,1,5,2,2,3,single-choice,spatial-relational,2|3,7,2/3,230214,2
4,2,23,215,1,780,1,9,4,4,5,single-choice,spatial-relational,4|5,7,4/5,230215,4
4,2,23,216,1,1262,1,3,1,1,2,single-choice,spatial-relational,1|2,7,1/2,230216,1
4,2,23,217,0,695,1,7,3,4,4,single-choice,spatial-relational,3|4,7,3/4,230217,3
4,2,23,218,1,1406,1,7,3,3,4,single-choice,spatial-relational,3|4,7,3/4,230218,3
4,2,23,219,1,1346,1,11,5,5,6,single-choice,spatial-relational,5|6,7,5/6,230219,5
4,2,23,220,1,975,1,13,6,6,7,single-choice,spatial-relational,6|7,7,6/7,230220,6
4,2,23,221,1,1918,1,9,4,4,5,single-choice,spatial-relational,4|5,7,4/5,230221,4
4,2,23,222,0,1776,1,5,2,3,3,single-choice,spatial-relational,2|3,7,2/3,230222,2
4,2,23,223,1,810,1,9,4,4,5,single-choice,spatial-relational,4|5,7,4/5,230223,4
4,2,23,224,1,1574,1,3,1,1,2,single-choice,spatial-relational,1|2,7,1/2,230224,1
4,2,23,225,1,1300,1,11,5,5,6,single-choice,spatial-relational,5|6,7,5/6,230225,5
4,2,23,226,0,1018,1,5,2,3,3,single-choice,spatial-relational,2|3,7,2/3,230226,2
4,2,23,227,0,1085,1,3,1,2,2,single-choice,spatial-relational,1|2,7,1/2,230227,1
4,2,23,228,1,875,1,13,6,6,7,single-choice,spatial-relational,6|7,7,6/7,230228,6
4,2,23,229,1,1212,1,5,2,2,3,single-choice,spatial-relational,2|3,7,2/3,230229,2
4,2,23,230,1,810,1,9,4,4,5,single-choice,spatial-relational,4|5,7,4/5,230230,4
4,2,23,231,1,1358,1,7,3,3,4,single-choice,spatial-relational,3|4,7,3/4,230231,3
4,2,23,232,1,839,1,13,6,6,7,single-choice,spatial-relational,6|7,7,6/7,230232,6
4,2,23,233,1,1221,1,3,1,1,2,single-choice,spatial-relational,1|2,7,1/2,230233,1
4,2,23,234,1,810,1,13,6,6,7,single-choice,spatial-relational,6|7,7,6/7,230234,6
4,2,23,235,1,1479,1,3,1,1,2,single-choice,spatial-relational,1|2,7,1/2,230235,1
4,2,23,236,1,1374,1,11,5,5,6,single-choice,spatial-relational,5|6,7,5/6,230236,5
4,2,23,237,1,1155,1,11,5,5,6,single-choice,spatial-relational,5|6,7,5/6,230237,5
4,2,23,238,0,1824,1,5,2,3,3,single-choice,spatial-relational,2|3,7,2/3,230238,2
4,2,23,239,0,694,1,7,3,4,4,single-choice,spatial-relational,3|4,7,3/4,230239,3
4,2,23,240,1,1015,1,9,4,4,5,single-choice,spatial-relational,4|5,7,4/5,230240,4
4,2,23,241,1,1358,1,5,2,2,3,single-choice,spatial-relational,2|3,7,2/3,230241,2
4,2,23,242,1,1186,1,11,5,5,6,single-choice,spatial-relational,5|6,7,5/6,230242,5
4,2,23,243,1,904,1,13,6,6,7,single-choice,spatial-relational,6|7,7,6/7,230243,6
4,2,23,244,1,1457,1,9,4,4,5,single-choice,spatial-relational,4|5,7,4/5,230244,4
4,2,23,245,1,1229,1,3,1,1,2,single-choice,spatial-relational,1|2,7,1/2,230245,1
4,2,23,246,1,974,1,7,3,3,4,single-choice,spatial-relational,3|4,7,3/4,230246,3
4,2,23,247,0,1140,1,7,3,4,4,single-choice,spatial-relational,3|4,7,3/4,230247,3
4,2,23,248,1,928,1,9,4,4,5,single-choice,spatial-relational,4|5,7,4/5,230248,4
4,2,23,249,1,1158,1,11,5,5,6,single-choice,spatial-relational,5|6,7,5/6,230249,5
4,2,23,250,1,1738,1,3,1,1,2,single-choice,spatial-relational,1|2,7,1/2,230250,1
4,2,23,251,1,766,1,13,6,6,7,single-choice,spatial-relational,6|7,7,6/7,230251,6
4,2,23,252,1,1452,1,5,2,2,3,single-choice,spatial-relational,2|3,7,2/3,230252,2
4,2,23,253,1,1348,1,5,2,2,3,single-choice,spatial-relational,2|3,7,2/3,230253,2
4,2,23,254,1,1060,1,7,3,3,4,single-choice,spatial-relational,3|4,7,3/4,230254,3
4,2,23,255,1,1256,1,13,6,6,7,single-choice,spatial-relational,6|7,7,6/7,230255,6
4,2,23,256,0,991,1,3,1,2,2,single-choice,spatial-relational,1|2,7,1/2,230256,1
4,2,23,257,1,1317,1,3,1,1,2,single-choice,spatial-relational,1|2,7,1/2,230257,1
4,2,23,258,1,1010,1,11,5,5,6,single-choice,spatial-relational,5|6,7,5/6,230258,5
4,2,23,259,1,1122,1,9,4,4,5,single-choice,spatial-relational,4|5,7,4/5,230259,4
4,2,23,260,1,1086,1,11,5,5,6,single-choice,spatial-relational,5|6,7,5/6,230260,5
4,2,23,261,1,968,1,13,6,6,7,single-choice,spatial-relational,6|7,7,6/7,230261,6
4,2,23,262,1,2630,1,5,2,2,3,single-choice,spatial-relational,2|3,7,2/3,230262,2
4,2,23,263,1,2093,1,7,3,3,4,single-choice,spatial-relational,3|4,7,3/4,230263,3
4,2,23,264,1,932,1,9,4,4,5,single-choice,spatial-relational,4|5,7,4/5,230264,4
4,2,23,265,1,1862,1,7,3,3,4,single-choice,spatial-relational,3|4,7,3/4,230265,3
4,2,23,266,1,1563,1,3,1,1,2,single-choice,spatial-relational,1|2,7,1/2,230266,1
4,2,23,267,1,1292,1,3,1,1,2,single-choice,spatial-relational,1|2,7,1/2,230267,1
4,2,23,268,1,949,1,7,3,3,4,single-choice,spatial-relational,3|4,7,3/4,230268,3
4,2,23,269,1,1313,1,9,4,4,5,single-choice,spatial-relational,4|5,7,4/5,230269,4
4,2,23,270,1,1200,1,5,2,2,3,single-choice,spatial-relational,2|3,7,2/3,230270,2
4,2,23,271,1,929,1,13,6,6,7,single-choice,spatial-relational,6|7,7,6/7,230271,6
4,2,23,272,1,1398,1,13,6,6,7,single-choice,spatial-relational,6|7,7,6/7,230272,6
4,2,23,273,1,1374,1,9,4,4,5,single-choice,spatial-relational,4|5,7,4/5,230273,4
4,2,23,274,1,1432,1,11,5,5,6,single-choice,spatial-relational,5|6,7,5/6,230274,5
4,2,23,275,1,1947,1,11,5,5,6,single-choice,spatial-relational,5|6,7,5/6,230275,5
4,2,23,276,1,2078,1,5,2,2,3,single-choice,spatial-relational,2|3,7,2/3,230276,2
4,2,23,277,1,1181,1,3,1,1,2,single-choice,spatial-relational,1|2,7,1/2,230277,1
4,2,23,278,0,1028,1,3,1,2,2,single-choice,spatial-relational,1|2,7,1/2,230278,1
4,2,23,279,1,861,1,13,6,6,7,single-choice,spatial-relational,6|7,7,6/7,230279,6
4,2,23,280,1,971,1,13,6,6,7,single-choice,spatial-relational,6|7,7,6/7,230280,6
4,2,23,281,0,1466,1,11,5,6,6,single-choice,spatial-relational,5|6,7,5/6,230281,5
4,2,23,282,1,1376,1,11,5,5,6,single-choice,spatial-relational,5|6,7,5/6,230282,5
4,2,23,283,1,1064,1,9,4,4,5,single-choice,spatial-relational,4|5,7,4/5,230283,4
4,2,23,284,1,1280,1,7,3,3,4,single-choice,spatial-relational,3|4,7,3/4,230284,3
4,2,23,285,0,1068,1,9,4,5,5,single-choice,spatial-relational,4|5,7,4/5,230285,4
4,2,23,286,0,721,1,7,3,4,4,single-choice,spatial-relational,3|4,7,3/4,230286,3
4,2,23,287,0,819,1,5,2,3,3,single-choice,spatial-relational,2|3,7,2/3,230287,2
4,2,23,288,0,875,1,5,2,3,3,single-choice,spatial-relational,2|3,7,2/3,230288,2
4,2,23,289,1,1429,1,11,5,5,6,single-choice,spatial-relational,5|6,7,5/6,230289,5
4,2,23,290,1,1341,1,3,1,1,2,single-choice,spatial-relational,1|2,7,1/2,230290,1
4,2,23,291,1,802,1,5,2,2,3,single-choice,spatial-relational,2|3,7,2/3,230291,2
4,2,23,292,1,1366,1,7,3,3,4,single-choice,spatial-relational,3|4,7,3/4,230292,3
4,2,23,293,1,1380,1,3,1,1,2,single-choice,spatial-relational,1|2,7,1/2,230293,1
4,2,23,294,1,1142,1,7,3,3,4,single-choice,spatial-relational,3|4,7,3/4,230294,3
4,2,23,295,1,1376,1,11,5,5,6,single-choice,spatial-relational,5|6,7,5/6,230295,5
4,2,23,296,1,978,1,13,6,6,7,single-choice,spatial-relational,6|7,7,6/7,230296,6
4,2,23,297,1,980,1,9,4,4,5,single-choice,spatial-relational,4|5,7,4/5,230297,4
4,2,23,298,1,1023,1,9,4,4,5,single-choice,spatial-relational,4|5,7,4/5,230298,4
4,2,23,299,1,980,1,13,6,6,7,single-choice,spatial-relational,6|7,7,6/7,230299,6
4,2,23,300,1,1379,1,5,2,2,3,single-choice,spatial-relational,2|3,7,2/3,230300,2
4,2,23,301,1,1437,1,5,2,2,3,single-choice,spatial-relational,2|3,7,2/3,230301,2
4,2,23,302,1,1279,1,7,3,3,4,single-choice,spatial-relational,3|4,7,3/4,230302,3
4,2,23,303,0,1496,1,11,5,6,6,single-choice,spatial-relational,5|6,7,5/6,230303,5
4,2,23,304,1,1137,1,3,1,1,2,single-choice,spatial-relational,1|2,7,1/2,230304,1
4,2,23,305,1,730,1,13,6,6,7,single-choice,spatial-relational,6|7,7,6/7,230305,6
4,2,23,306,1,1751,1,9,4,4,5,single-choice,spatial-relational,4|5,7,4/5,230306,4
4,2,23,307,1,1710,1,9,4,4,5,single-choice,spatial-relational,4|5,7,4/5,230307,4
4,2,23,308,1,1142,1,3,1,1,2,single-choice,spatial-relational,1|2,7,1/2,230308,1
4,2,23,309,1,846,1,13,6,6,7,single-choice,spatial-relational,6|7,7,6/7,230309,6
4,2,23,310,1,1131,1,7,3,3,4,single-choice,spatial-relational,3|4,7,3/4,230310,3
4,2,23,311,1,1504,1,11,5,5,6,single-choice,spatial-relational,5|6,7,5/6,230311,5
4,2,23,312,1,1230,1,5,2,2,3,single-choice,spatial-relational,2|3,7,2/3,230312,2
4,2,23,313,1,912,1,9,4,4,5,single-choice,spatial-relational,4|5,7,4/5,230313,4
4,2,23,314,1,1179,1,11,5,5,6,single-choice,spatial-relational,5|6,7,5/6,230314,5
4,2,23,315,1,1345,1,5,2,2,3,single-choice,spatial-relational,2|3,7,2/3,230315,2
4,2,23,316,1,1512,1,7,3,3,4,single-choice,spatial-relational,3|4,7,3/4,230316,3
4,2,23,317,1,990,1,13,6,6,7,single-choice,spatial-relational,6|7,7,6/7,230317,6
4,2,23,318,1,1252,1,7,3,3,4,single-choice,spatial-relational,3|4,7,3/4,230318,3
4,2,23,319,1,1373,1,13,6,6,7,single-choice,spatial-relational,6|7,7,6/7,230319,6
4,2,23,320,1,1211,1,9,4,4,5,single-choice,spatial-relational,4|5,7,4/5,230320,4
4,2,23,321,1,1413,1,11,5,5,6,single-choice,spatial-relational,5|6,7,5/6,230321,5
4,2,23,322,0,982,1,3,1,2,2,single-choice,spatial-relational,1|2,7,1/2,230322,1
4,2,23,323,1,1978,1,5,2,2,3,single-choice,spatial-relational,2|3,7,2/3,230323,2
4,2,23,324,1,979,1,3,1,1,2,single-choice,spatial-relational,1|2,7,1/2,230324,1
4,2,23,325,0,1668,1,5,2,3,3,single-choice,spatial-relational,2|3,7,2/3,230325,2
4,2,23,326,1,1560,1,5,2,2,3,single-choice,spatial-relational,2|3,7,2/3,230326,2
4,2,23,327,1,1102,1,7,3,3,4,single-choice,spatial-relational,3|4,7,3/4,230327,3
4,2,23,328,1,903,1,13,6,6,7,single-choice,spatial-relational,6|7,7,6/7,230328,6
4,2,23,329,1,980,1,11,5,5,6,single-choice,spatial-relational,5|6,7,5/6,230329,5
4,2,23,330,1,994,1,13,6,6,7,single-choice,spatial-relational,6|7,7,6/7,230330,6
4,2,23,331,0,1753,1,7,3,4,4,single-choice,spatial-relational,3|4,7,3/4,230331,3
4,2,23,332,1,1012,1,11,5,5,6,single-choice,spatial-relational,5|6,7,5/6,230332,5
4,2,23,333,1,1187,1,9,4,4,5,single-choice,spatial-relational,4|5,7,4/5,230333,4
4,2,23,334,1,2179,1,9,4,4,5,single-choice,spatial-relational,4|5,7,4/5,230334,4
4,2,23,335,1,1467,1,3,1,1,2,single-choice,spatial-relational,1|2,7,1/2,230335,1
4,2,23,336,1,1279,1,3,1,1,2,single-choice,spatial-relational,1|2,7,1/2,230336,1
4,2,23,337,0,937,1,3,1,2,2,single-choice,spatial-relational,1|2,7,1/2,230337,1
4,2,23,338,0,1147,1,5,2,3,3,single-choice,spatial-relational,2|3,7,2/3,230338,2
4,2,23,339,0,90,1,7,3,4,4,single-choice,spatial-relational,3|4,7,3/4,230339,3
4,2,23,340,1,1024,1,3,1,1,2,single-choice,spatial-relational,1|2,7,1/2,230340,1
4,2,23,341,1,1142,1,7,3,3,4,single-choice,spatial-relational,3|4,7,3/4,230341,3
4,2,23,342,1,794,1,13,6,6,7,single-choice,spatial-relational,6|7,7,6/7,230342,6
4,2,23,343,1,879,1,13,6,6,7,single-choice,spatial-relational,6|7,7,6/7,230343,6
4,2,23,344,0,981,1,9,4,5,5,single-choice,spatial-relational,4|5,7,4/5,230344,4
4,2,23,345,1,1012,1,11,5,5,6,single-choice,spatial-relational,5|6,7,5/6,230345,5
4,2,23,346,1,1008,1,9,4,4,5,single-choice,spatial-relational,4|5,7,4/5,230346,4
4,2,23,347,1,1268,1,11,5,5,6,single-choice,spatial-relational,5|6,7,5/6,230347,5
4,2,23,348,0,1229,1,5,2,3,3,single-choice,spatial-relational,2|3,7,2/3,230348,2
4,2,23,349,1,1015,1,3,1,1,2,single-choice,spatial-relational,1|2,7,1/2,230349,1
4,2,23,350,1,794,1,13,6,6,7,single-choice,spatial-relational,6|7,7,6/7,230350,6
4,2,23,351,1,1187,1,7,3,3,4,single-choice,spatial-relational,3|4,7,3/4,230351,3
4,2,23,352,0,1535,1,9,4,5,5,single-choice,spatial-relational,4|5,7,4/5,230352,4
4,2,23,353,1,1356,1,11,5,5,6,single-choice,spatial-relational,5|6,7,5/6,230353,5
4,2,23,354,1,1190,1,11,5,5,6,single-choice,spatial-relational,5|6,7,5/6,230354,5
4,2,23,355,1,918,1,3,1,1,2,single-choice,spatial-relational,1|2,7,1/2,230355,1
4,2,23,356,1,1298,1,9,4,4,5,single-choice,spatial-relational,4|5,7,4/5,230356,4
4,2,23,357,1,844,1,7,3,3,4,single-choice,spatial-relational,3|4,7,3/4,230357,3
4,2,23,358,1,1715,1,5,2,2,3,single-choice,spatial-relational,2|3,7,2/3,230358,2
4,2,23,359,1,889,1,13,6,6,7,single-choice,spatial-relational,6|7,7,6/7,230359,6
4,2,23,360,0,1744,1,5,2,3,3,single-choice,spatial-relational,2|3,7,2/3,230360,2
4,2,23,361,0,870,1,5,2,3,3,single-choice,spatial-relational,2|3,7,2/3,230361,2
4,2,23,362,1,752,1,9,4,4,5,single-choice,spatial-relational,4|5,7,4/5,230362,4
4,2,23,363,1,1459,1,11,5,5,6,single-choice,spatial-relational,5|6,7,5/6,230363,5
4,2,23,364,0,1038,1,7,3,4,4,single-choice,spatial-relational,3|4,7,3/4,230364,3
4,2,23,365,1,720,1,13,6,6,7,single-choice,spatial-relational,6|7,7,6/7,230365,6
4,2,23,366,1,1108,1,11,5,5,6,single-choice,spatial-relational,5|6,7,5/6,230366,5
4,2,23,367,1,1562,1,5,2,2,3,single-choice,spatial-relational,2|3,7,2/3,230367,2
4,2,23,368,1,779,1,13,6,6,7,single-choice,spatial-relational,6|7,7,6/7,230368,6
4,2,23,369,1,1152,1,3,1,1,2,single-choice,spatial-relational,1|2,7,1/2,230369,1
4,2,23,370,1,1040,1,7,3,3,4,single-choice,spatial-relational,3|4,7,3/4,230370,3
4,2,23,371,1,1737,1,3,1,1,2,single-choice,spatial-relational,1|2,7,1/2,230371,1
4,2,23,372,0,1198,1,9,4,5,5,single-choice,spatial-relational,4|5,7,4/5,230372,4
4,2,23,373,1,778,1,7,3,3,4,single-choice,spatial-relational,3|4,7,3/4,230373,3
4,2,23,374,1,984,1,13,6,6,7,single-choice,spatial-relational,6|7,7,6/7,230374,6
4,2,23,375,1,1215,1,3,1,1,2,single-choice,spatial-relational,1|2,7,1/2,230375,1
4,2,23,376,1,845,1,3,1,1,2,single-choice,spatial-relational,1|2,7,1/2,230376,1
4,2,23,377,1,997,1,11,5,5,6,single-choice,spatial-relational,5|6,7,5/6,230377,5
4,2,23,378,0,2136,1,5,2,3,3,single-choice,spatial-relational,2|3,7,2/3,230378,2
4,2,23,379,1,2166,1,9,4,4,5,single-choice,spatial-relational,4|5,7,4/5,230379,4
4,2,23,380,1,1346,1,9,4,4,5,single-choice,spatial-relational,4|5,7,4/5,230380,4
4,2,23,381,1,1038,1,13,6,6,7,single-choice,spatial-relational,6|7,7,6/7,230381,6
4,2,23,382,1,1211,1,5,2,2,3,single-choice,spatial-relational,2|3,7,2/3,230382,2
4,2,23,383,1,1172,1,11,5,5,6,single-choice,spatial-relational,5|6,7,5/6,230383,5
4,2,23,384,0,1072,1,7,3,4,4,single-choice,spatial-relational,3|4,7,3/4,230384,3
4,2,23,385,1,833,1,7,3,3,4,single-choice,spatial-relational,3|4,7,3/4,230385,3
4,2,23,386,1,1395,1,3,1,1,2,single-choice,spatial-relational,1|2,7,1/2,230386,1
4,2,23,387,1,1014,1,7,3,3,4,single-choice,spatial-relational,3|4,7,3/4,230387,3
4,2,23,388,1,943,1,11,5,5,6,single-choice,spatial-relational,5|6,7,5/6,230388,5
4,2,23,389,1,918,1,13,6,6,7,single-choice,spatial-relational,6|7,7,6/7,230389,6
4,2,23,390,1,1693,1,5,2,2,3,single-choice,spatial-relational,2|3,7,2/3,230390,2
4,2,23,391,1,902,1,13,6,6,7,single-choice,spatial-relational,6|7,7,6/7,230391,6
4,2,23,392,1,1366,1,11,5,5,6,single-choice,spatial-relational,5|6,7,5/6,230392,5
4,2,23,393,1,1802,1,9,4,4,5,single-choice,spatial-relational,4|5,7,4/5,230393,4
4,2,23,394,1,1383,1,3,1,1,2,single-choice,spatial-relational,1|2,7,1/2,230394,1
4,2,23,395,0,884,1,5,2,3,3,single-choice,spatial-relational,2|3,7,2/3,230395,2
4,2,23,396,1,945,1,9,4,4,5,single-choice,spatial-relational,4|5,7,4/5,230396,4
4,2,23,397,0,1113,1,9,4,5,5,single-choice,spatial-relational,4|5,7,4/5,230397,4
4,2,23,398,1,834,1,11,5,5,6,single-choice,spatial-relational,5|6,7,5/6,230398,5
4,2,23,399,1,1150,1,7,3,3,4,single-choice,spatial-relational,3|4,7,3/4,230399,3
4,2,23,400,1,1624,1,3,1,1,2,single-choice,spatial-relational,1|2,7,1/2,230400,1
4,2,23,401,1,1072,1,3,1,1,2,single-choice,spatial-relational,1|2,7,1/2,230401,1
4,2,23,402,1,724,1,13,6,6,7,single-choice,spatial-relational,6|7,7,6/7,230402,6
4,2,23,403,1,1059,1,5,2,2,3,single-choice,spatial-relational,2|3,7,2/3,230403,2
4,2,23,404,1,1815,1,9,4,4,5,single-choice,spatial-relational,4|5,7,4/5,230404,4
4,2,23,405,0,1142,1,5,2,3,3,single-choice,spatial-relational,2|3,7,2/3,230405,2
4,2,23,406,1,801,1,13,6,6,7,single-choice,spatial-relational,6|7,7,6/7,230406,6
4,2,23,407,1,1323,1,11,5,5,6,single-choice,spatial-relational,5|6,7,5/6,230407,5
4,2,23,408,1,1515,1,7,3,3,4,single-choice,spatial-relational,3|4,7,3/4,230408,3
4,2,23,409,1,1026,1,13,6,6,7,single-choice,spatial-relational,6|7,7,6/7,230409,6
4,2,23,410,1,1157,1,5,2,2,3,single-choice,spatial-relational,2|3,7,2/3,230410,2
4,2,23,411,0,1329,1,9,4,5,5,single-choice,spatial-relational,4|5,7,4/5,230411,4
4,2,23,412,1,126,1,9,4,4,5,single-choice,spatial-relational,4|5,7,4/5,230412,4
4,2,23,413,1,1548,1,3,1,1,2,single-choice,spatial-relational,1|2,7,1/2,230413,1
4,2,23,414,1,933,1,7,3,3,4,single-choice,spatial-relational,3|4,7,3/4,230414,3
4,2,23,415,1,1571,1,11,5,5,6,single-choice,spatial-relational,5|6,7,5/6,230415,5
4,2,23,416,1,1308,1,3,1,1,2,single-choice,spatial-relational,1|2,7,1/2,230416,1
4,2,23,417,1,1119,1,11,5,5,6,single-choice,spatial-relational,5|6,7,5/6,230417,5
4,2,23,418,1,1155,1,7,3,3,4,single-choice,spatial-relational,3|4,7,3/4,230418,3
4,2,23,419,1,888,1,13,6,6,7,single-choice,spatial-relational,6|7,7,6/7,230419,6
4,2,23,420,1,1858,1,5,2,2,3,single-choice,spatial-relational,2|3,7,2/3,230420,2
4,2,23,421,1,1283,1,11,5,5,6,single-choice,spatial-relational,5|6,7,5/6,230421,5
4,2,23,422,1,951,1,13,6,6,7,single-choice,spatial-relational,6|7,7,6/7,230422,6
4,2,23,423,0,1689,1,7,3,4,4,single-choice,spatial-relational,3|4,7,3/4,230423,3
4,2,23,424,1,1401,1,9,4,4,5,single-choice,spatial-relational,4|5,7,4/5,230424,4
4,2,23,425,1,1206,1,7,3,3,4,single-choice,spatial-relational,3|4,7,3/4,230425,3
4,2,23,426,1,849,1,13,6,6,7,single-choice,spatial-relational,6|7,7,6/7,230426,6
4,2,23,427,1,1291,1,3,1,1,2,single-choice,spatial-relational,1|2,7,1/2,230427,1
4,2,23,428,1,1348,1,5,2,2,3,single-choice,spatial-relational,2|3,7,2/3,230428,2
4,2,23,429,0,1328,1,9,4,5,5,single-choice,spatial-relational,4|5,7,4/5,230429,4
4,2,23,430,1,1403,1,11,5,5,6,single-choice,spatial-relational,5|6,7,5/6,230430,5
4,2,23,431,0,1265,1,5,2,3,3,single-choice,spatial-relational,2|3,7,2/3,230431,2
4,2,23,432,1,1326,1,3,1,1,2,single-choice,spatial-relational,1|2,7,1/2,230432,1
4,2,23,433,0,1018,1,5,2,3,3,single-choice,spatial-relational,2|3,7,2/3,230433,2
4,2,23,434,1,1582,1,3,1,1,2,single-choice,spatial-relational,1|2,7,1/2,230434,1
4,2,23,435,1,1069,1,9,4,4,5,single-choice,spatial-relational,4|5,7,4/5,230435,4
4,2,23,436,1,840,1,13,6,6,7,single-choice,spatial-relational,6|7,7,6/7,230436,6
4,2,23,437,1,1743,1,5,2,2,3,single-choice,spatial-relational,2|3,7,2/3,230437,2
4,2,23,438,0,1285,1,9,4,5,5,single-choice,spatial-relational,4|5,7,4/5,230438,4
4,2,23,439,1,1000,1,7,3,3,4,single-choice,spatial-relational,3|4,7,3/4,230439,3
4,2,23,440,1,1249,1,7,3,3,4,single-choice,spatial-relational,3|4,7,3/4,230440,3
4,2,23,441,1,923,1,13,6,6,7,single-choice,spatial-relational,6|7,7,6/7,230441,6
4,2,23,442,0,1623,1,11,5,6,6,single-choice,spatial-relational,5|6,7,5/6,230442,5
4,2,23,443,1,962,1,11,5,5,6,single-choice,spatial-relational,5|6,7,5/6,230443,5
4,2,23,444,1,1406,1,3,1,1,2,single-choice,spatial-relational,1|2,7,1/2,230444,1
4,2,23,445,1,1003,1,11,5,5,6,single-choice,spatial-relational,5|6,7,5/6,230445,5
4,2,23,446,1,1070,1,3,1,1,2,single-choice,spatial-relational,1|2,7,1/2,230446,1
4,2,23,447,1,828,1,13,6,6,7,single-choice,spatial-relational,6|7,7,6/7,230447,6
4,2,23,448,1,985,1,13,6,6,7,single-choice,spatial-relational,6|7,7,6/7,230448,6
4,2,23,449,1,969,1,7,3,3,4,single-choice,spatial-relational,3|4,7,3/4,230449,3
4,2,23,450,1,1031,1,3,1,1,2,single-choice,spatial-relational,1|2,7,1/2,230450,1
4,2,23,451,1,1191,1,5,2,2,3,single-choice,spatial-relational,2|3,7,2/3,230451,2
4,2,23,452,1,1362,1,11,5,5,6,single-choice,spatial-relational,5|6,7,5/6,230452,5
4,2,23,453,1,1246,1,9,4,4,5,single-choice,spatial-relational,4|5,7,4/5,230453,4
4,2,23,454,1,1547,1,9,4,4,5,single-choice,spatial-relational,4|5,7,4/5,230454,4
4,2,23,455,1,1165,1,7,3,3,4,single-choice,spatial-relational,3|4,7,3/4,230455,3
4,2,23,456,1,1988,1,5,2,2,3,single-choice,spatial-relational,2|3,7,2/3,230456,2
4,2,23,457,1,963,1,3,1,1,2,single-choice,spatial-relational,1|2,7,1/2,230457,1
4,2,23,458,1,826,1,11,5,5,6,single-choice,spatial-relational,5|6,7,5/6,230458,5
4,2,23,459,1,1358,1,9,4,4,5,single-choice,spatial-relational,4|5,7,4/5,230459,4
4,2,23,460,1,1141,1,7,3,3,4,single-choice,spatial-relational,3|4,7,3/4,230460,3
4,2,23,461,0,1018,1,13,6,7,7,single-choice,spatial-relational,6|7,7,6/7,230461,6
4,2,23,462,1,1682,1,9,4,4,5,single-choice,spatial-relational,4|5,7,4/5,230462,4
4,2,23,463,1,1100,1,3,1,1,2,single-choice,spatial-relational,1|2,7,1/2,230463,1
4,2,23,464,0,1023,1,5,2,3,3,single-choice,spatial-relational,2|3,7,2/3,230464,2
4,2,23,465,1,989,1,11,5,5,6,single-choice,spatial-relational,5|6,7,5/6,230465,5
4,2,23,466,0,1090,1,5,2,3,3,single-choice,spatial-relational,2|3,7,2/3,230466,2
4,2,23,467,1,770,1,13,6,6,7,single-choice,spatial-relational,6|7,7,6/7,230467,6
4,2,23,468,1,993,1,7,3,3,4,single-choice,spatial-relational,3|4,7,3/4,230468,3
4,2,23,469,1,1182,1,11,5,5,6,single-choice,spatial-relational,5|6,7,5/6,230469,5
4,2,23,470,1,1080,1,13,6,6,7,single-choice,spatial-relational,6|7,7,6/7,230470,6
4,2,23,471,1,1550,1,9,4,4,5,single-choice,spatial-relational,4|5,7,4/5,230471,4
4,2,23,472,1,1385,1,9,4,4,5,single-choice,spatial-relational,4|5,7,4/5,230472,4
4,2,23,473,0,889,1,5,2,3,3,single-choice,spatial-relational,2|3,7,2/3,230473,2
4,2,23,474,1,904,1,7,3,3,4,single-choice,spatial-relational,3|4,7,3/4,230474,3
4,2,23,475,1,1239,1,5,2,2,3,single-choice,spatial-relational,2|3,7,2/3,230475,2
4,2,23,476,1,1374,1,3,1,1,2,single-choice,spatial-relational,1|2,7,1/2,230476,1
4,2,23,477,1,1025,1,13,6,6,7,single-choice,spatial-relational,6|7,7,6/7,230477,6
4,2,23,478,0,1014,1,11,5,6,6,single-choice,spatial-relational,5|6,7,5/6,230478,5
4,2,23,479,1,16,1,7,3,3,4,single-choice,spatial-relational,3|4,7,3/4,230479,3
4,2,23,480,1,142,1,3,1,1,2,single-choice,spatial-relational,1|2,7,1/2,230480,1
4,2,23,481,1,1111,1,11,5,5,6,single-choice,spatial-relational,5|6,7,5/6,230481,5
4,2,23,482,0,1450,1,3,1,2,2,single-choice,spatial-relational,1|2,7,1/2,230482,1
4,2,23,483,1,794,1,13,6,6,7,single-choice,spatial-relational,6|7,7,6/7,230483,6
4,2,23,484,0,2631,1,9,4,5,5,single-choice,spatial-relational,4|5,7,4/5,230484,4
4,2,23,485,1,981,1,7,3,3,4,single-choice,spatial-relational,3|4,7,3/4,230485,3
4,2,23,486,1,1356,1,13,6,6,7,single-choice,spatial-relational,6|7,7,6/7,230486,6
4,2,23,487,1,1032,1,3,1,1,2,single-choice,spatial-relational,1|2,7,1/2,230487,1
4,2,23,488,1,1380,1,5,2,2,3,single-choice,spatial-relational,2|3,7,2/3,230488,2
4,2,23,489,1,1385,1,9,4,4,5,single-choice,spatial-relational,4|5,7,4/5,230489,4
4,2,23,490,0,1520,1,11,5,6,6,single-choice,spatial-relational,5|6,7,5/6,230490,5
4,2,23,491,1,936,1,7,3,3,4,single-choice,spatial-relational,3|4,7,3/4,230491,3
4,2,23,492,1,2532,1,5,2,2,3,single-choice,spatial-relational,2|3,7,2/3,230492,2
4,2,23,493,1,1172,1,5,2,2,3,single-choice,spatial-relational,2|3,7,2/3,230493,2
4,2,23,494,1,1212,1,3,1,1,2,single-choice,spatial-relational,1|2,7,1/2,230494,1
4,2,23,495,1,817,1,13,6,6,7,single-choice,spatial-relational,6|7,7,6/7,230495,6
4,2,23,496,1,1086,1,9,4,4,5,single-choice,spatial-relational,4|5,7,4/5,230496,4
4,2,23,497,1,1103,1,7,3,3,4,single-choice,spatial-relational,3|4,7,3/4,230497,3
4,2,23,498,1,1119,1,11,5,5,6,single-choice,spatial-relational,5|6,7,5/6,230498,5
4,2,23,499,1,890,1,13,6,6,7,single-choice,spatial-relational,6|7,7,6/7,230499,6
4,2,23,500,1,909,1,7,3,3,4,single-choice,spatial-relational,3|4,7,3/4,230500,3
4,2,23,501,1,1186,1,5,2,2,3,single-choice,spatial-relational,2|3,7,2/3,230501,2
4,2,23,502,1,1488,1,3,1,1,2,single-choice,spatial-relational,1|2,7,1/2,230502,1
4,2,23,503,1,1238,1,11,5,5,6,single-choice,spatial-relational,5|6,7,5/6,230503,5
4,2,23,504,0,1035,1,9,4,5,5,single-choice,spatial-relational,4|5,7,4/5,230504,4
4,2,23,505,1,945,1,7,3,3,4,single-choice,spatial-relational,3|4,7,3/4,230505,3
4,2,23,506,1,911,1,13,6,6,7,single-choice,spatial-relational,6|7,7,6/7,230506,6
4,2,23,507,1,1615,1,9,4,4,5,single-choice,spatial-relational,4|5,7,4/5,230507,4
4,2,23,508,1,1328,1,5,2,2,3,single-choice,spatial-relational,2|3,7,2/3,230508,2
4,2,23,509,0,880,1,5,2,3,3,single-choice,spatial-relational,2|3,7,2/3,230509,2
4,2,23,510,1,790,1,3,1,1,2,single-choice,spatial-relational,1|2,7,1/2,230510,1
4,2,23,511,1,896,1,11,5,5,6,single-choice,spatial-relational,5|6,7,5/6,230511,5
4,2,23,512,1,1049,1,3,1,1,2,single-choice,spatial-relational,1|2,7,1/2,230512,1
4,2,23,513,1,964,1,7,3,3,4,single-choice,spatial-relational,3|4,7,3/4,230513,3
4,2,23,514,1,1546,1,9,4,4,5,single-choice,spatial-relational,4|5,7,4/5,230514,4
4,2,23,515,1,1308,1,11,5,5,6,single-choice,spatial-relational,5|6,7,5/6,230515,5
4,2,23,516,1,835,1,13,6,6,7,single-choice,spatial-relational,6|7,7,6/7,230516,6
4,2,23,517,1,1160,1,11,5,5,6,single-choice,spatial-relational,5|6,7,5/6,230517,5
4,2,23,518,1,1080,1,9,4,4,5,single-choice,spatial-relational,4|5,7,4/5,230518,4
4,2,23,519,1,1127,1,3,1,1,2,single-choice,spatial-relational,1|2,7,1/2,230519,1
4,2,23,520,0,1312,1,7,3,4,4,single-choice,spatial-relational,3|4,7,3/4,230520,3
4,2,23,521,0,1103,1,11,5,6,6,single-choice,spatial-relational,5|6,7,5/6,230521,5
4,2,23,522,1,1635,1,5,2,2,3,single-choice,spatial-relational,2|3,7,2/3,230522,2
4,2,23,523,0,972,1,3,1,2,2,single-choice,spatial-relational,1|2,7,1/2,230523,1
4,2,23,524,0,834,1,5,2,3,3,single-choice,spatial-relational,2|3,7,2/3,230524,2
4,2,23,525,1,767,1,13,6,6,7,single-choice,spatial-relational,6|7,7,6/7,230525,6
4,2,23,526,1,1504,1,7,3,3,4,single-choice,spatial-relational,3|4,7,3/4,230526,3
4,2,23,527,1,925,1,9,4,4,5,single-choice,spatial-relational,4|5,7,4/5,230527,4
4,2,23,528,1,986,1,13,6,6,7,single-choice,spatial-relational,6|7,7,6/7,230528,6
4,2,23,529,0,1497,1,5,2,3,3,single-choice,spatial-relational,2|3,7,2/3,230529,2
4,2,23,530,1,972,1,5,2,2,3,single-choice,spatial-relational,2|3,7,2/3,230530,2
4,2,23,531,1,1137,1,11,5,5,6,single-choice,spatial-relational,5|6,7,5/6,230531,5
4,2,23,532,0,1048,1,3,1,2,2,single-choice,spatial-relational,1|2,7,1/2,230532,1
4,2,23,533,1,747,1,13,6,6,7,single-choice,spatial-relational,6|7,7,6/7,230533,6
4,2,23,534,1,921,1,9,4,4,5,single-choice,spatial-relational,4|5,7,4/5,230534,4
4,2,23,535,1,966,1,7,3,3,4,single-choice,spatial-relational,3|4,7,3/4,230535,3
4,2,23,536,1,998,1,7,3,3,4,single-choice,spatial-relational,3|4,7,3/4,230536,3
4,2,23,537,1,883,1,13,6,6,7,single-choice,spatial-relational,6|7,7,6/7,230537,6
4,2,23,538,1,1211,1,11,5,5,6,single-choice,spatial-relational,5|6,7,5/6,230538,5
4,2,23,539,1,1282,1,3,1,1,2,single-choice,spatial-relational,1|2,7,1/2,230539,1
4,2,23,540,1,1269,1,9,4,4,5,single-choice,spatial-relational,4|5,7,4/5,230540,4
4,2,23,541,1,893,1,7,3,3,4,single-choice,spatial-relational,3|4,7,3/4,230541,3
4,2,23,542,0,1317,1,9,4,5,5,single-choice,spatial-relational,4|5,7,4/5,230542,4
4,2,23,543,1,891,1,13,6,6,7,single-choice,spatial-relational,6|7,7,6/7,230543,6
4,2,23,544,1,838,1,9,4,4,5,single-choice,spatial-relational,4|5,7,4/5,230544,4
4,2,23,545,0,1367,1,5,2,3,3,single-choice,spatial-relational,2|3,7,2/3,230545,2
4,2,23,546,1,762,1,3,1,1,2,single-choice,spatial-relational,1|2,7,1/2,230546,1
4,2,23,547,1,987,1,11,5,5,6,single-choice,spatial-relational,5|6,7,5/6,230547,5
4,2,23,548,1,1096,1,3,1,1,2,single-choice,spatial-relational,1|2,7,1/2,230548,1
4,2,23,549,1,1358,1,11,5,5,6,single-choice,spatial-relational,5|6,7,5/6,230549,5
4,2,23,550,1,1042,1,5,2,2,3,single-choice,spatial-relational,2|3,7,2/3,230550,2
4,2,23,551,1,923,1,13,6,6,7,single-choice,spatial-relational,6|7,7,6/7,230551,6
4,2,23,552,1,1121,1,7,3,3,4,single-choice,spatial-relational,3|4,7,3/4,230552,3
4,2,23,553,1,822,1,13,6,6,7,single-choice,spatial-relational,6|7,7,6/7,230553,6
4,2,23,554,1,971,1,7,3,3,4,single-choice,spatial-relational,3|4,7,3/4,230554,3
4,2,23,555,1,962,1,3,1,1,2,single-choice,spatial-relational,1|2,7,1/2,230555,1
4,2,23,556,0,1185,1,9,4,5,5,single-choice,spatial-relational,4|5,7,4/5,230556,4
4,2,23,557,1,1227,1,11,5,5,6,single-choice,spatial-relational,5|6,7,5/6,230557,5
4,2,23,558,1,1084,1,7,3,3,4,single-choice,spatial-relational,3|4,7,3/4,230558,3
4,2,23,559,0,1088,1,9,4,5,5,single-choice,spatial-relational,4|5,7,4/5,230559,4
4,2,23,560,1,848,1,3,1,1,2,single-choice,spatial-relational,1|2,7,1/2,230560,1
4,2,23,561,1,814,1,13,6,6,7,single-choice,spatial-relational,6|7,7,6/7,230561,6
4,2,23,562,1,1256,1,5,2,2,3,single-choice,spatial-relational,2|3,7,2/3,230562,2
4,2,23,563,1,1283,1,5,2,2,3,single-choice,spatial-relational,2|3,7,2/3,230563,2
4,2,23,564,1,1227,1,11,5,5,6,single-choice,spatial-relational,5|6,7,5/6,230564,5
4,2,23,565,0,934,1,11,5,6,6,single-choice,spatial-relational,5|6,7,5/6,230565,5
4,2,23,566,1,1619,1,5,2,2,3,single-choice,spatial-relational,2|3,7,2/3,230566,2
4,2,23,567,1,1212,1,9,4,4,5,single-choice,spatial-relational,4|5,7,4/5,230567,4
4,2,23,568,0,1214,1,3,1,2,2,single-choice,spatial-relational,1|2,7,1/2,230568,1
4,2,23,569,1,929,1,7,3,3,4,single-choice,spatial-relational,3|4,7,3/4,230569,3
4,2,23,570,1,1252,1,3,1,1,2,single-choice,spatial-relational,1|2,7,1/2,230570,1
4,2,23,571,1,661,1,13,6,6,7,single-choice,spatial-relational,6|7,7,6/7,230571,6
4,2,23,572,0,1385,1,9,4,5,5,single-choice,spatial-relational,4|5,7,4/5,230572,4
4,2,23,573,0,1271,1,5,2,3,3,single-choice,spatial-relational,2|3,7,2/3,230573,2
4,2,23,574,1,1242,1,11,5,5,6,single-choice,spatial-relational,5|6,7,5/6,230574,5
4,2,23,575,1,1018,1,7,3,3,4,single-choice,spatial-relational,3|4,7,3/4,230575,3
4,2,23,576,1,1020,1,13,6,6,7,single-choice,spatial-relational,6|7,7,6/7,230576,6
4,2,23,577,1,1292,1,5,2,2,3,single-choice,spatial-relational,2|3,7,2/3,230577,2
4,2,23,578,1,1175,1,11,5,5,6,single-choice,spatial-relational,5|6,7,5/6,230578,5
4,2,23,579,1,1010,1,7,3,3,4,single-choice,spatial-relational,3|4,7,3/4,230579,3
4,2,23,580,0,903,1,11,5,6,6,single-choice,spatial-relational,5|6,7,5/6,230580,5
4,2,23,581,0,663,1,13,6,7,7,single-choice,spatial-relational,6|7,7,6/7,230581,6
4,2,23,582,0,822,1,5,2,3,3,single-choice,spatial-relational,2|3,7,2/3,230582,2
4,2,23,583,0,1274,1,9,4,5,5,single-choice,spatial-relational,4|5,7,4/5,230583,4
4,2,23,584,1,1038,1,3,1,1,2,single-choice,spatial-relational,1|2,7,1/2,230584,1
4,2,23,585,1,963,1,3,1,1,2,single-choice,spatial-relational,1|2,7,1/2,230585,1
4,2,23,586,1,1438,1,9,4,4,5,single-choice,spatial-relational,4|5,7,4/5,230586,4
4,2,23,587,1,909,1,7,3,3,4,single-choice,spatial-relational,3|4,7,3/4,230587,3
4,2,23,588,1,905,1,13,6,6,7,single-choice,spatial-relational,6|7,7,6/7,230588,6
4,2,23,589,1,1079,1,11,5,5,6,single-choice,spatial-relational,5|6,7,5/6,230589,5
4,2,23,590,0,1894,1,5,2,3,3,single-choice,spatial-relational,2|3,7,2/3,230590,2
4,2,23,591,1,18127,1,3,1,1,2,single-choice,spatial-relational,1|2,7,1/2,230591,1
4,2,23,592,1,1145,1,9,4,4,5,single-choice,spatial-relational,4|5,7,4/5,230592,4
4,2,23,593,1,1190,1,5,2,2,3,single-choice,spatial-relational,2|3,7,2/3,230593,2
4,2,23,594,1,1160,1,7,3,3,4,single-choice,spatial-relational,3|4,7,3/4,230594,3
4,2,23,595,1,1132,1,7,3,3,4,single-choice,spatial-relational,3|4,7,3/4,230595,3
4,2,23,596,1,958,1,13,6,6,7,single-choice,spatial-relational,6|7,7,6/7,230596,6
4,2,23,597,1,1197,1,3,1,1,2,single-choice,spatial-relational,1|2,7,1/2,230597,1
4,2,23,598,1,889,1,9,4,4,5,single-choice,spatial-relational,4|5,7,4/5,230598,4
4,2,23,599,1,852,1,13,6,6,7,single-choice,spatial-relational,6|7,7,6/7,230599,6
4,2,23,600,1,1064,1,11,5,5,6,single-choice,spatial-relational,5|6,7,5/6,230600,5
5,2,23,1,1,1270,1,3,1,1,2,single-choice,spatial-relational,1|2,7,1/2,230001,1
5,2,23,2,1,785,1,5,2,2,3,single-choice,spatial-relational,2|3,7,2/3,230002,2
5,2,23,3,1,1629,1,7,3,3,4,single-choice,spatial-relational,3|4,7,3/4,230003,3
5,2,23,4,1,1195,1,13,6,6,7,single-choice,spatial-relational,6|7,7,6/7,230004,6
5,2,23,5,1,2048,1,3,1,1,2,single-choice,spatial-relational,1|2,7,1/2,230005,1
5,2,23,6,1,1329,1,9,4,4,5,single-choice,spatial-relational,4|5,7,4/5,230006,4
5,2,23,7,0,786,1,5,2,3,3,single-choice,spatial-relational,2|3,7,2/3,230007,2
5,2,23,8,0,1068,1,11,5,6,6,single-choice,spatial-relational,5|6,7,5/6,230008,5
5,2,23,9,1,1251,1,13,6,6,7,single-choice,spatial-relational,6|7,7,6/7,230009,6
5,2,23,10,1,1415,1,11,5,5,6,single-choice,spatial-relational,5|6,7,5/6,230010,5
5,2,23,11,1,2125,1,7,3,3,4,single-choice,spatial-relational,3|4,7,3/4,230011,3
5,2,23,12,1,1332,1,9,4,4,5,single-choice,spatial-relational,4|5,7,4/5,230012,4
5,2,23,13,0,2351,1,5,2,3,3,single-choice,spatial-relational,2|3,7,2/3,230013,2
5,2,23,14,1,1112,1,13,6,6,7,single-choice,spatial-relational,6|7,7,6/7,230014,6
5,2,23,15,1,1165,1,9,4,4,5,single-choice,spatial-relational,4|5,7,4/5,230015,4
5,2,23,16,1,1068,1,13,6,6,7,single-choice,spatial-relational,6|7,7,6/7,230016,6
5,2,23,17,0,2253,1,5,2,3,3,single-choice,spatial-relational,2|3,7,2/3,230017,2
5,2,23,18,1,1086,1,3,1,1,2,single-choice,spatial-relational,1|2,7,1/2,230018,1
5,2,23,19,1,1495,1,3,1,1,2,single-choice,spatial-relational,1|2,7,1/2,230019,1
5,2,23,20,0,961,1,11,5,6,6,single-choice,spatial-relational,5|6,7,5/6,230020,5
5,2,23,21,1,1065,1,7,3,3,4,single-choice,spatial-relational,3|4,7,3/4,230021,3
5,2,23,22,1,1371,1,9,4,4,5,single-choice,spatial-relational,4|5,7,4/5,230022,4
5,2,23,23,0,2341,1,7,3,4,4,single-choice,spatial-relational,3|4,7,3/4,230023,3
5,2,23,24,0,949,1,11,5,6,6,single-choice,spatial-relational,5|6,7,5/6,230024,5
5,2,23,25,1,793,1,13,6,6,7,single-choice,spatial-relational,6|7,7,6/7,230025,6
5,2,23,26,1,1245,1,3,1,1,2,single-choice,spatial-relational,1|2,7,1/2,230026,1
5,2,23,27,1,1896,1,11,5,5,6,single-choice,spatial-relational,5|6,7,5/6,230027,5
5,2,23,28,0,2724,1,7,3,4,4,single-choice,spatial-relational,3|4,7,3/4,230028,3
5,2,23,29,1,1117,1,9,4,4,5,single-choice,spatial-relational,4|5,7,4/5,230029,4
5,2,23,30,1,943,1,13,6,6,7,single-choice,spatial-relational,6|7,7,6/7,230030,6
5,2,23,31,1,2004,1,5,2,2,3,single-choice,spatial-relational,2|3,7,2/3,230031,2
5,2,23,32,1,2030,1,3,1,1,2,single-choice,spatial-relational,1|2,7,1/2,230032,1
5,2,23,33,1,1272,1,5,2,2,3,single-choice,spatial-relational,2|3,7,2/3,230033,2
5,2,23,34,0,689,1,11,5,6,6,single-choice,spatial-relational,5|6,7,5/6,230034,5
5,2,23,35,1,923,1,7,3,3,4,single-choice,spatial-relational,3|4,7,3/4,230035,3
5,2,23,36,1,3054,1,9,4,4,5,single-choice,spatial-relational,4|5,7,4/5,230036,4
5,2,23,37,0,1404,1,3,1,2,2,single-choice,spatial-relational,1|2,7,1/2,230037,1
5,2,23,38,1,1249,1,11,5,5,6,single-choice,spatial-relational,5|6,7,5/6,230038,5
5,2,23,39,1,1025,1,13,6,6,7,single-choice,spatial-relational,6|7,7,6/7,230039,6
5,2,23,40,1,993,1,9,4,4,5,single-choice,spatial-relational,4|5,7,4/5,230040,4
5,2,23,41,1,1558,1,7,3,3,4,single-choice,spatial-relational,3|4,7,3/4,230041,3
5,2,23,42,1,1594,1,3,1,1,2,single-choice,spatial-relational,1|2,7,1/2,230042,1
5,2,23,43,1,941,1,9,4,4,5,single-choice,spatial-relational,4|5,7,4/5,230043,4
5,2,23,44,1,1655,1,7,3,3,4,single-choice,spatial-relational,3|4,7,3/4,230044,3
5,2,23,45,1,1273,1,11,5,5,6,single-choice,spatial-relational,5|6,7,5/6,230045,5
5,2,23,46,1,915,1,13,6,6,7,single-choice,spatial-relational,6|7,7,6/7,230046,6
5,2,23,47,0,2364,1,5,2,3,3,single-choice,spatial-relational,2|3,7,2/3,230047,2
5,2,23,48,1,1132,1,5,2,2,3,single-choice,spatial-relational,2|3,7,2/3,230048,2
5,2,23,49,1,897,1,3,1,1,2,single-choice,spatial-relational,1|2,7,1/2,230049,1
5,2,23,50,1,1374,1,9,4,4,5,single-choice,spatial-relational,4|5,7,4/5,230050,4
5,2,23,51,1,1231,1,13,6,6,7,single-choice,spatial-relational,6|7,7,6/7,230051,6
5,2,23,52,1,1027,1,13,6,6,7,single-choice,spatial-relational,6|7,7,6/7,230052,6
5,2,23,53,1,1865,1,7,3,3,4,single-choice,spatial-relational,3|4,7,3/4,230053,3
5,2,23,54,0,2282,1,5,2,3,3,single-choice,spatial-relational,2|3,7,2/3,230054,2
5,2,23,55,1,1082,1,3,1,1,2,single-choice,spatial-relational,1|2,7,1/2,230055,1
5,2,23,56,1,1219,1,5,2,2,3,single-choice,spatial-relational,2|3,7,2/3,230056,2
5,2,23,57,1,2438,1,7,3,3,4,single-choice,spatial-relational,3|4,7,3/4,230057,3
5,2,23,58,1,1177,1,11,5,5,6,single-choice,spatial-relational,5|6,7,5/6,230058,5
5,2,23,59,1,966,1,9,4,4,5,single-choice,spatial-relational,4|5,7,4/5,230059,4
5,2,23,60,1,1769,1,11,5,5,6,single-choice,spatial-relational,5|6,7,5/6,230060,5
5,2,23,61,1,889,1,13,6,6,7,single-choice,spatial-relational,6|7,7,6/7,230061,6
5,2,23,62,1,1240,1,11,5,5,6,single-choice,spatial-relational,5|6,7,5/6,230062,5
5,2,23,63,1,2182,1,5,2,2,3,single-choice,spatial-relational,2|3,7,2/3,230063,2
5,2,23,64,1,1257,1,3,1,1,2,single-choice,spatial-relational,1|2,7,1/2,230064,1
5,2,23,65,1,811,1,13,6,6,7,single-choice,spatial-relational,6|7,7,6/7,230065,6
5,2,23,66,1,1304,1,3,1,1,2,single-choice,spatial-relational,1|2,7,1/2,230066,1
5,2,23,67,0,665,1,11,5,6,6,single-choice,spatial-relational,5|6,7,5/6,230067,5
5,2,23,68,1,901,1,9,4,4,5,single-choice,spatial-relational,4|5,7,4/5,230068,4
5,2,23,69,1,2746,1,5,2,2,3,single-choice,spatial-relational,2|3,7,2/3,230069,2
5,2,23,70,1,1030,1,7,3,3,4,single-choice,spatial-relational,3|4,7,3/4,230070,3
5,2,23,71,1,1917,1,9,4,4,5,single-choice,spatial-relational,4|5,7,4/5,230071,4
5,2,23,72,1,2015,1,7,3,3,4,single-choice,spatial-relational,3|4,7,3/4,230072,3
5,2,23,73,1,1016,1,3,1,1,2,single-choice,spatial-relational,1|2,7,1/2,230073,1
5,2,23,74,1,1165,1,11,5,5,6,single-choice,spatial-relational,5|6,7,5/6,230074,5
5,2,23,75,1,1621,1,5,2,2,3,single-choice,spatial-relational,2|3,7,2/3,230075,2
5,2,23,76,1,1367,1,11,5,5,6,single-choice,spatial-relational,5|6,7,5/6,230076,5
5,2,23,77,0,1948,1,7,3,4,4,single-choice,spatial-relational,3|4,7,3/4,230077,3
5,2,23,78,1,927,1,13,6,6,7,single-choice,spatial-relational,6|7,7,6/7,230078,6
5,2,23,79,1,1246,1,5,2,2,3,single-choice,spatial-relational,2|3,7,2/3,230079,2
5,2,23,80,1,1090,1,9,4,4,5,single-choice,spatial-relational,4|5,7,4/5,230080,4
5,2,23,81,1,1344,1,3,1,1,2,single-choice,spatial-relational,1|2,7,1/2,230081,1
5,2,23,82,1,829,1,9,4,4,5,single-choice,spatial-relational,4|5,7,4/5,230082,4
5,2,23,83,1,1143,1,7,3,3,4,single-choice,spatial-relational,3|4,7,3/4,230083,3
5,2,23,84,1,1068,1,13,6,6,7,single-choice,spatial-relational,6|7,7,6/7,230084,6
5,2,23,85,1,1171,1,11,5,5,6,single-choice,spatial-relational,5|6,7,5/6,230085,5
5,2,23,86,1,1471,1,5,2,2,3,single-choice,spatial-relational,2|3,7,2/3,230086,2
5,2,23,87,1,2016,1,7,3,3,4,single-choice,spatial-relational,3|4,7,3/4,230087,3
5,2,23,88,0,1524,1,9,4,5,5,single-choice,spatial-relational,4|5,7,4/5,230088,4
5,2,23,89,1,765,1,13,6,6,7,single-choice,spatial-relational,6|7,7,6/7,230089,6
5,2,23,90,1,1183,1,5,2,2,3,single-choice,spatial-relational,2|3,7,2/3,230090,2
5,2,23,91,1,1248,1,3,1,1,2,single-choice,spatial-relational,1|2,7,1/2,230091,1
5,2,23,92,1,1275,1,7,3,3,4,single-choice,spatial-relational,3|4,7,3/4,230092,3
5,2,23,93,1,1445,1,11,5,5,6,single-choice,spatial-relational,5|6,7,5/6,230093,5
5,2,23,94,1,1880,1,13,6,6,7,single-choice,spatial-relational,6|7,7,6/7,230094,6
5,2,23,95,0,1041,1,3,1,2,2,single-choice,spatial-relational,1|2,7,1/2,230095,1
5,2,23,96,1,109,1,9,4,4,5,single-choice,spatial-relational,4|5,7,4/5,230096,4
5,2,23,97,1,1148,1,3,1,1,2,single-choice,spatial-relational,1|2,7,1/2,230097,1
5,2,23,98,1,1184,1,11,5,5,6,single-choice,spatial-relational,5|6,7,5/6,230098,5
5,2,23,99,1,1264,1,13,6,6,7,single-choice,spatial-relational,6|7,7,6/7,230099,6
5,2,23,100,1,1542,1,7,3,3,4,single-choice,spatial-relational,3|4,7,3/4,230100,3
5,2,23,101,1,1380,1,5,2,2,3,single-choice,spatial-relational,2|3,7,2/3,230101,2
5,2,23,102,1,919,1,11,5,5,6,single-choice,spatial-relational,5|6,7,5/6,230102,5
5,2,23,103,1,1139,1,9,4,4,5,single-choice,spatial-relational,4|5,7,4/5,230103,4
5,2,23,104,1,1743,1,9,4,4,5,single-choice,spatial-relational,4|5,7,4/5,230104,4
5,2,23,105,1,1864,1,3,1,1,2,single-choice,spatial-relational,1|2,7,1/2,230105,1
5,2,23,106,1,1259,1,7,3,3,4,single-choice,spatial-relational,3|4,7,3/4,230106,3
5,2,23,107,1,1037,1,13,6,6,7,single-choice,spatial-relational,6|7,7,6/7,230107,6
5,2,23,108,1,1263,1,5,2,2,3,single-choice,spatial-relational,2|3,7,2/3,230108,2
5,2,23,109,1,1316,1,5,2,2,3,single-choice,spatial-relational,2|3,7,2/3,230109,2
5,2,23,110,1,1216,1,5,2,2,3,single-choice,spatial-relational,2|3,7,2/3,230110,2
5,2,23,111,1,1488,1,7,3,3,4,single-choice,spatial-relational,3|4,7,3/4,230111,3
5,2,23,112,1,1632,1,7,3,3,4,single-choice,spatial-relational,3|4,7,3/4,230112,3
5,2,23,113,1,1528,1,3,1,1,2,single-choice,spatial-relational,1|2,7,1/2,230113,1
5,2,23,114,1,822,1,13,6,6,7,single-choice,spatial-relational,6|7,7,6/7,230114,6
5,2,23,115,1,1274,1,3,1,1,2,single-choice,spatial-relational,1|2,7,1/2,230115,1
5,2,23,116,1,938,1,11,5,5,6,single-choice,spatial-relational,5|6,7,5/6,230116,5
5,2,23,117,1,1222,1,11,5,5,6,single-choice,spatial-relational,5|6,7,5/6,230117,5
5,2,23,118,1,970,1,9,4,4,5,single-choice,spatial-relational,4|5,7,4/5,230118,4
5,2,23,119,0,1628,1,9,4,5,5,single-choice,spatial-relational,4|5,7,4/5,230119,4
5,2,23,120,1,724,1,13,6,6,7,single-choice,spatial-relational,6|7,7,6/7,230120,6
5,2,23,121,0,154,1,7,3,4,4,single-choice,spatial-relational,3|4,7,3/4,230121,3
5,2,23,122,0,675,1,11,5,6,6,single-choice,spatial-relational,5|6,7,5/6,230122,5
5,2,23,123,1,1134,1,9,4,4,5,single-choice,spatial-relational,4|5,7,4/5,230123,4
5,2,23,124,1,1190,1,13,6,6,7,single-choice,spatial-relational,6|7,7,6/7,230124,6
5,2,23,125,1,1413,1,5,2,2,3,single-choice,spatial-relational,2|3,7,2/3,230125,2
5,2,23,126,0,962,1,3,1,2,2,single-choice,spatial-relational,1|2,7,1/2,230126,1
5,2,23,127,1,1176,1,13,6,6,7,single-choice,spatial-relational,6|7,7,6/7,230127,6
5,2,23,128,0,971,1,5,2,3,3,single-choice,spatial-relational,2|3,7,2/3,230128,2
5,2,23,129,1,1050,1,11,5,5,6,single-choice,spatial-relational,5|6,7,5/6,230129,5
5,2,23,130,1,1508,1,7,3,3,4,single-choice,spatial-relational,3|4,7,3/4,230130,3
5,2,23,131,1,1345,1,3,1,1,2,single-choice,spatial-relational,1|2,7,1/2,230131,1
5,2,23,132,1,1182,1,9,4,4,5,single-choice,spatial-relational,4|5,7,4/5,230132,4
5,2,23,133,1,1265,1,5,2,2,3,single-choice,spatial-relational,2|3,7,2/3,230133,2
5,2,23,134,1,1105,1,3,1,1,2,single-choice,spatial-relational,1|2,7,1/2,230134,1
5,2,23,135,1,748,1,9,4,4,5,single-choice,spatial-relational,4|5,7,4/5,230135,4
5,2,23,136,1,1402,1,11,5,5,6,single-choice,spatial-relational,5|6,7,5/6,230136,5
5,2,23,137,1,1659,1,5,2,2,3,single-choice,spatial-relational,2|3,7,2/3,230137,2
5,2,23,138,1,848,1,13,6,6,7,single-choice,spatial-relational,6|7,7,6/7,230138,6
5,2,23,139,1,1249,1,3,1,1,2,single-choice,spatial-relational,1|2,7,1/2,230139,1
5,2,23,140,1,891,1,7,3,3,4,single-choice,spatial-relational,3|4,7,3/4,230140,3
5,2,23,141,1,1861,1,9,4,4,5,single-choice,spatial-relational,4|5,7,4/5,230141,4
5,2,23,142,0,923,1,7,3,4,4,single-choice,spatial-relational,3|4,7,3/4,230142,3
5,2,23,143,1,1184,1,11,5,5,6,single-choice,spatial-relational,5|6,7,5/6,230143,5
5,2,23,144,1,1226,1,13,6,6,7,single-choice,spatial-relational,6|7,7,6/7,230144,6
5,2,23,145,1,1093,1,13,6,6,7,single-choice,spatial-relational,6|7,7,6/7,230145,6
5,2,23,146,1,1911,1,9,4,4,5,single-choice,spatial-relational,4|5,7,4/5,230146,4
5,2,23,147,1,1092,1,3,1,1,2,single-choice,spatial-relational,1|2,7,1/2,230147,1
5,2,23,148,1,739,1,13,6,6,7,single-choice,spatial-relational,6|7,7,6/7,230148,6
5,2,23,149,1,1503,1,7,3,3,4,single-choice,spatial-relational,3|4,7,3/4,230149,3
5,2,23,150,1,1001,1,11,5,5,6,single-choice,spatial-relational,5|6,7,5/6,230150,5
5,2,23,151,1,1320,1,9,4,4,5,single-choice,spatial-relational,4|5,7,4/5,230151,4
5,2,23,152,1,1132,1,7,3,3,4,single-choice,spatial-relational,3|4,7,3/4,230152,3
5,2,23,153,1,1224,1,3,1,1,2,single-choice,spatial-relational,1|2,7,1/2,230153,1
5,2,23,154,1,1240,1,5,2,2,3,single-choice,spatial-relational,2|3,7,2/3,230154,2
5,2,23,155,1,1278,1,5,2,2,3,single-choice,spatial-relational,2|3,7,2/3,230155,2
5,2,23,156,1,1134,1,11,5,5,6,single-choice,spatial-relational,5|6,7,5/6,230156,5
5,2,23,157,1,913,1,13,6,6,7,single-choice,spatial-relational,6|7,7,6/7,230157,6
5,2,23,158,1,1612,1,9,4,4,5,single-choice,spatial-relational,4|5,7,4/5,230158,4
5,2,23,159,1,1311,1,9,4,4,5,single-choice,spatial-relational,4|5,7,4/5,230159,4
5,2,23,160,1,1110,1,7,3,3,4,single-choice,spatial-relational,3|4,7,3/4,230160,3
5,2,23,161,1,897,1,13,6,6,7,single-choice,spatial-relational,6|7,7,6/7,230161,6
5,2,23,162,1,1955,1,5,2,2,3,single-choice,spatial-relational,2|3,7,2/3,230162,2
5,2,23,163,1,1303,1,11,5,5,6,single-choice,spatial-relational,5|6,7,5/6,230163,5
5,2,23,164,1,1234,1,5,2,2,3,single-choice,spatial-relational,2|3,7,2/3,230164,2
5,2,23,165,1,1210,1,7,3,3,4,single-choice,spatial-relational,3|4,7,3/4,230165,3
5,2,23,166,1,944,1,3,1,1,2,single-choice,spatial-relational,1|2,7,1/2,230166,1
5,2,23,167,1,1282,1,11,5,5,6,single-choice,spatial-relational,5|6,7,5/6,230167,5
5,2,23,168,1,1422,1,3,1,1,2,single-choice,spatial-relational,1|2,7,1/2,230168,1
5,2,23,169,1,798,1,9,4,4,5,single-choice,spatial-relational,4|5,7,4/5,230169,4
5,2,23,170,1,858,1,13,6,6,7,single-choice,spatial-relational,6|7,7,6/7,230170,6
5,2,23,171,1,1754,1,9,4,4,5,single-choice,spatial-relational,4|5,7,4/5,230171,4
5,2,23,172,1,1347,1,7,3,3,4,single-choice,spatial-relational,3|4,7,3/4,230172,3
5,2,23,173,1,1355,1,3,1,1,2,single-choice,spatial-relational,1|2,7,1/2,230173,1
5,2,23,174,1,1105,1,13,6,6,7,single-choice,spatial-relational,6|7,7,6/7,230174,6
5,2,23,175,1,1154,1,7,3,3,4,single-choice,spatial-relational,3|4,7,3/4,230175,3
5,2,23,176,0,850,1,5,2,3,3,single-choice,spatial-relational,2|3,7,2/3,230176,2
5,2,23,177,1,1574,1,11,5,5,6,single-choice,spatial-relational,5|6,7,5/6,230177,5
5,2,23,178,1,1923,1,3,1,1,2,single-choice,spatial-relational,1|2,7,1/2,230178,1
5,2,23,179,1,1004,1,11,5,5,6,single-choice,spatial-relational,5|6,7,5/6,230179,5
5,2,23,180,1,1232,1,5,2,2,3,single-choice,spatial-relational,2|3,7,2/3,230180,2
5,2,23,181,1,1566,1,11,5,5,6,single-choice,spatial-relational,5|6,7,5/6,230181,5
5,2,23,182,1,1337,1,5,2,2,3,single-choice,spatial-relational,2|3,7,2/3,230182,2
5,2,23,183,1,884,1,13,6,6,7,single-choice,spatial-relational,6|7,7,6/7,230183,6
5,2,23,184,1,860,1,11,5,5,6,single-choice,spatial-relational,5|6,7,5/6,230184,5
5,2,23,185,1,1448,1,3,1,1,2,single-choice,spatial-relational,1|2,7,1/2,230185,1
5,2,23,186,1,1028,1,3,1,1,2,single-choice,spatial-relational,1|2,7,1/2,230186,1
5,2,23,187,1,1204,1,7,3,3,4,single-choice,spatial-relational,3|4,7,3/4,230187,3
5,2,23,188,1,1702,1,5,2,2,3,single-choice,spatial-relational,2|3,7,2/3,230188,2
5,2,23,189,1,1183,1,7,3,3,4,single-choice,spatial-relational,3|4,7,3/4,230189,3
5,2,23,190,1,989,1,13,6,6,7,single-choice,spatial-relational,6|7,7,6/7,230190,6
5,2,23,191,0,1174,1,9,4,5,5,single-choice,spatial-relational,4|5,7,4/5,230191,4
5,2,23,192,1,1188,1,9,4,4,5,single-choice,spatial-relational,4|5,7,4/5,230192,4
5,2,23,193,1,1249,1,11,5,5,6,single-choice,spatial-relational,5|6,7,5/6,230193,5
5,2,23,194,1,977,1,13,6,6,7,single-choice,spatial-relational,6|7,7,6/7,230194,6
5,2,23,195,1,1180,1,7,3,3,4,single-choice,spatial-relational,3|4,7,3/4,230195,3
5,2,23,196,1,1233,1,5,2,2,3,single-choice,spatial-relational,2|3,7,2/3,230196,2
5,2,23,197,1,795,1,13,6,6,7,single-choice,spatial-relational,6|7,7,6/7,230197,6
5,2,23,198,1,1189,1,7,3,3,4,single-choice,spatial-relational,3|4,7,3/4,230198,3
5,2,23,199,0,926,1,3,1,2,2,single-choice,spatial-relational,1|2,7,1/2,230199,1
5,2,23,200,1,1153,1,9,4,4,5,single-choice,spatial-relational,4|5,7,4/5,230200,4
5,2,23,201,0,909,1,5,2,3,3,single-choice,spatial-relational,2|3,7,2/3,230201,2
5,2,23,202,1,888,1,9,4,4,5,single-choice,spatial-relational,4|5,7,4/5,230202,4
5,2,23,203,1,1029,1,3,1,1,2,single-choice,spatial-relational,1|2,7,1/2,230203,1
5,2,23,204,1,1144,1,11,5,5,6,single-choice,spatial-relational,5|6,7,5/6,230204,5
5,2,23,205,1,1212,1,3,1,1,2,single-choice,spatial-relational,1|2,7,1/2,230205,1
5,2,23,206,1,757,1,13,6,6,7,single-choice,spatial-relational,6|7,7,6/7,230206,6
5,2,23,207,1,1374,1,5,2,2,3,single-choice,spatial-relational,2|3,7,2/3,230207,2
5,2,23,208,1,1282,1,3,1,1,2,single-choice,spatial-relational,1|2,7,1/2,230208,1
5,2,23,209,1,803,1,13,6,6,7,single-choice,spatial-relational,6|7,7,6/7,230209,6
5,2,23,210,0,955,1,7,3,4,4,single-choice,spatial-relational,3|4,7,3/4,230210,3
5,2,23,211,1,1450,1,11,5,5,6,single-choice,spatial-relational,5|6,7,5/6,230211,5
5,2,23,212,0,1689,1,7,3,4,4,single-choice,spatial-relational,3|4,7,3/4,230212,3
5,2,23,213,1,1632,1,11,5,5,6,single-choice,spatial-relational,5|6,7,5/6,230213,5
5,2,23,214,1,1186,1,9,4,4,5,single-choice,spatial-relational,4|5,7,4/5,230214,4
5,2,23,215,1,837,1,9,4,4,5,single-choice,spatial-relational,4|5,7,4/5,230215,4
5,2,23,216,1,1902,1,5,2,2,3,single-choice,spatial-relational,2|3,7,2/3,230216,2
5,2,23,217,1,1183,1,3,1,1,2,single-choice,spatial-relational,1|2,7,1/2,230217,1
5,2,23,218,0,1455,1,9,4,5,5,single-choice,spatial-relational,4|5,7,4/5,230218,4
5,2,23,219,1,810,1,13,6,6,7,single-choice,spatial-relational,6|7,7,6/7,230219,6
5,2,23,220,1,1211,1,13,6,6,7,single-choice,spatial-relational,6|7,7,6/7,230220,6
5,2,23,221,1,1158,1,5,2,2,3,single-choice,spatial-relational,2|3,7,2/3,230221,2
5,2,23,222,1,1256,1,3,1,1,2,single-choice,spatial-relational,1|2,7,1/2,230222,1
5,2,23,223,1,1401,1,9,4,4,5,single-choice,spatial-relational,4|5,7,4/5,230223,4
5,2,23,224,0,990,1,5,2,3,3,single-choice,spatial-relational,2|3,7,2/3,230224,2
5,2,23,225,0,923,1,11,5,6,6,single-choice,spatial-relational,5|6,7,5/6,230225,5
5,2,23,226,1,991,1,7,3,3,4,single-choice,spatial-relational,3|4,7,3/4,230226,3
5,2,23,227,1,951,1,7,3,3,4,single-choice,spatial-relational,3|4,7,3/4,230227,3
5,2,23,228,1,1120,1,11,5,5,6,single-choice,spatial-relational,5|6,7,5/6,230228,5
5,2,23,229,1,1484,1,3,1,1,2,single-choice,spatial-relational,1|2,7,1/2,230229,1
5,2,23,230,1,953,1,7,3,3,4,single-choice,spatial-relational,3|4,7,3/4,230230,3
5,2,23,231,1,1021,1,11,5,5,6,single-choice,spatial-relational,5|6,7,5/6,230231,5
5,2,23,232,1,1349,1,11,5,5,6,single-choice,spatial-relational,5|6,7,5/6,230232,5
5,2,23,233,1,804,1,13,6,6,7,single-choice,spatial-relational,6|7,7,6/7,230233,6
5,2,23,234,1,969,1,7,3,3,4,single-choice,spatial-relational,3|4,7,3/4,230234,3
5,2,23,235,1,1617,1,9,4,4,5,single-choice,spatial-relational,4|5,7,4/5,230235,4
5,2,23,236,1,2138,1,9,4,4,5,single-choice,spatial-relational,4|5,7,4/5,230236,4
5,2,23,237,1,848,1,3,1,1,2,single-choice,spatial-relational,1|2,7,1/2,230237,1
5,2,23,238,1,1322,1,5,2,2,3,single-choice,spatial-relational,2|3,7,2/3,230238,2
5,2,23,239,1,1243,1,5,2,2,3,single-choice,spatial-relational,2|3,7,2/3,230239,2
5,2,23,240,1,903,1,13,6,6,7,single-choice,spatial-relational,6|7,7,6/7,230240,6
5,2,23,241,1,1293,1,3,1,1,2,single-choice,spatial-relational,1|2,7,1/2,230241,1
5,2,23,242,1,1008,1,5,2,2,3,single-choice,spatial-relational,2|3,7,2/3,230242,2
5,2,23,243,1,883,1,7,3,3,4,single-choice,spatial-relational,3|4,7,3/4,230243,3
5,2,23,244,1,1631,1,9,4,4,5,single-choice,spatial-relational,4|5,7,4/5,230244,4
5,2,23,245,0,1495,1,11,5,6,6,single-choice,spatial-relational,5|6,7,5/6,230245,5
5,2,23,246,1,960,1,13,6,6,7,single-choice,spatial-relational,6|7,7,6/7,230246,6
5,2,23,247,1,1306,1,11,5,5,6,single-choice,spatial-relational,5|6,7,5/6,230247,5
5,2,23,248,1,858,1,13,6,6,7,single-choice,spatial-relational,6|7,7,6/7,230248,6
5,2,23,249,1,1020,1,3,1,1,2,single-choice,spatial-relational,1|2,7,1/2,230249,1
5,2,23,250,1,1145,1,7,3,3,4,single-choice,spatial-relational,3|4,7,3/4,230250,3
5,2,23,251,1,1259,1,5,2,2,3,single-choice,spatial-relational,2|3,7,2/3,230251,2
5,2,23,252,1,878,1,9,4,4,5,single-choice,spatial-relational,4|5,7,4/5,230252,4
5,2,23,253,1,1054,1,5,2,2,3,single-choice,spatial-relational,2|3,7,2/3,230253,2
5,2,23,254,1,1226,1,11,5,5,6,single-choice,spatial-relational,5|6,7,5/6,230254,5
5,2,23,255,1,1683,1,3,1,1,2,single-choice,spatial-relational,1|2,7,1/2,230255,1
5,2,23,256,1,1385,1,11,5,5,6,single-choice,spatial-relational,5|6,7,5/6,230256,5
5,2,23,257,1,1200,1,7,3,3,4,single-choice,spatial-relational,3|4,7,3/4,230257,3
5,2,23,258,1,1369,1,7,3,3,4,single-choice,spatial-relational,3|4,7,3/4,230258,3
5,2,23,259,1,1756,1,9,4,4,5,single-choice,spatial-relational,4|5,7,4/5,230259,4
5,2,23,260,1,1439,1,3,1,1,2,single-choice,spatial-relational,1|2,7,1/2,230260,1
5,2,23,261,1,1165,1,9,4,4,5,single-choice,spatial-relational,4|5,7,4/5,230261,4
5,2,23,262,1,1807,1,13,6,6,7,single-choice,spatial-relational,6|7,7,6/7,230262,6
5,2,23,263,1,1515,1,5,2,2,3,single-choice,spatial-relational,2|3,7,2/3,230263,2
5,2,23,264,1,931,1,13,6,6,7,single-choice,spatial-relational,6|7,7,6/7,230264,6
5,2,23,265,1,1331,1,3,1,1,2,single-choice,spatial-relational,1|2,7,1/2,230265,1
5,2,23,266,1,1158,1,11,5,5,6,single-choice,spatial-relational,5|6,7,5/6,230266,5
5,2,23,267,1,1368,1,5,2,2,3,single-choice,spatial-relational,2|3,7,2/3,230267,2
5,2,23,268,1,923,1,7,3,3,4,single-choice,spatial-relational,3|4,7,3/4,230268,3
5,2,23,269,1,1393,1,9,4,4,5,single-choice,spatial-relational,4|5,7,4/5,230269,4
5,2,23,270,1,890,1,13,6,6,7,single-choice,spatial-relational,6|7,7,6/7,230270,6
5,2,23,271,1,1509,1,11,5,5,6,single-choice,spatial-relational,5|6,7,5/6,230271,5
5,2,23,272,0,777,1,3,1,2,2,single-choice,spatial-relational,1|2,7,1/2,230272,1
5,2,23,273,1,2900,1,7,3,3,4,single-choice,spatial-relational,3|4,7,3/4,230273,3
5,2,23,274,1,1031,1,13,6,6,7,single-choice,spatial-relational,6|7,7,6/7,230274,6
5,2,23,275,1,2477,1,5,2,2,3,single-choice,spatial-relational,2|3,7,2/3,230275,2
5,2,23,276,1,987,1,9,4,4,5,single-choice,spatial-relational,4|5,7,4/5,230276,4
5,2,23,277,1,2112,1,9,4,4,5,single-choice,spatial-relational,4|5,7,4/5,230277,4
5,2,23,278,1,1310,1,5,2,2,3,single-choice,spatial-relational,2|3,7,2/3,230278,2
5,2,23,279,1,1545,1,9,4,4,5,single-choice,spatial-relational,4|5,7,4/5,230279,4
5,2,23,280,1,5384,1,3,1,1,2,single-choice,spatial-relational,1|2,7,1/2,230280,1
5,2,23,281,0,962,1,5,2,3,3,single-choice,spatial-relational,2|3,7,2/3,230281,2
5,2,23,282,1,1164,1,11,5,5,6,single-choice,spatial-relational,5|6,7,5/6,230282,5
5,2,23,283,1,1259,1,13,6,6,7,single-choice,spatial-relational,6|7,7,6/7,230283,6
5,2,23,284,1,2373,1,3,1,1,2,single-choice,spatial-relational,1|2,7,1/2,230284,1
5,2,23,285,1,1161,1,7,3,3,4,single-choice,spatial-relational,3|4,7,3/4,230285,3
5,2,23,286,1,1196,1,13,6,6,7,single-choice,spatial-relational,6|7,7,6/7,230286,6
5,2,23,287,1,983,1,7,3,3,4,single-choice,spatial-relational,3|4,7,3/4,230287,3
5,2,23,288,1,990,1,11,5,5,6,single-choice,spatial-relational,5|6,7,5/6,230288,5
5,2,23,289,1,1014,1,11,5,5,6,single-choice,spatial-relational,5|6,7,5/6,230289,5
5,2,23,290,1,1244,1,5,2,2,3,single-choice,spatial-relational,2|3,7,2/3,230290,2
5,2,23,291,1,1308,1,7,3,3,4,single-choice,spatial-relational,3|4,7,3/4,230291,3
5,2,23,292,0,875,1,5,2,3,3,single-choice,spatial-relational,2|3,7,2/3,230292,2
5,2,23,293,1,804,1,13,6,6,7,single-choice,spatial-relational,6|7,7,6/7,230293,6
5,2,23,294,1,2128,1,3,1,1,2,single-choice,spatial-relational,1|2,7,1/2,230294,1
5,2,23,295,1,1844,1,3,1,1,2,single-choice,spatial-relational,1|2,7,1/2,230295,1
5,2,23,296,1,956,1,11,5,5,6,single-choice,spatial-relational,5|6,7,5/6,230296,5
5,2,23,297,1,1695,1,9,4,4,5,single-choice,spatial-relational,4|5,7,4/5,230297,4
5,2,23,298,1,2120,1,7,3,3,4,single-choice,spatial-relational,3|4,7,3/4,230298,3
5,2,23,299,1,1199,1,13,6,6,7,single-choice,spatial-relational,6|7,7,6/7,230299,6
5,2,23,300,1,1319,1,9,4,4,5,single-choice,spatial-relational,4|5,7,4/5,230300,4
5,2,23,301,1,1207,1,11,5,5,6,single-choice,spatial-relational,5|6,7,5/6,230301,5
5,2,23,302,1,1156,1,5,2,2,3,single-choice,spatial-relational,2|3,7,2/3,230302,2
5,2,23,303,0,1367,1,3,1,2,2,single-choice,spatial-relational,1|2,7,1/2,230303,1
5,2,23,304,1,1218,1,7,3,3,4,single-choice,spatial-relational,3|4,7,3/4,230304,3
5,2,23,305,1,1384,1,13,6,6,7,single-choice,spatial-relational,6|7,7,6/7,230305,6
5,2,23,306,0,988,1,3,1,2,2,single-choice,spatial-relational,1|2,7,1/2,230306,1
5,2,23,307,1,1127,1,5,2,2,3,single-choice,spatial-relational,2|3,7,2/3,230307,2
5,2,23,308,1,992,1,9,4,4,5,single-choice,spatial-relational,4|5,7,4/5,230308,4
5,2,23,309,1,848,1,13,6,6,7,single-choice,spatial-relational,6|7,7,6/7,230309,6
5,2,23,310,1,946,1,7,3,3,4,single-choice,spatial-relational,3|4,7,3/4,230310,3
5,2,23,311,1,1264,1,11,5,5,6,single-choice,spatial-relational,5|6,7,5/6,230311,5
5,2,23,312,0,1084,1,9,4,5,5,single-choice,spatial-relational,4|5,7,4/5,230312,4
5,2,23,313,1,1129,1,3,1,1,2,single-choice,spatial-relational,1|2,7,1/2,230313,1
5,2,23,314,1,946,1,7,3,3,4,single-choice,spatial-relational,3|4,7,3/4,230314,3
5,2,23,315,1,1189,1,5,2,2,3,single-choice,spatial-relational,2|3,7,2/3,230315,2
5,2,23,316,1,918,1,11,5,5,6,single-choice,spatial-relational,5|6,7,5/6,230316,5
5,2,23,317,1,1333,1,5,2,2,3,single-choice,spatial-relational,2|3,7,2/3,230317,2
5,2,23,318,0,1473,1,7,3,4,4,single-choice,spatial-relational,3|4,7,3/4,230318,3
5,2,23,319,1,1011,1,9,4,4,5,single-choice,spatial-relational,4|5,7,4/5,230319,4
5,2,23,320,1,874,1,13,6,6,7,single-choice,spatial-relational,6|7,7,6/7,230320,6
5,2,23,321,0,873,1,9,4,5,5,single-choice,spatial-relational,4|5,7,4/5,230321,4
5,2,23,322,1,1774,1,13,6,6,7,single-choice,spatial-relational,6|7,7,6/7,230322,6
5,2,23,323,1,1009,1,11,5,5,6,single-choice,spatial-relational,5|6,7,5/6,230323,5
5,2,23,324,1,2359,1,3,1,1,2,single-choice,spatial-relational,1|2,7,1/2,230324,1
5,2,23,325,0,595,1,7,3,4,4,single-choice,spatial-relational,3|4,7,3/4,230325,3
5,2,23,326,1,1033,1,11,5,5,6,single-choice,spatial-relational,5|6,7,5/6,230326,5
5,2,23,327,0,1299,1,3,1,2,2,single-choice,spatial-relational,1|2,7,1/2,230327,1
5,2,23,328,1,1074,1,9,4,4,5,single-choice,spatial-relational,4|5,7,4/5,230328,4
5,2,23,329,1,2441,1,7,3,3,4,single-choice,spatial-relational,3|4,7,3/4,230329,3
5,2,23,330,1,1228,1,3,1,1,2,single-choice,spatial-relational,1|2,7,1/2,230330,1
5,2,23,331,1,1017,1,5,2,2,3,single-choice,spatial-relational,2|3,7,2/3,230331,2
5,2,23,332,0,1192,1,11,5,6,6,single-choice,spatial-relational,5|6,7,5/6,230332,5
5,2,23,333,1,32,1,9,4,4,5,single-choice,spatial-relational,4|5,7,4/5,230333,4
5,2,23,334,1,953,1,13,6,6,7,single-choice,spatial-relational,6|7,7,6/7,230334,6
5,2,23,335,1,1408,1,5,2,2,3,single-choice,spatial-relational,2|3,7,2/3,230335,2
5,2,23,336,1,806,1,13,6,6,7,single-choice,spatial-relational,6|7,7,6/7,230336,6
5,2,23,337,0,2022,1,5,2,3,3,single-choice,spatial-relational,2|3,7,2/3,230337,2
5,2,23,338,1,1435,1,9,4,4,5,single-choice,spatial-relational,4|5,7,4/5,230338,4
5,2,23,339,1,1288,1,7,3,3,4,single-choice,spatial-relational,3|4,7,3/4,230339,3
5,2,23,340,1,895,1,13,6,6,7,single-choice,spatial-relational,6|7,7,6/7,230340,6
5,2,23,341,0,1177,1,3,1,2,2,single-choice,spatial-relational,1|2,7,1/2,230341,1
5,2,23,342,1,967,1,11,5,5,6,single-choice,spatial-relational,5|6,7,5/6,230342,5
5,2,23,343,1,1201,1,3,1,1,2,single-choice,spatial-relational,1|2,7,1/2,230343,1
5,2,23,344,1,934,1,7,3,3,4,single-choice,spatial-relational,3|4,7,3/4,230344,3
5,2,23,345,1,2007,1,9,4,4,5,single-choice,spatial-relational,4|5,7,4/5,230345,4
5,2,23,346,1,170,1,5,2,2,3,single-choice,spatial-relational,2|3,7,2/3,230346,2
5,2,23,347,1,889,1,13,6,6,7,single-choice,spatial-relational,6|7,7,6/7,230347,6
5,2,23,348,1,1385,1,11,5,5,6,single-choice,spatial-relational,5|6,7,5/6,230348,5
5,2,23,349,1,1734,1,11,5,5,6,single-choice,spatial-relational,5|6,7,5/6,230349,5
5,2,23,350,1,845,1,13,6,6,7,single-choice,spatial-relational,6|7,7,6/7,230350,6
5,2,23,351,1,950,1,7,3,3,4,single-choice,spatial-relational,3|4,7,3/4,230351,3
5,2,23,352,1,1229,1,5,2,2,3,single-choice,spatial-relational,2|3,7,2/3,230352,2
5,2,23,353,1,1706,1,3,1,1,2,single-choice,spatial-relational,1|2,7,1/2,230353,1
5,2,23,354,1,1546,1,9,4,4,5,single-choice,spatial-relational,4|5,7,4/5,230354,4
5,2,23,355,1,953,1,13,6,6,7,single-choice,spatial-relational,6|7,7,6/7,230355,6
5,2,23,356,1,929,1,9,4,4,5,single-choice,spatial-relational,4|5,7,4/5,230356,4
5,2,23,357,1,1135,1,5,2,2,3,single-choice,spatial-relational,2|3,7,2/3,230357,2
5,2,23,358,1,994,1,7,3,3,4,single-choice,spatial-relational,3|4,7,3/4,230358,3
5,2,23,359,1,978,1,11,5,5,6,single-choice,spatial-relational,5|6,7,5/6,230359,5
5,2,23,360,0,890,1,3,1,2,2,single-choice,spatial-relational,1|2,7,1/2,230360,1
5,2,23,361,1,982,1,7,3,3,4,single-choice,spatial-relational,3|4,7,3/4,230361,3
5,2,23,362,1,1242,1,5,2,2,3,single-choice,spatial-relational,2|3,7,2/3,230362,2
5,2,23,363,1,917,1,13,6,6,7,single-choice,spatial-relational,6|7,7,6/7,230363,6
5,2,23,364,0,1473,1,9,4,5,5,single-choice,spatial-relational,4|5,7,4/5,230364,4
5,2,23,365,1,791,1,13,6,6,7,single-choice,spatial-relational,6|7,7,6/7,230365,6
5,2,23,366,1,1048,1,3,1,1,2,single-choice,spatial-relational,1|2,7,1/2,230366,1
5,2,23,367,1,821,1,7,3,3,4,single-choice,spatial-relational,3|4,7,3/4,230367,3
5,2,23,368,0,846,1,3,1,2,2,single-choice,spatial-relational,1|2,7,1/2,230368,1
5,2,23,369,0,769,1,5,2,3,3,single-choice,spatial-relational,2|3,7,2/3,230369,2
5,2,23,370,1,714,1,9,4,4,5,single-choice,spatial-relational,4|5,7,4/5,230370,4
5,2,23,371,1,1130,1,11,5,5,6,single-choice,spatial-relational,5|6,7,5/6,230371,5
5,2,23,372,1,885,1,11,5,5,6,single-choice,spatial-relational,5|6,7,5/6,230372,5
5,2,23,373,1,1555,1,13,6,6,7,single-choice,spatial-relational,6|7,7,6/7,230373,6
5,2,23,374,1,956,1,7,3,3,4,single-choice,spatial-relational,3|4,7,3/4,230374,3
5,2,23,375,1,1023,1,13,6,6,7,single-choice,spatial-relational,6|7,7,6/7,230375,6
5,2,23,376,0,1305,1,9,4,5,5,single-choice,spatial-relational,4|5,7,4/5,230376,4
5,2,23,377,1,949,1,9,4,4,5,single-choice,spatial-relational,4|5,7,4/5,230377,4
5,2,23,378,1,977,1,3,1,1,2,single-choice,spatial-relational,1|2,7,1/2,230378,1
5,2,23,379,1,1328,1,5,2,2,3,single-choice,spatial-relational,2|3,7,2/3,230379,2
5,2,23,380,1,1208,1,11,5,5,6,single-choice,spatial-relational,5|6,7,5/6,230380,5
5,2,23,381,1,1108,1,5,2,2,3,single-choice,spatial-relational,2|3,7,2/3,230381,2
5,2,23,382,1,889,1,7,3,3,4,single-choice,spatial-relational,3|4,7,3/4,230382,3
5,2,23,383,1,975,1,11,5,5,6,single-choice,spatial-relational,5|6,7,5/6,230383,5
5,2,23,384,1,1326,1,3,1,1,2,single-choice,spatial-relational,1|2,7,1/2,230384,1
5,2,23,385,1,783,1,7,3,3,4,single-choice,spatial-relational,3|4,7,3/4,230385,3
5,2,23,386,1,1271,1,13,6,6,7,single-choice,spatial-relational,6|7,7,6/7,230386,6
5,2,23,387,1,1041,1,5,2,2,3,single-choice,spatial-relational,2|3,7,2/3,230387,2
5,2,23,388,1,1189,1,9,4,4,5,single-choice,spatial-relational,4|5,7,4/5,230388,4
5,2,23,389,1,998,1,3,1,1,2,single-choice,spatial-relational,1|2,7,1/2,230389,1
5,2,23,390,1,944,1,11,5,5,6,single-choice,spatial-relational,5|6,7,5/6,230390,5
5,2,23,391,1,903,1,13,6,6,7,single-choice,spatial-relational,6|7,7,6/7,230391,6
5,2,23,392,1,869,1,9,4,4,5,single-choice,spatial-relational,4|5,7,4/5,230392,4
5,2,23,393,0,972,1,3,1,2,2,single-choice,spatial-relational,1|2,7,1/2,230393,1
5,2,23,394,1,997,1,7,3,3,4,single-choice,spatial-relational,3|4,7,3/4,230394,3
5,2,23,395,1,1364,1,11,5,5,6,single-choice,spatial-relational,5|6,7,5/6,230395,5
5,2,23,396,1,1807,1,5,2,2,3,single-choice,spatial-relational,2|3,7,2/3,230396,2
5,2,23,397,1,1450,1,5,2,2,3,single-choice,spatial-relational,2|3,7,2/3,230397,2
5,2,23,398,0,1023,1,9,4,5,5,single-choice,spatial-relational,4|5,7,4/5,230398,4
5,2,23,399,1,685,1,9,4,4,5,single-choice,spatial-relational,4|5,7,4/5,230399,4
5,2,23,400,1,1202,1,3,1,1,2,single-choice,spatial-relational,1|2,7,1/2,230400,1
5,2,23,401,1,858,1,11,5,5,6,single-choice,spatial-relational,5|6,7,5/6,230401,5
5,2,23,402,1,1196,1,7,3,3,4,single-choice,spatial-relational,3|4,7,3/4,230402,3
5,2,23,403,1,1346,1,3,1,1,2,single-choice,spatial-relational,1|2,7,1/2,230403,1
5,2,23,404,1,821,1,11,5,5,6,single-choice,spatial-relational,5|6,7,5/6,230404,5
5,2,23,405,0,689,1,5,2,3,3,single-choice,spatial-relational,2|3,7,2/3,230405,2
5,2,23,406,1,814,1,13,6,6,7,single-choice,spatial-relational,6|7,7,6/7,230406,6
5,2,23,407,1,1861,1,13,6,6,7,single-choice,spatial-relational,6|7,7,6/7,230407,6
5,2,23,408,1,1160,1,7,3,3,4,single-choice,spatial-relational,3|4,7,3/4,230408,3
5,2,23,409,1,1620,1,7,3,3,4,single-choice,spatial-relational,3|4,7,3/4,230409,3
5,2,23,410,1,966,1,3,1,1,2,single-choice,spatial-relational,1|2,7,1/2,230410,1
5,2,23,411,1,649,1,13,6,6,7,single-choice,spatial-relational,6|7,7,6/7,230411,6
5,2,23,412,1,1111,1,9,4,4,5,single-choice,spatial-relational,4|5,7,4/5,230412,4
5,2,23,413,1,981,1,13,6,6,7,single-choice,spatial-relational,6|7,7,6/7,230413,6
5,2,23,414,1,1170,1,3,1,1,2,single-choice,spatial-relational,1|2,7,1/2,230414,1
5,2,23,415,1,1171,1,11,5,5,6,single-choice,spatial-relational,5|6,7,5/6,230415,5
5,2,23,416,1,1007,1,9,4,4,5,single-choice,spatial-relational,4|5,7,4/5,230416,4
5,2,23,417,1,1043,1,5,2,2,3,single-choice,spatial-relational,2|3,7,2/3,230417,2
5,2,23,418,1,909,1,7,3,3,4,single-choice,spatial-relational,3|4,7,3/4,230418,3
5,2,23,419,1,1026,1,5,2,2,3,single-choice,spatial-relational,2|3,7,2/3,230419,2
5,2,23,420,1,813,1,11,5,5,6,single-choice,spatial-relational,5|6,7,5/6,230420,5
5,2,23,421,1,998,1,11,5,5,6,single-choice,spatial-relational,5|6,7,5/6,230421,5
5,2,23,422,1,932,1,7,3,3,4,single-choice,spatial-relational,3|4,7,3/4,230422,3
5,2,23,423,1,820,1,13,6,6,7,single-choice,spatial-relational,6|7,7,6/7,230423,6
5,2,23,424,1,1280,1,11,5,5,6,single-choice,spatial-relational,5|6,7,5/6,230424,5
5,2,23,425,1,1263,1,9,4,4,5,single-choice,spatial-relational,4|5,7,4/5,230425,4
5,2,23,426,1,867,1,9,4,4,5,single-choice,spatial-relational,4|5,7,4/5,230426,4
5,2,23,427,1,971,1,7,3,3,4,single-choice,spatial-relational,3|4,7,3/4,230427,3
5,2,23,428,0,58601,1,5,2,3,3,single-choice,spatial-relational,2|3,7,2/3,230428,2
5,2,23,429,1,1200,1,3,1,1,2,single-choice,spatial-relational,1|2,7,1/2,230429,1
5,2,23,430,1,1108,1,5,2,2,3,single-choice,spatial-relational,2|3,7,2/3,230430,2
5,2,23,431,1,1141,1,3,1,1,2,single-choice,spatial-relational,1|2,7,1/2,230431,1
5,2,23,432,1,697,1,13,6,6,7,single-choice,spatial-relational,6|7,7,6/7,230432,6
5,2,23,433,1,1700,1,5,2,2,3,single-choice,spatial-relational,2|3,7,2/3,230433,2
5,2,23,434,1,1318,1,7,3,3,4,single-choice,spatial-relational,3|4,7,3/4,230434,3
5,2,23,435,1,1690,1,7,3,3,4,single-choice,spatial-relational,3|4,7,3/4,230435,3
5,2,23,436,1,1221,1,11,5,5,6,single-choice,spatial-relational,5|6,7,5/6,230436,5
5,2,23,437,1,886,1,13,6,6,7,single-choice,spatial-relational,6|7,7,6/7,230437,6
5,2,23,438,0,870,1,3,1,2,2,single-choice,spatial-relational,1|2,7,1/2,230438,1
5,2,23,439,1,1519,1,9,4,4,5,single-choice,spatial-relational,4|5,7,4/5,230439,4
5,2,23,440,1,1290,1,9,4,4,5,single-choice,spatial-relational,4|5,7,4/5,230440,4
5,2,23,441,1,1053,1,13,6,6,7,single-choice,spatial-relational,6|7,7,6/7,230441,6
5,2,23,442,0,844,1,5,2,3,3,single-choice,spatial-relational,2|3,7,2/3,230442,2
5,2,23,443,1,974,1,11,5,5,6,single-choice,spatial-relational,5|6,7,5/6,230443,5
5,2,23,444,1,1410,1,3,1,1,2,single-choice,spatial-relational,1|2,7,1/2,230444,1
5,2,23,445,1,779,1,7,3,3,4,single-choice,spatial-relational,3|4,7,3/4,230445,3
5,2,23,446,1,1041,1,3,1,1,2,single-choice,spatial-relational,1|2,7,1/2,230446,1
5,2,23,447,1,703,1,13,6,6,7,single-choice,spatial-relational,6|7,7,6/7,230447,6
5,2,23,448,1,752,1,9,4,4,5,single-choice,spatial-relational,4|5,7,4/5,230448,4
5,2,23,449,0,1086,1,9,4,5,5,single-choice,spatial-relational,4|5,7,4/5,230449,4
5,2,23,450,1,1054,1,5,2,2,3,single-choice,spatial-relational,2|3,7,2/3,230450,2
5,2,23,451,0,1321,1,7,3,4,4,single-choice,spatial-relational,3|4,7,3/4,230451,3
5,2,23,452,1,1550,1,5,2,2,3,single-choice,spatial-relational,2|3,7,2/3,230452,2
5,2,23,453,1,1487,1,3,1,1,2,single-choice,spatial-relational,1|2,7,1/2,230453,1
5,2,23,454,1,811,1,13,6,6,7,single-choice,spatial-relational,6|7,7,6/7,230454,6
5,2,23,455,1,1114,1,11,5,5,6,single-choice,spatial-relational,5|6,7,5/6,230455,5
5,2,23,456,1,893,1,11,5,5,6,single-choice,spatial-relational,5|6,7,5/6,230456,5
5,2,23,457,1,1255,1,3,1,1,2,single-choice,spatial-relational,1|2,7,1/2,230457,1
5,2,23,458,1,2042,1,5,2,2,3,single-choice,spatial-relational,2|3,7,2/3,230458,2
5,2,23,459,1,1097,1,5,2,2,3,single-choice,spatial-relational,2|3,7,2/3,230459,2
5,2,23,460,1,1073,1,11,5,5,6,single-choice,spatial-relational,5|6,7,5/6,230460,5
5,2,23,461,1,1121,1,9,4,4,5,single-choice,spatial-relational,4|5,7,4/5,230461,4
5,2,23,462,1,1193,1,3,1,1,2,single-choice,spatial-relational,1|2,7,1/2,230462,1
5,2,23,463,1,850,1,7,3,3,4,single-choice,spatial-relational,3|4,7,3/4,230463,3
5,2,23,464,1,820,1,13,6,6,7,single-choice,spatial-relational,6|7,7,6/7,230464,6
5,2,23,465,1,1127,1,9,4,4,5,single-choice,spatial-relational,4|5,7,4/5,230465,4
5,2,23,466,1,968,1,11,5,5,6,single-choice,spatial-relational,5|6,7,5/6,230466,5
5,2,23,467,1,820,1,7,3,3,4,single-choice,spatial-relational,3|4,7,3/4,230467,3
5,2,23,468,1,935,1,13,6,6,7,single-choice,spatial-relational,6|7,7,6/7,230468,6
5,2,23,469,1,1236,1,7,3,3,4,single-choice,spatial-relational,3|4,7,3/4,230469,3
5,2,23,470,1,1279,1,5,2,2,3,single-choice,spatial-relational,2|3,7,2/3,230470,2
5,2,23,471,1,1200,1,3,1,1,2,single-choice,spatial-relational,1|2,7,1/2,230471,1
5,2,23,472,1,874,1,11,5,5,6,single-choice,spatial-relational,5|6,7,5/6,230472,5
5,2,23,473,1,1301,1,3,1,1,2,single-choice,spatial-relational,1|2,7,1/2,230473,1
5,2,23,474,1,844,1,13,6,6,7,single-choice,spatial-relational,6|7,7,6/7,230474,6
5,2,23,475,1,1652,1,5,2,2,3,single-choice,spatial-relational,2|3,7,2/3,230475,2
5,2,23,476,1,1111,1,9,4,4,5,single-choice,spatial-relational,4|5,7,4/5,230476,4
5,2,23,477,1,982,1,11,5,5,6,single-choice,spatial-relational,5|6,7,5/6,230477,5
5,2,23,478,1,1012,1,9,4,4,5,single-choice,spatial-relational,4|5,7,4/5,230478,4
5,2,23,479,1,795,1,13,6,6,7,single-choice,spatial-relational,6|7,7,6/7,230479,6
5,2,23,480,1,1390,1,7,3,3,4,single-choice,spatial-relational,3|4,7,3/4,230480,3
5,2,23,481,1,871,1,13,6,6,7,single-choice,spatial-relational,6|7,7,6/7,230481,6
5,2,23,482,0,926,1,3,1,2,2,single-choice,spatial-relational,1|2,7,1/2,230482,1
5,2,23,483,1,914,1,13,6,6,7,single-choice,spatial-relational,6|7,7,6/7,230483,6
5,2,23,484,1,3319,1,9,4,4,5,single-choice,spatial-relational,4|5,7,4/5,230484,4
5,2,23,485,1,982,1,7,3,3,4,single-choice,spatial-relational,3|4,7,3/4,230485,3
5,2,23,486,1,1149,1,7,3,3,4,single-choice,spatial-relational,3|4,7,3/4,230486,3
5,2,23,487,1,1246,1,11,5,5,6,single-choice,spatial-relational,5|6,7,5/6,230487,5
5,2,23,488,1,1434,1,3,1,1,2,single-choice,spatial-relational,1|2,7,1/2,230488,1
5,2,23,489,1,1068,1,9,4,4,5,single-choice,spatial-relational,4|5,7,4/5,230489,4
5,2,23,490,1,1583,1,5,2,2,3,single-choice,spatial-relational,2|3,7,2/3,230490,2
5,2,23,491,1,1243,1,11,5,5,6,single-choice,spatial-relational,5|6,7,5/6,230491,5
5,2,23,492,1,1712,1,5,2,2,3,single-choice,spatial-relational,2|3,7,2/3,230492,2
5,2,23,493,1,956,1,3,1,1,2,single-choice,spatial-relational,1|2,7,1/2,230493,1
5,2,23,494,1,799,1,13,6,6,7,single-choice,spatial-relational,6|7,7,6/7,230494,6
5,2,23,495,1,879,1,11,5,5,6,single-choice,spatial-relational,5|6,7,5/6,230495,5
5,2,23,496,1,2120,1,3,1,1,2,single-choice,spatial-relational,1|2,7,1/2,230496,1
5,2,23,497,1,1170,1,13,6,6,7,single-choice,spatial-relational,6|7,7,6/7,230497,6
5,2,23,498,0,1489,1,5,2,3,3,single-choice,spatial-relational,2|3,7,2/3,230498,2
5,2,23,499,1,1321,1,7,3,3,4,single-choice,spatial-relational,3|4,7,3/4,230499,3
5,2,23,500,1,1108,1,5,2,2,3,single-choice,spatial-relational,2|3,7,2/3,230500,2
5,2,23,501,1,1178,1,11,5,5,6,single-choice,spatial-relational,5|6,7,5/6,230501,5
5,2,23,502,1,1169,1,9,4,4,5,single-choice,spatial-relational,4|5,7,4/5,230502,4
5,2,23,503,1,1297,1,7,3,3,4,single-choice,spatial-relational,3|4,7,3/4,230503,3
5,2,23,504,0,1601,1,9,4,5,5,single-choice,spatial-relational,4|5,7,4/5,230504,4
5,2,23,505,1,1050,1,11,5,5,6,single-choice,spatial-relational,5|6,7,5/6,230505,5
5,2,23,506,1,1199,1,13,6,6,7,single-choice,spatial-relational,6|7,7,6/7,230506,6
5,2,23,507,1,1591,1,3,1,1,2,single-choice,spatial-relational,1|2,7,1/2,230507,1
5,2,23,508,1,1298,1,9,4,4,5,single-choice,spatial-relational,4|5,7,4/5,230508,4
5,2,23,509,1,880,1,13,6,6,7,single-choice,spatial-relational,6|7,7,6/7,230509,6
5,2,23,510,1,1010,1,7,3,3,4,single-choice,spatial-relational,3|4,7,3/4,230510,3
5,2,23,511,1,849,1,3,1,1,2,single-choice,spatial-relational,1|2,7,1/2,230511,1
5,2,23,512,1,1477,1,5,2,2,3,single-choice,spatial-relational,2|3,7,2/3,230512,2
5,2,23,513,1,1384,1,11,5,5,6,single-choice,spatial-relational,5|6,7,5/6,230513,5
5,2,23,514,1,1916,1,7,3,3,4,single-choice,spatial-relational,3|4,7,3/4,230514,3
5,2,23,515,1,1274,1,5,2,2,3,single-choice,spatial-relational,2|3,7,2/3,230515,2
5,2,23,516,1,1215,1,9,4,4,5,single-choice,spatial-relational,4|5,7,4/5,230516,4
5,2,23,517,1,917,1,3,1,1,2,single-choice,spatial-relational,1|2,7,1/2,230517,1
5,2,23,518,0,1041,1,9,4,5,5,single-choice,spatial-relational,4|5,7,4/5,230518,4
5,2,23,519,1,914,1,13,6,6,7,single-choice,spatial-relational,6|7,7,6/7,230519,6
5,2,23,520,1,1426,1,3,1,1,2,single-choice,spatial-relational,1|2,7,1/2,230520,1
5,2,23,521,1,1187,1,7,3,3,4,single-choice,spatial-relational,3|4,7,3/4,230521,3
5,2,23,522,1,1481,1,9,4,4,5,single-choice,spatial-relational,4|5,7,4/5,230522,4
5,2,23,523,1,904,1,11,5,5,6,single-choice,spatial-relational,5|6,7,5/6,230523,5
5,2,23,524,1,994,1,7,3,3,4,single-choice,spatial-relational,3|4,7,3/4,230524,3
5,2,23,525,1,1037,1,11,5,5,6,single-choice,spatial-relational,5|6,7,5/6,230525,5
5,2,23,526,1,978,1,13,6,6,7,single-choice,spatial-relational,6|7,7,6/7,230526,6
5,2,23,527,0,885,1,5,2,3,3,single-choice,spatial-relational,2|3,7,2/3,230527,2
5,2,23,528,0,5704,1,5,2,3,3,single-choice,spatial-relational,2|3,7,2/3,230528,2
5,2,23,529,1,978,1,11,5,5,6,single-choice,spatial-relational,5|6,7,5/6,230529,5
5,2,23,530,1,1494,1,7,3,3,4,single-choice,spatial-relational,3|4,7,3/4,230530,3
5,2,23,531,1,1092,1,9,4,4,5,single-choice,spatial-relational,4|5,7,4/5,230531,4
5,2,23,532,0,984,1,3,1,2,2,single-choice,spatial-relational,1|2,7,1/2,230532,1
5,2,23,533,1,1501,1,7,3,3,4,single-choice,spatial-relational,3|4,7,3/4,230533,3
5,2,23,534,1,1659,1,5,2,2,3,single-choice,spatial-relational,2|3,7,2/3,230534,2
5,2,23,535,1,1327,1,5,2,2,3,single-choice,spatial-relational,2|3,7,2/3,230535,2
5,2,23,536,1,941,1,13,6,6,7,single-choice,spatial-relational,6|7,7,6/7,230536,6
5,2,23,537,1,1207,1,11,5,5,6,single-choice,spatial-relational,5|6,7,5/6,230537,5
5,2,23,538,0,1063,1,3,1,2,2,single-choice,spatial-relational,1|2,7,1/2,230538,1
5,2,23,539,1,1043,1,13,6,6,7,single-choice,spatial-relational,6|7,7,6/7,230539,6
5,2,23,540,0,1330,1,9,4,5,5,single-choice,spatial-relational,4|5,7,4/5,230540,4
5,2,23,541,1,934,1,9,4,4,5,single-choice,spatial-relational,4|5,7,4/5,230541,4
5,2,23,542,0,1169,1,3,1,2,2,single-choice,spatial-relational,1|2,7,1/2,230542,1
5,2,23,543,1,925,1,11,5,5,6,single-choice,spatial-relational,5|6,7,5/6,230543,5
5,2,23,544,1,1774,1,5,2,2,3,single-choice,spatial-relational,2|3,7,2/3,230544,2
5,2,23,545,1,1418,1,9,4,4,5,single-choice,spatial-relational,4|5,7,4/5,230545,4
5,2,23,546,1,839,1,7,3,3,4,single-choice,spatial-relational,3|4,7,3/4,230546,3
5,2,23,547,1,1231,1,11,5,5,6,single-choice,spatial-relational,5|6,7,5/6,230547,5
5,2,23,548,1,862,1,13,6,6,7,single-choice,spatial-relational,6|7,7,6/7,230548,6
5,2,23,549,1,1232,1,7,3,3,4,single-choice,spatial-relational,3|4,7,3/4,230549,3
5,2,23,550,1,2944,1,3,1,1,2,single-choice,spatial-relational,1|2,7,1/2,230550,1
5,2,23,551,1,1747,1,5,2,2,3,single-choice,spatial-relational,2|3,7,2/3,230551,2
5,2,23,552,1,830,1,13,6,6,7,single-choice,spatial-relational,6|7,7,6/7,230552,6
5,2,23,553,0,27817,1,5,2,3,3,single-choice,spatial-relational,2|3,7,2/3,230553,2
5,2,23,554,1,1311,1,11,5,5,6,single-choice,spatial-relational,5|6,7,5/6,230554,5
5,2,23,555,1,2276,1,9,4,4,5,single-choice,spatial-relational,4|5,7,4/5,230555,4
5,2,23,556,1,1107,1,9,4,4,5,single-choice,spatial-relational,4|5,7,4/5,230556,4
5,2,23,557,1,1020,1,7,3,3,4,single-choice,spatial-relational,3|4,7,3/4,230557,3
5,2,23,558,0,937,1,3,1,2,2,single-choice,spatial-relational,1|2,7,1/2,230558,1
5,2,23,559,1,1128,1,5,2,2,3,single-choice,spatial-relational,2|3,7,2/3,230559,2
5,2,23,560,1,1188,1,7,3,3,4,single-choice,spatial-relational,3|4,7,3/4,230560,3
5,2,23,561,1,1089,1,3,1,1,2,single-choice,spatial-relational,1|2,7,1/2,230561,1
5,2,23,562,1,1021,1,11,5,5,6,single-choice,spatial-relational,5|6,7,5/6,230562,5
5,2,23,563,1,878,1,13,6,6,7,single-choice,spatial-relational,6|7,7,6/7,230563,6
5,2,23,564,1,869,1,13,6,6,7,single-choice,spatial-relational,6|7,7,6/7,230564,6
5,2,23,565,0,1100,1,11,5,6,6,single-choice,spatial-relational,5|6,7,5/6,230565,5
5,2,23,566,1,1296,1,3,1,1,2,single-choice,spatial-relational,1|2,7,1/2,230566,1
5,2,23,567,1,1075,1,5,2,2,3,single-choice,spatial-relational,2|3,7,2/3,230567,2
5,2,23,568,1,1131,1,11,5,5,6,single-choice,spatial-relational,5|6,7,5/6,230568,5
5,2,23,569,1,1248,1,3,1,1,2,single-choice,spatial-relational,1|2,7,1/2,230569,1
5,2,23,570,1,1022,1,7,3,3,4,single-choice,spatial-relational,3|4,7,3/4,230570,3
5,2,23,571,1,1230,1,9,4,4,5,single-choice,spatial-relational,4|5,7,4/5,230571,4
5,2,23,572,1,1335,1,5,2,2,3,single-choice,spatial-relational,2|3,7,2/3,230572,2
5,2,23,573,1,839,1,13,6,6,7,single-choice,spatial-relational,6|7,7,6/7,230573,6
5,2,23,574,1,1516,1,9,4,4,5,single-choice,spatial-relational,4|5,7,4/5,230574,4
5,2,23,575,1,1005,1,7,3,3,4,single-choice,spatial-relational,3|4,7,3/4,230575,3
5,2,23,576,1,815,1,13,6,6,7,single-choice,spatial-relational,6|7,7,6/7,230576,6
5,2,23,577,0,1175,1,13,6,7,7,single-choice,spatial-relational,6|7,7,6/7,230577,6
6,2,23,1,1,1149,1,11,5,5,6,single-choice,spatial-relational,5|6,7,5/6,230001,5
6,2,23,2,0,895,1,5,2,3,3,single-choice,spatial-relational,2|3,7,2/3,230002,2
6,2,23,3,1,44,1,5,2,2,3,single-choice,spatial-relational,2|3,7,2/3,230003,2
6,2,23,4,1,1293,1,9,4,4,5,single-choice,spatial-relational,4|5,7,4/5,230004,4
6,2,23,5,0,1508,1,7,3,4,4,single-choice,spatial-relational,3|4,7,3/4,230005,3
6,2,23,6,1,1381,1,13,6,6,7,single-choice,spatial-relational,6|7,7,6/7,230006,6
6,2,23,7,1,1313,1,13,6,6,7,single-choice,spatial-relational,6|7,7,6/7,230007,6
6,2,23,8,1,7222,1,3,1,1,2,single-choice,spatial-relational,1|2,7,1/2,230008,1
6,2,23,9,1,1697,1,11,5,5,6,single-choice,spatial-relational,5|6,7,5/6,230009,5
6,2,23,10,1,603,1,9,4,4,5,single-choice,spatial-relational,4|5,7,4/5,230010,4
6,2,23,11,0,999,1,7,3,4,4,single-choice,spatial-relational,3|4,7,3/4,230011,3
6,2,23,12,1,1016,1,3,1,1,2,single-choice,spatial-relational,1|2,7,1/2,230012,1
6,2,23,13,1,2153,1,3,1,1,2,single-choice,spatial-relational,1|2,7,1/2,230013,1
6,2,23,14,1,13119,1,5,2,2,3,single-choice,spatial-relational,2|3,7,2/3,230014,2
6,2,23,15,1,1338,1,13,6,6,7,single-choice,spatial-relational,6|7,7,6/7,230015,6
6,2,23,16,0,1833,1,7,3,4,4,single-choice,spatial-relational,3|4,7,3/4,230016,3
6,2,23,17,0,842,1,11,5,6,6,single-choice,spatial-relational,5|6,7,5/6,230017,5
6,2,23,18,0,1098,1,5,2,3,3,single-choice,spatial-relational,2|3,7,2/3,230018,2
6,2,23,19,1,1037,1,3,1,1,2,single-choice,spatial-relational,1|2,7,1/2,230019,1
6,2,23,20,1,1281,1,11,5,5,6,single-choice,spatial-relational,5|6,7,5/6,230020,5
6,2,23,21,1,2634,1,7,3,3,4,single-choice,spatial-relational,3|4,7,3/4,230021,3
6,2,23,22,1,2229,1,9,4,4,5,single-choice,spatial-relational,4|5,7,4/5,230022,4
6,2,23,23,1,1210,1,13,6,6,7,single-choice,spatial-relational,6|7,7,6/7,230023,6
6,2,23,24,1,2100,1,9,4,4,5,single-choice,spatial-relational,4|5,7,4/5,230024,4
6,2,23,25,1,2615,1,11,5,5,6,single-choice,spatial-relational,5|6,7,5/6,230025,5
6,2,23,26,0,1392,1,5,2,3,3,single-choice,spatial-relational,2|3,7,2/3,230026,2
6,2,23,27,1,950,1,3,1,1,2,single-choice,spatial-relational,1|2,7,1/2,230027,1
6,2,23,28,1,854,1,13,6,6,7,single-choice,spatial-relational,6|7,7,6/7,230028,6
6,2,23,29,1,1102,1,13,6,6,7,single-choice,spatial-relational,6|7,7,6/7,230029,6
6,2,23,30,0,2322,1,7,3,4,4,single-choice,spatial-relational,3|4,7,3/4,230030,3
6,2,23,31,1,887,1,3,1,1,2,single-choice,spatial-relational,1|2,7,1/2,230031,1
6,2,23,32,1,193,1,9,4,4,5,single-choice,spatial-relational,4|5,7,4/5,230032,4
6,2,23,33,1,1751,1,11,5,5,6,single-choice,spatial-relational,5|6,7,5/6,230033,5
6,2,23,34,1,1270,1,7,3,3,4,single-choice,spatial-relational,3|4,7,3/4,230034,3
6,2,23,35,1,1833,1,9,4,4,5,single-choice,spatial-relational,4|5,7,4/5,230035,4
6,2,23,36,1,1938,1,5,2,2,3,single-choice,spatial-relational,2|3,7,2/3,230036,2
6,2,23,37,1,1497,1,7,3,3,4,single-choice,spatial-relational,3|4,7,3/4,230037,3
6,2,23,38,1,936,1,13,6,6,7,single-choice,spatial-relational,6|7,7,6/7,230038,6
6,2,23,39,1,1143,1,3,1,1,2,single-choice,spatial-relational,1|2,7,1/2,230039,1
6,2,23,40,0,1126,1,9,4,5,5,single-choice,spatial-relational,4|5,7,4/5,230040,4
6,2,23,41,1,874,1,11,5,5,6,single-choice,spatial-relational,5|6,7,5/6,230041,5
6,2,23,42,1,1328,1,11,5,5,6,single-choice,spatial-relational,5|6,7,5/6,230042,5
6,2,23,43,0,1525,1,7,3,4,4,single-choice,spatial-relational,3|4,7,3/4,230043,3
6,2,23,44,1,727,1,9,4,4,5,single-choice,spatial-relational,4|5,7,4/5,230044,4
6,2,23,45,0,203,1,5,2,3,3,single-choice,spatial-relational,2|3,7,2/3,230045,2
6,2,23,46,1,707,1,13,6,6,7,single-choice,spatial-relational,6|7,7,6/7,230046,6
6,2,23,47,0,2507,1,5,2,3,3,single-choice,spatial-relational,2|3,7,2/3,230047,2
6,2,23,48,1,916,1,3,1,1,2,single-choice,spatial-relational,1|2,7,1/2,230048,1
6,2,23,49,0,970,1,11,5,6,6,single-choice,spatial-relational,5|6,7,5/6,230049,5
6,2,23,50,1,903,1,3,1,1,2,single-choice,spatial-relational,1|2,7,1/2,230050,1
6,2,23,51,1,1179,1,7,3,3,4,single-choice,spatial-relational,3|4,7,3/4,230051,3
6,2,23,52,0,1241,1,3,1,2,2,single-choice,spatial-relational,1|2,7,1/2,230052,1
6,2,23,53,0,577,1,11,5,6,6,single-choice,spatial-relational,5|6,7,5/6,230053,5
6,2,23,54,1,880,1,9,4,4,5,single-choice,spatial-relational,4|5,7,4/5,230054,4
6,2,23,55,1,1165,1,7,3,3,4,single-choice,spatial-relational,3|4,7,3/4,230055,3
6,2,23,56,1,1501,1,5,2,2,3,single-choice,spatial-relational,2|3,7,2/3,230056,2
6,2,23,57,1,1095,1,13,6,6,7,single-choice,spatial-relational,6|7,7,6/7,230057,6
6,2,23,58,1,3242,1,5,2,2,3,single-choice,spatial-relational,2|3,7,2/3,230058,2
6,2,23,59,1,866,1,13,6,6,7,single-choice,spatial-relational,6|7,7,6/7,230059,6
6,2,23,60,0,1282,1,9,4,5,5,single-choice,spatial-relational,4|5,7,4/5,230060,4
6,2,23,61,1,1368,1,5,2,2,3,single-choice,spatial-relational,2|3,7,2/3,230061,2
6,2,23,62,1,1168,1,9,4,4,5,single-choice,spatial-relational,4|5,7,4/5,230062,4
6,2,23,63,1,947,1,13,6,6,7,single-choice,spatial-relational,6|7,7,6/7,230063,6
6,2,23,64,1,1007,1,13,6,6,7,single-choice,spatial-relational,6|7,7,6/7,230064,6
6,2,23,65,1,1099,1,9,4,4,5,single-choice,spatial-relational,4|5,7,4/5,230065,4
6,2,23,66,1,2077,1,3,1,1,2,single-choice,spatial-relational,1|2,7,1/2,230066,1
6,2,23,67,1,1146,1,5,2,2,3,single-choice,spatial-relational,2|3,7,2/3,230067,2
6,2,23,68,1,1160,1,11,5,5,6,single-choice,spatial-relational,5|6,7,5/6,230068,5
6,2,23,69,0,1107,1,7,3,4,4,single-choice,spatial-relational,3|4,7,3/4,230069,3
6,2,23,70,1,1241,1,11,5,5,6,single-choice,spatial-relational,5|6,7,5/6,230070,5
6,2,23,71,0,1504,1,7,3,4,4,single-choice,spatial-relational,3|4,7,3/4,230071,3
6,2,23,72,1,1192,1,3,1,1,2,single-choice,spatial-relational,1|2,7,1/2,230072,1
6,2,23,73,1,1142,1,5,2,2,3,single-choice,spatial-relational,2|3,7,2/3,230073,2
6,2,23,74,1,1222,1,11,5,5,6,single-choice,spatial-relational,5|6,7,5/6,230074,5
6,2,23,75,1,1612,1,5,2,2,3,single-choice,spatial-relational,2|3,7,2/3,230075,2
6,2,23,76,1,1144,1,7,3,3,4,single-choice,spatial-relational,3|4,7,3/4,230076,3
6,2,23,77,0,1345,1,13,6,7,7,single-choice,spatial-relational,6|7,7,6/7,230077,6
6,2,23,78,0,907,1,3,1,2,2,single-choice,spatial-relational,1|2,7,1/2,230078,1
6,2,23,79,1,785,1,9,4,4,5,single-choice,spatial-relational,4|5,7,4/5,230079,4
6,2,23,80,1,1084,1,11,5,5,6,single-choice,spatial-relational,5|6,7,5/6,230080,5
6,2,23,81,1,2222,1,9,4,4,5,single-choice,spatial-relational,4|5,7,4/5,230081,4
6,2,23,82,1,1258,1,3,1,1,2,single-choice,spatial-relational,1|2,7,1/2,230082,1
6,2,23,83,0,704,1,7,3,4,4,single-choice,spatial-relational,3|4,7,3/4,230083,3
6,2,23,84,1,850,1,13,6,6,7,single-choice,spatial-relational,6|7,7,6/7,230084,6
6,2,23,85,1,1124,1,3,1,1,2,single-choice,spatial-relational,1|2,7,1/2,230085,1
6,2,23,86,0,1744,1,9,4,5,5,single-choice,spatial-relational,4|5,7,4/5,230086,4
6,2,23,87,1,710,1,9,4,4,5,single-choice,spatial-relational,4|5,7,4/5,230087,4
6,2,23,88,1,1229,1,7,3,3,4,single-choice,spatial-relational,3|4,7,3/4,230088,3
6,2,23,89,1,2254,1,3,1,1,2,single-choice,spatial-relational,1|2,7,1/2,230089,1
6,2,23,90,1,941,1,5,2,2,3,single-choice,spatial-relational,2|3,7,2/3,230090,2
6,2,23,91,1,1240,1,5,2,2,3,single-choice,spatial-relational,2|3,7,2/3,230091,2
6,2,23,92,1,826,1,13,6,6,7,single-choice,spatial-relational,6|7,7,6/7,230092,6
6,2,23,93,0,1301,1,11,5,6,6,single-choice,spatial-relational,5|6,7,5/6,230093,5
6,2,23,94,1,1015,1,11,5,5,6,single-choice,spatial-relational,5|6,7,5/6,230094,5
6,2,23,95,1,1140,1,7,3,3,4,single-choice,spatial-relational,3|4,7,3/4,230095,3
6,2,23,96,1,1189,1,13,6,6,7,single-choice,spatial-relational,6|7,7,6/7,230096,6
6,2,23,97,1,1258,1,5,2,2,3,single-choice,spatial-relational,2|3,7,2/3,230097,2
6,2,23,98,1,908,1,5,2,2,3,single-choice,spatial-relational,2|3,7,2/3,230098,2
6,2,23,99,1,1425,1,3,1,1,2,single-choice,spatial-relational,1|2,7,1/2,230099,1
6,2,23,100,1,979,1,11,5,5,6,single-choice,spatial-relational,5|6,7,5/6,230100,5
6,2,23,101,1,1408,1,13,6,6,7,single-choice,spatial-relational,6|7,7,6/7,230101,6
6,2,23,102,1,962,1,9,4,4,5,single-choice,spatial-relational,4|5,7,4/5,230102,4
6,2,23,103,1,1328,1,11,5,5,6,single-choice,spatial-relational,5|6,7,5/6,230103,5
6,2,23,104,1,1468,1,7,3,3,4,single-choice,spatial-relational,3|4,7,3/4,230104,3
6,2,23,105,1,1461,1,7,3,3,4,single-choice,spatial-relational,3|4,7,3/4,230105,3
6,2,23,106,1,1459,1,3,1,1,2,single-choice,spatial-relational,1|2,7,1/2,230106,1
6,2,23,107,1,1921,1,9,4,4,5,single-choice,spatial-relational,4|5,7,4/5,230107,4
6,2,23,108,1,1094,1,13,6,6,7,single-choice,spatial-relational,6|7,7,6/7,230108,6
6,2,23,109,1,1090,1,3,1,1,2,single-choice,spatial-relational,1|2,7,1/2,230109,1
6,2,23,110,1,1267,1,13,6,6,7,single-choice,spatial-relational,6|7,7,6/7,230110,6
6,2,23,111,1,1249,1,13,6,6,7,single-choice,spatial-relational,6|7,7,6/7,230111,6
6,2,23,112,1,915,1,11,5,5,6,single-choice,spatial-relational,5|6,7,5/6,230112,5
6,2,23,113,1,1158,1,3,1,1,2,single-choice,spatial-relational,1|2,7,1/2,230113,1
6,2,23,114,0,1584,1,9,4,5,5,single-choice,spatial-relational,4|5,7,4/5,230114,4
6,2,23,115,0,684,1,7,3,4,4,single-choice,spatial-relational,3|4,7,3/4,230115,3
6,2,23,116,1,1030,1,5,2,2,3,single-choice,spatial-relational,2|3,7,2/3,230116,2
6,2,23,117,1,1497,1,5,2,2,3,single-choice,spatial-relational,2|3,7,2/3,230117,2
6,2,23,118,1,1011,1,7,3,3,4,single-choice,spatial-relational,3|4,7,3/4,230118,3
6,2,23,119,1,1136,1,11,5,5,6,single-choice,spatial-relational,5|6,7,5/6,230119,5
6,2,23,120,1,1231,1,9,4,4,5,single-choice,spatial-relational,4|5,7,4/5,230120,4
6,2,23,121,1,1001,1,7,3,3,4,single-choice,spatial-relational,3|4,7,3/4,230121,3
6,2,23,122,1,1329,1,9,4,4,5,single-choice,spatial-relational,4|5,7,4/5,230122,4
6,2,23,123,0,1157,1,3,1,2,2,single-choice,spatial-relational,1|2,7,1/2,230123,1
6,2,23,124,1,1388,1,13,6,6,7,single-choice,spatial-relational,6|7,7,6/7,230124,6
6,2,23,125,1,1452,1,13,6,6,7,single-choice,spatial-relational,6|7,7,6/7,230125,6
6,2,23,126,1,931,1,11,5,5,6,single-choice,spatial-relational,5|6,7,5/6,230126,5
6,2,23,127,0,1743,1,9,4,5,5,single-choice,spatial-relational,4|5,7,4/5,230127,4
6,2,23,128,1,1150,1,7,3,3,4,single-choice,spatial-relational,3|4,7,3/4,230128,3
6,2,23,129,0,1329,1,5,2,3,3,single-choice,spatial-relational,2|3,7,2/3,230129,2
6,2,23,130,1,1135,1,5,2,2,3,single-choice,spatial-relational,2|3,7,2/3,230130,2
6,2,23,131,0,1022,1,3,1,2,2,single-choice,spatial-relational,1|2,7,1/2,230131,1
6,2,23,132,1,1004,1,11,5,5,6,single-choice,spatial-relational,5|6,7,5/6,230132,5
6,2,23,133,1,2170,1,9,4,4,5,single-choice,spatial-relational,4|5,7,4/5,230133,4
6,2,23,134,1,1032,1,9,4,4,5,single-choice,spatial-relational,4|5,7,4/5,230134,4
6,2,23,135,1,1295,1,11,5,5,6,single-choice,spatial-relational,5|6,7,5/6,230135,5
6,2,23,136,1,1083,1,13,6,6,7,single-choice,spatial-relational,6|7,7,6/7,230136,6
6,2,23,137,1,998,1,13,6,6,7,single-choice,spatial-relational,6|7,7,6/7,230137,6
6,2,23,138,1,1530,1,3,1,1,2,single-choice,spatial-relational,1|2,7,1/2,230138,1
6,2,23,139,1,927,1,3,1,1,2,single-choice,spatial-relational,1|2,7,1/2,230139,1
6,2,23,140,1,1675,1,5,2,2,3,single-choice,spatial-relational,2|3,7,2/3,230140,2
6,2,23,141,1,1048,1,7,3,3,4,single-choice,spatial-relational,3|4,7,3/4,230141,3
6,2,23,142,1,1102,1,11,5,5,6,single-choice,spatial-relational,5|6,7,5/6,230142,5
6,2,23,143,1,1815,1,7,3,3,4,single-choice,spatial-relational,3|4,7,3/4,230143,3
6,2,23,144,1,1858,1,5,2,2,3,single-choice,spatial-relational,2|3,7,2/3,230144,2
6,2,23,145,1,920,1,13,6,6,7,single-choice,spatial-relational,6|7,7,6/7,230145,6
6,2,23,146,1,1514,1,5,2,2,3,single-choice,spatial-relational,2|3,7,2/3,230146,2
6,2,23,147,1,1812,1,9,4,4,5,single-choice,spatial-relational,4|5,7,4/5,230147,4
6,2,23,148,1,1363,1,7,3,3,4,single-choice,spatial-relational,3|4,7,3/4,230148,3
6,2,23,149,1,951,1,13,6,6,7,single-choice,spatial-relational,6|7,7,6/7,230149,6
6,2,23,150,1,1301,1,9,4,4,5,single-choice,spatial-relational,4|5,7,4/5,230150,4
6,2,23,151,1,2037,1,7,3,3,4,single-choice,spatial-relational,3|4,7,3/4,230151,3
6,2,23,152,0,1733,1,11,5,6,6,single-choice,spatial-relational,5|6,7,5/6,230152,5
6,2,23,153,0,854,1,5,2,3,3,single-choice,spatial-relational,2|3,7,2/3,230153,2
6,2,23,154,1,1049,1,3,1,1,2,single-choice,spatial-relational,1|2,7,1/2,230154,1
6,2,23,155,1,1125,1,11,5,5,6,single-choice,spatial-relational,5|6,7,5/6,230155,5
6,2,23,156,1,1546,1,3,1,1,2,single-choice,spatial-relational,1|2,7,1/2,230156,1
6,2,23,157,1,990,1,7,3,3,4,single-choice,spatial-relational,3|4,7,3/4,230157,3
6,2,23,158,1,1022,1,13,6,6,7,single-choice,spatial-relational,6|7,7,6/7,230158,6
6,2,23,159,1,939,1,11,5,5,6,single-choice,spatial-relational,5|6,7,5/6,230159,5
6,2,23,160,1,1195,1,9,4,4,5,single-choice,spatial-relational,4|5,7,4/5,230160,4
6,2,23,161,1,1147,1,3,1,1,2,single-choice,spatial-relational,1|2,7,1/2,230161,1
6,2,23,162,1,1639,1,5,2,2,3,single-choice,spatial-relational,2|3,7,2/3,230162,2
6,2,23,163,1,1311,1,13,6,6,7,single-choice,spatial-relational,6|7,7,6/7,230163,6
6,2,23,164,1,1025,1,11,5,5,6,single-choice,spatial-relational,5|6,7,5/6,230164,5
6,2,23,165,1,1195,1,5,2,2,3,single-choice,spatial-relational,2|3,7,2/3,230165,2
6,2,23,166,1,1101,1,7,3,3,4,single-choice,spatial-relational,3|4,7,3/4,230166,3
6,2,23,167,0,1130,1,3,1,2,2,single-choice,spatial-relational,1|2,7,1/2,230167,1
6,2,23,168,1,1422,1,9,4,4,5,single-choice,spatial-relational,4|5,7,4/5,230168,4
6,2,23,169,1,1339,1,13,6,6,7,single-choice,spatial-relational,6|7,7,6/7,230169,6
6,2,23,170,1,1642,1,13,6,6,7,single-choice,spatial-relational,6|7,7,6/7,230170,6
6,2,23,171,1,1092,1,3,1,1,2,single-choice,spatial-relational,1|2,7,1/2,230171,1
6,2,23,172,1,1115,1,5,2,2,3,single-choice,spatial-relational,2|3,7,2/3,230172,2
6,2,23,173,1,1224,1,9,4,4,5,single-choice,spatial-relational,4|5,7,4/5,230173,4
6,2,23,174,1,2505,1,7,3,3,4,single-choice,spatial-relational,3|4,7,3/4,230174,3
6,2,23,175,1,1723,1,9,4,4,5,single-choice,spatial-relational,4|5,7,4/5,230175,4
6,2,23,176,1,1570,1,7,3,3,4,single-choice,spatial-relational,3|4,7,3/4,230176,3
6,2,23,177,1,1158,1,5,2,2,3,single-choice,spatial-relational,2|3,7,2/3,230177,2
6,2,23,178,1,1196,1,11,5,5,6,single-choice,spatial-relational,5|6,7,5/6,230178,5
6,2,23,179,1,1766,1,3,1,1,2,single-choice,spatial-relational,1|2,7,1/2,230179,1
6,2,23,180,1,978,1,11,5,5,6,single-choice,spatial-relational,5|6,7,5/6,230180,5
6,2,23,181,1,2352,1,13,6,6,7,single-choice,spatial-relational,6|7,7,6/7,230181,6
6,2,23,182,1,850,1,13,6,6,7,single-choice,spatial-relational,6|7,7,6/7,230182,6
6,2,23,183,1,1701,1,3,1,1,2,single-choice,spatial-relational,1|2,7,1/2,230183,1
6,2,23,184,1,1524,1,3,1,1,2,single-choice,spatial-relational,1|2,7,1/2,230184,1
6,2,23,185,1,1248,1,7,3,3,4,single-choice,spatial-relational,3|4,7,3/4,230185,3
6,2,23,186,1,1075,1,7,3,3,4,single-choice,spatial-relational,3|4,7,3/4,230186,3
6,2,23,187,0,1567,1,5,2,3,3,single-choice,spatial-relational,2|3,7,2/3,230187,2
6,2,23,188,1,1104,1,9,4,4,5,single-choice,spatial-relational,4|5,7,4/5,230188,4
6,2,23,189,1,1886,1,9,4,4,5,single-choice,spatial-relational,4|5,7,4/5,230189,4
6,2,23,190,1,1251,1,11,5,5,6,single-choice,spatial-relational,5|6,7,5/6,230190,5
6,2,23,191,1,1001,1,11,5,5,6,single-choice,spatial-relational,5|6,7,5/6,230191,5
6,2,23,192,1,1948,1,5,2,2,3,single-choice,spatial-relational,2|3,7,2/3,230192,2
6,2,23,193,1,895,1,13,6,6,7,single-choice,spatial-relational,6|7,7,6/7,230193,6
6,2,23,194,1,1222,1,13,6,6,7,single-choice,spatial-relational,6|7,7,6/7,230194,6
6,2,23,195,1,1217,1,5,2,2,3,single-choice,spatial-relational,2|3,7,2/3,230195,2
6,2,23,196,1,1340,1,7,3,3,4,single-choice,spatial-relational,3|4,7,3/4,230196,3
6,2,23,197,1,1174,1,11,5,5,6,single-choice,spatial-relational,5|6,7,5/6,230197,5
6,2,23,198,1,1135,1,9,4,4,5,single-choice,spatial-relational,4|5,7,4/5,230198,4
6,2,23,199,1,1456,1,3,1,1,2,single-choice,spatial-relational,1|2,7,1/2,230199,1
6,2,23,200,0,900,1,5,2,3,3,single-choice,spatial-relational,2|3,7,2/3,230200,2
6,2,23,201,1,924,1,3,1,1,2,single-choice,spatial-relational,1|2,7,1/2,230201,1
6,2,23,202,1,896,1,11,5,5,6,single-choice,spatial-relational,5|6,7,5/6,230202,5
6,2,23,203,1,1488,1,9,4,4,5,single-choice,spatial-relational,4|5,7,4/5,230203,4
6,2,23,204,1,922,1,7,3,3,4,single-choice,spatial-relational,3|4,7,3/4,230204,3
6,2,23,205,1,1158,1,3,1,1,2,single-choice,spatial-relational,1|2,7,1/2,230205,1
6,2,23,206,1,926,1,13,6,6,7,single-choice,spatial-relational,6|7,7,6/7,230206,6
6,2,23,207,1,1237,1,3,1,1,2,single-choice,spatial-relational,1|2,7,1/2,230207,1
6,2,23,208,1,857,1,13,6,6,7,single-choice,spatial-relational,6|7,7,6/7,230208,6
6,2,23,209,1,1149,1,5,2,2,3,single-choice,spatial-relational,2|3,7,2/3,230209,2
6,2,23,210,0,3547,1,7,3,4,4,single-choice,spatial-relational,3|4,7,3/4,230210,3
6,2,23,211,0,1171,1,9,4,5,5,single-choice,spatial-relational,4|5,7,4/5,230211,4
6,2,23,212,0,1083,1,7,3,4,4,single-choice,spatial-relational,3|4,7,3/4,230212,3
6,2,23,213,1,1180,1,11,5,5,6,single-choice,spatial-relational,5|6,7,5/6,230213,5
6,2,23,214,1,1181,1,11,5,5,6,single-choice,spatial-relational,5|6,7,5/6,230214,5
6,2,23,215,1,1706,1,5,2,2,3,single-choice,spatial-relational,2|3,7,2/3,230215,2
6,2,23,216,0,1234,1,9,4,5,5,single-choice,spatial-relational,4|5,7,4/5,230216,4
6,2,23,217,0,44,1,5,2,3,3,single-choice,spatial-relational,2|3,7,2/3,230217,2
6,2,23,218,0,799,1,7,3,4,4,single-choice,spatial-relational,3|4,7,3/4,230218,3
6,2,23,219,1,1183,1,9,4,4,5,single-choice,spatial-relational,4|5,7,4/5,230219,4
6,2,23,220,1,1621,1,13,6,6,7,single-choice,spatial-relational,6|7,7,6/7,230220,6
6,2,23,221,1,224,1,9,4,4,5,single-choice,spatial-relational,4|5,7,4/5,230221,4
6,2,23,222,1,1040,1,11,5,5,6,single-choice,spatial-relational,5|6,7,5/6,230222,5
6,2,23,223,1,1231,1,5,2,2,3,single-choice,spatial-relational,2|3,7,2/3,230223,2
6,2,23,224,1,1090,1,11,5,5,6,single-choice,spatial-relational,5|6,7,5/6,230224,5
6,2,23,225,1,1590,1,3,1,1,2,single-choice,spatial-relational,1|2,7,1/2,230225,1
6,2,23,226,1,1298,1,13,6,6,7,single-choice,spatial-relational,6|7,7,6/7,230226,6
6,2,23,227,0,1397,1,7,3,4,4,single-choice,spatial-relational,3|4,7,3/4,230227,3
6,2,23,228,1,1021,1,3,1,1,2,single-choice,spatial-relational,1|2,7,1/2,230228,1
6,2,23,229,1,1346,1,3,1,1,2,single-choice,spatial-relational,1|2,7,1/2,230229,1
6,2,23,230,1,1049,1,7,3,3,4,single-choice,spatial-relational,3|4,7,3/4,230230,3
6,2,23,231,1,1220,1,13,6,6,7,single-choice,spatial-relational,6|7,7,6/7,230231,6
6,2,23,232,1,1410,1,9,4,4,5,single-choice,spatial-relational,4|5,7,4/5,230232,4
6,2,23,233,1,914,1,3,1,1,2,single-choice,spatial-relational,1|2,7,1/2,230233,1
6,2,23,234,1,115,1,13,6,6,7,single-choice,spatial-relational,6|7,7,6/7,230234,6
6,2,23,235,1,2303,1,7,3,3,4,single-choice,spatial-relational,3|4,7,3/4,230235,3
6,2,23,236,1,1128,1,5,2,2,3,single-choice,spatial-relational,2|3,7,2/3,230236,2
6,2,23,237,1,1118,1,5,2,2,3,single-choice,spatial-relational,2|3,7,2/3,230237,2
6,2,23,238,0,135,1,11,5,6,6,single-choice,spatial-relational,5|6,7,5/6,230238,5
6,2,23,239,1,1187,1,11,5,5,6,single-choice,spatial-relational,5|6,7,5/6,230239,5
6,2,23,240,0,3099,1,9,4,5,5,single-choice,spatial-relational,4|5,7,4/5,230240,4
6,2,23,241,1,706,1,13,6,6,7,single-choice,spatial-relational,6|7,7,6/7,230241,6
6,2,23,242,0,1888,1,5,2,3,3,single-choice,spatial-relational,2|3,7,2/3,230242,2
6,2,23,243,0,52,1,11,5,6,6,single-choice,spatial-relational,5|6,7,5/6,230243,5
6,2,23,244,1,1182,1,3,1,1,2,single-choice,spatial-relational,1|2,7,1/2,230244,1
6,2,23,245,1,816,1,13,6,6,7,single-choice,spatial-relational,6|7,7,6/7,230245,6
6,2,23,246,0,1067,1,9,4,5,5,single-choice,spatial-relational,4|5,7,4/5,230246,4
6,2,23,247,1,936,1,9,4,4,5,single-choice,spatial-relational,4|5,7,4/5,230247,4
6,2,23,248,1,133,1,5,2,2,3,single-choice,spatial-relational,2|3,7,2/3,230248,2
6,2,23,249,1,1008,1,11,5,5,6,single-choice,spatial-relational,5|6,7,5/6,230249,5
6,2,23,250,0,1867,1,7,3,4,4,single-choice,spatial-relational,3|4,7,3/4,230250,3
6,2,23,251,1,844,1,3,1,1,2,single-choice,spatial-relational,1|2,7,1/2,230251,1
6,2,23,252,1,1222,1,7,3,3,4,single-choice,spatial-relational,3|4,7,3/4,230252,3
6,2,23,253,0,1042,1,3,1,2,2,single-choice,spatial-relational,1|2,7,1/2,230253,1
6,2,23,254,0,661,1,7,3,4,4,single-choice,spatial-relational,3|4,7,3/4,230254,3
6,2,23,255,1,918,1,5,2,2,3,single-choice,spatial-relational,2|3,7,2/3,230255,2
6,2,23,256,1,857,1,11,5,5,6,single-choice,spatial-relational,5|6,7,5/6,230256,5
6,2,23,257,1,1081,1,3,1,1,2,single-choice,spatial-relational,1|2,7,1/2,230257,1
6,2,23,258,1,786,1,13,6,6,7,single-choice,spatial-relational,6|7,7,6/7,230258,6
6,2,23,259,0,1734,1,9,4,5,5,single-choice,spatial-relational,4|5,7,4/5,230259,4
6,2,23,260,1,900,1,9,4,4,5,single-choice,spatial-relational,4|5,7,4/5,230260,4
6,2,23,261,1,1340,1,11,5,5,6,single-choice,spatial-relational,5|6,7,5/6,230261,5
6,2,23,262,0,963,1,5,2,3,3,single-choice,spatial-relational,2|3,7,2/3,230262,2
6,2,23,263,1,867,1,13,6,6,7,single-choice,spatial-relational,6|7,7,6/7,230263,6
6,2,23,264,1,1712,1,7,3,3,4,single-choice,spatial-relational,3|4,7,3/4,230264,3
6,2,23,265,0,1248,1,3,1,2,2,single-choice,spatial-relational,1|2,7,1/2,230265,1
6,2,23,266,1,851,1,11,5,5,6,single-choice,spatial-relational,5|6,7,5/6,230266,5
6,2,23,267,1,1024,1,13,6,6,7,single-choice,spatial-relational,6|7,7,6/7,230267,6
6,2,23,268,0,1599,1,3,1,2,2,single-choice,spatial-relational,1|2,7,1/2,230268,1
6,2,23,269,0,52,1,13,6,7,7,single-choice,spatial-relational,6|7,7,6/7,230269,6
6,2,23,270,0,1176,1,7,3,4,4,single-choice,spatial-relational,3|4,7,3/4,230270,3
6,2,23,271,1,1074,1,5,2,2,3,single-choice,spatial-relational,2|3,7,2/3,230271,2
6,2,23,272,1,823,1,11,5,5,6,single-choice,spatial-relational,5|6,7,5/6,230272,5
6,2,23,273,1,1290,1,7,3,3,4,single-choice,spatial-relational,3|4,7,3/4,230273,3
6,2,23,274,1,1160,1,5,2,2,3,single-choice,spatial-relational,2|3,7,2/3,230274,2
6,2,23,275,1,931,1,9,4,4,5,single-choice,spatial-relational,4|5,7,4/5,230275,4
6,2,23,276,1,1456,1,9,4,4,5,single-choice,spatial-relational,4|5,7,4/5,230276,4
6,2,23,277,1,1618,1,11,5,5,6,single-choice,spatial-relational,5|6,7,5/6,230277,5
6,2,23,278,0,1794,1,5,2,3,3,single-choice,spatial-relational,2|3,7,2/3,230278,2
6,2,23,279,1,1050,1,5,2,2,3,single-choice,spatial-relational,2|3,7,2/3,230279,2
6,2,23,280,1,913,1,11,5,5,6,single-choice,spatial-relational,5|6,7,5/6,230280,5
6,2,23,281,1,1084,1,13,6,6,7,single-choice,spatial-relational,6|7,7,6/7,230281,6
6,2,23,282,0,1656,1,9,4,5,5,single-choice,spatial-relational,4|5,7,4/5,230282,4
6,2,23,283,0,556,1,7,3,4,4,single-choice,spatial-relational,3|4,7,3/4,230283,3
6,2,23,284,1,1052,1,3,1,1,2,single-choice,spatial-relational,1|2,7,1/2,230284,1
6,2,23,285,1,1114,1,3,1,1,2,single-choice,spatial-relational,1|2,7,1/2,230285,1
6,2,23,286,0,1119,1,9,4,5,5,single-choice,spatial-relational,4|5,7,4/5,230286,4
6,2,23,287,1,750,1,13,6,6,7,single-choice,spatial-relational,6|7,7,6/7,230287,6
6,2,23,288,0,2239,1,7,3,4,4,single-choice,spatial-relational,3|4,7,3/4,230288,3
6,2,23,289,1,55,1,13,6,6,7,single-choice,spatial-relational,6|7,7,6/7,230289,6
6,2,23,290,0,1760,1,9,4,5,5,single-choice,spatial-relational,4|5,7,4/5,230290,4
6,2,23,291,1,1060,1,11,5,5,6,single-choice,spatial-relational,5|6,7,5/6,230291,5
6,2,23,292,1,1436,1,3,1,1,2,single-choice,spatial-relational,1|2,7,1/2,230292,1
6,2,23,293,1,1124,1,7,3,3,4,single-choice,spatial-relational,3|4,7,3/4,230293,3
6,2,23,294,1,1191,1,5,2,2,3,single-choice,spatial-relational,2|3,7,2/3,230294,2
6,2,23,295,1,914,1,11,5,5,6,single-choice,spatial-relational,5|6,7,5/6,230295,5
6,2,23,296,1,959,1,7,3,3,4,single-choice,spatial-relational,3|4,7,3/4,230296,3
6,2,23,297,1,1530,1,5,2,2,3,single-choice,spatial-relational,2|3,7,2/3,230297,2
6,2,23,298,1,1251,1,9,4,4,5,single-choice,spatial-relational,4|5,7,4/5,230298,4
6,2,23,299,1,880,1,13,6,6,7,single-choice,spatial-relational,6|7,7,6/7,230299,6
6,2,23,300,1,1096,1,3,1,1,2,single-choice,spatial-relational,1|2,7,1/2,230300,1
6,2,23,301,1,930,1,7,3,3,4,single-choice,spatial-relational,3|4,7,3/4,230301,3
6,2,23,302,0,1241,1,7,3,4,4,single-choice,spatial-relational,3|4,7,3/4,230302,3
6,2,23,303,1,1126,1,5,2,2,3,single-choice,spatial-relational,2|3,7,2/3,230303,2
6,2,23,304,1,994,1,13,6,6,7,single-choice,spatial-relational,6|7,7,6/7,230304,6
6,2,23,305,0,1231,1,9,4,5,5,single-choice,spatial-relational,4|5,7,4/5,230305,4
6,2,23,306,1,983,1,5,2,2,3,single-choice,spatial-relational,2|3,7,2/3,230306,2
6,2,23,307,1,933,1,11,5,5,6,single-choice,spatial-relational,5|6,7,5/6,230307,5
6,2,23,308,0,1309,1,3,1,2,2,single-choice,spatial-relational,1|2,7,1/2,230308,1
6,2,23,309,1,1068,1,9,4,4,5,single-choice,spatial-relational,4|5,7,4/5,230309,4
6,2,23,310,1,1047,1,13,6,6,7,single-choice,spatial-relational,6|7,7,6/7,230310,6
6,2,23,311,1,979,1,11,5,5,6,single-choice,spatial-relational,5|6,7,5/6,230311,5
6,2,23,312,1,1664,1,3,1,1,2,single-choice,spatial-relational,1|2,7,1/2,230312,1
6,2,23,313,1,1171,1,9,4,4,5,single-choice,spatial-relational,4|5,7,4/5,230313,4
6,2,23,314,0,903,1,9,4,5,5,single-choice,spatial-relational,4|5,7,4/5,230314,4
6,2,23,315,1,839,1,11,5,5,6,single-choice,spatial-relational,5|6,7,5/6,230315,5
6,2,23,316,0,1455,1,11,5,6,6,single-choice,spatial-relational,5|6,7,5/6,230316,5
6,2,23,317,1,926,1,13,6,6,7,single-choice,spatial-relational,6|7,7,6/7,230317,6
6,2,23,318,1,1913,1,7,3,3,4,single-choice,spatial-relational,3|4,7,3/4,230318,3
6,2,23,319,1,919,1,13,6,6,7,single-choice,spatial-relational,6|7,7,6/7,230319,6
6,2,23,320,1,1188,1,7,3,3,4,single-choice,spatial-relational,3|4,7,3/4,230320,3
6,2,23,321,1,1104,1,5,2,2,3,single-choice,spatial-relational,2|3,7,2/3,230321,2
6,2,23,322,1,1166,1,3,1,1,2,single-choice,spatial-relational,1|2,7,1/2,230322,1
6,2,23,323,1,1340,1,3,1,1,2,single-choice,spatial-relational,1|2,7,1/2,230323,1
6,2,23,324,1,1241,1,5,2,2,3,single-choice,spatial-relational,2|3,7,2/3,230324,2
6,2,23,325,1,1003,1,7,3,3,4,single-choice,spatial-relational,3|4,7,3/4,230325,3
6,2,23,326,1,1341,1,3,1,1,2,single-choice,spatial-relational,1|2,7,1/2,230326,1
6,2,23,327,1,967,1,11,5,5,6,single-choice,spatial-relational,5|6,7,5/6,230327,5
6,2,23,328,1,1292,1,5,2,2,3,single-choice,spatial-relational,2|3,7,2/3,230328,2
6,2,23,329,1,1216,1,11,5,5,6,single-choice,spatial-relational,5|6,7,5/6,230329,5
6,2,23,330,1,1142,1,7,3,3,4,single-choice,spatial-relational,3|4,7,3/4,230330,3
6,2,23,331,1,1969,1,5,2,2,3,single-choice,spatial-relational,2|3,7,2/3,230331,2
6,2,23,332,1,897,1,13,6,6,7,single-choice,spatial-relational,6|7,7,6/7,230332,6
6,2,23,333,1,1027,1,3,1,1,2,single-choice,spatial-relational,1|2,7,1/2,230333,1
6,2,23,334,1,825,1,13,6,6,7,single-choice,spatial-relational,6|7,7,6/7,230334,6
6,2,23,335,0,1588,1,9,4,5,5,single-choice,spatial-relational,4|5,7,4/5,230335,4
6,2,23,336,1,1103,1,9,4,4,5,single-choice,spatial-relational,4|5,7,4/5,230336,4
6,2,23,337,1,2716,1,7,3,3,4,single-choice,spatial-relational,3|4,7,3/4,230337,3
6,2,23,338,1,1344,1,9,4,4,5,single-choice,spatial-relational,4|5,7,4/5,230338,4
6,2,23,339,1,2412,1,11,5,5,6,single-choice,spatial-relational,5|6,7,5/6,230339,5
6,2,23,340,1,2086,1,11,5,5,6,single-choice,spatial-relational,5|6,7,5/6,230340,5
6,2,23,341,0,1539,1,7,3,4,4,single-choice,spatial-relational,3|4,7,3/4,230341,3
6,2,23,342,1,766,1,13,6,6,7,single-choice,spatial-relational,6|7,7,6/7,230342,6
6,2,23,343,1,1800,1,5,2,2,3,single-choice,spatial-relational,2|3,7,2/3,230343,2
6,2,23,344,1,1352,1,5,2,2,3,single-choice,spatial-relational,2|3,7,2/3,230344,2
6,2,23,345,0,1427,1,3,1,2,2,single-choice,spatial-relational,1|2,7,1/2,230345,1
6,2,23,346,1,1058,1,3,1,1,2,single-choice,spatial-relational,1|2,7,1/2,230346,1
6,2,23,347,1,780,1,13,6,6,7,single-choice,spatial-relational,6|7,7,6/7,230347,6
6,2,23,348,1,1625,1,9,4,4,5,single-choice,spatial-relational,4|5,7,4/5,230348,4
6,2,23,349,0,842,1,9,4,5,5,single-choice,spatial-relational,4|5,7,4/5,230349,4
6,2,23,350,1,686,1,13,6,6,7,single-choice,spatial-relational,6|7,7,6/7,230350,6
6,2,23,351,1,1191,1,3,1,1,2,single-choice,spatial-relational,1|2,7,1/2,230351,1
6,2,23,352,1,1287,1,7,3,3,4,single-choice,spatial-relational,3|4,7,3/4,230352,3
6,2,23,353,1,1409,1,5,2,2,3,single-choice,spatial-relational,2|3,7,2/3,230353,2
6,2,23,354,1,1227,1,7,3,3,4,single-choice,spatial-relational,3|4,7,3/4,230354,3
6,2,23,355,1,1365,1,5,2,2,3,single-choice,spatial-relational,2|3,7,2/3,230355,2
6,2,23,356,1,1030,1,11,5,5,6,single-choice,spatial-relational,5|6,7,5/6,230356,5
6,2,23,357,1,1032,1,9,4,4,5,single-choice,spatial-relational,4|5,7,4/5,230357,4
6,2,23,358,1,959,1,13,6,6,7,single-choice,spatial-relational,6|7,7,6/7,230358,6
6,2,23,359,0,984,1,3,1,2,2,single-choice,spatial-relational,1|2,7,1/2,230359,1
6,2,23,360,1,1042,1,11,5,5,6,single-choice,spatial-relational,5|6,7,5/6,230360,5
6,2,23,361,1,1944,1,3,1,1,2,single-choice,spatial-relational,1|2,7,1/2,230361,1
6,2,23,362,1,852,1,13,6,6,7,single-choice,spatial-relational,6|7,7,6/7,230362,6
6,2,23,363,1,1569,1,7,3,3,4,single-choice,spatial-relational,3|4,7,3/4,230363,3
6,2,23,364,1,1926,1,9,4,4,5,single-choice,spatial-relational,4|5,7,4/5,230364,4
6,2,23,365,1,1490,1,9,4,4,5,single-choice,spatial-relational,4|5,7,4/5,230365,4
6,2,23,366,1,164,1,11,5,5,6,single-choice,spatial-relational,5|6,7,5/6,230366,5
6,2,23,367,1,1572,1,5,2,2,3,single-choice,spatial-relational,2|3,7,2/3,230367,2
6,2,23,368,1,1144,1,7,3,3,4,single-choice,spatial-relational,3|4,7,3/4,230368,3
6,2,23,369,1,1070,1,13,6,6,7,single-choice,spatial-relational,6|7,7,6/7,230369,6
6,2,23,370,1,1587,1,11,5,5,6,single-choice,spatial-relational,5|6,7,5/6,230370,5
6,2,23,371,1,1748,1,3,1,1,2,single-choice,spatial-relational,1|2,7,1/2,230371,1
6,2,23,372,1,1238,1,5,2,2,3,single-choice,spatial-relational,2|3,7,2/3,230372,2
6,2,23,373,1,1241,1,7,3,3,4,single-choice,spatial-relational,3|4,7,3/4,230373,3
6,2,23,374,1,1140,1,5,2,2,3,single-choice,spatial-relational,2|3,7,2/3,230374,2
6,2,23,375,1,123,1,9,4,4,5,single-choice,spatial-relational,4|5,7,4/5,230375,4
6,2,23,376,1,1152,1,11,5,5,6,single-choice,spatial-relational,5|6,7,5/6,230376,5
6,2,23,377,1,1115,1,3,1,1,2,single-choice,spatial-relational,1|2,7,1/2,230377,1
6,2,23,378,1,989,1,5,2,2,3,single-choice,spatial-relational,2|3,7,2/3,230378,2
6,2,23,379,1,832,1,11,5,5,6,single-choice,spatial-relational,5|6,7,5/6,230379,5
6,2,23,380,1,865,1,13,6,6,7,single-choice,spatial-relational,6|7,7,6/7,230380,6
6,2,23,381,1,957,1,3,1,1,2,single-choice,spatial-relational,1|2,7,1/2,230381,1
6,2,23,382,1,875,1,13,6,6,7,single-choice,spatial-relational,6|7,7,6/7,230382,6
6,2,23,383,0,1364,1,9,4,5,5,single-choice,spatial-relational,4|5,7,4/5,230383,4
6,2,23,384,0,623,1,7,3,4,4,single-choice,spatial-relational,3|4,7,3/4,230384,3
6,2,23,385,1,557,1,9,4,4,5,single-choice,spatial-relational,4|5,7,4/5,230385,4
6,2,23,386,1,1052,1,13,6,6,7,single-choice,spatial-relational,6|7,7,6/7,230386,6
6,2,23,387,1,1154,1,7,3,3,4,single-choice,spatial-relational,3|4,7,3/4,230387,3
6,2,23,388,1,1237,1,5,2,2,3,single-choice,spatial-relational,2|3,7,2/3,230388,2
6,2,23,389,0,1015,1,11,5,6,6,single-choice,spatial-relational,5|6,7,5/6,230389,5
6,2,23,390,1,1032,1,7,3,3,4,single-choice,spatial-relational,3|4,7,3/4,230390,3
6,2,23,391,1,1379,1,11,5,5,6,single-choice,spatial-relational,5|6,7,5/6,230391,5
6,2,23,392,1,1221,1,9,4,4,5,single-choice,spatial-relational,4|5,7,4/5,230392,4
6,2,23,393,1,1291,1,3,1,1,2,single-choice,spatial-relational,1|2,7,1/2,230393,1
6,2,23,394,1,1068,1,5,2,2,3,single-choice,spatial-relational,2|3,7,2/3,230394,2
6,2,23,395,1,782,1,13,6,6,7,single-choice,spatial-relational,6|7,7,6/7,230395,6
6,2,23,396,1,1445,1,3,1,1,2,single-choice,spatial-relational,1|2,7,1/2,230396,1
6,2,23,397,1,1104,1,11,5,5,6,single-choice,spatial-relational,5|6,7,5/6,230397,5
6,2,23,398,1,1052,1,9,4,4,5,single-choice,spatial-relational,4|5,7,4/5,230398,4
6,2,23,399,0,874,1,3,1,2,2,single-choice,spatial-relational,1|2,7,1/2,230399,1
6,2,23,400,1,729,1,13,6,6,7,single-choice,spatial-relational,6|7,7,6/7,230400,6
6,2,23,401,1,1012,1,13,6,6,7,single-choice,spatial-relational,6|7,7,6/7,230401,6
6,2,23,402,0,1013,1,5,2,3,3,single-choice,spatial-relational,2|3,7,2/3,230402,2
6,2,23,403,1,664,1,11,5,5,6,single-choice,spatial-relational,5|6,7,5/6,230403,5
6,2,23,404,1,1849,1,5,2,2,3,single-choice,spatial-relational,2|3,7,2/3,230404,2
6,2,23,405,1,967,1,7,3,3,4,single-choice,spatial-relational,3|4,7,3/4,230405,3
6,2,23,406,1,1177,1,7,3,3,4,single-choice,spatial-relational,3|4,7,3/4,230406,3
6,2,23,407,1,1393,1,9,4,4,5,single-choice,spatial-relational,4|5,7,4/5,230407,4
6,2,23,408,1,1451,1,3,1,1,2,single-choice,spatial-relational,1|2,7,1/2,230408,1
6,2,23,409,1,1072,1,5,2,2,3,single-choice,spatial-relational,2|3,7,2/3,230409,2
6,2,23,410,1,1249,1,9,4,4,5,single-choice,spatial-relational,4|5,7,4/5,230410,4
6,2,23,411,1,1009,1,7,3,3,4,single-choice,spatial-relational,3|4,7,3/4,230411,3
6,2,23,412,1,1014,1,3,1,1,2,single-choice,spatial-relational,1|2,7,1/2,230412,1
6,2,23,413,1,1074,1,5,2,2,3,single-choice,spatial-relational,2|3,7,2/3,230413,2
6,2,23,414,1,922,1,13,6,6,7,single-choice,spatial-relational,6|7,7,6/7,230414,6
6,2,23,415,0,111,1,9,4,5,5,single-choice,spatial-relational,4|5,7,4/5,230415,4
6,2,23,416,1,9148,1,13,6,6,7,single-choice,spatial-relational,6|7,7,6/7,230416,6
6,2,23,417,1,1065,1,11,5,5,6,single-choice,spatial-relational,5|6,7,5/6,230417,5
6,2,23,418,1,1351,1,7,3,3,4,single-choice,spatial-relational,3|4,7,3/4,230418,3
6,2,23,419,1,1271,1,11,5,5,6,single-choice,spatial-relational,5|6,7,5/6,230419,5
6,2,23,420,0,810,1,3,1,2,2,single-choice,spatial-relational,1|2,7,1/2,230420,1
6,2,23,421,1,1818,1,7,3,3,4,single-choice,spatial-relational,3|4,7,3/4,230421,3
6,2,23,422,1,1091,1,11,5,5,6,single-choice,spatial-relational,5|6,7,5/6,230422,5
6,2,23,423,1,1087,1,13,6,6,7,single-choice,spatial-relational,6|7,7,6/7,230423,6
6,2,23,424,1,1727,1,9,4,4,5,single-choice,spatial-relational,4|5,7,4/5,230424,4
6,2,23,425,0,875,1,5,2,3,3,single-choice,spatial-relational,2|3,7,2/3,230425,2
6,2,23,426,1,762,1,13,6,6,7,single-choice,spatial-relational,6|7,7,6/7,230426,6
6,2,23,427,1,1117,1,3,1,1,2,single-choice,spatial-relational,1|2,7,1/2,230427,1
6,2,23,428,1,999,1,11,5,5,6,single-choice,spatial-relational,5|6,7,5/6,230428,5
6,2,23,429,1,1395,1,5,2,2,3,single-choice,spatial-relational,2|3,7,2/3,230429,2
6,2,23,430,0,738,1,7,3,4,4,single-choice,spatial-relational,3|4,7,3/4,230430,3
6,2,23,431,0,931,1,9,4,5,5,single-choice,spatial-relational,4|5,7,4/5,230431,4
6,2,23,432,1,893,1,3,1,1,2,single-choice,spatial-relational,1|2,7,1/2,230432,1
6,2,23,433,1,977,1,5,2,2,3,single-choice,spatial-relational,2|3,7,2/3,230433,2
6,2,23,434,1,918,1,13,6,6,7,single-choice,spatial-relational,6|7,7,6/7,230434,6
6,2,23,435,1,1052,1,7,3,3,4,single-choice,spatial-relational,3|4,7,3/4,230435,3
6,2,23,436,1,890,1,13,6,6,7,single-choice,spatial-relational,6|7,7,6/7,230436,6
6,2,23,437,1,878,1,3,1,1,2,single-choice,spatial-relational,1|2,7,1/2,230437,1
6,2,23,438,1,1053,1,9,4,4,5,single-choice,spatial-relational,4|5,7,4/5,230438,4
6,2,23,439,1,1097,1,7,3,3,4,single-choice,spatial-relational,3|4,7,3/4,230439,3
6,2,23,440,1,2236,1,11,5,5,6,single-choice,spatial-relational,5|6,7,5/6,230440,5
6,2,23,441,0,1065,1,5,2,3,3,single-choice,spatial-relational,2|3,7,2/3,230441,2
6,2,23,442,1,847,1,9,4,4,5,single-choice,spatial-relational,4|5,7,4/5,230442,4
6,2,23,443,1,1361,1,11,5,5,6,single-choice,spatial-relational,5|6,7,5/6,230443,5
6,2,23,444,1,2630,1,3,1,1,2,single-choice,spatial-relational,1|2,7,1/2,230444,1
6,2,23,445,1,926,1,9,4,4,5,single-choice,spatial-relational,4|5,7,4/5,230445,4
6,2,23,446,0,794,1,5,2,3,3,single-choice,spatial-relational,2|3,7,2/3,230446,2
6,2,23,447,1,996,1,11,5,5,6,single-choice,spatial-relational,5|6,7,5/6,230447,5
6,2,23,448,1,1560,1,7,3,3,4,single-choice,spatial-relational,3|4,7,3/4,230448,3
6,2,23,449,1,1509,1,11,5,5,6,single-choice,spatial-relational,5|6,7,5/6,230449,5
6,2,23,450,1,1342,1,3,1,1,2,single-choice,spatial-relational,1|2,7,1/2,230450,1
6,2,23,451,1,860,1,3,1,1,2,single-choice,spatial-relational,1|2,7,1/2,230451,1
6,2,23,452,1,666,1,13,6,6,7,single-choice,spatial-relational,6|7,7,6/7,230452,6
6,2,23,453,1,2044,1,5,2,2,3,single-choice,spatial-relational,2|3,7,2/3,230453,2
6,2,23,454,1,955,1,7,3,3,4,single-choice,spatial-relational,3|4,7,3/4,230454,3
6,2,23,455,1,834,1,13,6,6,7,single-choice,spatial-relational,6|7,7,6/7,230455,6
6,2,23,456,1,999,1,9,4,4,5,single-choice,spatial-relational,4|5,7,4/5,230456,4
6,2,23,457,1,1000,1,13,6,6,7,single-choice,spatial-relational,6|7,7,6/7,230457,6
6,2,23,458,0,908,1,7,3,4,4,single-choice,spatial-relational,3|4,7,3/4,230458,3
6,2,23,459,1,1094,1,7,3,3,4,single-choice,spatial-relational,3|4,7,3/4,230459,3
6,2,23,460,1,1227,1,5,2,2,3,single-choice,spatial-relational,2|3,7,2/3,230460,2
6,2,23,461,1,1309,1,11,5,5,6,single-choice,spatial-relational,5|6,7,5/6,230461,5
6,2,23,462,1,1095,1,9,4,4,5,single-choice,spatial-relational,4|5,7,4/5,230462,4
6,2,23,463,0,718,1,3,1,2,2,single-choice,spatial-relational,1|2,7,1/2,230463,1
6,2,23,464,0,1279,1,3,1,2,2,single-choice,spatial-relational,1|2,7,1/2,230464,1
6,2,23,465,1,1500,1,11,5,5,6,single-choice,spatial-relational,5|6,7,5/6,230465,5
6,2,23,466,1,1039,1,13,6,6,7,single-choice,spatial-relational,6|7,7,6/7,230466,6
6,2,23,467,1,1858,1,5,2,2,3,single-choice,spatial-relational,2|3,7,2/3,230467,2
6,2,23,468,1,1246,1,9,4,4,5,single-choice,spatial-relational,4|5,7,4/5,230468,4
6,2,23,469,1,920,1,7,3,3,4,single-choice,spatial-relational,3|4,7,3/4,230469,3
6,2,23,470,0,1239,1,9,4,5,5,single-choice,spatial-relational,4|5,7,4/5,230470,4
6,2,23,471,0,1441,1,5,2,3,3,single-choice,spatial-relational,2|3,7,2/3,230471,2
6,2,23,472,1,1087,1,11,5,5,6,single-choice,spatial-relational,5|6,7,5/6,230472,5
6,2,23,473,1,1626,1,3,1,1,2,single-choice,spatial-relational,1|2,7,1/2,230473,1
6,2,23,474,1,941,1,3,1,1,2,single-choice,spatial-relational,1|2,7,1/2,230474,1
6,2,23,475,1,1586,1,5,2,2,3,single-choice,spatial-relational,2|3,7,2/3,230475,2
6,2,23,476,1,831,1,13,6,6,7,single-choice,spatial-relational,6|7,7,6/7,230476,6
6,2,23,477,1,918,1,11,5,5,6,single-choice,spatial-relational,5|6,7,5/6,230477,5
6,2,23,478,1,847,1,13,6,6,7,single-choice,spatial-relational,6|7,7,6/7,230478,6
6,2,23,479,0,1232,1,7,3,4,4,single-choice,spatial-relational,3|4,7,3/4,230479,3
6,2,23,480,1,1300,1,9,4,4,5,single-choice,spatial-relational,4|5,7,4/5,230480,4
6,2,23,481,0,370007,1,5,2,3,3,single-choice,spatial-relational,2|3,7,2/3,230481,2
6,2,23,482,1,805,1,13,6,6,7,single-choice,spatial-relational,6|7,7,6/7,230482,6
6,2,23,483,0,2305,1,9,4,5,5,single-choice,spatial-relational,4|5,7,4/5,230483,4
6,2,23,484,0,736,1,3,1,2,2,single-choice,spatial-relational,1|2,7,1/2,230484,1
6,2,23,485,1,969,1,11,5,5,6,single-choice,spatial-relational,5|6,7,5/6,230485,5
6,2,23,486,1,2367,1,13,6,6,7,single-choice,spatial-relational,6|7,7,6/7,230486,6
6,2,23,487,1,1297,1,3,1,1,2,single-choice,spatial-relational,1|2,7,1/2,230487,1
6,2,23,488,1,1200,1,9,4,4,5,single-choice,spatial-relational,4|5,7,4/5,230488,4
6,2,23,489,1,785,1,7,3,3,4,single-choice,spatial-relational,3|4,7,3/4,230489,3
6,2,23,490,1,211116,1,5,2,2,3,single-choice,spatial-relational,2|3,7,2/3,230490,2
6,2,23,491,0,1272,1,7,3,4,4,single-choice,spatial-relational,3|4,7,3/4,230491,3
6,2,23,492,1,1224,1,11,5,5,6,single-choice,spatial-relational,5|6,7,5/6,230492,5
6,2,23,493,0,1336,1,3,1,2,2,single-choice,spatial-relational,1|2,7,1/2,230493,1
6,2,23,494,1,1173,1,3,1,1,2,single-choice,spatial-relational,1|2,7,1/2,230494,1
6,2,23,495,1,1586,1,5,2,2,3,single-choice,spatial-relational,2|3,7,2/3,230495,2
6,2,23,496,0,2448,1,9,4,5,5,single-choice,spatial-relational,4|5,7,4/5,230496,4
6,2,23,497,1,750,1,13,6,6,7,single-choice,spatial-relational,6|7,7,6/7,230497,6
6,2,23,498,1,1320,1,13,6,6,7,single-choice,spatial-relational,6|7,7,6/7,230498,6
6,2,23,499,1,979,1,11,5,5,6,single-choice,spatial-relational,5|6,7,5/6,230499,5
6,2,23,500,1,1209,1,9,4,4,5,single-choice,spatial-relational,4|5,7,4/5,230500,4
6,2,23,501,1,1104,1,7,3,3,4,single-choice,spatial-relational,3|4,7,3/4,230501,3
6,2,23,502,1,947,1,5,2,2,3,single-choice,spatial-relational,2|3,7,2/3,230502,2
6,2,23,503,1,914,1,11,5,5,6,single-choice,spatial-relational,5|6,7,5/6,230503,5
6,2,23,504,0,1319,1,7,3,4,4,single-choice,spatial-relational,3|4,7,3/4,230504,3
6,2,23,505,1,1397,1,11,5,5,6,single-choice,spatial-relational,5|6,7,5/6,230505,5
6,2,23,506,1,1385,1,7,3,3,4,single-choice,spatial-relational,3|4,7,3/4,230506,3
6,2,23,507,1,1497,1,9,4,4,5,single-choice,spatial-relational,4|5,7,4/5,230507,4
6,2,23,508,1,931,1,13,6,6,7,single-choice,spatial-relational,6|7,7,6/7,230508,6
6,2,23,509,1,1025,1,3,1,1,2,single-choice,spatial-relational,1|2,7,1/2,230509,1
6,2,23,510,1,1001,1,9,4,4,5,single-choice,spatial-relational,4|5,7,4/5,230510,4
6,2,23,511,1,932,1,13,6,6,7,single-choice,spatial-relational,6|7,7,6/7,230511,6
6,2,23,512,0,1762,1,5,2,3,3,single-choice,spatial-relational,2|3,7,2/3,230512,2
6,2,23,513,1,1095,1,11,5,5,6,single-choice,spatial-relational,5|6,7,5/6,230513,5
6,2,23,514,0,3208,1,7,3,4,4,single-choice,spatial-relational,3|4,7,3/4,230514,3
6,2,23,515,1,1260,1,5,2,2,3,single-choice,spatial-relational,2|3,7,2/3,230515,2
6,2,23,516,1,1369,1,3,1,1,2,single-choice,spatial-relational,1|2,7,1/2,230516,1
6,2,23,517,1,743,1,13,6,6,7,single-choice,spatial-relational,6|7,7,6/7,230517,6
6,2,23,518,1,1358,1,3,1,1,2,single-choice,spatial-relational,1|2,7,1/2,230518,1
6,2,23,519,1,2547,1,5,2,2,3,single-choice,spatial-relational,2|3,7,2/3,230519,2
6,2,23,520,1,906,1,7,3,3,4,single-choice,spatial-relational,3|4,7,3/4,230520,3
6,2,23,521,1,1539,1,9,4,4,5,single-choice,spatial-relational,4|5,7,4/5,230521,4
6,2,23,522,1,1706,1,9,4,4,5,single-choice,spatial-relational,4|5,7,4/5,230522,4
6,2,23,523,1,1464,1,3,1,1,2,single-choice,spatial-relational,1|2,7,1/2,230523,1
6,2,23,524,1,1105,1,5,2,2,3,single-choice,spatial-relational,2|3,7,2/3,230524,2
6,2,23,525,1,826,1,13,6,6,7,single-choice,spatial-relational,6|7,7,6/7,230525,6
6,2,23,526,1,2576,1,11,5,5,6,single-choice,spatial-relational,5|6,7,5/6,230526,5
6,2,23,527,1,973,1,11,5,5,6,single-choice,spatial-relational,5|6,7,5/6,230527,5
6,2,23,528,0,1717,1,7,3,4,4,single-choice,spatial-relational,3|4,7,3/4,230528,3
6,2,23,529,1,1116,1,9,4,4,5,single-choice,spatial-relational,4|5,7,4/5,230529,4
6,2,23,530,1,1133,1,13,6,6,7,single-choice,spatial-relational,6|7,7,6/7,230530,6
6,2,23,531,0,1134,1,5,2,3,3,single-choice,spatial-relational,2|3,7,2/3,230531,2
6,2,23,532,1,1441,1,5,2,2,3,single-choice,spatial-relational,2|3,7,2/3,230532,2
6,2,23,533,1,1260,1,11,5,5,6,single-choice,spatial-relational,5|6,7,5/6,230533,5
6,2,23,534,1,1056,1,3,1,1,2,single-choice,spatial-relational,1|2,7,1/2,230534,1
6,2,23,535,1,1488,1,7,3,3,4,single-choice,spatial-relational,3|4,7,3/4,230535,3
6,2,23,536,1,767,1,13,6,6,7,single-choice,spatial-relational,6|7,7,6/7,230536,6
6,2,23,537,0,1040,1,9,4,5,5,single-choice,spatial-relational,4|5,7,4/5,230537,4
6,2,23,538,1,1121,1,3,1,1,2,single-choice,spatial-relational,1|2,7,1/2,230538,1
6,2,23,539,1,1256,1,7,3,3,4,single-choice,spatial-relational,3|4,7,3/4,230539,3
6,2,23,540,1,908,1,11,5,5,6,single-choice,spatial-relational,5|6,7,5/6,230540,5
6,2,23,541,1,1349,1,3,1,1,2,single-choice,spatial-relational,1|2,7,1/2,230541,1
6,2,23,542,1,801,1,13,6,6,7,single-choice,spatial-relational,6|7,7,6/7,230542,6
6,2,23,543,0,1555,1,11,5,6,6,single-choice,spatial-relational,5|6,7,5/6,230543,5
6,2,23,544,1,1169,1,5,2,2,3,single-choice,spatial-relational,2|3,7,2/3,230544,2
6,2,23,545,1,1373,1,11,5,5,6,single-choice,spatial-relational,5|6,7,5/6,230545,5
6,2,23,546,1,948,1,7,3,3,4,single-choice,spatial-relational,3|4,7,3/4,230546,3
6,2,23,547,1,1458,1,5,2,2,3,single-choice,spatial-relational,2|3,7,2/3,230547,2
6,2,23,548,1,1010,1,7,3,3,4,single-choice,spatial-relational,3|4,7,3/4,230548,3
6,2,23,549,1,1185,1,9,4,4,5,single-choice,spatial-relational,4|5,7,4/5,230549,4
6,2,23,550,1,962,1,13,6,6,7,single-choice,spatial-relational,6|7,7,6/7,230550,6
6,2,23,551,1,2084,1,3,1,1,2,single-choice,spatial-relational,1|2,7,1/2,230551,1
6,2,23,552,0,1288,1,9,4,5,5,single-choice,spatial-relational,4|5,7,4/5,230552,4
6,2,23,553,1,2146,1,3,1,1,2,single-choice,spatial-relational,1|2,7,1/2,230553,1
6,2,23,554,1,949,1,7,3,3,4,single-choice,spatial-relational,3|4,7,3/4,230554,3
6,2,23,555,1,1470,1,9,4,4,5,single-choice,spatial-relational,4|5,7,4/5,230555,4
6,2,23,556,1,862,1,13,6,6,7,single-choice,spatial-relational,6|7,7,6/7,230556,6
6,2,23,557,0,1280,1,11,5,6,6,single-choice,spatial-relational,5|6,7,5/6,230557,5
6,2,23,558,1,996,1,13,6,6,7,single-choice,spatial-relational,6|7,7,6/7,230558,6
6,2,23,559,0,1140,1,5,2,3,3,single-choice,spatial-relational,2|3,7,2/3,230559,2
6,2,23,560,1,1050,1,3,1,1,2,single-choice,spatial-relational,1|2,7,1/2,230560,1
6,2,23,561,1,1249,1,5,2,2,3,single-choice,spatial-relational,2|3,7,2/3,230561,2
6,2,23,562,1,1707,1,7,3,3,4,single-choice,spatial-relational,3|4,7,3/4,230562,3
6,2,23,563,0,910,1,11,5,6,6,single-choice,spatial-relational,5|6,7,5/6,230563,5
6,2,23,564,1,1108,1,9,4,4,5,single-choice,spatial-relational,4|5,7,4/5,230564,4
6,2,23,565,1,1987,1,5,2,2,3,single-choice,spatial-relational,2|3,7,2/3,230565,2
6,2,23,566,1,955,1,13,6,6,7,single-choice,spatial-relational,6|7,7,6/7,230566,6
6,2,23,567,1,1307,1,9,4,4,5,single-choice,spatial-relational,4|5,7,4/5,230567,4
6,2,23,568,1,970,1,3,1,1,2,single-choice,spatial-relational,1|2,7,1/2,230568,1
6,2,23,569,1,951,1,11,5,5,6,single-choice,spatial-relational,5|6,7,5/6,230569,5
6,2,23,570,1,1022,1,7,3,3,4,single-choice,spatial-relational,3|4,7,3/4,230570,3
6,2,23,571,1,1389,1,9,4,4,5,single-choice,spatial-relational,4|5,7,4/5,230571,4
6,2,23,572,1,1045,1,7,3,3,4,single-choice,spatial-relational,3|4,7,3/4,230572,3
6,2,23,573,1,1022,1,3,1,1,2,single-choice,spatial-relational,1|2,7,1/2,230573,1
6,2,23,574,1,873,1,13,6,6,7,single-choice,spatial-relational,6|7,7,6/7,230574,6
6,2,23,575,1,1315,1,11,5,5,6,single-choice,spatial-relational,5|6,7,5/6,230575,5
6,2,23,576,1,1234,1,5,2,2,3,single-choice,spatial-relational,2|3,7,2/3,230576,2
6,2,23,577,1,921,1,11,5,5,6,single-choice,spatial-relational,5|6,7,5/6,230577,5
6,2,23,578,1,1089,1,9,4,4,5,single-choice,spatial-relational,4|5,7,4/5,230578,4
6,2,23,579,0,847,1,3,1,2,2,single-choice,spatial-relational,1|2,7,1/2,230579,1
6,2,23,580,0,1659,1,7,3,4,4,single-choice,spatial-relational,3|4,7,3/4,230580,3
6,2,23,581,1,736,1,13,6,6,7,single-choice,spatial-relational,6|7,7,6/7,230581,6
6,2,23,582,1,218,1,9,4,4,5,single-choice,spatial-relational,4|5,7,4/5,230582,4
6,2,23,583,1,992,1,3,1,1,2,single-choice,spatial-relational,1|2,7,1/2,230583,1
6,2,23,584,0,591,1,11,5,6,6,single-choice,spatial-relational,5|6,7,5/6,230584,5
6,2,23,585,1,3445,1,13,6,6,7,single-choice,spatial-relational,6|7,7,6/7,230585,6
6,2,23,586,1,1143,1,5,2,2,3,single-choice,spatial-relational,2|3,7,2/3,230586,2
6,2,23,587,0,91783,1,5,2,3,3,single-choice,spatial-relational,2|3,7,2/3,230587,2
6,2,23,588,1,1036,1,7,3,3,4,single-choice,spatial-relational,3|4,7,3/4,230588,3
6,2,23,589,0,978,1,3,1,2,2,single-choice,spatial-relational,1|2,7,1/2,230589,1
6,2,23,590,1,1248,1,11,5,5,6,single-choice,spatial-relational,5|6,7,5/6,230590,5
6,2,23,591,1,1275,1,9,4,4,5,single-choice,spatial-relational,4|5,7,4/5,230591,4
6,2,23,592,1,1473,1,5,2,2,3,single-choice,spatial-relational,2|3,7,2/3,230592,2
6,2,23,593,1,1605,1,5,2,2,3,single-choice,spatial-relational,2|3,7,2/3,230593,2
6,2,23,594,0,1512,1,7,3,4,4,single-choice,spatial-relational,3|4,7,3/4,230594,3
6,2,23,595,1,1258,1,3,1,1,2,single-choice,spatial-relational,1|2,7,1/2,230595,1
6,2,23,596,1,1130,1,7,3,3,4,single-choice,spatial-relational,3|4,7,3/4,230596,3
6,2,23,597,1,898,1,13,6,6,7,single-choice,spatial-relational,6|7,7,6/7,230597,6
6,2,23,598,0,1404,1,9,4,5,5,single-choice,spatial-relational,4|5,7,4/5,230598,4
6,2,23,599,1,1698,1,11,5,5,6,single-choice,spatial-relational,5|6,7,5/6,230599,5
6,2,23,600,1,1030,1,13,6,6,7,single-choice,spatial-relational,6|7,7,6/7,230600,6
7,2,23,1,1,1342,1,7,3,3,4,single-choice,spatial-relational,3|4,7,3/4,230001,3
7,2,23,2,1,638,1,11,5,5,6,single-choice,spatial-relational,5|6,7,5/6,230002,5
7,2,23,3,1,302,1,3,1,1,2,single-choice,spatial-relational,1|2,7,1/2,230003,1
7,2,23,4,1,971,1,9,4,4,5,single-choice,spatial-relational,4|5,7,4/5,230004,4
7,2,23,5,0,3304,1,5,2,3,3,single-choice,spatial-relational,2|3,7,2/3,230005,2
7,2,23,6,0,744,1,7,3,4,4,single-choice,spatial-relational,3|4,7,3/4,230006,3
7,2,23,7,0,803,1,3,1,2,2,single-choice,spatial-relational,1|2,7,1/2,230007,1
7,2,23,8,1,949,1,9,4,4,5,single-choice,spatial-relational,4|5,7,4/5,230008,4
7,2,23,9,0,1026,1,13,6,7,7,single-choice,spatial-relational,6|7,7,6/7,230009,6
7,2,23,10,1,727,1,13,6,6,7,single-choice,spatial-relational,6|7,7,6/7,230010,6
7,2,23,11,1,648,1,11,5,5,6,single-choice,spatial-relational,5|6,7,5/6,230011,5
7,2,23,12,0,141,1,5,2,3,3,single-choice,spatial-relational,2|3,7,2/3,230012,2
7,2,23,13,0,1313,1,9,4,5,5,single-choice,spatial-relational,4|5,7,4/5,230013,4
7,2,23,14,1,837,1,5,2,2,3,single-choice,spatial-relational,2|3,7,2/3,230014,2
7,2,23,15,1,282,1,5,2,2,3,single-choice,spatial-relational,2|3,7,2/3,230015,2
7,2,23,16,0,1339,1,11,5,6,6,single-choice,spatial-relational,5|6,7,5/6,230016,5
7,2,23,17,1,720,1,13,6,6,7,single-choice,spatial-relational,6|7,7,6/7,230017,6
7,2,23,18,0,752,1,11,5,6,6,single-choice,spatial-relational,5|6,7,5/6,230018,5
7,2,23,19,0,632,1,7,3,4,4,single-choice,spatial-relational,3|4,7,3/4,230019,3
7,2,23,20,1,1281,1,7,3,3,4,single-choice,spatial-relational,3|4,7,3/4,230020,3
7,2,23,21,1,1507,1,9,4,4,5,single-choice,spatial-relational,4|5,7,4/5,230021,4
7,2,23,22,1,850,1,13,6,6,7,single-choice,spatial-relational,6|7,7,6/7,230022,6
7,2,23,23,0,1054,1,3,1,2,2,single-choice,spatial-relational,1|2,7,1/2,230023,1
7,2,23,24,1,1013,1,3,1,1,2,single-choice,spatial-relational,1|2,7,1/2,230024,1
7,2,23,25,1,1020,1,11,5,5,6,single-choice,spatial-relational,5|6,7,5/6,230025,5
7,2,23,26,0,1892,1,5,2,3,3,single-choice,spatial-relational,2|3,7,2/3,230026,2
7,2,23,27,0,713,1,7,3,4,4,single-choice,spatial-relational,3|4,7,3/4,230027,3
7,2,23,28,1,723,1,13,6,6,7,single-choice,spatial-relational,6|7,7,6/7,230028,6
7,2,23,29,0,1540,1,9,4,5,5,single-choice,spatial-relational,4|5,7,4/5,230029,4
7,2,23,30,1,1064,1,7,3,3,4,single-choice,spatial-relational,3|4,7,3/4,230030,3
7,2,23,31,1,1386,1,5,2,2,3,single-choice,spatial-relational,2|3,7,2/3,230031,2
7,2,23,32,1,1095,1,13,6,6,7,single-choice,spatial-relational,6|7,7,6/7,230032,6
7,2,23,33,1,2005,1,9,4,4,5,single-choice,spatial-relational,4|5,7,4/5,230033,4
7,2,23,34,1,2283,1,3,1,1,2,single-choice,spatial-relational,1|2,7,1/2,230034,1
7,2,23,35,1,1124,1,11,5,5,6,single-choice,spatial-relational,5|6,7,5/6,230035,5
7,2,23,36,1,1670,1,3,1,1,2,single-choice,spatial-relational,1|2,7,1/2,230036,1
7,2,23,37,1,879,1,5,2,2,3,single-choice,spatial-relational,2|3,7,2/3,230037,2
7,2,23,38,1,1282,1,7,3,3,4,single-choice,spatial-relational,3|4,7,3/4,230038,3
7,2,23,39,1,1085,1,5,2,2,3,single-choice,spatial-relational,2|3,7,2/3,230039,2
7,2,23,40,0,1137,1,9,4,5,5,single-choice,spatial-relational,4|5,7,4/5,230040,4
7,2,23,41,1,661,1,13,6,6,7,single-choice,spatial-relational,6|7,7,6/7,230041,6
7,2,23,42,1,1431,1,13,6,6,7,single-choice,spatial-relational,6|7,7,6/7,230042,6
7,2,23,43,0,1041,1,3,1,2,2,single-choice,spatial-relational,1|2,7,1/2,230043,1
7,2,23,44,1,842,1,7,3,3,4,single-choice,spatial-relational,3|4,7,3/4,230044,3
7,2,23,45,1,2608,1,3,1,1,2,single-choice,spatial-relational,1|2,7,1/2,230045,1
7,2,23,46,1,1188,1,11,5,5,6,single-choice,spatial-relational,5|6,7,5/6,230046,5
7,2,23,47,1,1270,1,11,5,5,6,single-choice,spatial-relational,5|6,7,5/6,230047,5
7,2,23,48,1,2374,1,9,4,4,5,single-choice,spatial-relational,4|5,7,4/5,230048,4
7,2,23,49,1,1169,1,13,6,6,7,single-choice,spatial-relational,6|7,7,6/7,230049,6
7,2,23,50,1,1602,1,5,2,2,3,single-choice,spatial-relational,2|3,7,2/3,230050,2
7,2,23,51,1,1053,1,11,5,5,6,single-choice,spatial-relational,5|6,7,5/6,230051,5
7,2,23,52,1,1308,1,7,3,3,4,single-choice,spatial-relational,3|4,7,3/4,230052,3
7,2,23,53,1,1446,1,9,4,4,5,single-choice,spatial-relational,4|5,7,4/5,230053,4
7,2,23,54,1,2840,1,5,2,2,3,single-choice,spatial-relational,2|3,7,2/3,230054,2
7,2,23,55,1,1048,1,11,5,5,6,single-choice,spatial-relational,5|6,7,5/6,230055,5
7,2,23,56,0,1479,1,9,4,5,5,single-choice,spatial-relational,4|5,7,4/5,230056,4
7,2,23,57,1,977,1,3,1,1,2,single-choice,spatial-relational,1|2,7,1/2,230057,1
7,2,23,58,1,350,1,3,1,1,2,single-choice,spatial-relational,1|2,7,1/2,230058,1
7,2,23,59,1,753,1,13,6,6,7,single-choice,spatial-relational,6|7,7,6/7,230059,6
7,2,23,60,1,1310,1,7,3,3,4,single-choice,spatial-relational,3|4,7,3/4,230060,3
7,2,23,61,1,1347,1,11,5,5,6,single-choice,spatial-relational,5|6,7,5/6,230061,5
7,2,23,62,1,1866,1,13,6,6,7,single-choice,spatial-relational,6|7,7,6/7,230062,6
7,2,23,63,1,1908,1,9,4,4,5,single-choice,spatial-relational,4|5,7,4/5,230063,4
7,2,23,64,1,2567,1,5,2,2,3,single-choice,spatial-relational,2|3,7,2/3,230064,2
7,2,23,65,1,1139,1,3,1,1,2,single-choice,spatial-relational,1|2,7,1/2,230065,1
7,2,23,66,1,1201,1,5,2,2,3,single-choice,spatial-relational,2|3,7,2/3,230066,2
7,2,23,67,1,1439,1,7,3,3,4,single-choice,spatial-relational,3|4,7,3/4,230067,3
7,2,23,68,1,1201,1,13,6,6,7,single-choice,spatial-relational,6|7,7,6/7,230068,6
7,2,23,69,1,1103,1,11,5,5,6,single-choice,spatial-relational,5|6,7,5/6,230069,5
7,2,23,70,1,1431,1,9,4,4,5,single-choice,spatial-relational,4|5,7,4/5,230070,4
7,2,23,71,1,2601,1,7,3,3,4,single-choice,spatial-relational,3|4,7,3/4,230071,3
7,2,23,72,1,1274,1,3,1,1,2,single-choice,spatial-relational,1|2,7,1/2,230072,1
7,2,23,73,1,1097,1,5,2,2,3,single-choice,spatial-relational,2|3,7,2/3,230073,2
7,2,23,74,1,1004,1,7,3,3,4,single-choice,spatial-relational,3|4,7,3/4,230074,3
7,2,23,75,1,1631,1,9,4,4,5,single-choice,spatial-relational,4|5,7,4/5,230075,4
7,2,23,76,1,1207,1,13,6,6,7,single-choice,spatial-relational,6|7,7,6/7,230076,6
7,2,23,77,1,1767,1,9,4,4,5,single-choice,spatial-relational,4|5,7,4/5,230077,4
7,2,23,78,1,1739,1,5,2,2,3,single-choice,spatial-relational,2|3,7,2/3,230078,2
7,2,23,79,1,1535,1,11,5,5,6,single-choice,spatial-relational,5|6,7,5/6,230079,5
7,2,23,80,1,1358,1,11,5,5,6,single-choice,spatial-relational,5|6,7,5/6,230080,5
7,2,23,81,1,1364,1,13,6,6,7,single-choice,spatial-relational,6|7,7,6/7,230081,6
7,2,23,82,1,2806,1,7,3,3,4,single-choice,spatial-relational,3|4,7,3/4,230082,3
7,2,23,83,1,1107,1,3,1,1,2,single-choice,spatial-relational,1|2,7,1/2,230083,1
7,2,23,84,1,1168,1,3,1,1,2,single-choice,spatial-relational,1|2,7,1/2,230084,1
7,2,23,85,1,1224,1,13,6,6,7,single-choice,spatial-relational,6|7,7,6/7,230085,6
7,2,23,86,1,1057,1,13,6,6,7,single-choice,spatial-relational,6|7,7,6/7,230086,6
7,2,23,87,1,2536,1,9,4,4,5,single-choice,spatial-relational,4|5,7,4/5,230087,4
7,2,23,88,1,2427,1,5,2,2,3,single-choice,spatial-relational,2|3,7,2/3,230088,2
7,2,23,89,1,1206,1,11,5,5,6,single-choice,spatial-relational,5|6,7,5/6,230089,5
7,2,23,90,1,1274,1,11,5,5,6,single-choice,spatial-relational,5|6,7,5/6,230090,5
7,2,23,91,1,1411,1,5,2,2,3,single-choice,spatial-relational,2|3,7,2/3,230091,2
7,2,23,92,1,1119,1,7,3,3,4,single-choice,spatial-relational,3|4,7,3/4,230092,3
7,2,23,93,1,1210,1,3,1,1,2,single-choice,spatial-relational,1|2,7,1/2,230093,1
7,2,23,94,1,1401,1,3,1,1,2,single-choice,spatial-relational,1|2,7,1/2,230094,1
7,2,23,95,1,1190,1,9,4,4,5,single-choice,spatial-relational,4|5,7,4/5,230095,4
7,2,23,96,1,1132,1,7,3,3,4,single-choice,spatial-relational,3|4,7,3/4,230096,3
7,2,23,97,1,1694,1,5,2,2,3,single-choice,spatial-relational,2|3,7,2/3,230097,2
7,2,23,98,1,1057,1,7,3,3,4,single-choice,spatial-relational,3|4,7,3/4,230098,3
7,2,23,99,1,1258,1,9,4,4,5,single-choice,spatial-relational,4|5,7,4/5,230099,4
7,2,23,100,1,1138,1,13,6,6,7,single-choice,spatial-relational,6|7,7,6/7,230100,6
7,2,23,101,1,2403,1,11,5,5,6,single-choice,spatial-relational,5|6,7,5/6,230101,5
7,2,23,102,1,1102,1,11,5,5,6,single-choice,spatial-relational,5|6,7,5/6,230102,5
7,2,23,103,1,1362,1,7,3,3,4,single-choice,spatial-relational,3|4,7,3/4,230103,3
7,2,23,104,1,2025,1,3,1,1,2,single-choice,spatial-relational,1|2,7,1/2,230104,1
7,2,23,105,1,785,1,9,4,4,5,single-choice,spatial-relational,4|5,7,4/5,230105,4
7,2,23,106,1,1584,1,13,6,6,7,single-choice,spatial-relational,6|7,7,6/7,230106,6
7,2,23,107,1,3304,1,5,2,2,3,single-choice,spatial-relational,2|3,7,2/3,230107,2
7,2,23,108,0,980,1,3,1,2,2,single-choice,spatial-relational,1|2,7,1/2,230108,1
7,2,23,109,1,967,1,5,2,2,3,single-choice,spatial-relational,2|3,7,2/3,230109,2
7,2,23,110,1,1002,1,7,3,3,4,single-choice,spatial-relational,3|4,7,3/4,230110,3
7,2,23,111,1,1065,1,7,3,3,4,single-choice,spatial-relational,3|4,7,3/4,230111,3
7,2,23,112,1,2107,1,5,2,2,3,single-choice,spatial-relational,2|3,7,2/3,230112,2
7,2,23,113,1,820,1,9,4,4,5,single-choice,spatial-relational,4|5,7,4/5,230113,4
7,2,23,114,0,1681,1,11,5,6,6,single-choice,spatial-relational,5|6,7,5/6,230114,5
7,2,23,115,1,762,1,9,4,4,5,single-choice,spatial-relational,4|5,7,4/5,230115,4
7,2,23,116,1,1040,1,13,6,6,7,single-choice,spatial-relational,6|7,7,6/7,230116,6
7,2,23,117,1,1018,1,11,5,5,6,single-choice,spatial-relational,5|6,7,5/6,230117,5
7,2,23,118,1,1344,1,13,6,6,7,single-choice,spatial-relational,6|7,7,6/7,230118,6
7,2,23,119,1,1197,1,3,1,1,2,single-choice,spatial-relational,1|2,7,1/2,230119,1
7,2,23,120,1,1072,1,3,1,1,2,single-choice,spatial-relational,1|2,7,1/2,230120,1
7,2,23,121,1,1240,1,5,2,2,3,single-choice,spatial-relational,2|3,7,2/3,230121,2
7,2,23,122,0,1325,1,7,3,4,4,single-choice,spatial-relational,3|4,7,3/4,230122,3
7,2,23,123,1,865,1,7,3,3,4,single-choice,spatial-relational,3|4,7,3/4,230123,3
7,2,23,124,1,1366,1,3,1,1,2,single-choice,spatial-relational,1|2,7,1/2,230124,1
7,2,23,125,1,1467,1,5,2,2,3,single-choice,spatial-relational,2|3,7,2/3,230125,2
7,2,23,126,1,874,1,11,5,5,6,single-choice,spatial-relational,5|6,7,5/6,230126,5
7,2,23,127,1,891,1,13,6,6,7,single-choice,spatial-relational,6|7,7,6/7,230127,6
7,2,23,128,1,984,1,9,4,4,5,single-choice,spatial-relational,4|5,7,4/5,230128,4
7,2,23,129,1,1536,1,3,1,1,2,single-choice,spatial-relational,1|2,7,1/2,230129,1
7,2,23,130,1,767,1,13,6,6,7,single-choice,spatial-relational,6|7,7,6/7,230130,6
7,2,23,131,1,985,1,11,5,5,6,single-choice,spatial-relational,5|6,7,5/6,230131,5
7,2,23,132,1,1158,1,9,4,4,5,single-choice,spatial-relational,4|5,7,4/5,230132,4
7,2,23,133,1,940,1,13,6,6,7,single-choice,spatial-relational,6|7,7,6/7,230133,6
7,2,23,134,1,1061,1,13,6,6,7,single-choice,spatial-relational,6|7,7,6/7,230134,6
7,2,23,135,1,1151,1,3,1,1,2,single-choice,spatial-relational,1|2,7,1/2,230135,1
7,2,23,136,1,1354,1,5,2,2,3,single-choice,spatial-relational,2|3,7,2/3,230136,2
7,2,23,137,1,974,1,9,4,4,5,single-choice,spatial-relational,4|5,7,4/5,230137,4
7,2,23,138,0,1010,1,5,2,3,3,single-choice,spatial-relational,2|3,7,2/3,230138,2
7,2,23,139,1,1204,1,9,4,4,5,single-choice,spatial-relational,4|5,7,4/5,230139,4
7,2,23,140,1,1410,1,11,5,5,6,single-choice,spatial-relational,5|6,7,5/6,230140,5
7,2,23,141,1,1458,1,3,1,1,2,single-choice,spatial-relational,1|2,7,1/2,230141,1
7,2,23,142,1,809,1,11,5,5,6,single-choice,spatial-relational,5|6,7,5/6,230142,5
7,2,23,143,1,3127,1,7,3,3,4,single-choice,spatial-relational,3|4,7,3/4,230143,3
7,2,23,144,1,1392,1,7,3,3,4,single-choice,spatial-relational,3|4,7,3/4,230144,3
7,2,23,145,1,1073,1,7,3,3,4,single-choice,spatial-relational,3|4,7,3/4,230145,3
7,2,23,146,1,1756,1,7,3,3,4,single-choice,spatial-relational,3|4,7,3/4,230146,3
7,2,23,147,0,1276,1,11,5,6,6,single-choice,spatial-relational,5|6,7,5/6,230147,5
7,2,23,148,1,689,1,13,6,6,7,single-choice,spatial-relational,6|7,7,6/7,230148,6
7,2,23,149,1,1236,1,9,4,4,5,single-choice,spatial-relational,4|5,7,4/5,230149,4
7,2,23,150,1,986,1,11,5,5,6,single-choice,spatial-relational,5|6,7,5/6,230150,5
7,2,23,151,1,1186,1,13,6,6,7,single-choice,spatial-relational,6|7,7,6/7,230151,6
7,2,23,152,1,2145,1,9,4,4,5,single-choice,spatial-relational,4|5,7,4/5,230152,4
7,2,23,153,1,1297,1,3,1,1,2,single-choice,spatial-relational,1|2,7,1/2,230153,1
7,2,23,154,1,1244,1,5,2,2,3,single-choice,spatial-relational,2|3,7,2/3,230154,2
7,2,23,155,1,965,1,5,2,2,3,single-choice,spatial-relational,2|3,7,2/3,230155,2
7,2,23,156,1,1267,1,3,1,1,2,single-choice,spatial-relational,1|2,7,1/2,230156,1
7,2,23,157,1,981,1,5,2,2,3,single-choice,spatial-relational,2|3,7,2/3,230157,2
7,2,23,158,1,982,1,3,1,1,2,single-choice,spatial-relational,1|2,7,1/2,230158,1
7,2,23,159,1,1075,1,7,3,3,4,single-choice,spatial-relational,3|4,7,3/4,230159,3
7,2,23,160,1,1689,1,9,4,4,5,single-choice,spatial-relational,4|5,7,4/5,230160,4
7,2,23,161,1,1742,1,7,3,3,4,single-choice,spatial-relational,3|4,7,3/4,230161,3
7,2,23,162,1,1381,1,11,5,5,6,single-choice,spatial-relational,5|6,7,5/6,230162,5
7,2,23,163,1,2000,1,11,5,5,6,single-choice,spatial-relational,5|6,7,5/6,230163,5
7,2,23,164,1,1752,1,3,1,1,2,single-choice,spatial-relational,1|2,7,1/2,230164,1
7,2,23,165,1,801,1,13,6,6,7,single-choice,spatial-relational,6|7,7,6/7,230165,6
7,2,23,166,1,1459,1,5,2,2,3,single-choice,spatial-relational,2|3,7,2/3,230166,2
7,2,23,167,1,1007,1,13,6,6,7,single-choice,spatial-relational,6|7,7,6/7,230167,6
7,2,23,168,1,2184,1,9,4,4,5,single-choice,spatial-relational,4|5,7,4/5,230168,4
7,2,23,169,1,2030,1,3,1,1,2,single-choice,spatial-relational,1|2,7,1/2,230169,1
7,2,23,170,1,834,1,13,6,6,7,single-choice,spatial-relational,6|7,7,6/7,230170,6
7,2,23,171,1,1129,1,3,1,1,2,single-choice,spatial-relational,1|2,7,1/2,230171,1
7,2,23,172,0,708,1,7,3,4,4,single-choice,spatial-relational,3|4,7,3/4,230172,3
7,2,23,173,1,1208,1,5,2,2,3,single-choice,spatial-relational,2|3,7,2/3,230173,2
7,2,23,174,1,1100,1,7,3,3,4,single-choice,spatial-relational,3|4,7,3/4,230174,3
7,2,23,175,1,1272,1,11,5,5,6,single-choice,spatial-relational,5|6,7,5/6,230175,5
7,2,23,176,1,1530,1,5,2,2,3,single-choice,spatial-relational,2|3,7,2/3,230176,2
7,2,23,177,0,1596,1,9,4,5,5,single-choice,spatial-relational,4|5,7,4/5,230177,4
7,2,23,178,1,827,1,9,4,4,5,single-choice,spatial-relational,4|5,7,4/5,230178,4
7,2,23,179,1,1020,1,11,5,5,6,single-choice,spatial-relational,5|6,7,5/6,230179,5
7,2,23,180,1,890,1,13,6,6,7,single-choice,spatial-relational,6|7,7,6/7,230180,6
7,2,23,181,1,960,1,13,6,6,7,single-choice,spatial-relational,6|7,7,6/7,230181,6
7,2,23,182,1,1139,1,13,6,6,7,single-choice,spatial-relational,6|7,7,6/7,230182,6
7,2,23,183,1,1771,1,9,4,4,5,single-choice,spatial-relational,4|5,7,4/5,230183,4
7,2,23,184,1,1284,1,7,3,3,4,single-choice,spatial-relational,3|4,7,3/4,230184,3
7,2,23,185,1,1064,1,11,5,5,6,single-choice,spatial-relational,5|6,7,5/6,230185,5
7,2,23,186,1,1917,1,5,2,2,3,single-choice,spatial-relational,2|3,7,2/3,230186,2
7,2,23,187,1,1070,1,7,3,3,4,single-choice,spatial-relational,3|4,7,3/4,230187,3
7,2,23,188,1,1527,1,3,1,1,2,single-choice,spatial-relational,1|2,7,1/2,230188,1
7,2,23,189,0,1353,1,9,4,5,5,single-choice,spatial-relational,4|5,7,4/5,230189,4
7,2,23,190,1,1068,1,5,2,2,3,single-choice,spatial-relational,2|3,7,2/3,230190,2
7,2,23,191,1,1402,1,11,5,5,6,single-choice,spatial-relational,5|6,7,5/6,230191,5
7,2,23,192,1,1227,1,3,1,1,2,single-choice,spatial-relational,1|2,7,1/2,230192,1
7,2,23,193,1,1788,1,7,3,3,4,single-choice,spatial-relational,3|4,7,3/4,230193,3
7,2,23,194,1,1136,1,5,2,2,3,single-choice,spatial-relational,2|3,7,2/3,230194,2
7,2,23,195,1,1260,1,9,4,4,5,single-choice,spatial-relational,4|5,7,4/5,230195,4
7,2,23,196,1,1182,1,13,6,6,7,single-choice,spatial-relational,6|7,7,6/7,230196,6
7,2,23,197,1,916,1,13,6,6,7,single-choice,spatial-relational,6|7,7,6/7,230197,6
7,2,23,198,1,1244,1,11,5,5,6,single-choice,spatial-relational,5|6,7,5/6,230198,5
7,2,23,199,1,2680,1,7,3,3,4,single-choice,spatial-relational,3|4,7,3/4,230199,3
7,2,23,200,1,1471,1,9,4,4,5,single-choice,spatial-relational,4|5,7,4/5,230200,4
7,2,23,201,1,1146,1,5,2,2,3,single-choice,spatial-relational,2|3,7,2/3,230201,2
7,2,23,202,1,1958,1,3,1,1,2,single-choice,spatial-relational,1|2,7,1/2,230202,1
7,2,23,203,1,1100,1,3,1,1,2,single-choice,spatial-relational,1|2,7,1/2,230203,1
7,2,23,204,1,1578,1,11,5,5,6,single-choice,spatial-relational,5|6,7,5/6,230204,5
7,2,23,205,1,1049,1,13,6,6,7,single-choice,spatial-relational,6|7,7,6/7,230205,6
7,2,23,206,1,1344,1,9,4,4,5,single-choice,spatial-relational,4|5,7,4/5,230206,4
7,2,23,207,1,1299,1,5,2,2,3,single-choice,spatial-relational,2|3,7,2/3,230207,2
7,2,23,208,1,821,1,13,6,6,7,single-choice,spatial-relational,6|7,7,6/7,230208,6
7,2,23,209,1,1174,1,3,1,1,2,single-choice,spatial-relational,1|2,7,1/2,230209,1
7,2,23,210,0,970,1,9,4,5,5,single-choice,spatial-relational,4|5,7,4/5,230210,4
7,2,23,211,1,987,1,5,2,2,3,single-choice,spatial-relational,2|3,7,2/3,230211,2
7,2,23,212,1,964,1,7,3,3,4,single-choice,spatial-relational,3|4,7,3/4,230212,3
7,2,23,213,1,2005,1,3,1,1,2,single-choice,spatial-relational,1|2,7,1/2,230213,1
7,2,23,214,0,192,1,11,5,6,6,single-choice,spatial-relational,5|6,7,5/6,230214,5
7,2,23,215,1,28,1,7,3,3,4,single-choice,spatial-relational,3|4,7,3/4,230215,3
7,2,23,216,1,1559,1,11,5,5,6,single-choice,spatial-relational,5|6,7,5/6,230216,5
7,2,23,217,1,1050,1,7,3,3,4,single-choice,spatial-relational,3|4,7,3/4,230217,3
7,2,23,218,0,1305,1,9,4,5,5,single-choice,spatial-relational,4|5,7,4/5,230218,4
7,2,23,219,0,927,1,3,1,2,2,single-choice,spatial-relational,1|2,7,1/2,230219,1
7,2,23,220,1,40,1,11,5,5,6,single-choice,spatial-relational,5|6,7,5/6,230220,5
7,2,23,221,1,924,1,11,5,5,6,single-choice,spatial-relational,5|6,7,5/6,230221,5
7,2,23,222,1,1332,1,13,6,6,7,single-choice,spatial-relational,6|7,7,6/7,230222,6
7,2,23,223,1,827,1,13,6,6,7,single-choice,spatial-relational,6|7,7,6/7,230223,6
7,2,23,224,1,2211,1,5,2,2,3,single-choice,spatial-relational,2|3,7,2/3,230224,2
7,2,23,225,1,1201,1,9,4,4,5,single-choice,spatial-relational,4|5,7,4/5,230225,4
7,2,23,226,1,1134,1,7,3,3,4,single-choice,spatial-relational,3|4,7,3/4,230226,3
7,2,23,227,1,1266,1,5,2,2,3,single-choice,spatial-relational,2|3,7,2/3,230227,2
7,2,23,228,1,1229,1,3,1,1,2,single-choice,spatial-relational,1|2,7,1/2,230228,1
7,2,23,229,1,930,1,11,5,5,6,single-choice,spatial-relational,5|6,7,5/6,230229,5
7,2,23,230,1,1366,1,9,4,4,5,single-choice,spatial-relational,4|5,7,4/5,230230,4
7,2,23,231,1,1055,1,7,3,3,4,single-choice,spatial-relational,3|4,7,3/4,230231,3
7,2,23,232,1,1042,1,13,6,6,7,single-choice,spatial-relational,6|7,7,6/7,230232,6
7,2,23,233,1,2006,1,3,1,1,2,single-choice,spatial-relational,1|2,7,1/2,230233,1
7,2,23,234,1,1155,1,5,2,2,3,single-choice,spatial-relational,2|3,7,2/3,230234,2
7,2,23,235,1,1104,1,11,5,5,6,single-choice,spatial-relational,5|6,7,5/6,230235,5
7,2,23,236,1,1169,1,13,6,6,7,single-choice,spatial-relational,6|7,7,6/7,230236,6
7,2,23,237,0,964,1,5,2,3,3,single-choice,spatial-relational,2|3,7,2/3,230237,2
7,2,23,238,0,672,1,7,3,4,4,single-choice,spatial-relational,3|4,7,3/4,230238,3
7,2,23,239,0,739,1,3,1,2,2,single-choice,spatial-relational,1|2,7,1/2,230239,1
7,2,23,240,0,1072,1,9,4,5,5,single-choice,spatial-relational,4|5,7,4/5,230240,4
7,2,23,241,1,1964,1,3,1,1,2,single-choice,spatial-relational,1|2,7,1/2,230241,1
7,2,23,242,1,1426,1,5,2,2,3,single-choice,spatial-relational,2|3,7,2/3,230242,2
7,2,23,243,1,871,1,13,6,6,7,single-choice,spatial-relational,6|7,7,6/7,230243,6
7,2,23,244,1,1100,1,7,3,3,4,single-choice,spatial-relational,3|4,7,3/4,230244,3
7,2,23,245,0,181,1,9,4,5,5,single-choice,spatial-relational,4|5,7,4/5,230245,4
7,2,23,246,0,962,1,7,3,4,4,single-choice,spatial-relational,3|4,7,3/4,230246,3
7,2,23,247,1,757,1,11,5,5,6,single-choice,spatial-relational,5|6,7,5/6,230247,5
7,2,23,248,1,1208,1,9,4,4,5,single-choice,spatial-relational,4|5,7,4/5,230248,4
7,2,23,249,1,1192,1,3,1,1,2,single-choice,spatial-relational,1|2,7,1/2,230249,1
7,2,23,250,1,1257,1,5,2,2,3,single-choice,spatial-relational,2|3,7,2/3,230250,2
7,2,23,251,1,844,1,13,6,6,7,single-choice,spatial-relational,6|7,7,6/7,230251,6
7,2,23,252,1,1122,1,11,5,5,6,single-choice,spatial-relational,5|6,7,5/6,230252,5
7,2,23,253,1,1492,1,9,4,4,5,single-choice,spatial-relational,4|5,7,4/5,230253,4
7,2,23,254,1,1667,1,3,1,1,2,single-choice,spatial-relational,1|2,7,1/2,230254,1
7,2,23,255,1,934,1,11,5,5,6,single-choice,spatial-relational,5|6,7,5/6,230255,5
7,2,23,256,1,1518,1,11,5,5,6,single-choice,spatial-relational,5|6,7,5/6,230256,5
7,2,23,257,1,1044,1,9,4,4,5,single-choice,spatial-relational,4|5,7,4/5,230257,4
7,2,23,258,1,1259,1,5,2,2,3,single-choice,spatial-relational,2|3,7,2/3,230258,2
7,2,23,259,1,1065,1,7,3,3,4,single-choice,spatial-relational,3|4,7,3/4,230259,3
7,2,23,260,1,955,1,7,3,3,4,single-choice,spatial-relational,3|4,7,3/4,230260,3
7,2,23,261,1,1189,1,3,1,1,2,single-choice,spatial-relational,1|2,7,1/2,230261,1
7,2,23,262,1,781,1,13,6,6,7,single-choice,spatial-relational,6|7,7,6/7,230262,6
7,2,23,263,1,1073,1,13,6,6,7,single-choice,spatial-relational,6|7,7,6/7,230263,6
7,2,23,264,1,1421,1,5,2,2,3,single-choice,spatial-relational,2|3,7,2/3,230264,2
7,2,23,265,1,816,1,9,4,4,5,single-choice,spatial-relational,4|5,7,4/5,230265,4
7,2,23,266,1,1287,1,7,3,3,4,single-choice,spatial-relational,3|4,7,3/4,230266,3
7,2,23,267,0,936,1,3,1,2,2,single-choice,spatial-relational,1|2,7,1/2,230267,1
7,2,23,268,0,923,1,9,4,5,5,single-choice,spatial-relational,4|5,7,4/5,230268,4
7,2,23,269,1,827,1,13,6,6,7,single-choice,spatial-relational,6|7,7,6/7,230269,6
7,2,23,270,1,1069,1,11,5,5,6,single-choice,spatial-relational,5|6,7,5/6,230270,5
7,2,23,271,1,1177,1,7,3,3,4,single-choice,spatial-relational,3|4,7,3/4,230271,3
7,2,23,272,1,1223,1,3,1,1,2,single-choice,spatial-relational,1|2,7,1/2,230272,1
7,2,23,273,1,907,1,5,2,2,3,single-choice,spatial-relational,2|3,7,2/3,230273,2
7,2,23,274,1,957,1,13,6,6,7,single-choice,spatial-relational,6|7,7,6/7,230274,6
7,2,23,275,0,1968,1,5,2,3,3,single-choice,spatial-relational,2|3,7,2/3,230275,2
7,2,23,276,0,858,1,11,5,6,6,single-choice,spatial-relational,5|6,7,5/6,230276,5
7,2,23,277,1,1887,1,11,5,5,6,single-choice,spatial-relational,5|6,7,5/6,230277,5
7,2,23,278,1,1216,1,3,1,1,2,single-choice,spatial-relational,1|2,7,1/2,230278,1
7,2,23,279,1,978,1,7,3,3,4,single-choice,spatial-relational,3|4,7,3/4,230279,3
7,2,23,280,0,1244,1,3,1,2,2,single-choice,spatial-relational,1|2,7,1/2,230280,1
7,2,23,281,1,1278,1,5,2,2,3,single-choice,spatial-relational,2|3,7,2/3,230281,2
7,2,23,282,1,1078,1,7,3,3,4,single-choice,spatial-relational,3|4,7,3/4,230282,3
7,2,23,283,1,1024,1,5,2,2,3,single-choice,spatial-relational,2|3,7,2/3,230283,2
7,2,23,284,1,945,1,11,5,5,6,single-choice,spatial-relational,5|6,7,5/6,230284,5
7,2,23,285,1,938,1,9,4,4,5,single-choice,spatial-relational,4|5,7,4/5,230285,4
7,2,23,286,1,1008,1,13,6,6,7,single-choice,spatial-relational,6|7,7,6/7,230286,6
7,2,23,287,1,1387,1,9,4,4,5,single-choice,spatial-relational,4|5,7,4/5,230287,4
7,2,23,288,1,1163,1,13,6,6,7,single-choice,spatial-relational,6|7,7,6/7,230288,6
7,2,23,289,1,1223,1,7,3,3,4,single-choice,spatial-relational,3|4,7,3/4,230289,3
7,2,23,290,1,1082,1,11,5,5,6,single-choice,spatial-relational,5|6,7,5/6,230290,5
7,2,23,291,0,1471,1,5,2,3,3,single-choice,spatial-relational,2|3,7,2/3,230291,2
7,2,23,292,1,1324,1,9,4,4,5,single-choice,spatial-relational,4|5,7,4/5,230292,4
7,2,23,293,0,134,1,9,4,5,5,single-choice,spatial-relational,4|5,7,4/5,230293,4
7,2,23,294,1,976,1,5,2,2,3,single-choice,spatial-relational,2|3,7,2/3,230294,2
7,2,23,295,1,814,1,13,6,6,7,single-choice,spatial-relational,6|7,7,6/7,230295,6
7,2,23,296,1,1249,1,11,5,5,6,single-choice,spatial-relational,5|6,7,5/6,230296,5
7,2,23,297,1,1455,1,3,1,1,2,single-choice,spatial-relational,1|2,7,1/2,230297,1
7,2,23,298,1,1265,1,3,1,1,2,single-choice,spatial-relational,1|2,7,1/2,230298,1
7,2,23,299,1,733,1,13,6,6,7,single-choice,spatial-relational,6|7,7,6/7,230299,6
7,2,23,300,1,1666,1,7,3,3,4,single-choice,spatial-relational,3|4,7,3/4,230300,3
7,2,23,301,1,1754,1,3,1,1,2,single-choice,spatial-relational,1|2,7,1/2,230301,1
7,2,23,302,1,778,1,13,6,6,7,single-choice,spatial-relational,6|7,7,6/7,230302,6
7,2,23,303,1,2023,1,11,5,5,6,single-choice,spatial-relational,5|6,7,5/6,230303,5
7,2,23,304,1,1520,1,5,2,2,3,single-choice,spatial-relational,2|3,7,2/3,230304,2
7,2,23,305,1,1422,1,9,4,4,5,single-choice,spatial-relational,4|5,7,4/5,230305,4
7,2,23,306,1,1083,1,13,6,6,7,single-choice,spatial-relational,6|7,7,6/7,230306,6
7,2,23,307,1,1696,1,7,3,3,4,single-choice,spatial-relational,3|4,7,3/4,230307,3
7,2,23,308,1,1038,1,7,3,3,4,single-choice,spatial-relational,3|4,7,3/4,230308,3
7,2,23,309,1,1644,1,3,1,1,2,single-choice,spatial-relational,1|2,7,1/2,230309,1
7,2,23,310,1,1140,1,11,5,5,6,single-choice,spatial-relational,5|6,7,5/6,230310,5
7,2,23,311,1,1407,1,9,4,4,5,single-choice,spatial-relational,4|5,7,4/5,230311,4
7,2,23,312,1,1533,1,5,2,2,3,single-choice,spatial-relational,2|3,7,2/3,230312,2
7,2,23,313,1,1110,1,9,4,4,5,single-choice,spatial-relational,4|5,7,4/5,230313,4
7,2,23,314,0,1497,1,7,3,4,4,single-choice,spatial-relational,3|4,7,3/4,230314,3
7,2,23,315,1,827,1,11,5,5,6,single-choice,spatial-relational,5|6,7,5/6,230315,5
7,2,23,316,1,1679,1,7,3,3,4,single-choice,spatial-relational,3|4,7,3/4,230316,3
7,2,23,317,1,1444,1,3,1,1,2,single-choice,spatial-relational,1|2,7,1/2,230317,1
7,2,23,318,1,1646,1,3,1,1,2,single-choice,spatial-relational,1|2,7,1/2,230318,1
7,2,23,319,1,822,1,13,6,6,7,single-choice,spatial-relational,6|7,7,6/7,230319,6
7,2,23,320,1,2145,1,9,4,4,5,single-choice,spatial-relational,4|5,7,4/5,230320,4
7,2,23,321,1,1112,1,11,5,5,6,single-choice,spatial-relational,5|6,7,5/6,230321,5
7,2,23,322,1,1802,1,5,2,2,3,single-choice,spatial-relational,2|3,7,2/3,230322,2
7,2,23,323,1,1622,1,5,2,2,3,single-choice,spatial-relational,2|3,7,2/3,230323,2
7,2,23,324,1,787,1,13,6,6,7,single-choice,spatial-relational,6|7,7,6/7,230324,6
7,2,23,325,1,2239,1,11,5,5,6,single-choice,spatial-relational,5|6,7,5/6,230325,5
7,2,23,326,1,1640,1,9,4,4,5,single-choice,spatial-relational,4|5,7,4/5,230326,4
7,2,23,327,1,1910,1,7,3,3,4,single-choice,spatial-relational,3|4,7,3/4,230327,3
7,2,23,328,1,1063,1,5,2,2,3,single-choice,spatial-relational,2|3,7,2/3,230328,2
7,2,23,329,1,920,1,13,6,6,7,single-choice,spatial-relational,6|7,7,6/7,230329,6
7,2,23,330,0,1799,1,3,1,2,2,single-choice,spatial-relational,1|2,7,1/2,230330,1
7,2,23,331,1,1289,1,5,2,2,3,single-choice,spatial-relational,2|3,7,2/3,230331,2
7,2,23,332,1,968,1,7,3,3,4,single-choice,spatial-relational,3|4,7,3/4,230332,3
7,2,23,333,1,1286,1,3,1,1,2,single-choice,spatial-relational,1|2,7,1/2,230333,1
7,2,23,334,1,1235,1,9,4,4,5,single-choice,spatial-relational,4|5,7,4/5,230334,4
7,2,23,335,1,1077,1,13,6,6,7,single-choice,spatial-relational,6|7,7,6/7,230335,6
7,2,23,336,1,1185,1,11,5,5,6,single-choice,spatial-relational,5|6,7,5/6,230336,5
7,2,23,337,1,1914,1,9,4,4,5,single-choice,spatial-relational,4|5,7,4/5,230337,4
7,2,23,338,1,1915,1,3,1,1,2,single-choice,spatial-relational,1|2,7,1/2,230338,1
7,2,23,339,1,2143,1,5,2,2,3,single-choice,spatial-relational,2|3,7,2/3,230339,2
7,2,23,340,1,931,1,7,3,3,4,single-choice,spatial-relational,3|4,7,3/4,230340,3
7,2,23,341,1,1313,1,11,5,5,6,single-choice,spatial-relational,5|6,7,5/6,230341,5
7,2,23,342,1,1910,1,13,6,6,7,single-choice,spatial-relational,6|7,7,6/7,230342,6
7,2,23,343,0,1627,1,5,2,3,3,single-choice,spatial-relational,2|3,7,2/3,230343,2
7,2,23,344,1,711,1,11,5,5,6,single-choice,spatial-relational,5|6,7,5/6,230344,5
7,2,23,345,1,1950,1,7,3,3,4,single-choice,spatial-relational,3|4,7,3/4,230345,3
7,2,23,346,1,1162,1,9,4,4,5,single-choice,spatial-relational,4|5,7,4/5,230346,4
7,2,23,347,1,84,1,3,1,1,2,single-choice,spatial-relational,1|2,7,1/2,230347,1
7,2,23,348,1,875,1,13,6,6,7,single-choice,spatial-relational,6|7,7,6/7,230348,6
7,2,23,349,1,1931,1,11,5,5,6,single-choice,spatial-relational,5|6,7,5/6,230349,5
7,2,23,350,0,2120,1,7,3,4,4,single-choice,spatial-relational,3|4,7,3/4,230350,3
7,2,23,351,1,1136,1,9,4,4,5,single-choice,spatial-relational,4|5,7,4/5,230351,4
7,2,23,352,1,1809,1,5,2,2,3,single-choice,spatial-relational,2|3,7,2/3,230352,2
7,2,23,353,1,1346,1,3,1,1,2,single-choice,spatial-relational,1|2,7,1/2,230353,1
7,2,23,354,1,1159,1,11,5,5,6,single-choice,spatial-relational,5|6,7,5/6,230354,5
7,2,23,355,1,978,1,13,6,6,7,single-choice,spatial-relational,6|7,7,6/7,230355,6
7,2,23,356,1,1510,1,9,4,4,5,single-choice,spatial-relational,4|5,7,4/5,230356,4
7,2,23,357,0,1112,1,5,2,3,3,single-choice,spatial-relational,2|3,7,2/3,230357,2
7,2,23,358,0,644,1,7,3,4,4,single-choice,spatial-relational,3|4,7,3/4,230358,3
7,2,23,359,1,1042,1,3,1,1,2,single-choice,spatial-relational,1|2,7,1/2,230359,1
7,2,23,360,1,1520,1,13,6,6,7,single-choice,spatial-relational,6|7,7,6/7,230360,6
7,2,23,361,1,1329,1,5,2,2,3,single-choice,spatial-relational,2|3,7,2/3,230361,2
7,2,23,362,1,1186,1,3,1,1,2,single-choice,spatial-relational,1|2,7,1/2,230362,1
7,2,23,363,1,957,1,5,2,2,3,single-choice,spatial-relational,2|3,7,2/3,230363,2
7,2,23,364,1,1186,1,11,5,5,6,single-choice,spatial-relational,5|6,7,5/6,230364,5
7,2,23,365,1,1979,1,7,3,3,4,single-choice,spatial-relational,3|4,7,3/4,230365,3
7,2,23,366,1,1100,1,7,3,3,4,single-choice,spatial-relational,3|4,7,3/4,230366,3
7,2,23,367,1,1926,1,9,4,4,5,single-choice,spatial-relational,4|5,7,4/5,230367,4
7,2,23,368,1,1253,1,11,5,5,6,single-choice,spatial-relational,5|6,7,5/6,230368,5
7,2,23,369,1,1237,1,13,6,6,7,single-choice,spatial-relational,6|7,7,6/7,230369,6
7,2,23,370,0,2091,1,3,1,2,2,single-choice,spatial-relational,1|2,7,1/2,230370,1
7,2,23,371,1,710,1,13,6,6,7,single-choice,spatial-relational,6|7,7,6/7,230371,6
7,2,23,372,1,2282,1,9,4,4,5,single-choice,spatial-relational,4|5,7,4/5,230372,4
7,2,23,373,1,921,1,9,4,4,5,single-choice,spatial-relational,4|5,7,4/5,230373,4
7,2,23,374,1,1565,1,9,4,4,5,single-choice,spatial-relational,4|5,7,4/5,230374,4
7,2,23,375,1,2085,1,5,2,2,3,single-choice,spatial-relational,2|3,7,2/3,230375,2
7,2,23,376,1,1033,1,11,5,5,6,single-choice,spatial-relational,5|6,7,5/6,230376,5
7,2,23,377,1,1776,1,5,2,2,3,single-choice,spatial-relational,2|3,7,2/3,230377,2
7,2,23,378,1,831,1,13,6,6,7,single-choice,spatial-relational,6|7,7,6/7,230378,6
7,2,23,379,1,1915,1,11,5,5,6,single-choice,spatial-relational,5|6,7,5/6,230379,5
7,2,23,380,0,2221,1,3,1,2,2,single-choice,spatial-relational,1|2,7,1/2,230380,1
7,2,23,381,1,922,1,13,6,6,7,single-choice,spatial-relational,6|7,7,6/7,230381,6
7,2,23,382,1,1843,1,3,1,1,2,single-choice,spatial-relational,1|2,7,1/2,230382,1
7,2,23,383,1,1113,1,7,3,3,4,single-choice,spatial-relational,3|4,7,3/4,230383,3
7,2,23,384,1,1000,1,7,3,3,4,single-choice,spatial-relational,3|4,7,3/4,230384,3
7,2,23,385,1,1163,1,5,2,2,3,single-choice,spatial-relational,2|3,7,2/3,230385,2
7,2,23,386,1,1206,1,11,5,5,6,single-choice,spatial-relational,5|6,7,5/6,230386,5
7,2,23,387,1,953,1,3,1,1,2,single-choice,spatial-relational,1|2,7,1/2,230387,1
7,2,23,388,1,98,1,11,5,5,6,single-choice,spatial-relational,5|6,7,5/6,230388,5
7,2,23,389,1,1324,1,9,4,4,5,single-choice,spatial-relational,4|5,7,4/5,230389,4
7,2,23,390,1,1486,1,3,1,1,2,single-choice,spatial-relational,1|2,7,1/2,230390,1
7,2,23,391,1,1399,1,5,2,2,3,single-choice,spatial-relational,2|3,7,2/3,230391,2
7,2,23,392,1,1224,1,7,3,3,4,single-choice,spatial-relational,3|4,7,3/4,230392,3
7,2,23,393,1,1061,1,7,3,3,4,single-choice,spatial-relational,3|4,7,3/4,230393,3
7,2,23,394,1,959,1,13,6,6,7,single-choice,spatial-relational,6|7,7,6/7,230394,6
7,2,23,395,1,1373,1,9,4,4,5,single-choice,spatial-relational,4|5,7,4/5,230395,4
7,2,23,396,1,1187,1,13,6,6,7,single-choice,spatial-relational,6|7,7,6/7,230396,6
7,2,23,397,1,1033,1,13,6,6,7,single-choice,spatial-relational,6|7,7,6/7,230397,6
7,2,23,398,1,1377,1,7,3,3,4,single-choice,spatial-relational,3|4,7,3/4,230398,3
7,2,23,399,1,1177,1,11,5,5,6,single-choice,spatial-relational,5|6,7,5/6,230399,5
7,2,23,400,1,1401,1,3,1,1,2,single-choice,spatial-relational,1|2,7,1/2,230400,1
7,2,23,401,1,1134,1,5,2,2,3,single-choice,spatial-relational,2|3,7,2/3,230401,2
7,2,23,402,1,847,1,13,6,6,7,single-choice,spatial-relational,6|7,7,6/7,230402,6
7,2,23,403,1,1849,1,3,1,1,2,single-choice,spatial-relational,1|2,7,1/2,230403,1
7,2,23,404,1,891,1,5,2,2,3,single-choice,spatial-relational,2|3,7,2/3,230404,2
7,2,23,405,1,1102,1,7,3,3,4,single-choice,spatial-relational,3|4,7,3/4,230405,3
7,2,23,406,1,1811,1,9,4,4,5,single-choice,spatial-relational,4|5,7,4/5,230406,4
7,2,23,407,1,1429,1,9,4,4,5,single-choice,spatial-relational,4|5,7,4/5,230407,4
7,2,23,408,0,1318,1,11,5,6,6,single-choice,spatial-relational,5|6,7,5/6,230408,5
7,2,23,409,1,1200,1,7,3,3,4,single-choice,spatial-relational,3|4,7,3/4,230409,3
7,2,23,410,1,1275,1,5,2,2,3,single-choice,spatial-relational,2|3,7,2/3,230410,2
7,2,23,411,0,883,1,3,1,2,2,single-choice,spatial-relational,1|2,7,1/2,230411,1
7,2,23,412,1,775,1,13,6,6,7,single-choice,spatial-relational,6|7,7,6/7,230412,6
7,2,23,413,1,956,1,13,6,6,7,single-choice,spatial-relational,6|7,7,6/7,230413,6
7,2,23,414,0,2233,1,7,3,4,4,single-choice,spatial-relational,3|4,7,3/4,230414,3
7,2,23,415,1,768,1,11,5,5,6,single-choice,spatial-relational,5|6,7,5/6,230415,5
7,2,23,416,1,1129,1,11,5,5,6,single-choice,spatial-relational,5|6,7,5/6,230416,5
7,2,23,417,1,1360,1,5,2,2,3,single-choice,spatial-relational,2|3,7,2/3,230417,2
7,2,23,418,1,1145,1,9,4,4,5,single-choice,spatial-relational,4|5,7,4/5,230418,4
7,2,23,419,1,1123,1,9,4,4,5,single-choice,spatial-relational,4|5,7,4/5,230419,4
7,2,23,420,1,932,1,3,1,1,2,single-choice,spatial-relational,1|2,7,1/2,230420,1
7,2,23,421,1,929,1,5,2,2,3,single-choice,spatial-relational,2|3,7,2/3,230421,2
7,2,23,422,0,1071,1,9,4,5,5,single-choice,spatial-relational,4|5,7,4/5,230422,4
7,2,23,423,1,840,1,7,3,3,4,single-choice,spatial-relational,3|4,7,3/4,230423,3
7,2,23,424,1,1018,1,11,5,5,6,single-choice,spatial-relational,5|6,7,5/6,230424,5
7,2,23,425,1,1284,1,7,3,3,4,single-choice,spatial-relational,3|4,7,3/4,230425,3
7,2,23,426,1,1379,1,3,1,1,2,single-choice,spatial-relational,1|2,7,1/2,230426,1
7,2,23,427,1,1146,1,5,2,2,3,single-choice,spatial-relational,2|3,7,2/3,230427,2
7,2,23,428,1,1227,1,9,4,4,5,single-choice,spatial-relational,4|5,7,4/5,230428,4
7,2,23,429,0,1502,1,11,5,6,6,single-choice,spatial-relational,5|6,7,5/6,230429,5
7,2,23,430,1,788,1,13,6,6,7,single-choice,spatial-relational,6|7,7,6/7,230430,6
7,2,23,431,0,2080,1,3,1,2,2,single-choice,spatial-relational,1|2,7,1/2,230431,1
7,2,23,432,1,2059,1,13,6,6,7,single-choice,spatial-relational,6|7,7,6/7,230432,6
7,2,23,433,1,1291,1,7,3,3,4,single-choice,spatial-relational,3|4,7,3/4,230433,3
7,2,23,434,1,1244,1,5,2,2,3,single-choice,spatial-relational,2|3,7,2/3,230434,2
7,2,23,435,1,1168,1,11,5,5,6,single-choice,spatial-relational,5|6,7,5/6,230435,5
7,2,23,436,1,1808,1,7,3,3,4,single-choice,spatial-relational,3|4,7,3/4,230436,3
7,2,23,437,1,1669,1,13,6,6,7,single-choice,spatial-relational,6|7,7,6/7,230437,6
7,2,23,438,1,1346,1,5,2,2,3,single-choice,spatial-relational,2|3,7,2/3,230438,2
7,2,23,439,1,1375,1,9,4,4,5,single-choice,spatial-relational,4|5,7,4/5,230439,4
7,2,23,440,0,1056,1,3,1,2,2,single-choice,spatial-relational,1|2,7,1/2,230440,1
7,2,23,441,1,1434,1,3,1,1,2,single-choice,spatial-relational,1|2,7,1/2,230441,1
7,2,23,442,1,949,1,11,5,5,6,single-choice,spatial-relational,5|6,7,5/6,230442,5
7,2,23,443,0,1237,1,9,4,5,5,single-choice,spatial-relational,4|5,7,4/5,230443,4
7,2,23,444,1,773,1,13,6,6,7,single-choice,spatial-relational,6|7,7,6/7,230444,6
7,2,23,445,1,1319,1,5,2,2,3,single-choice,spatial-relational,2|3,7,2/3,230445,2
7,2,23,446,1,1256,1,3,1,1,2,single-choice,spatial-relational,1|2,7,1/2,230446,1
7,2,23,447,1,1006,1,3,1,1,2,single-choice,spatial-relational,1|2,7,1/2,230447,1
7,2,23,448,1,1509,1,11,5,5,6,single-choice,spatial-relational,5|6,7,5/6,230448,5
7,2,23,449,1,913,1,7,3,3,4,single-choice,spatial-relational,3|4,7,3/4,230449,3
7,2,23,450,1,923,1,13,6,6,7,single-choice,spatial-relational,6|7,7,6/7,230450,6
7,2,23,451,1,1928,1,7,3,3,4,single-choice,spatial-relational,3|4,7,3/4,230451,3
7,2,23,452,0,1308,1,11,5,6,6,single-choice,spatial-relational,5|6,7,5/6,230452,5
7,2,23,453,1,36201,1,5,2,2,3,single-choice,spatial-relational,2|3,7,2/3,230453,2
7,2,23,454,1,1030,1,9,4,4,5,single-choice,spatial-relational,4|5,7,4/5,230454,4
7,2,23,455,1,992,1,13,6,6,7,single-choice,spatial-relational,6|7,7,6/7,230455,6
7,2,23,456,1,1084,1,9,4,4,5,single-choice,spatial-relational,4|5,7,4/5,230456,4
7,2,23,457,1,1010,1,7,3,3,4,single-choice,spatial-relational,3|4,7,3/4,230457,3
7,2,23,458,1,1512,1,11,5,5,6,single-choice,spatial-relational,5|6,7,5/6,230458,5
7,2,23,459,0,1637,1,3,1,2,2,single-choice,spatial-relational,1|2,7,1/2,230459,1
7,2,23,460,1,865,1,11,5,5,6,single-choice,spatial-relational,5|6,7,5/6,230460,5
7,2,23,461,1,1208,1,3,1,1,2,single-choice,spatial-relational,1|2,7,1/2,230461,1
7,2,23,462,1,831,1,13,6,6,7,single-choice,spatial-relational,6|7,7,6/7,230462,6
7,2,23,463,1,1305,1,9,4,4,5,single-choice,spatial-relational,4|5,7,4/5,230463,4
7,2,23,464,1,929,1,9,4,4,5,single-choice,spatial-relational,4|5,7,4/5,230464,4
7,2,23,465,1,1050,1,13,6,6,7,single-choice,spatial-relational,6|7,7,6/7,230465,6
7,2,23,466,1,1358,1,5,2,2,3,single-choice,spatial-relational,2|3,7,2/3,230466,2
7,2,23,467,1,1088,1,7,3,3,4,single-choice,spatial-relational,3|4,7,3/4,230467,3
7,2,23,468,1,1132,1,5,2,2,3,single-choice,spatial-relational,2|3,7,2/3,230468,2
7,2,23,469,1,1263,1,9,4,4,5,single-choice,spatial-relational,4|5,7,4/5,230469,4
7,2,23,470,0,1387,1,3,1,2,2,single-choice,spatial-relational,1|2,7,1/2,230470,1
7,2,23,471,1,1304,1,5,2,2,3,single-choice,spatial-relational,2|3,7,2/3,230471,2
7,2,23,472,1,846,1,13,6,6,7,single-choice,spatial-relational,6|7,7,6/7,230472,6
7,2,23,473,1,1398,1,3,1,1,2,single-choice,spatial-relational,1|2,7,1/2,230473,1
7,2,23,474,1,1367,1,11,5,5,6,single-choice,spatial-relational,5|6,7,5/6,230474,5
7,2,23,475,1,1033,1,9,4,4,5,single-choice,spatial-relational,4|5,7,4/5,230475,4
7,2,23,476,1,1726,1,11,5,5,6,single-choice,spatial-relational,5|6,7,5/6,230476,5
7,2,23,477,1,2804,1,7,3,3,4,single-choice,spatial-relational,3|4,7,3/4,230477,3
7,2,23,478,1,1306,1,5,2,2,3,single-choice,spatial-relational,2|3,7,2/3,230478,2
7,2,23,479,1,1644,1,13,6,6,7,single-choice,spatial-relational,6|7,7,6/7,230479,6
7,2,23,480,1,1020,1,7,3,3,4,single-choice,spatial-relational,3|4,7,3/4,230480,3
7,2,23,481,1,932,1,7,3,3,4,single-choice,spatial-relational,3|4,7,3/4,230481,3
7,2,23,482,1,1478,1,11,5,5,6,single-choice,spatial-relational,5|6,7,5/6,230482,5
7,2,23,483,1,905,1,3,1,1,2,single-choice,spatial-relational,1|2,7,1/2,230483,1
7,2,23,484,0,859,1,3,1,2,2,single-choice,spatial-relational,1|2,7,1/2,230484,1
7,2,23,485,1,814,1,11,5,5,6,single-choice,spatial-relational,5|6,7,5/6,230485,5
7,2,23,486,1,1318,1,13,6,6,7,single-choice,spatial-relational,6|7,7,6/7,230486,6
7,2,23,487,1,87,1,5,2,2,3,single-choice,spatial-relational,2|3,7,2/3,230487,2
7,2,23,488,1,1240,1,9,4,4,5,single-choice,spatial-relational,4|5,7,4/5,230488,4
7,2,23,489,1,1511,1,5,2,2,3,single-choice,spatial-relational,2|3,7,2/3,230489,2
7,2,23,490,0,1344,1,7,3,4,4,single-choice,spatial-relational,3|4,7,3/4,230490,3
7,2,23,491,0,768,1,9,4,5,5,single-choice,spatial-relational,4|5,7,4/5,230491,4
7,2,23,492,1,793,1,13,6,6,7,single-choice,spatial-relational,6|7,7,6/7,230492,6
7,2,23,493,1,959,1,13,6,6,7,single-choice,spatial-relational,6|7,7,6/7,230493,6
7,2,23,494,1,1307,1,5,2,2,3,single-choice,spatial-relational,2|3,7,2/3,230494,2
7,2,23,495,1,1143,1,3,1,1,2,single-choice,spatial-relational,1|2,7,1/2,230495,1
7,2,23,496,1,1039,1,11,5,5,6,single-choice,spatial-relational,5|6,7,5/6,230496,5
7,2,23,497,1,1268,1,11,5,5,6,single-choice,spatial-relational,5|6,7,5/6,230497,5
7,2,23,498,1,1081,1,7,3,3,4,single-choice,spatial-relational,3|4,7,3/4,230498,3
7,2,23,499,1,1420,1,5,2,2,3,single-choice,spatial-relational,2|3,7,2/3,230499,2
7,2,23,500,1,2197,1,9,4,4,5,single-choice,spatial-relational,4|5,7,4/5,230500,4
7,2,23,501,1,1350,1,3,1,1,2,single-choice,spatial-relational,1|2,7,1/2,230501,1
7,2,23,502,1,894,1,7,3,3,4,single-choice,spatial-relational,3|4,7,3/4,230502,3
7,2,23,503,1,2198,1,13,6,6,7,single-choice,spatial-relational,6|7,7,6/7,230503,6
7,2,23,504,1,2619,1,9,4,4,5,single-choice,spatial-relational,4|5,7,4/5,230504,4
7,2,23,505,0,1200,1,11,5,6,6,single-choice,spatial-relational,5|6,7,5/6,230505,5
7,2,23,506,1,1415,1,5,2,2,3,single-choice,spatial-relational,2|3,7,2/3,230506,2
7,2,23,507,1,918,1,13,6,6,7,single-choice,spatial-relational,6|7,7,6/7,230507,6
7,2,23,508,1,1737,1,5,2,2,3,single-choice,spatial-relational,2|3,7,2/3,230508,2
7,2,23,509,1,1193,1,9,4,4,5,single-choice,spatial-relational,4|5,7,4/5,230509,4
7,2,23,510,1,1414,1,3,1,1,2,single-choice,spatial-relational,1|2,7,1/2,230510,1
7,2,23,511,1,1074,1,9,4,4,5,single-choice,spatial-relational,4|5,7,4/5,230511,4
7,2,23,512,0,2216,1,11,5,6,6,single-choice,spatial-relational,5|6,7,5/6,230512,5
7,2,23,513,1,1015,1,13,6,6,7,single-choice,spatial-relational,6|7,7,6/7,230513,6
7,2,23,514,1,2227,1,7,3,3,4,single-choice,spatial-relational,3|4,7,3/4,230514,3
7,2,23,515,0,1440,1,7,3,4,4,single-choice,spatial-relational,3|4,7,3/4,230515,3
7,2,23,516,1,1445,1,3,1,1,2,single-choice,spatial-relational,1|2,7,1/2,230516,1
7,2,23,517,1,820,1,13,6,6,7,single-choice,spatial-relational,6|7,7,6/7,230517,6
7,2,23,518,1,135,1,5,2,2,3,single-choice,spatial-relational,2|3,7,2/3,230518,2
7,2,23,519,1,690,1,13,6,6,7,single-choice,spatial-relational,6|7,7,6/7,230519,6
7,2,23,520,1,1058,1,11,5,5,6,single-choice,spatial-relational,5|6,7,5/6,230520,5
7,2,23,521,1,1330,1,7,3,3,4,single-choice,spatial-relational,3|4,7,3/4,230521,3
7,2,23,522,1,1499,1,9,4,4,5,single-choice,spatial-relational,4|5,7,4/5,230522,4
7,2,23,523,1,1429,1,3,1,1,2,single-choice,spatial-relational,1|2,7,1/2,230523,1
7,2,23,524,1,1250,1,5,2,2,3,single-choice,spatial-relational,2|3,7,2/3,230524,2
7,2,23,525,1,1260,1,9,4,4,5,single-choice,spatial-relational,4|5,7,4/5,230525,4
7,2,23,526,1,1368,1,3,1,1,2,single-choice,spatial-relational,1|2,7,1/2,230526,1
7,2,23,527,1,821,1,7,3,3,4,single-choice,spatial-relational,3|4,7,3/4,230527,3
7,2,23,528,1,1001,1,11,5,5,6,single-choice,spatial-relational,5|6,7,5/6,230528,5
7,2,23,529,1,148,1,7,3,3,4,single-choice,spatial-relational,3|4,7,3/4,230529,3
7,2,23,530,1,804,1,13,6,6,7,single-choice,spatial-relational,6|7,7,6/7,230530,6
7,2,23,531,1,1230,1,7,3,3,4,single-choice,spatial-relational,3|4,7,3/4,230531,3
7,2,23,532,1,1377,1,11,5,5,6,single-choice,spatial-relational,5|6,7,5/6,230532,5
7,2,23,533,0,1115,1,3,1,2,2,single-choice,spatial-relational,1|2,7,1/2,230533,1
7,2,23,534,1,738,1,11,5,5,6,single-choice,spatial-relational,5|6,7,5/6,230534,5
7,2,23,535,1,111,1,3,1,1,2,single-choice,spatial-relational,1|2,7,1/2,230535,1
7,2,23,536,1,1382,1,5,2,2,3,single-choice,spatial-relational,2|3,7,2/3,230536,2
7,2,23,537,1,1131,1,5,2,2,3,single-choice,spatial-relational,2|3,7,2/3,230537,2
7,2,23,538,1,1510,1,13,6,6,7,single-choice,spatial-relational,6|7,7,6/7,230538,6
7,2,23,539,1,1028,1,9,4,4,5,single-choice,spatial-relational,4|5,7,4/5,230539,4
7,2,23,540,1,2094,1,9,4,4,5,single-choice,spatial-relational,4|5,7,4/5,230540,4
7,2,23,541,1,1164,1,5,2,2,3,single-choice,spatial-relational,2|3,7,2/3,230541,2
7,2,23,542,0,1150,1,7,3,4,4,single-choice,spatial-relational,3|4,7,3/4,230542,3
7,2,23,543,1,1159,1,9,4,4,5,single-choice,spatial-relational,4|5,7,4/5,230543,4
7,2,23,544,1,1129,1,7,3,3,4,single-choice,spatial-relational,3|4,7,3/4,230544,3
7,2,23,545,1,1609,1,9,4,4,5,single-choice,spatial-relational,4|5,7,4/5,230545,4
7,2,23,546,1,1386,1,11,5,5,6,single-choice,spatial-relational,5|6,7,5/6,230546,5
7,2,23,547,0,1022,1,3,1,2,2,single-choice,spatial-relational,1|2,7,1/2,230547,1
7,2,23,548,1,28,1,13,6,6,7,single-choice,spatial-relational,6|7,7,6/7,230548,6
7,2,23,549,1,1194,1,3,1,1,2,single-choice,spatial-relational,1|2,7,1/2,230549,1
7,2,23,550,1,1326,1,11,5,5,6,single-choice,spatial-relational,5|6,7,5/6,230550,5
7,2,23,551,1,1088,1,13,6,6,7,single-choice,spatial-relational,6|7,7,6/7,230551,6
7,2,23,552,1,1670,1,5,2,2,3,single-choice,spatial-relational,2|3,7,2/3,230552,2
7,2,23,553,1,1409,1,5,2,2,3,single-choice,spatial-relational,2|3,7,2/3,230553,2
7,2,23,554,1,1255,1,11,5,5,6,single-choice,spatial-relational,5|6,7,5/6,230554,5
7,2,23,555,1,1260,1,3,1,1,2,single-choice,spatial-relational,1|2,7,1/2,230555,1
7,2,23,556,1,1005,1,9,4,4,5,single-choice,spatial-relational,4|5,7,4/5,230556,4
7,2,23,557,1,1127,1,11,5,5,6,single-choice,spatial-relational,5|6,7,5/6,230557,5
7,2,23,558,1,1396,1,5,2,2,3,single-choice,spatial-relational,2|3,7,2/3,230558,2
7,2,23,559,1,1106,1,3,1,1,2,single-choice,spatial-relational,1|2,7,1/2,230559,1
7,2,23,560,1,812,1,13,6,6,7,single-choice,spatial-relational,6|7,7,6/7,230560,6
7,2,23,561,1,919,1,13,6,6,7,single-choice,spatial-relational,6|7,7,6/7,230561,6
7,2,23,562,1,1114,1,7,3,3,4,single-choice,spatial-relational,3|4,7,3/4,230562,3
7,2,23,563,1,975,1,7,3,3,4,single-choice,spatial-relational,3|4,7,3/4,230563,3
7,2,23,564,0,1100,1,9,4,5,5,single-choice,spatial-relational,4|5,7,4/5,230564,4
7,2,23,565,1,1772,1,3,1,1,2,single-choice,spatial-relational,1|2,7,1/2,230565,1
7,2,23,566,1,1129,1,7,3,3,4,single-choice,spatial-relational,3|4,7,3/4,230566,3
7,2,23,567,1,998,1,13,6,6,7,single-choice,spatial-relational,6|7,7,6/7,230567,6
7,2,23,568,1,5715,1,13,6,6,7,single-choice,spatial-relational,6|7,7,6/7,230568,6
7,2,23,569,0,1530,1,7,3,4,4,single-choice,spatial-relational,3|4,7,3/4,230569,3
7,2,23,570,1,1911,1,11,5,5,6,single-choice,spatial-relational,5|6,7,5/6,230570,5
7,2,23,571,1,2758,1,9,4,4,5,single-choice,spatial-relational,4|5,7,4/5,230571,4
7,2,23,572,1,3547,1,9,4,4,5,single-choice,spatial-relational,4|5,7,4/5,230572,4
7,2,23,573,1,1382,1,5,2,2,3,single-choice,spatial-relational,2|3,7,2/3,230573,2
7,2,23,574,1,1401,1,3,1,1,2,single-choice,spatial-relational,1|2,7,1/2,230574,1
7,2,23,575,1,965,1,11,5,5,6,single-choice,spatial-relational,5|6,7,5/6,230575,5
7,2,23,576,1,1084,1,5,2,2,3,single-choice,spatial-relational,2|3,7,2/3,230576,2
7,2,23,577,1,908,1,11,5,5,6,single-choice,spatial-relational,5|6,7,5/6,230577,5
7,2,23,578,1,1135,1,9,4,4,5,single-choice,spatial-relational,4|5,7,4/5,230578,4
7,2,23,579,1,1965,1,5,2,2,3,single-choice,spatial-relational,2|3,7,2/3,230579,2
7,2,23,580,1,898,1,13,6,6,7,single-choice,spatial-relational,6|7,7,6/7,230580,6
7,2,23,581,1,1211,1,11,5,5,6,single-choice,spatial-relational,5|6,7,5/6,230581,5
7,2,23,582,1,2361,1,9,4,4,5,single-choice,spatial-relational,4|5,7,4/5,230582,4
7,2,23,583,1,809,1,13,6,6,7,single-choice,spatial-relational,6|7,7,6/7,230583,6
7,2,23,584,1,1190,1,3,1,1,2,single-choice,spatial-relational,1|2,7,1/2,230584,1
7,2,23,585,1,1035,1,7,3,3,4,single-choice,spatial-relational,3|4,7,3/4,230585,3
7,2,23,586,1,1267,1,7,3,3,4,single-choice,spatial-relational,3|4,7,3/4,230586,3
7,2,23,587,1,1209,1,5,2,2,3,single-choice,spatial-relational,2|3,7,2/3,230587,2
7,2,23,588,1,67646,1,3,1,1,2,single-choice,spatial-relational,1|2,7,1/2,230588,1
7,2,23,589,1,1202,1,7,3,3,4,single-choice,spatial-relational,3|4,7,3/4,230589,3
7,2,23,590,1,1136,1,11,5,5,6,single-choice,spatial-relational,5|6,7,5/6,230590,5
7,2,23,591,1,1224,1,5,2,2,3,single-choice,spatial-relational,2|3,7,2/3,230591,2
7,2,23,592,1,1068,1,9,4,4,5,single-choice,spatial-relational,4|5,7,4/5,230592,4
7,2,23,593,1,1307,1,3,1,1,2,single-choice,spatial-relational,1|2,7,1/2,230593,1
7,2,23,594,1,1206,1,9,4,4,5,single-choice,spatial-relational,4|5,7,4/5,230594,4
7,2,23,595,1,1130,1,13,6,6,7,single-choice,spatial-relational,6|7,7,6/7,230595,6
7,2,23,596,1,901,1,7,3,3,4,single-choice,spatial-relational,3|4,7,3/4,230596,3
7,2,23,597,1,1363,1,11,5,5,6,single-choice,spatial-relational,5|6,7,5/6,230597,5
7,2,23,598,1,903,1,3,1,1,2,single-choice,spatial-relational,1|2,7,1/2,230598,1
7,2,23,599,1,832,1,13,6,6,7,single-choice,spatial-relational,6|7,7,6/7,230599,6
7,2,23,600,0,1013,1,5,2,3,3,single-choice,spatial-relational,2|3,7,2/3,230600,2
1,2,24,1,1,2656,1,11,5,5,6,single-choice,spatial-relational,5|6,7,5/6,240001,5
1,2,24,2,1,1196,1,5,2,2,3,single-choice,spatial-relational,2|3,7,2/3,240002,2
1,2,24,3,1,7871,3,11,4,4,7,single-choice,spatial-relational,4|7,7,4/7,240003,4
1,2,24,4,0,740,2,8,3,5,5,single-choice,spatial-relational,3|5,7,3/5,240004,3
1,2,24,5,0,873,4,10,3,7,7,single-choice,spatial-relational,3|7,7,3/7,240005,3
1,2,24,6,1,1106,1,3,1,1,2,single-choice,spatial-relational,1|2,7,1/2,240006,1
1,2,24,7,1,1896,1,7,3,3,4,single-choice,spatial-relational,3|4,7,3/4,240007,3
1,2,24,8,1,1131,1,13,6,6,7,single-choice,spatial-relational,6|7,7,6/7,240008,6
1,2,24,9,1,1430,5,9,2,2,7,single-choice,spatial-relational,2|7,7,2/7,240009,2
1,2,24,10,0,1116,3,7,2,5,5,single-choice,spatial-relational,2|5,7,2/5,240010,2
1,2,24,11,1,958,1,9,4,4,5,single-choice,spatial-relational,4|5,7,4/5,240011,4
1,2,24,12,0,2422,2,8,3,5,5,single-choice,spatial-relational,3|5,7,3/5,240012,3
1,2,24,13,1,1598,3,9,3,3,6,single-choice,spatial-relational,3|6,7,3/6,240013,3
1,2,24,14,1,1601,2,4,1,1,3,single-choice,spatial-relational,1|3,7,1/3,240014,1
1,2,24,15,1,751,1,9,4,4,5,single-choice,spatial-relational,4|5,7,4/5,240015,4
1,2,24,16,1,2819,1,5,2,2,3,single-choice,spatial-relational,2|3,7,2/3,240016,2
1,2,24,17,0,1329,2,12,5,7,7,single-choice,spatial-relational,5|7,7,5/7,240017,5
1,2,24,18,1,1080,4,6,1,1,5,single-choice,spatial-relational,1|5,7,1/5,240018,1
1,2,24,19,1,1053,2,12,5,5,7,single-choice,spatial-relational,5|7,7,5/7,240019,5
1,2,24,20,1,1357,5,9,2,2,7,single-choice,spatial-relational,2|7,7,2/7,240020,2
1,2,24,21,0,900,2,10,4,6,6,single-choice,spatial-relational,4|6,7,4/6,240021,4
1,2,24,22,1,1283,4,8,2,2,6,single-choice,spatial-relational,2|6,7,2/6,240022,2
1,2,24,23,0,1225,3,7,2,5,5,single-choice,spatial-relational,2|5,7,2/5,240023,2
1,2,24,24,1,1004,6,8,1,1,7,single-choice,spatial-relational,1|7,7,1/7,240024,1
1,2,24,25,1,1560,4,6,1,1,5,single-choice,spatial-relational,1|5,7,1/5,240025,1
1,2,24,26,1,1191,6,8,1,1,7,single-choice,spatial-relational,1|7,7,1/7,240026,1
1,2,24,27,1,1171,1,7,3,3,4,single-choice,spatial-relational,3|4,7,3/4,240027,3
1,2,24,28,1,2758,2,4,1,1,3,single-choice,spatial-relational,1|3,7,1/3,240028,1
1,2,24,29,1,1111,4,8,2,2,6,single-choice,spatial-relational,2|6,7,2/6,240029,2
1,2,24,30,1,1537,5,7,1,1,6,single-choice,spatial-relational,1|6,7,1/6,240030,1
1,2,24,31,1,1090,2,6,2,2,4,single-choice,spatial-relational,2|4,7,2/4,240031,2
1,2,24,32,1,862,1,11,5,5,6,single-choice,spatial-relational,5|6,7,5/6,240032,5
1,2,24,33,1,883,3,11,4,4,7,single-choice,spatial-relational,4|7,7,4/7,240033,4
1,2,24,34,1,1160,5,7,1,1,6,single-choice,spatial-relational,1|6,7,1/6,240034,1
1,2,24,35,1,1070,4,10,3,3,7,single-choice,spatial-relational,3|7,7,3/7,240035,3
1,2,24,36,1,1519,1,3,1,1,2,single-choice,spatial-relational,1|2,7,1/2,240036,1
1,2,24,37,1,830,1,13,6,6,7,single-choice,spatial-relational,6|7,7,6/7,240037,6
1,2,24,38,0,1347,2,6,2,4,4,single-choice,spatial-relational,2|4,7,2/4,240038,2
1,2,24,39,1,1106,2,10,4,4,6,single-choice,spatial-relational,4|6,7,4/6,240039,4
1,2,24,40,1,1766,3,9,3,3,6,single-choice,spatial-relational,3|6,7,3/6,240040,3
1,2,24,41,1,2006,3,5,1,1,4,single-choice,spatial-relational,1|4,7,1/4,240041,1
1,2,24,42,1,1001,3,5,1,1,4,single-choice,spatial-relational,1|4,7,1/4,240042,1
1,2,24,43,1,765,1,13,6,6,7,single-choice,spatial-relational,6|7,7,6/7,240043,6
1,2,24,44,1,2189,1,3,1,1,2,single-choice,spatial-relational,1|2,7,1/2,240044,1
1,2,24,45,1,953,4,8,2,2,6,single-choice,spatial-relational,2|6,7,2/6,240045,2
1,2,24,46,1,1193,3,11,4,4,7,single-choice,spatial-relational,4|7,7,4/7,240046,4
1,2,24,47,1,1836,3,5,1,1,4,single-choice,spatial-relational,1|4,7,1/4,240047,1
1,2,24,48,1,892,3,11,4,4,7,single-choice,spatial-relational,4|7,7,4/7,240048,4
1,2,24,49,0,2339,2,8,3,5,5,single-choice,spatial-relational,3|5,7,3/5,240049,3
1,2,24,50,1,1014,4,8,2,2,6,single-choice,spatial-relational,2|6,7,2/6,240050,2
1,2,24,51,1,936,2,12,5,5,7,single-choice,spatial-relational,5|7,7,5/7,240051,5
1,2,24,52,1,1347,4,10,3,3,7,single-choice,spatial-relational,3|7,7,3/7,240052,3
1,2,24,53,1,1191,2,4,1,1,3,single-choice,spatial-relational,1|3,7,1/3,240053,1
1,2,24,54,1,1103,2,8,3,3,5,single-choice,spatial-relational,3|5,7,3/5,240054,3
1,2,24,55,1,955,4,10,3,3,7,single-choice,spatial-relational,3|7,7,3/7,240055,3
1,2,24,56,1,1468,1,11,5,5,6,single-choice,spatial-relational,5|6,7,5/6,240056,5
1,2,24,57,1,930,1,5,2,2,3,single-choice,spatial-relational,2|3,7,2/3,240057,2
1,2,24,58,1,1088,2,6,2,2,4,single-choice,spatial-relational,2|4,7,2/4,240058,2
1,2,24,59,1,1299,2,12,5,5,7,single-choice,spatial-relational,5|7,7,5/7,240059,5
1,2,24,60,0,2393,2,10,4,6,6,single-choice,spatial-relational,4|6,7,4/6,240060,4
1,2,24,61,1,1032,3,9,3,3,6,single-choice,spatial-relational,3|6,7,3/6,240061,3
1,2,24,62,1,1068,1,7,3,3,4,single-choice,spatial-relational,3|4,7,3/4,240062,3
1,2,24,63,1,1023,5,9,2,2,7,single-choice,spatial-relational,2|7,7,2/7,240063,2
1,2,24,64,1,1100,6,8,1,1,7,single-choice,spatial-relational,1|7,7,1/7,240064,1
1,2,24,65,1,1256,3,7,2,2,5,single-choice,spatial-relational,2|5,7,2/5,240065,2
1,2,24,66,1,1367,3,5,1,1,4,single-choice,spatial-relational,1|4,7,1/4,240066,1
1,2,24,67,1,802,1,7,3,3,4,single-choice,spatial-relational,3|4,7,3/4,240067,3
1,2,24,68,1,1246,3,7,2,2,5,single-choice,spatial-relational,2|5,7,2/5,240068,2
1,2,24,69,1,1343,1,5,2,2,3,single-choice,spatial-relational,2|3,7,2/3,240069,2
1,2,24,70,1,1276,2,6,2,2,4,single-choice,spatial-relational,2|4,7,2/4,240070,2
1,2,24,71,1,1100,1,11,5,5,6,single-choice,spatial-relational,5|6,7,5/6,240071,5
1,2,24,72,1,3034,4,6,1,1,5,single-choice,spatial-relational,1|5,7,1/5,240072,1
1,2,24,73,1,790,1,13,6,6,7,single-choice,spatial-relational,6|7,7,6/7,240073,6
1,2,24,74,1,1099,3,9,3,3,6,single-choice,spatial-relational,3|6,7,3/6,240074,3
1,2,24,75,1,1068,5,9,2,2,7,single-choice,spatial-relational,2|7,7,2/7,240075,2
1,2,24,76,1,1012,5,7,1,1,6,single-choice,spatial-relational,1|6,7,1/6,240076,1
1,2,24,77,1,1001,1,9,4,4,5,single-choice,spatial-relational,4|5,7,4/5,240077,4
1,2,24,78,1,1442,6,8,1,1,7,single-choice,spatial-relational,1|7,7,1/7,240078,1
1,2,24,79,1,156,1,3,1,1,2,single-choice,spatial-relational,1|2,7,1/2,240079,1
1,2,24,80,1,1088,1,9,4,4,5,single-choice,spatial-relational,4|5,7,4/5,240080,4
1,2,24,81,1,1481,5,7,1,1,6,single-choice,spatial-relational,1|6,7,1/6,240081,1
1,2,24,82,1,1162,2,4,1,1,3,single-choice,spatial-relational,1|3,7,1/3,240082,1
1,2,24,83,1,1170,2,10,4,4,6,single-choice,spatial-relational,4|6,7,4/6,240083,4
1,2,24,84,1,153,4,6,1,1,5,single-choice,spatial-relational,1|5,7,1/5,240084,1
1,2,24,85,1,770,4,10,3,3,7,single-choice,spatial-relational,3|7,7,3/7,240085,3
1,2,24,86,1,2210,2,8,3,3,5,single-choice,spatial-relational,3|5,7,3/5,240086,3
1,2,24,87,1,1467,2,4,1,1,3,single-choice,spatial-relational,1|3,7,1/3,240087,1
1,2,24,88,1,1367,1,3,1,1,2,single-choice,spatial-relational,1|2,7,1/2,240088,1
1,2,24,89,1,980,5,9,2,2,7,single-choice,spatial-relational,2|7,7,2/7,240089,2
1,2,24,90,1,1124,1,5,2,2,3,single-choice,spatial-relational,2|3,7,2/3,240090,2
1,2,24,91,1,1130,2,10,4,4,6,single-choice,spatial-relational,4|6,7,4/6,240091,4
1,2,24,92,1,1176,4,6,1,1,5,single-choice,spatial-relational,1|5,7,1/5,240092,1
1,2,24,93,1,877,4,10,3,3,7,single-choice,spatial-relational,3|7,7,3/7,240093,3
1,2,24,94,1,1008,3,11,4,4,7,single-choice,spatial-relational,4|7,7,4/7,240094,4
1,2,24,95,1,1305,2,4,1,1,3,single-choice,spatial-relational,1|3,7,1/3,240095,1
1,2,24,96,1,791,3,11,4,4,7,single-choice,spatial-relational,4|7,7,4/7,240096,4
1,2,24,97,1,1697,1,7,3,3,4,single-choice,spatial-relational,3|4,7,3/4,240097,3
1,2,24,98,1,1208,3,7,2,2,5,single-choice,spatial-relational,2|5,7,2/5,240098,2
1,2,24,99,1,1309,3,9,3,3,6,single-choice,spatial-relational,3|6,7,3/6,240099,3
1,2,24,100,1,1406,2,12,5,5,7,single-choice,spatial-relational,5|7,7,5/7,240100,5
1,2,24,101,1,1260,6,8,1,1,7,single-choice,spatial-relational,1|7,7,1/7,240101,1
1,2,24,102,1,935,2,8,3,3,5,single-choice,spatial-relational,3|5,7,3/5,240102,3
1,2,24,103,1,1290,1,5,2,2,3,single-choice,spatial-relational,2|3,7,2/3,240103,2
1,2,24,104,1,1218,5,7,1,1,6,single-choice,spatial-relational,1|6,7,1/6,240104,1
1,2,24,105,1,1475,5,9,2,2,7,single-choice,spatial-relational,2|7,7,2/7,240105,2
1,2,24,106,1,1039,1,11,5,5,6,single-choice,spatial-relational,5|6,7,5/6,240106,5
1,2,24,107,1,942,1,7,3,3,4,single-choice,spatial-relational,3|4,7,3/4,240107,3
1,2,24,108,1,1270,3,5,1,1,4,single-choice,spatial-relational,1|4,7,1/4,240108,1
1,2,24,109,1,1074,4,8,2,2,6,single-choice,spatial-relational,2|6,7,2/6,240109,2
1,2,24,110,1,1437,3,9,3,3,6,single-choice,spatial-relational,3|6,7,3/6,240110,3
1,2,24,111,1,1201,2,12,5,5,7,single-choice,spatial-relational,5|7,7,5/7,240111,5
1,2,24,112,0,2368,2,6,2,4,4,single-choice,spatial-relational,2|4,7,2/4,240112,2
1,2,24,113,0,1342,2,10,4,6,6,single-choice,spatial-relational,4|6,7,4/6,240113,4
1,2,24,114,1,1247,1,9,4,4,5,single-choice,spatial-relational,4|5,7,4/5,240114,4
1,2,24,115,1,1260,2,6,2,2,4,single-choice,spatial-relational,2|4,7,2/4,240115,2
1,2,24,116,1,1012,1,13,6,6,7,single-choice,spatial-relational,6|7,7,6/7,240116,6
1,2,24,117,1,1377,3,5,1,1,4,single-choice,spatial-relational,1|4,7,1/4,240117,1
1,2,24,118,1,122,4,6,1,1,5,single-choice,spatial-relational,1|5,7,1/5,240118,1
1,2,24,119,1,1095,6,8,1,1,7,single-choice,spatial-relational,1|7,7,1/7,240119,1
1,2,24,120,1,1638,1,3,1,1,2,single-choice,spatial-relational,1|2,7,1/2,240120,1
1,2,24,121,1,1321,5,7,1,1,6,single-choice,spatial-relational,1|6,7,1/6,240121,1
1,2,24,122,1,991,1,13,6,6,7,single-choice,spatial-relational,6|7,7,6/7,240122,6
1,2,24,123,0,1707,3,7,2,5,5,single-choice,spatial-relational,2|5,7,2/5,240123,2
1,2,24,124,1,1299,1,9,4,4,5,single-choice,spatial-relational,4|5,7,4/5,240124,4
1,2,24,125,1,1214,4,8,2,2,6,single-choice,spatial-relational,2|6,7,2/6,240125,2
1,2,24,126,1,1114,1,11,5,5,6,single-choice,spatial-relational,5|6,7,5/6,240126,5
1,2,24,127,1,1235,1,9,4,4,5,single-choice,spatial-relational,4|5,7,4/5,240127,4
1,2,24,128,1,1157,6,8,1,1,7,single-choice,spatial-relational,1|7,7,1/7,240128,1
1,2,24,129,1,862,1,5,2,2,3,single-choice,spatial-relational,2|3,7,2/3,240129,2
1,2,24,130,1,994,2,10,4,4,6,single-choice,spatial-relational,4|6,7,4/6,240130,4
1,2,24,131,1,1102,2,6,2,2,4,single-choice,spatial-relational,2|4,7,2/4,240131,2
1,2,24,132,1,872,1,7,3,3,4,single-choice,spatial-relational,3|4,7,3/4,240132,3
1,2,24,133,1,1299,5,9,2,2,7,single-choice,spatial-relational,2|7,7,2/7,240133,2
1,2,24,134,1,935,1,13,6,6,7,single-choice,spatial-relational,6|7,7,6/7,240134,6
1,2,24,135,1,1539,5,7,1,1,6,single-choice,spatial-relational,1|6,7,1/6,240135,1
1,2,24,136,1,1130,5,7,1,1,6,single-choice,spatial-relational,1|6,7,1/6,240136,1
1,2,24,137,1,844,4,10,3,3,7,single-choice,spatial-relational,3|7,7,3/7,240137,3
1,2,24,138,1,1478,1,3,1,1,2,single-choice,spatial-relational,1|2,7,1/2,240138,1
1,2,24,139,0,98,2,10,4,6,6,single-choice,spatial-relational,4|6,7,4/6,240139,4
1,2,24,140,1,1113,3,7,2,2,5,single-choice,spatial-relational,2|5,7,2/5,240140,2
1,2,24,141,1,1224,3,5,1,1,4,single-choice,spatial-relational,1|4,7,1/4,240141,1
1,2,24,142,1,1227,2,12,5,5,7,single-choice,spatial-relational,5|7,7,5/7,240142,5
1,2,24,143,1,1184,4,8,2,2,6,single-choice,spatial-relational,2|6,7,2/6,240143,2
1,2,24,144,1,1329,1,5,2,2,3,single-choice,spatial-relational,2|3,7,2/3,240144,2
1,2,24,145,1,1154,1,3,1,1,2,single-choice,spatial-relational,1|2,7,1/2,240145,1
1,2,24,146,1,933,2,8,3,3,5,single-choice,spatial-relational,3|5,7,3/5,240146,3
1,2,24,147,1,1159,2,4,1,1,3,single-choice,spatial-relational,1|3,7,1/3,240147,1
1,2,24,148,1,1443,3,5,1,1,4,single-choice,spatial-relational,1|4,7,1/4,240148,1
1,2,24,149,1,913,2,6,2,2,4,single-choice,spatial-relational,2|4,7,2/4,240149,2
1,2,24,150,1,1167,3,11,4,4,7,single-choice,spatial-relational,4|7,7,4/7,240150,4
1,2,24,151,1,1231,2,8,3,3,5,single-choice,spatial-relational,3|5,7,3/5,240151,3
1,2,24,152,1,1187,2,4,1,1,3,single-choice,spatial-relational,1|3,7,1/3,240152,1
1,2,24,153,1,1048,1,9,4,4,5,single-choice,spatial-relational,4|5,7,4/5,240153,4
1,2,24,154,1,1146,6,8,1,1,7,single-choice,spatial-relational,1|7,7,1/7,240154,1
1,2,24,155,1,1259,1,11,5,5,6,single-choice,spatial-relational,5|6,7,5/6,240155,5
1,2,24,156,1,1313,3,9,3,3,6,single-choice,spatial-relational,3|6,7,3/6,240156,3
1,2,24,157,1,1266,1,7,3,3,4,single-choice,spatial-relational,3|4,7,3/4,240157,3
1,2,24,158,1,1230,5,9,2,2,7,single-choice,spatial-relational,2|7,7,2/7,240158,2
1,2,24,159,1,1070,4,8,2,2,6,single-choice,spatial-relational,2|6,7,2/6,240159,2
1,2,24,160,0,154,3,9,3,6,6,single-choice,spatial-relational,3|6,7,3/6,240160,3
1,2,24,161,1,799,4,10,3,3,7,single-choice,spatial-relational,3|7,7,3/7,240161,3
1,2,24,162,1,1426,4,6,1,1,5,single-choice,spatial-relational,1|5,7,1/5,240162,1
1,2,24,163,1,1114,3,7,2,2,5,single-choice,spatial-relational,2|5,7,2/5,240163,2
1,2,24,164,1,1130,3,11,4,4,7,single-choice,spatial-relational,4|7,7,4/7,240164,4
1,2,24,165,1,1634,4,6,1,1,5,single-choice,spatial-relational,1|5,7,1/5,240165,1
1,2,24,166,1,978,1,13,6,6,7,single-choice,spatial-relational,6|7,7,6/7,240166,6
1,2,24,167,1,1242,1,11,5,5,6,single-choice,spatial-relational,5|6,7,5/6,240167,5
1,2,24,168,1,1327,2,12,5,5,7,single-choice,spatial-relational,5|7,7,5/7,240168,5
1,2,24,169,1,1227,1,3,1,1,2,single-choice,spatial-relational,1|2,7,1/2,240169,1
1,2,24,170,1,1234,2,12,5,5,7,single-choice,spatial-relational,5|7,7,5/7,240170,5
1,2,24,171,1,923,1,13,6,6,7,single-choice,spatial-relational,6|7,7,6/7,240171,6
1,2,24,172,1,1120,4,8,2,2,6,single-choice,spatial-relational,2|6,7,2/6,240172,2
1,2,24,173,1,1142,6,8,1,1,7,single-choice,spatial-relational,1|7,7,1/7,240173,1
1,2,24,174,1,1045,4,10,3,3,7,single-choice,spatial-relational,3|7,7,3/7,240174,3
1,2,24,175,1,142,4,6,1,1,5,single-choice,spatial-relational,1|5,7,1/5,240175,1
1,2,24,176,1,997,3,9,3,3,6,single-choice,spatial-relational,3|6,7,3/6,240176,3
1,2,24,177,0,1792,2,6,2,4,4,single-choice,spatial-relational,2|4,7,2/4,240177,2
1,2,24,178,1,823,4,10,3,3,7,single-choice,spatial-relational,3|7,7,3/7,240178,3
1,2,24,179,1,1490,1,3,1,1,2,single-choice,spatial-relational,1|2,7,1/2,240179,1
1,2,24,180,0,1832,3,7,2,5,5,single-choice,spatial-relational,2|5,7,2/5,240180,2
1,2,24,181,1,988,6,8,1,1,7,single-choice,spatial-relational,1|7,7,1/7,240181,1
1,2,24,182,1,1070,3,5,1,1,4,single-choice,spatial-relational,1|4,7,1/4,240182,1
1,2,24,183,1,803,2,8,3,3,5,single-choice,spatial-relational,3|5,7,3/5,240183,3
1,2,24,184,1,1046,1,11,5,5,6,single-choice,spatial-relational,5|6,7,5/6,240184,5
1,2,24,185,1,1321,1,11,5,5,6,single-choice,spatial-relational,5|6,7,5/6,240185,5
1,2,24,186,1,1117,2,8,3,3,5,single-choice,spatial-relational,3|5,7,3/5,240186,3
1,2,24,187,1,1248,3,11,4,4,7,single-choice,spatial-relational,4|7,7,4/7,240187,4
1,2,24,188,1,1089,1,9,4,4,5,single-choice,spatial-relational,4|5,7,4/5,240188,4
1,2,24,189,1,1617,2,10,4,4,6,single-choice,spatial-relational,4|6,7,4/6,240189,4
1,2,24,190,1,1396,2,4,1,1,3,single-choice,spatial-relational,1|3,7,1/3,240190,1
1,2,24,191,1,814,1,7,3,3,4,single-choice,spatial-relational,3|4,7,3/4,240191,3
1,2,24,192,1,1368,4,6,1,1,5,single-choice,spatial-relational,1|5,7,1/5,240192,1
1,2,24,193,1,1271,4,8,2,2,6,single-choice,spatial-relational,2|6,7,2/6,240193,2
1,2,24,194,1,1042,1,7,3,3,4,single-choice,spatial-relational,3|4,7,3/4,240194,3
1,2,24,195,1,1231,3,5,1,1,4,single-choice,spatial-relational,1|4,7,1/4,240195,1
1,2,24,196,1,1067,2,6,2,2,4,single-choice,spatial-relational,2|4,7,2/4,240196,2
1,2,24,197,1,1229,1,5,2,2,3,single-choice,spatial-relational,2|3,7,2/3,240197,2
1,2,24,198,1,1447,1,5,2,2,3,single-choice,spatial-relational,2|3,7,2/3,240198,2
1,2,24,199,1,970,5,7,1,1,6,single-choice,spatial-relational,1|6,7,1/6,240199,1
1,2,24,200,1,1294,1,9,4,4,5,single-choice,spatial-relational,4|5,7,4/5,240200,4
1,2,24,201,1,1039,1,13,6,6,7,single-choice,spatial-relational,6|7,7,6/7,240201,6
1,2,24,202,1,1088,5,9,2,2,7,single-choice,spatial-relational,2|7,7,2/7,240202,2
1,2,24,203,1,1094,2,10,4,4,6,single-choice,spatial-relational,4|6,7,4/6,240203,4
1,2,24,204,1,2322,3,7,2,2,5,single-choice,spatial-relational,2|5,7,2/5,240204,2
1,2,24,205,1,1115,3,11,4,4,7,single-choice,spatial-relational,4|7,7,4/7,240205,4
1,2,24,206,0,1225,5,7,1,6,6,single-choice,spatial-relational,1|6,7,1/6,240206,1
1,2,24,207,1,1027,2,4,1,1,3,single-choice,spatial-relational,1|3,7,1/3,240207,1
1,2,24,208,1,1348,5,9,2,2,7,single-choice,spatial-relational,2|7,7,2/7,240208,2
1,2,24,209,1,1350,2,12,5,5,7,single-choice,spatial-relational,5|7,7,5/7,240209,5
1,2,24,210,1,1115,3,9,3,3,6,single-choice,spatial-relational,3|6,7,3/6,240210,3
1,2,24,211,1,930,1,5,2,2,3,single-choice,spatial-relational,2|3,7,2/3,240211,2
1,2,24,212,1,930,2,12,5,5,7,single-choice,spatial-relational,5|7,7,5/7,240212,5
1,2,24,213,1,903,4,10,3,3,7,single-choice,spatial-relational,3|7,7,3/7,240213,3
1,2,24,214,1,1197,1,9,4,4,5,single-choice,spatial-relational,4|5,7,4/5,240214,4
1,2,24,215,1,1281,3,7,2,2,5,single-choice,spatial-relational,2|5,7,2/5,240215,2
1,2,24,216,1,785,1,7,3,3,4,single-choice,spatial-relational,3|4,7,3/4,240216,3
1,2,24,217,0,3453,3,7,2,5,5,single-choice,spatial-relational,2|5,7,2/5,240217,2
1,2,24,218,0,155,6,8,1,7,7,single-choice,spatial-relational,1|7,7,1/7,240218,1
1,2,24,219,1,1031,4,6,1,1,5,single-choice,spatial-relational,1|5,7,1/5,240219,1
1,2,24,220,1,1418,5,7,1,1,6,single-choice,spatial-relational,1|6,7,1/6,240220,1
1,2,24,221,1,1172,2,8,3,3,5,single-choice,spatial-relational,3|5,7,3/5,240221,3
1,2,24,222,1,926,3,9,3,3,6,single-choice,spatial-relational,3|6,7,3/6,240222,3
1,2,24,223,1,1234,4,6,1,1,5,single-choice,spatial-relational,1|5,7,1/5,240223,1
1,2,24,224,1,1179,3,11,4,4,7,single-choice,spatial-relational,4|7,7,4/7,240224,4
1,2,24,225,1,1131,1,11,5,5,6,single-choice,spatial-relational,5|6,7,5/6,240225,5
1,2,24,226,1,1442,2,4,1,1,3,single-choice,spatial-relational,1|3,7,1/3,240226,1
1,2,24,227,1,87,3,5,1,1,4,single-choice,spatial-relational,1|4,7,1/4,240227,1
1,2,24,228,1,1135,3,5,1,1,4,single-choice,spatial-relational,1|4,7,1/4,240228,1
1,2,24,229,1,2169,1,5,2,2,3,single-choice,spatial-relational,2|3,7,2/3,240229,2
1,2,24,230,1,174,1,9,4,4,5,single-choice,spatial-relational,4|5,7,4/5,240230,4
1,2,24,231,1,1288,1,13,6,6,7,single-choice,spatial-relational,6|7,7,6/7,240231,6
1,2,24,232,1,1059,1,13,6,6,7,single-choice,spatial-relational,6|7,7,6/7,240232,6
1,2,24,233,1,1117,2,8,3,3,5,single-choice,spatial-relational,3|5,7,3/5,240233,3
1,2,24,234,1,1129,3,9,3,3,6,single-choice,spatial-relational,3|6,7,3/6,240234,3
1,2,24,235,1,1367,4,8,2,2,6,single-choice,spatial-relational,2|6,7,2/6,240235,2
1,2,24,236,1,923,5,9,2,2,7,single-choice,spatial-relational,2|7,7,2/7,240236,2
1,2,24,237,1,1130,4,8,2,2,6,single-choice,spatial-relational,2|6,7,2/6,240237,2
1,2,24,238,1,1024,1,3,1,1,2,single-choice,spatial-relational,1|2,7,1/2,240238,1
1,2,24,239,1,1110,1,11,5,5,6,single-choice,spatial-relational,5|6,7,5/6,240239,5
1,2,24,240,1,1421,2,4,1,1,3,single-choice,spatial-relational,1|3,7,1/3,240240,1
1,2,24,241,1,1001,5,9,2,2,7,single-choice,spatial-relational,2|7,7,2/7,240241,2
1,2,24,242,1,1690,3,11,4,4,7,single-choice,spatial-relational,4|7,7,4/7,240242,4
1,2,24,243,1,1130,5,7,1,1,6,single-choice,spatial-relational,1|6,7,1/6,240243,1
1,2,24,244,1,1880,1,3,1,1,2,single-choice,spatial-relational,1|2,7,1/2,240244,1
1,2,24,245,0,114,2,12,5,7,7,single-choice,spatial-relational,5|7,7,5/7,240245,5
1,2,24,246,1,1004,1,7,3,3,4,single-choice,spatial-relational,3|4,7,3/4,240246,3
1,2,24,247,1,1623,2,10,4,4,6,single-choice,spatial-relational,4|6,7,4/6,240247,4
1,2,24,248,1,1135,6,8,1,1,7,single-choice,spatial-relational,1|7,7,1/7,240248,1
1,2,24,249,1,911,2,6,2,2,4,single-choice,spatial-relational,2|4,7,2/4,240249,2
1,2,24,250,1,1959,2,10,4,4,6,single-choice,spatial-relational,4|6,7,4/6,240250,4
1,2,24,251,1,1067,4,10,3,3,7,single-choice,spatial-relational,3|7,7,3/7,240251,3
1,2,24,252,1,1201,2,6,2,2,4,single-choice,spatial-relational,2|4,7,2/4,240252,2
1,2,24,253,1,1135,3,5,1,1,4,single-choice,spatial-relational,1|4,7,1/4,240253,1
1,2,24,254,1,1309,5,7,1,1,6,single-choice,spatial-relational,1|6,7,1/6,240254,1
1,2,24,255,1,1089,1,11,5,5,6,single-choice,spatial-relational,5|6,7,5/6,240255,5
1,2,24,256,0,887,2,4,1,3,3,single-choice,spatial-relational,1|3,7,1/3,240256,1
1,2,24,257,1,884,1,11,5,5,6,single-choice,spatial-relational,5|6,7,5/6,240257,5
1,2,24,258,1,1134,4,8,2,2,6,single-choice,spatial-relational,2|6,7,2/6,240258,2
1,2,24,259,1,1049,6,8,1,1,7,single-choice,spatial-relational,1|7,7,1/7,240259,1
1,2,24,260,1,952,3,11,4,4,7,single-choice,spatial-relational,4|7,7,4/7,240260,4
1,2,24,261,1,871,2,6,2,2,4,single-choice,spatial-relational,2|4,7,2/4,240261,2
1,2,24,262,1,1274,2,4,1,1,3,single-choice,spatial-relational,1|3,7,1/3,240262,1
1,2,24,263,1,1270,4,6,1,1,5,single-choice,spatial-relational,1|5,7,1/5,240263,1
1,2,24,264,1,900,3,9,3,3,6,single-choice,spatial-relational,3|6,7,3/6,240264,3
1,2,24,265,1,1722,1,3,1,1,2,single-choice,spatial-relational,1|2,7,1/2,240265,1
1,2,24,266,1,891,1,5,2,2,3,single-choice,spatial-relational,2|3,7,2/3,240266,2
1,2,24,267,1,1503,2,10,4,4,6,single-choice,spatial-relational,4|6,7,4/6,240267,4
1,2,24,268,1,1310,1,3,1,1,2,single-choice,spatial-relational,1|2,7,1/2,240268,1
1,2,24,269,1,1363,2,10,4,4,6,single-choice,spatial-relational,4|6,7,4/6,240269,4
1,2,24,270,1,1121,6,8,1,1,7,single-choice,spatial-relational,1|7,7,1/7,240270,1
1,2,24,271,1,5002,1,9,4,4,5,single-choice,spatial-relational,4|5,7,4/5,240271,4
1,2,24,272,0,1695,1,5,2,3,3,single-choice,spatial-relational,2|3,7,2/3,240272,2
1,2,24,273,1,885,3,9,3,3,6,single-choice,spatial-relational,3|6,7,3/6,240273,3
1,2,24,274,1,1264,2,6,2,2,4,single-choice,spatial-relational,2|4,7,2/4,240274,2
1,2,24,275,1,1150,1,9,4,4,5,single-choice,spatial-relational,4|5,7,4/5,240275,4
1,2,24,276,1,942,4,10,3,3,7,single-choice,spatial-relational,3|7,7,3/7,240276,3
1,2,24,277,1,1424,2,12,5,5,7,single-choice,spatial-relational,5|7,7,5/7,240277,5
1,2,24,278,1,8078,1,7,3,3,4,single-choice,spatial-relational,3|4,7,3/4,240278,3
1,2,24,279,1,1305,2,8,3,3,5,single-choice,spatial-relational,3|5,7,3/5,240279,3
1,2,24,280,1,1412,3,11,4,4,7,single-choice,spatial-relational,4|7,7,4/7,240280,4
1,2,24,281,1,1106,1,13,6,6,7,single-choice,spatial-relational,6|7,7,6/7,240281,6
1,2,24,282,1,205,3,7,2,2,5,single-choice,spatial-relational,2|5,7,2/5,240282,2
1,2,24,283,1,772,1,7,3,3,4,single-choice,spatial-relational,3|4,7,3/4,240283,3
1,2,24,284,1,1057,5,9,2,2,7,single-choice,spatial-relational,2|7,7,2/7,240284,2
1,2,24,285,1,1061,4,10,3,3,7,single-choice,spatial-relational,3|7,7,3/7,240285,3
1,2,24,286,1,1173,4,6,1,1,5,single-choice,spatial-relational,1|5,7,1/5,240286,1
1,2,24,287,1,1319,1,13,6,6,7,single-choice,spatial-relational,6|7,7,6/7,240287,6
1,2,24,288,1,1270,4,8,2,2,6,single-choice,spatial-relational,2|6,7,2/6,240288,2
1,2,24,289,1,1467,3,7,2,2,5,single-choice,spatial-relational,2|5,7,2/5,240289,2
1,2,24,290,1,1523,2,8,3,3,5,single-choice,spatial-relational,3|5,7,3/5,240290,3
1,2,24,291,1,1180,5,7,1,1,6,single-choice,spatial-relational,1|6,7,1/6,240291,1
1,2,24,292,1,1393,3,5,1,1,4,single-choice,spatial-relational,1|4,7,1/4,240292,1
1,2,24,293,1,3478,5,9,2,2,7,single-choice,spatial-relational,2|7,7,2/7,240293,2
1,2,24,294,1,873,2,12,5,5,7,single-choice,spatial-relational,5|7,7,5/7,240294,5
1,2,24,295,1,941,3,7,2,2,5,single-choice,spatial-relational,2|5,7,2/5,240295,2
1,2,24,296,1,1288,4,6,1,1,5,single-choice,spatial-relational,1|5,7,1/5,240296,1
1,2,24,297,1,1374,1,11,5,5,6,single-choice,spatial-relational,5|6,7,5/6,240297,5
1,2,24,298,1,1169,3,11,4,4,7,single-choice,spatial-relational,4|7,7,4/7,240298,4
1,2,24,299,0,1602,1,5,2,3,3,single-choice,spatial-relational,2|3,7,2/3,240299,2
1,2,24,300,1,1746,1,9,4,4,5,single-choice,spatial-relational,4|5,7,4/5,240300,4
1,2,24,301,1,1079,4,10,3,3,7,single-choice,spatial-relational,3|7,7,3/7,240301,3
1,2,24,302,1,1163,1,3,1,1,2,single-choice,spatial-relational,1|2,7,1/2,240302,1
1,2,24,303,1,1045,6,8,1,1,7,single-choice,spatial-relational,1|7,7,1/7,240303,1
1,2,24,304,1,1289,3,9,3,3,6,single-choice,spatial-relational,3|6,7,3/6,240304,3
1,2,24,305,1,1278,5,7,1,1,6,single-choice,spatial-relational,1|6,7,1/6,240305,1
1,2,24,306,1,950,2,6,2,2,4,single-choice,spatial-relational,2|4,7,2/4,240306,2
1,2,24,307,1,1080,2,10,4,4,6,single-choice,spatial-relational,4|6,7,4/6,240307,4
1,2,24,308,1,1569,5,7,1,1,6,single-choice,spatial-relational,1|6,7,1/6,240308,1
1,2,24,309,0,1130,1,5,2,3,3,single-choice,spatial-relational,2|3,7,2/3,240309,2
1,2,24,310,1,947,2,6,2,2,4,single-choice,spatial-relational,2|4,7,2/4,240310,2
1,2,24,311,1,1329,2,8,3,3,5,single-choice,spatial-relational,3|5,7,3/5,240311,3
1,2,24,312,1,1350,2,10,4,4,6,single-choice,spatial-relational,4|6,7,4/6,240312,4
1,2,24,313,1,904,5,9,2,2,7,single-choice,spatial-relational,2|7,7,2/7,240313,2
1,2,24,314,1,1134,4,6,1,1,5,single-choice,spatial-relational,1|5,7,1/5,240314,1
1,2,24,315,1,1924,2,4,1,1,3,single-choice,spatial-relational,1|3,7,1/3,240315,1
1,2,24,316,1,967,4,8,2,2,6,single-choice,spatial-relational,2|6,7,2/6,240316,2
1,2,24,317,1,1161,3,5,1,1,4,single-choice,spatial-relational,1|4,7,1/4,240317,1
1,2,24,318,1,1130,1,13,6,6,7,single-choice,spatial-relational,6|7,7,6/7,240318,6
1,2,24,319,1,1400,2,12,5,5,7,single-choice,spatial-relational,5|7,7,5/7,240319,5
1,2,24,320,0,1139,3,5,1,4,4,single-choice,spatial-relational,1|4,7,1/4,240320,1
1,2,24,321,1,1380,2,4,1,1,3,single-choice,spatial-relational,1|3,7,1/3,240321,1
1,2,24,322,0,94,1,13,6,7,7,single-choice,spatial-relational,6|7,7,6/7,240322,6
1,2,24,323,1,957,6,8,1,1,7,single-choice,spatial-relational,1|7,7,1/7,240323,1
1,2,24,324,1,1097,1,7,3,3,4,single-choice,spatial-relational,3|4,7,3/4,240324,3
1,2,24,325,1,3049,3,7,2,2,5,single-choice,spatial-relational,2|5,7,2/5,240325,2
1,2,24,326,1,911,4,10,3,3,7,single-choice,spatial-relational,3|7,7,3/7,240326,3
1,2,24,327,1,1107,2,8,3,3,5,single-choice,spatial-relational,3|5,7,3/5,240327,3
1,2,24,328,1,1381,1,3,1,1,2,single-choice,spatial-relational,1|2,7,1/2,240328,1
1,2,24,329,1,1153,5,9,2,2,7,single-choice,spatial-relational,2|7,7,2/7,240329,2
1,2,24,330,1,913,1,11,5,5,6,single-choice,spatial-relational,5|6,7,5/6,240330,5
1,2,24,331,0,1080,3,9,3,6,6,single-choice,spatial-relational,3|6,7,3/6,240331,3
1,2,24,332,1,892,1,7,3,3,4,single-choice,spatial-relational,3|4,7,3/4,240332,3
1,2,24,333,1,1197,2,12,5,5,7,single-choice,spatial-relational,5|7,7,5/7,240333,5
1,2,24,334,1,1079,1,9,4,4,5,single-choice,spatial-relational,4|5,7,4/5,240334,4
1,2,24,335,1,1524,3,11,4,4,7,single-choice,spatial-relational,4|7,7,4/7,240335,4
1,2,24,336,1,1685,4,8,2,2,6,single-choice,spatial-relational,2|6,7,2/6,240336,2
1,2,24,337,1,1187,1,3,1,1,2,single-choice,spatial-relational,1|2,7,1/2,240337,1
1,2,24,338,1,1024,5,9,2,2,7,single-choice,spatial-relational,2|7,7,2/7,240338,2
1,2,24,339,1,1029,2,8,3,3,5,single-choice,spatial-relational,3|5,7,3/5,240339,3
1,2,24,340,1,1391,3,11,4,4,7,single-choice,spatial-relational,4|7,7,4/7,240340,4
1,2,24,341,1,1149,2,6,2,2,4,single-choice,spatial-relational,2|4,7,2/4,240341,2
1,2,24,342,1,1308,4,6,1,1,5,single-choice,spatial-relational,1|5,7,1/5,240342,1
1,2,24,343,0,1648,3,7,2,5,5,single-choice,spatial-relational,2|5,7,2/5,240343,2
1,2,24,344,1,847,4,10,3,3,7,single-choice,spatial-relational,3|7,7,3/7,240344,3
1,2,24,345,1,1068,4,10,3,3,7,single-choice,spatial-relational,3|7,7,3/7,240345,3
1,2,24,346,1,1020,4,8,2,2,6,single-choice,spatial-relational,2|6,7,2/6,240346,2
1,2,24,347,1,1077,3,5,1,1,4,single-choice,spatial-relational,1|4,7,1/4,240347,1
1,2,24,348,1,873,1,13,6,6,7,single-choice,spatial-relational,6|7,7,6/7,240348,6
1,2,24,349,1,1171,2,10,4,4,6,single-choice,spatial-relational,4|6,7,4/6,240349,4
1,2,24,350,1,147,3,9,3,3,6,single-choice,spatial-relational,3|6,7,3/6,240350,3
1,2,24,351,1,952,3,11,4,4,7,single-choice,spatial-relational,4|7,7,4/7,240351,4
1,2,24,352,1,1244,6,8,1,1,7,single-choice,spatial-relational,1|7,7,1/7,240352,1
1,2,24,353,1,2284,2,8,3,3,5,single-choice,spatial-relational,3|5,7,3/5,240353,3
1,2,24,354,1,1358,1,9,4,4,5,single-choice,spatial-relational,4|5,7,4/5,240354,4
1,2,24,355,1,1339,1,3,1,1,2,single-choice,spatial-relational,1|2,7,1/2,240355,1
1,2,24,356,1,979,1,11,5,5,6,single-choice,spatial-relational,5|6,7,5/6,240356,5
1,2,24,357,1,1418,5,7,1,1,6,single-choice,spatial-relational,1|6,7,1/6,240357,1
1,2,24,358,1,1144,3,5,1,1,4,single-choice,spatial-relational,1|4,7,1/4,240358,1
1,2,24,359,1,1640,2,6,2,2,4,single-choice,spatial-relational,2|4,7,2/4,240359,2
1,2,24,360,1,789,1,13,6,6,7,single-choice,spatial-relational,6|7,7,6/7,240360,6
1,2,24,361,1,1350,6,8,1,1,7,single-choice,spatial-relational,1|7,7,1/7,240361,1
1,2,24,362,1,707,2,12,5,5,7,single-choice,spatial-relational,5|7,7,5/7,240362,5
1,2,24,363,1,155,1,7,3,3,4,single-choice,spatial-relational,3|4,7,3/4,240363,3
1,2,24,364,1,922,3,9,3,3,6,single-choice,spatial-relational,3|6,7,3/6,240364,3
1,2,24,365,1,1205,4,6,1,1,5,single-choice,spatial-relational,1|5,7,1/5,240365,1
1,2,24,366,1,915,4,8,2,2,6,single-choice,spatial-relational,2|6,7,2/6,240366,2
1,2,24,367,1,1079,1,5,2,2,3,single-choice,spatial-relational,2|3,7,2/3,240367,2
1,2,24,368,1,1070,2,4,1,1,3,single-choice,spatial-relational,1|3,7,1/3,240368,1
1,2,24,369,1,1222,2,4,1,1,3,single-choice,spatial-relational,1|3,7,1/3,240369,1
1,2,24,370,0,1124,1,5,2,3,3,single-choice,spatial-relational,2|3,7,2/3,240370,2
1,2,24,371,1,864,1,11,5,5,6,single-choice,spatial-relational,5|6,7,5/6,240371,5
1,2,24,372,1,1308,1,9,4,4,5,single-choice,spatial-relational,4|5,7,4/5,240372,4
1,2,24,373,1,1422,2,10,4,4,6,single-choice,spatial-relational,4|6,7,4/6,240373,4
1,2,24,374,1,1638,1,7,3,3,4,single-choice,spatial-relational,3|4,7,3/4,240374,3
1,2,24,375,0,1109,2,12,5,7,7,single-choice,spatial-relational,5|7,7,5/7,240375,5
1,2,24,376,1,1081,3,7,2,2,5,single-choice,spatial-relational,2|5,7,2/5,240376,2
1,2,24,377,1,1123,5,7,1,1,6,single-choice,spatial-relational,1|6,7,1/6,240377,1
1,2,24,378,1,1116,5,9,2,2,7,single-choice,spatial-relational,2|7,7,2/7,240378,2
1,2,24,379,1,937,1,7,3,3,4,single-choice,spatial-relational,3|4,7,3/4,240379,3
1,2,24,380,1,1094,3,5,1,1,4,single-choice,spatial-relational,1|4,7,1/4,240380,1
1,2,24,381,1,1017,3,9,3,3,6,single-choice,spatial-relational,3|6,7,3/6,240381,3
1,2,24,382,1,1332,3,11,4,4,7,single-choice,spatial-relational,4|7,7,4/7,240382,4
1,2,24,383,1,996,4,8,2,2,6,single-choice,spatial-relational,2|6,7,2/6,240383,2
1,2,24,384,1,1202,3,5,1,1,4,single-choice,spatial-relational,1|4,7,1/4,240384,1
1,2,24,385,1,1190,1,3,1,1,2,single-choice,spatial-relational,1|2,7,1/2,240385,1
1,2,24,386,1,1238,4,6,1,1,5,single-choice,spatial-relational,1|5,7,1/5,240386,1
1,2,24,387,1,1377,5,9,2,2,7,single-choice,spatial-relational,2|7,7,2/7,240387,2
1,2,24,388,1,1447,6,8,1,1,7,single-choice,spatial-relational,1|7,7,1/7,240388,1
1,2,24,389,1,860,2,8,3,3,5,single-choice,spatial-relational,3|5,7,3/5,240389,3
1,2,24,390,1,1331,1,11,5,5,6,single-choice,spatial-relational,5|6,7,5/6,240390,5
1,2,24,391,1,7999,3,7,2,2,5,single-choice,spatial-relational,2|5,7,2/5,240391,2
1,2,24,392,1,1402,2,4,1,1,3,single-choice,spatial-relational,1|3,7,1/3,240392,1
1,2,24,393,1,1052,1,5,2,2,3,single-choice,spatial-relational,2|3,7,2/3,240393,2
1,2,24,394,1,1093,1,9,4,4,5,single-choice,spatial-relational,4|5,7,4/5,240394,4
1,2,24,395,1,1053,4,8,2,2,6,single-choice,spatial-relational,2|6,7,2/6,240395,2
1,2,24,396,1,934,1,7,3,3,4,single-choice,spatial-relational,3|4,7,3/4,240396,3
1,2,24,397,1,884,4,10,3,3,7,single-choice,spatial-relational,3|7,7,3/7,240397,3
1,2,24,398,1,972,5,9,2,2,7,single-choice,spatial-relational,2|7,7,2/7,240398,2
1,2,24,399,1,960,2,12,5,5,7,single-choice,spatial-relational,5|7,7,5/7,240399,5
1,2,24,400,0,92,2,12,5,7,7,single-choice,spatial-relational,5|7,7,5/7,240400,5
1,2,24,401,1,995,4,10,3,3,7,single-choice,spatial-relational,3|7,7,3/7,240401,3
1,2,24,402,0,1423,2,10,4,6,6,single-choice,spatial-relational,4|6,7,4/6,240402,4
1,2,24,403,1,767,1,13,6,6,7,single-choice,spatial-relational,6|7,7,6/7,240403,6
1,2,24,404,0,142,1,3,1,2,2,single-choice,spatial-relational,1|2,7,1/2,240404,1
1,2,24,405,1,690,3,11,4,4,7,single-choice,spatial-relational,4|7,7,4/7,240405,4
1,2,24,406,1,1277,1,13,6,6,7,single-choice,spatial-relational,6|7,7,6/7,240406,6
1,2,24,407,1,1468,3,7,2,2,5,single-choice,spatial-relational,2|5,7,2/5,240407,2
1,2,24,408,1,1199,1,5,2,2,3,single-choice,spatial-relational,2|3,7,2/3,240408,2
1,2,24,409,0,1101,2,6,2,4,4,single-choice,spatial-relational,2|4,7,2/4,240409,2
1,2,24,410,1,1191,2,8,3,3,5,single-choice,spatial-relational,3|5,7,3/5,240410,3
1,2,24,411,1,1919,2,10,4,4,6,single-choice,spatial-relational,4|6,7,4/6,240411,4
1,2,24,412,1,1903,1,11,5,5,6,single-choice,spatial-relational,5|6,7,5/6,240412,5
1,2,24,413,1,1066,4,6,1,1,5,single-choice,spatial-relational,1|5,7,1/5,240413,1
1,2,24,414,1,1263,2,4,1,1,3,single-choice,spatial-relational,1|3,7,1/3,240414,1
1,2,24,415,1,1079,2,6,2,2,4,single-choice,spatial-relational,2|4,7,2/4,240415,2
1,2,24,416,1,1030,5,7,1,1,6,single-choice,spatial-relational,1|6,7,1/6,240416,1
1,2,24,417,1,1055,5,7,1,1,6,single-choice,spatial-relational,1|6,7,1/6,240417,1
1,2,24,418,1,834,3,9,3,3,6,single-choice,spatial-relational,3|6,7,3/6,240418,3
1,2,24,419,1,1255,6,8,1,1,7,single-choice,spatial-relational,1|7,7,1/7,240419,1
1,2,24,420,1,878,1,9,4,4,5,single-choice,spatial-relational,4|5,7,4/5,240420,4
1,2,24,421,1,972,3,9,3,3,6,single-choice,spatial-relational,3|6,7,3/6,240421,3
1,2,24,422,1,953,6,8,1,1,7,single-choice,spatial-relational,1|7,7,1/7,240422,1
1,2,24,423,1,940,5,7,1,1,6,single-choice,spatial-relational,1|6,7,1/6,240423,1
1,2,24,424,0,745,4,6,1,5,5,single-choice,spatial-relational,1|5,7,1/5,240424,1
1,2,24,425,1,986,1,9,4,4,5,single-choice,spatial-relational,4|5,7,4/5,240425,4
1,2,24,426,0,954,2,4,1,3,3,single-choice,spatial-relational,1|3,7,1/3,240426,1
1,2,24,427,1,1058,6,8,1,1,7,single-choice,spatial-relational,1|7,7,1/7,240427,1
1,2,24,428,1,1184,2,6,2,2,4,single-choice,spatial-relational,2|4,7,2/4,240428,2
1,2,24,429,1,1167,5,7,1,1,6,single-choice,spatial-relational,1|6,7,1/6,240429,1
1,2,24,430,1,1087,4,8,2,2,6,single-choice,spatial-relational,2|6,7,2/6,240430,2
1,2,24,431,1,994,1,3,1,1,2,single-choice,spatial-relational,1|2,7,1/2,240431,1
1,2,24,432,1,923,1,5,2,2,3,single-choice,spatial-relational,2|3,7,2/3,240432,2
1,2,24,433,1,1037,2,10,4,4,6,single-choice,spatial-relational,4|6,7,4/6,240433,4
1,2,24,434,1,1286,5,9,2,2,7,single-choice,spatial-relational,2|7,7,2/7,240434,2
1,2,24,435,1,1023,3,11,4,4,7,single-choice,spatial-relational,4|7,7,4/7,240435,4
1,2,24,436,1,1050,1,13,6,6,7,single-choice,spatial-relational,6|7,7,6/7,240436,6
1,2,24,437,1,1083,1,3,1,1,2,single-choice,spatial-relational,1|2,7,1/2,240437,1
1,2,24,438,1,1475,3,9,3,3,6,single-choice,spatial-relational,3|6,7,3/6,240438,3
1,2,24,439,1,1492,3,5,1,1,4,single-choice,spatial-relational,1|4,7,1/4,240439,1
1,2,24,440,1,1173,3,5,1,1,4,single-choice,spatial-relational,1|4,7,1/4,240440,1
1,2,24,441,1,1195,3,7,2,2,5,single-choice,spatial-relational,2|5,7,2/5,240441,2
1,2,24,442,0,1293,2,6,2,4,4,single-choice,spatial-relational,2|4,7,2/4,240442,2
1,2,24,443,1,851,1,7,3,3,4,single-choice,spatial-relational,3|4,7,3/4,240443,3
1,2,24,444,1,949,1,13,6,6,7,single-choice,spatial-relational,6|7,7,6/7,240444,6
1,2,24,445,1,1233,2,10,4,4,6,single-choice,spatial-relational,4|6,7,4/6,240445,4
1,2,24,446,0,1993,1,5,2,3,3,single-choice,spatial-relational,2|3,7,2/3,240446,2
1,2,24,447,1,1115,3,11,4,4,7,single-choice,spatial-relational,4|7,7,4/7,240447,4
1,2,24,448,1,937,4,10,3,3,7,single-choice,spatial-relational,3|7,7,3/7,240448,3
1,2,24,449,1,811,4,10,3,3,7,single-choice,spatial-relational,3|7,7,3/7,240449,3
1,2,24,450,1,1150,2,8,3,3,5,single-choice,spatial-relational,3|5,7,3/5,240450,3
1,2,24,451,1,1152,2,4,1,1,3,single-choice,spatial-relational,1|3,7,1/3,240451,1
1,2,24,452,1,1176,4,6,1,1,5,single-choice,spatial-relational,1|5,7,1/5,240452,1
1,2,24,453,1,885,4,8,2,2,6,single-choice,spatial-relational,2|6,7,2/6,240453,2
1,2,24,454,1,1328,2,12,5,5,7,single-choice,spatial-relational,5|7,7,5/7,240454,5
1,2,24,455,1,1018,2,12,5,5,7,single-choice,spatial-relational,5|7,7,5/7,240455,5
1,2,24,456,1,1177,1,11,5,5,6,single-choice,spatial-relational,5|6,7,5/6,240456,5
1,2,24,457,1,153,5,9,2,2,7,single-choice,spatial-relational,2|7,7,2/7,240457,2
1,2,24,458,1,1155,2,8,3,3,5,single-choice,spatial-relational,3|5,7,3/5,240458,3
1,2,24,459,1,1356,3,7,2,2,5,single-choice,spatial-relational,2|5,7,2/5,240459,2
1,2,24,460,1,858,1,7,3,3,4,single-choice,spatial-relational,3|4,7,3/4,240460,3
1,2,24,461,1,1275,1,11,5,5,6,single-choice,spatial-relational,5|6,7,5/6,240461,5
1,2,24,462,1,2276,1,9,4,4,5,single-choice,spatial-relational,4|5,7,4/5,240462,4
1,2,24,463,1,1560,5,9,2,2,7,single-choice,spatial-relational,2|7,7,2/7,240463,2
1,2,24,464,1,1015,6,8,1,1,7,single-choice,spatial-relational,1|7,7,1/7,240464,1
1,2,24,465,1,765,3,11,4,4,7,single-choice,spatial-relational,4|7,7,4/7,240465,4
1,2,24,466,1,1420,3,5,1,1,4,single-choice,spatial-relational,1|4,7,1/4,240466,1
1,2,24,467,1,1336,2,4,1,1,3,single-choice,spatial-relational,1|3,7,1/3,240467,1
1,2,24,468,1,837,3,11,4,4,7,single-choice,spatial-relational,4|7,7,4/7,240468,4
1,2,24,469,0,1979,2,10,4,6,6,single-choice,spatial-relational,4|6,7,4/6,240469,4
1,2,24,470,1,1513,3,5,1,1,4,single-choice,spatial-relational,1|4,7,1/4,240470,1
1,2,24,471,1,898,2,8,3,3,5,single-choice,spatial-relational,3|5,7,3/5,240471,3
1,2,24,472,1,1229,1,5,2,2,3,single-choice,spatial-relational,2|3,7,2/3,240472,2
1,2,24,473,1,1687,2,6,2,2,4,single-choice,spatial-relational,2|4,7,2/4,240473,2
1,2,24,474,1,935,3,9,3,3,6,single-choice,spatial-relational,3|6,7,3/6,240474,3
1,2,24,475,1,1127,5,7,1,1,6,single-choice,spatial-relational,1|6,7,1/6,240475,1
1,2,24,476,1,819,1,7,3,3,4,single-choice,spatial-relational,3|4,7,3/4,240476,3
1,2,24,477,1,1698,2,8,3,3,5,single-choice,spatial-relational,3|5,7,3/5,240477,3
1,2,24,478,1,1308,3,7,2,2,5,single-choice,spatial-relational,2|5,7,2/5,240478,2
1,2,24,479,1,1096,4,6,1,1,5,single-choice,spatial-relational,1|5,7,1/5,240479,1
1,2,24,480,1,852,4,8,2,2,6,single-choice,spatial-relational,2|6,7,2/6,240480,2
1,2,24,481,1,1140,1,11,5,5,6,single-choice,spatial-relational,5|6,7,5/6,240481,5
1,2,24,482,1,103,5,7,1,1,6,single-choice,spatial-relational,1|6,7,1/6,240482,1
1,2,24,483,0,38072,1,3,1,2,2,single-choice,spatial-relational,1|2,7,1/2,240483,1
1,2,24,484,1,1335,1,3,1,1,2,single-choice,spatial-relational,1|2,7,1/2,240484,1
1,2,24,485,0,880,2,4,1,3,3,single-choice,spatial-relational,1|3,7,1/3,240485,1
1,2,24,486,1,933,6,8,1,1,7,single-choice,spatial-relational,1|7,7,1/7,240486,1
1,2,24,487,1,762,4,10,3,3,7,single-choice,spatial-relational,3|7,7,3/7,240487,3
1,2,24,488,1,832,1,13,6,6,7,single-choice,spatial-relational,6|7,7,6/7,240488,6
1,2,24,489,0,1123,2,10,4,6,6,single-choice,spatial-relational,4|6,7,4/6,240489,4
1,2,24,490,1,1095,2,12,5,5,7,single-choice,spatial-relational,5|7,7,5/7,240490,5
1,2,24,491,1,1089,1,9,4,4,5,single-choice,spatial-relational,4|5,7,4/5,240491,4
1,2,24,492,1,1799,2,12,5,5,7,single-choice,spatial-relational,5|7,7,5/7,240492,5
1,2,24,493,1,1163,4,8,2,2,6,single-choice,spatial-relational,2|6,7,2/6,240493,2
1,2,24,494,1,873,1,11,5,5,6,single-choice,spatial-relational,5|6,7,5/6,240494,5
1,2,24,495,1,1084,1,13,6,6,7,single-choice,spatial-relational,6|7,7,6/7,240495,6
1,2,24,496,1,1189,5,9,2,2,7,single-choice,spatial-relational,2|7,7,2/7,240496,2
1,2,24,497,1,1178,4,6,1,1,5,single-choice,spatial-relational,1|5,7,1/5,240497,1
1,2,24,498,1,1048,3,7,2,2,5,single-choice,spatial-relational,2|5,7,2/5,240498,2
1,2,24,499,1,856,4,10,3,3,7,single-choice,spatial-relational,3|7,7,3/7,240499,3
1,2,24,500,1,1334,3,9,3,3,6,single-choice,spatial-relational,3|6,7,3/6,240500,3
1,2,24,501,1,1346,2,6,2,2,4,single-choice,spatial-relational,2|4,7,2/4,240501,2
1,2,24,502,1,1177,1,7,3,3,4,single-choice,spatial-relational,3|4,7,3/4,240502,3
1,2,24,503,1,1027,1,5,2,2,3,single-choice,spatial-relational,2|3,7,2/3,240503,2
1,2,24,504,1,1281,1,9,4,4,5,single-choice,spatial-relational,4|5,7,4/5,240504,4
1,2,24,505,1,1008,2,6,2,2,4,single-choice,spatial-relational,2|4,7,2/4,240505,2
1,2,24,506,1,39832,1,3,1,1,2,single-choice,spatial-relational,1|2,7,1/2,240506,1
1,2,24,507,1,140,3,9,3,3,6,single-choice,spatial-relational,3|6,7,3/6,240507,3
1,2,24,508,1,865,4,10,3,3,7,single-choice,spatial-relational,3|7,7,3/7,240508,3
1,2,24,509,1,1090,3,11,4,4,7,single-choice,spatial-relational,4|7,7,4/7,240509,4
1,2,24,510,1,1430,2,6,2,2,4,single-choice,spatial-relational,2|4,7,2/4,240510,2
1,2,24,511,1,1151,2,8,3,3,5,single-choice,spatial-relational,3|5,7,3/5,240511,3
1,2,24,512,1,858,1,11,5,5,6,single-choice,spatial-relational,5|6,7,5/6,240512,5
1,2,24,513,1,1716,1,5,2,2,3,single-choice,spatial-relational,2|3,7,2/3,240513,2
1,2,24,514,1,868,1,13,6,6,7,single-choice,spatial-relational,6|7,7,6/7,240514,6
1,2,24,515,0,783,3,7,2,5,5,single-choice,spatial-relational,2|5,7,2/5,240515,2
1,2,24,516,1,1028,5,7,1,1,6,single-choice,spatial-relational,1|6,7,1/6,240516,1
1,2,24,517,1,830,4,10,3,3,7,single-choice,spatial-relational,3|7,7,3/7,240517,3
1,2,24,518,1,1236,1,3,1,1,2,single-choice,spatial-relational,1|2,7,1/2,240518,1
1,2,24,519,1,833,1,7,3,3,4,single-choice,spatial-relational,3|4,7,3/4,240519,3
1,2,24,520,1,944,1,9,4,4,5,single-choice,spatial-relational,4|5,7,4/5,240520,4
1,2,24,521,1,1231,3,5,1,1,4,single-choice,spatial-relational,1|4,7,1/4,240521,1
1,2,24,522,1,728,1,13,6,6,7,single-choice,spatial-relational,6|7,7,6/7,240522,6
1,2,24,523,1,1301,5,9,2,2,7,single-choice,spatial-relational,2|7,7,2/7,240523,2
1,2,24,524,1,1259,1,11,5,5,6,single-choice,spatial-relational,5|6,7,5/6,240524,5
1,2,24,525,0,130,2,8,3,5,5,single-choice,spatial-relational,3|5,7,3/5,240525,3
1,2,24,526,1,1251,2,4,1,1,3,single-choice,spatial-relational,1|3,7,1/3,240526,1
1,2,24,527,1,1318,2,12,5,5,7,single-choice,spatial-relational,5|7,7,5/7,240527,5
1,2,24,528,1,1200,6,8,1,1,7,single-choice,spatial-relational,1|7,7,1/7,240528,1
1,2,24,529,1,826,5,9,2,2,7,single-choice,spatial-relational,2|7,7,2/7,240529,2
1,2,24,530,1,1192,6,8,1,1,7,single-choice,spatial-relational,1|7,7,1/7,240530,1
1,2,24,531,0,1453,2,10,4,6,6,single-choice,spatial-relational,4|6,7,4/6,240531,4
1,2,24,532,1,1516,4,6,1,1,5,single-choice,spatial-relational,1|5,7,1/5,240532,1
1,2,24,533,1,1009,5,7,1,1,6,single-choice,spatial-relational,1|6,7,1/6,240533,1
1,2,24,534,1,871,2,12,5,5,7,single-choice,spatial-relational,5|7,7,5/7,240534,5
1,2,24,535,1,1068,4,6,1,1,5,single-choice,spatial-relational,1|5,7,1/5,240535,1
1,2,24,536,1,974,4,8,2,2,6,single-choice,spatial-relational,2|6,7,2/6,240536,2
1,2,24,537,1,1205,3,9,3,3,6,single-choice,spatial-relational,3|6,7,3/6,240537,3
1,2,24,538,1,2130,3,7,2,2,5,single-choice,spatial-relational,2|5,7,2/5,240538,2
1,2,24,539,1,1109,4,8,2,2,6,single-choice,spatial-relational,2|6,7,2/6,240539,2
1,2,24,540,0,1239,2,10,4,6,6,single-choice,spatial-relational,4|6,7,4/6,240540,4
1,2,24,541,1,1201,1,5,2,2,3,single-choice,spatial-relational,2|3,7,2/3,240541,2
1,2,24,542,1,1140,3,5,1,1,4,single-choice,spatial-relational,1|4,7,1/4,240542,1
1,2,24,543,1,908,1,9,4,4,5,single-choice,spatial-relational,4|5,7,4/5,240543,4
1,2,24,544,1,1298,2,4,1,1,3,single-choice,spatial-relational,1|3,7,1/3,240544,1
1,2,24,545,1,827,3,11,4,4,7,single-choice,spatial-relational,4|7,7,4/7,240545,4
1,2,24,546,1,1277,1,7,3,3,4,single-choice,spatial-relational,3|4,7,3/4,240546,3
1,2,24,547,1,1420,2,12,5,5,7,single-choice,spatial-relational,5|7,7,5/7,240547,5
1,2,24,548,0,1259,3,5,1,4,4,single-choice,spatial-relational,1|4,7,1/4,240548,1
1,2,24,549,1,1382,4,6,1,1,5,single-choice,spatial-relational,1|5,7,1/5,240549,1
1,2,24,550,1,1155,1,9,4,4,5,single-choice,spatial-relational,4|5,7,4/5,240550,4
1,2,24,551,1,963,1,13,6,6,7,single-choice,spatial-relational,6|7,7,6/7,240551,6
1,2,24,552,1,1222,1,5,2,2,3,single-choice,spatial-relational,2|3,7,2/3,240552,2
1,2,24,553,1,801,1,7,3,3,4,single-choice,spatial-relational,3|4,7,3/4,240553,3
1,2,24,554,1,1646,3,9,3,3,6,single-choice,spatial-relational,3|6,7,3/6,240554,3
1,2,24,555,1,1088,3,7,2,2,5,single-choice,spatial-relational,2|5,7,2/5,240555,2
1,2,24,556,1,909,6,8,1,1,7,single-choice,spatial-relational,1|7,7,1/7,240556,1
1,2,24,557,1,747,1,9,4,4,5,single-choice,spatial-relational,4|5,7,4/5,240557,4
1,2,24,558,1,1302,3,7,2,2,5,single-choice,spatial-relational,2|5,7,2/5,240558,2
1,2,24,559,0,1043,4,8,2,6,6,single-choice,spatial-relational,2|6,7,2/6,240559,2
1,2,24,560,1,1044,1,11,5,5,6,single-choice,spatial-relational,5|6,7,5/6,240560,5
1,2,24,561,1,1066,4,8,2,2,6,single-choice,spatial-relational,2|6,7,2/6,240561,2
1,2,24,562,1,889,4,10,3,3,7,single-choice,spatial-relational,3|7,7,3/7,240562,3
1,2,24,563,1,1280,4,10,3,3,7,single-choice,spatial-relational,3|7,7,3/7,240563,3
1,2,24,564,1,902,1,11,5,5,6,single-choice,spatial-relational,5|6,7,5/6,240564,5
1,2,24,565,0,1964,2,6,2,4,4,single-choice,spatial-relational,2|4,7,2/4,240565,2
1,2,24,566,1,1031,1,3,1,1,2,single-choice,spatial-relational,1|2,7,1/2,240566,1
1,2,24,567,1,963,2,10,4,4,6,single-choice,spatial-relational,4|6,7,4/6,240567,4
1,2,24,568,1,1325,2,4,1,1,3,single-choice,spatial-relational,1|3,7,1/3,240568,1
1,2,24,569,1,957,5,7,1,1,6,single-choice,spatial-relational,1|6,7,1/6,240569,1
1,2,24,570,1,965,5,9,2,2,7,single-choice,spatial-relational,2|7,7,2/7,240570,2
1,2,24,571,1,998,2,6,2,2,4,single-choice,spatial-relational,2|4,7,2/4,240571,2
1,2,24,572,0,1297,1,5,2,3,3,single-choice,spatial-relational,2|3,7,2/3,240572,2
1,2,24,573,1,956,3,11,4,4,7,single-choice,spatial-relational,4|7,7,4/7,240573,4
1,2,24,574,1,1326,6,8,1,1,7,single-choice,spatial-relational,1|7,7,1/7,240574,1
1,2,24,575,1,886,5,9,2,2,7,single-choice,spatial-relational,2|7,7,2/7,240575,2
1,2,24,576,1,1131,4,6,1,1,5,single-choice,spatial-relational,1|5,7,1/5,240576,1
1,2,24,577,1,996,2,10,4,4,6,single-choice,spatial-relational,4|6,7,4/6,240577,4
1,2,24,578,1,1325,5,7,1,1,6,single-choice,spatial-relational,1|6,7,1/6,240578,1
1,2,24,579,1,929,3,11,4,4,7,single-choice,spatial-relational,4|7,7,4/7,240579,4
1,2,24,580,1,1059,3,9,3,3,6,single-choice,spatial-relational,3|6,7,3/6,240580,3
1,2,24,581,0,1453,2,4,1,3,3,single-choice,spatial-relational,1|3,7,1/3,240581,1
1,2,24,582,1,844,2,12,5,5,7,single-choice,spatial-relational,5|7,7,5/7,240582,5
1,2,24,583,0,95,3,5,1,4,4,single-choice,spatial-relational,1|4,7,1/4,240583,1
1,2,24,584,1,1392,2,8,3,3,5,single-choice,spatial-relational,3|5,7,3/5,240584,3
1,2,24,585,1,1073,2,8,3,3,5,single-choice,spatial-relational,3|5,7,3/5,240585,3
1,2,24,586,1,1119,1,13,6,6,7,single-choice,spatial-relational,6|7,7,6/7,240586,6
1,2,24,587,1,1336,1,7,3,3,4,single-choice,spatial-relational,3|4,7,3/4,240587,3
1,2,24,588,1,1384,1,3,1,1,2,single-choice,spatial-relational,1|2,7,1/2,240588,1
1,2,24,589,1,840,3,11,4,4,7,single-choice,spatial-relational,4|7,7,4/7,240589,4
1,2,24,590,1,1705,4,6,1,1,5,single-choice,spatial-relational,1|5,7,1/5,240590,1
1,2,24,591,1,991,3,9,3,3,6,single-choice,spatial-relational,3|6,7,3/6,240591,3
1,2,24,592,1,1143,2,4,1,1,3,single-choice,spatial-relational,1|3,7,1/3,240592,1
1,2,24,593,1,1111,3,7,2,2,5,single-choice,spatial-relational,2|5,7,2/5,240593,2
1,2,24,594,1,1187,3,7,2,2,5,single-choice,spatial-relational,2|5,7,2/5,240594,2
1,2,24,595,1,988,5,7,1,1,6,single-choice,spatial-relational,1|6,7,1/6,240595,1
1,2,24,596,1,775,4,10,3,3,7,single-choice,spatial-relational,3|7,7,3/7,240596,3
1,2,24,597,1,839,1,5,2,2,3,single-choice,spatial-relational,2|3,7,2/3,240597,2
1,2,24,598,1,1276,2,12,5,5,7,single-choice,spatial-relational,5|7,7,5/7,240598,5
1,2,24,599,1,1328,2,10,4,4,6,single-choice,spatial-relational,4|6,7,4/6,240599,4
1,2,24,600,1,1655,1,9,4,4,5,single-choice,spatial-relational,4|5,7,4/5,240600,4
2,2,24,1,0,718,3,5,1,4,4,single-choice,spatial-relational,1|4,7,1/4,240001,1
2,2,24,2,1,6,2,4,1,1,3,single-choice,spatial-relational,1|3,7,1/3,240002,1
2,2,24,3,0,581,5,7,1,6,6,single-choice,spatial-relational,1|6,7,1/6,240003,1
2,2,24,4,0,981,3,7,2,5,5,single-choice,spatial-relational,2|5,7,2/5,240004,2
2,2,24,5,0,1022,3,5,1,4,4,single-choice,spatial-relational,1|4,7,1/4,240005,1
2,2,24,6,1,818,1,13,6,6,7,single-choice,spatial-relational,6|7,7,6/7,240006,6
2,2,24,7,0,190,2,12,5,7,7,single-choice,spatial-relational,5|7,7,5/7,240007,5
2,2,24,8,0,8,5,9,2,7,7,single-choice,spatial-relational,2|7,7,2/7,240008,2
2,2,24,9,1,1310,4,6,1,1,5,single-choice,spatial-relational,1|5,7,1/5,240009,1
2,2,24,10,1,161,1,11,5,5,6,single-choice,spatial-relational,5|6,7,5/6,240010,5
2,2,24,11,0,143,2,10,4,6,6,single-choice,spatial-relational,4|6,7,4/6,240011,4
2,2,24,12,1,1460,2,8,3,3,5,single-choice,spatial-relational,3|5,7,3/5,240012,3
2,2,24,13,1,1745,4,8,2,2,6,single-choice,spatial-relational,2|6,7,2/6,240013,2
2,2,24,14,0,1361,4,8,2,6,6,single-choice,spatial-relational,2|6,7,2/6,240014,2
2,2,24,15,1,54,4,10,3,3,7,single-choice,spatial-relational,3|7,7,3/7,240015,3
2,2,24,16,1,151,2,12,5,5,7,single-choice,spatial-relational,5|7,7,5/7,240016,5
2,2,24,17,1,2816,3,9,3,3,6,single-choice,spatial-relational,3|6,7,3/6,240017,3
2,2,24,18,1,84,3,9,3,3,6,single-choice,spatial-relational,3|6,7,3/6,240018,3
2,2,24,19,0,71,2,6,2,4,4,single-choice,spatial-relational,2|4,7,2/4,240019,2
2,2,24,20,1,1038,6,8,1,1,7,single-choice,spatial-relational,1|7,7,1/7,240020,1
2,2,24,21,1,83,2,10,4,4,6,single-choice,spatial-relational,4|6,7,4/6,240021,4
2,2,24,22,1,154,5,7,1,1,6,single-choice,spatial-relational,1|6,7,1/6,240022,1
2,2,24,23,0,17,1,11,5,6,6,single-choice,spatial-relational,5|6,7,5/6,240023,5
2,2,24,24,1,503,3,7,2,2,5,single-choice,spatial-relational,2|5,7,2/5,240024,2
2,2,24,25,0,894,1,9,4,5,5,single-choice,spatial-relational,4|5,7,4/5,240025,4
2,2,24,26,1,1028,2,6,2,2,4,single-choice,spatial-relational,2|4,7,2/4,240026,2
2,2,24,27,1,2062,1,7,3,3,4,single-choice,spatial-relational,3|4,7,3/4,240027,3
2,2,24,28,0,774,2,4,1,3,3,single-choice,spatial-relational,1|3,7,1/3,240028,1
2,2,24,29,1,761,1,3,1,1,2,single-choice,spatial-relational,1|2,7,1/2,240029,1
2,2,24,30,0,11,1,9,4,5,5,single-choice,spatial-relational,4|5,7,4/5,240030,4
2,2,24,31,0,1014,2,10,4,6,6,single-choice,spatial-relational,4|6,7,4/6,240031,4
2,2,24,32,0,701,3,5,1,4,4,single-choice,spatial-relational,1|4,7,1/4,240032,1
2,2,24,33,1,1105,2,8,3,3,5,single-choice,spatial-relational,3|5,7,3/5,240033,3
2,2,24,34,0,1359,3,7,2,5,5,single-choice,spatial-relational,2|5,7,2/5,240034,2
2,2,24,35,1,763,3,9,3,3,6,single-choice,spatial-relational,3|6,7,3/6,240035,3
2,2,24,36,1,1132,3,9,3,3,6,single-choice,spatial-relational,3|6,7,3/6,240036,3
2,2,24,37,1,136,3,11,4,4,7,single-choice,spatial-relational,4|7,7,4/7,240037,4
2,2,24,38,0,120,2,10,4,6,6,single-choice,spatial-relational,4|6,7,4/6,240038,4
2,2,24,39,1,950,4,8,2,2,6,single-choice,spatial-relational,2|6,7,2/6,240039,2
2,2,24,40,0,99,1,7,3,4,4,single-choice,spatial-relational,3|4,7,3/4,240040,3
2,2,24,41,1,1390,4,6,1,1,5,single-choice,spatial-relational,1|5,7,1/5,240041,1
2,2,24,42,1,87,2,6,2,2,4,single-choice,spatial-relational,2|4,7,2/4,240042,2
2,2,24,43,0,217,3,7,2,5,5,single-choice,spatial-relational,2|5,7,2/5,240043,2
2,2,24,44,0,811,2,4,1,3,3,single-choice,spatial-relational,1|3,7,1/3,240044,1
2,2,24,45,1,1098,2,12,5,5,7,single-choice,spatial-relational,5|7,7,5/7,240045,5
2,2,24,46,1,1428,2,8,3,3,5,single-choice,spatial-relational,3|5,7,3/5,240046,3
2,2,24,47,1,1384,1,11,5,5,6,single-choice,spatial-relational,5|6,7,5/6,240047,5
2,2,24,48,0,2473,4,6,1,5,5,single-choice,spatial-relational,1|5,7,1/5,240048,1
2,2,24,49,1,850,4,10,3,3,7,single-choice,spatial-relational,3|7,7,3/7,240049,3
2,2,24,50,1,179,1,5,2,2,3,single-choice,spatial-relational,2|3,7,2/3,240050,2
2,2,24,51,1,306,5,9,2,2,7,single-choice,spatial-relational,2|7,7,2/7,240051,2
2,2,24,52,1,1737,1,13,6,6,7,single-choice,spatial-relational,6|7,7,6/7,240052,6
2,2,24,53,0,218,5,7,1,6,6,single-choice,spatial-relational,1|6,7,1/6,240053,1
2,2,24,54,1,1005,1,3,1,1,2,single-choice,spatial-relational,1|2,7,1/2,240054,1
2,2,24,55,1,1989,3,11,4,4,7,single-choice,spatial-relational,4|7,7,4/7,240055,4
2,2,24,56,0,1976,4,8,2,6,6,single-choice,spatial-relational,2|6,7,2/6,240056,2
2,2,24,57,1,881,1,7,3,3,4,single-choice,spatial-relational,3|4,7,3/4,240057,3
2,2,24,58,1,131,4,10,3,3,7,single-choice,spatial-relational,3|7,7,3/7,240058,3
2,2,24,59,0,156,1,5,2,3,3,single-choice,spatial-relational,2|3,7,2/3,240059,2
2,2,24,60,1,962,1,3,1,1,2,single-choice,spatial-relational,1|2,7,1/2,240060,1
2,2,24,61,0,932,2,4,1,3,3,single-choice,spatial-relational,1|3,7,1/3,240061,1
2,2,24,62,1,1262,6,8,1,1,7,single-choice,spatial-relational,1|7,7,1/7,240062,1
2,2,24,63,1,1237,2,6,2,2,4,single-choice,spatial-relational,2|4,7,2/4,240063,2
2,2,24,64,1,189,1,9,4,4,5,single-choice,spatial-relational,4|5,7,4/5,240064,4
2,2,24,65,1,1951,5,7,1,1,6,single-choice,spatial-relational,1|6,7,1/6,240065,1
2,2,24,66,1,1090,6,8,1,1,7,single-choice,spatial-relational,1|7,7,1/7,240066,1
2,2,24,67,1,1049,1,11,5,5,6,single-choice,spatial-relational,5|6,7,5/6,240067,5
2,2,24,68,0,1250,3,5,1,4,4,single-choice,spatial-relational,1|4,7,1/4,240068,1
2,2,24,69,1,984,5,9,2,2,7,single-choice,spatial-relational,2|7,7,2/7,240069,2
2,2,24,70,1,1840,1,13,6,6,7,single-choice,spatial-relational,6|7,7,6/7,240070,6
2,2,24,71,1,1207,2,12,5,5,7,single-choice,spatial-relational,5|7,7,5/7,240071,5
2,2,24,72,1,1277,5,7,1,1,6,single-choice,spatial-relational,1|6,7,1/6,240072,1
2,2,24,73,1,871,4,10,3,3,7,single-choice,spatial-relational,3|7,7,3/7,240073,3
2,2,24,74,1,1197,2,12,5,5,7,single-choice,spatial-relational,5|7,7,5/7,240074,5
2,2,24,75,1,2279,6,8,1,1,7,single-choice,spatial-relational,1|7,7,1/7,240075,1
2,2,24,76,0,772,1,5,2,3,3,single-choice,spatial-relational,2|3,7,2/3,240076,2
2,2,24,77,0,899,3,5,1,4,4,single-choice,spatial-relational,1|4,7,1/4,240077,1
2,2,24,78,1,1091,4,6,1,1,5,single-choice,spatial-relational,1|5,7,1/5,240078,1
2,2,24,79,1,1103,4,6,1,1,5,single-choice,spatial-relational,1|5,7,1/5,240079,1
2,2,24,80,0,173,3,11,4,7,7,single-choice,spatial-relational,4|7,7,4/7,240080,4
2,2,24,81,1,954,5,9,2,2,7,single-choice,spatial-relational,2|7,7,2/7,240081,2
2,2,24,82,0,1009,1,5,2,3,3,single-choice,spatial-relational,2|3,7,2/3,240082,2
2,2,24,83,1,924,3,9,3,3,6,single-choice,spatial-relational,3|6,7,3/6,240083,3
2,2,24,84,0,1346,3,7,2,5,5,single-choice,spatial-relational,2|5,7,2/5,240084,2
2,2,24,85,1,1044,2,8,3,3,5,single-choice,spatial-relational,3|5,7,3/5,240085,3
2,2,24,86,1,2001,3,5,1,1,4,single-choice,spatial-relational,1|4,7,1/4,240086,1
2,2,24,87,1,1341,1,7,3,3,4,single-choice,spatial-relational,3|4,7,3/4,240087,3
2,2,24,88,1,1015,4,8,2,2,6,single-choice,spatial-relational,2|6,7,2/6,240088,2
2,2,24,89,1,1391,5,9,2,2,7,single-choice,spatial-relational,2|7,7,2/7,240089,2
2,2,24,90,1,1018,5,7,1,1,6,single-choice,spatial-relational,1|6,7,1/6,240090,1
2,2,24,91,1,2150,2,4,1,1,3,single-choice,spatial-relational,1|3,7,1/3,240091,1
2,2,24,92,1,872,1,7,3,3,4,single-choice,spatial-relational,3|4,7,3/4,240092,3
2,2,24,93,1,1499,1,9,4,4,5,single-choice,spatial-relational,4|5,7,4/5,240093,4
2,2,24,94,1,1764,1,13,6,6,7,single-choice,spatial-relational,6|7,7,6/7,240094,6
2,2,24,95,1,1292,6,8,1,1,7,single-choice,spatial-relational,1|7,7,1/7,240095,1
2,2,24,96,0,753,2,4,1,3,3,single-choice,spatial-relational,1|3,7,1/3,240096,1
2,2,24,97,1,927,2,8,3,3,5,single-choice,spatial-relational,3|5,7,3/5,240097,3
2,2,24,98,1,226,1,3,1,1,2,single-choice,spatial-relational,1|2,7,1/2,240098,1
2,2,24,99,1,989,1,9,4,4,5,single-choice,spatial-relational,4|5,7,4/5,240099,4
2,2,24,100,1,1271,4,10,3,3,7,single-choice,spatial-relational,3|7,7,3/7,240100,3
2,2,24,101,1,1264,3,9,3,3,6,single-choice,spatial-relational,3|6,7,3/6,240101,3
2,2,24,102,1,1295,2,12,5,5,7,single-choice,spatial-relational,5|7,7,5/7,240102,5
2,2,24,103,1,1257,1,13,6,6,7,single-choice,spatial-relational,6|7,7,6/7,240103,6
2,2,24,104,1,1572,1,11,5,5,6,single-choice,spatial-relational,5|6,7,5/6,240104,5
2,2,24,105,1,1304,2,10,4,4,6,single-choice,spatial-relational,4|6,7,4/6,240105,4
2,2,24,106,1,1049,2,10,4,4,6,single-choice,spatial-relational,4|6,7,4/6,240106,4
2,2,24,107,1,2243,4,8,2,2,6,single-choice,spatial-relational,2|6,7,2/6,240107,2
2,2,24,108,1,904,2,6,2,2,4,single-choice,spatial-relational,2|4,7,2/4,240108,2
2,2,24,109,0,1700,2,6,2,4,4,single-choice,spatial-relational,2|4,7,2/4,240109,2
2,2,24,110,1,1000,1,11,5,5,6,single-choice,spatial-relational,5|6,7,5/6,240110,5
2,2,24,111,1,1160,3,7,2,2,5,single-choice,spatial-relational,2|5,7,2/5,240111,2
2,2,24,112,1,845,3,11,4,4,7,single-choice,spatial-relational,4|7,7,4/7,240112,4
2,2,24,113,1,1418,1,3,1,1,2,single-choice,spatial-relational,1|2,7,1/2,240113,1
2,2,24,114,1,985,4,8,2,2,6,single-choice,spatial-relational,2|6,7,2/6,240114,2
2,2,24,115,0,1183,1,9,4,5,5,single-choice,spatial-relational,4|5,7,4/5,240115,4
2,2,24,116,1,760,5,9,2,2,7,single-choice,spatial-relational,2|7,7,2/7,240116,2
2,2,24,117,1,1006,2,4,1,1,3,single-choice,spatial-relational,1|3,7,1/3,240117,1
2,2,24,118,1,777,3,11,4,4,7,single-choice,spatial-relational,4|7,7,4/7,240118,4
2,2,24,119,0,207,1,11,5,6,6,single-choice,spatial-relational,5|6,7,5/6,240119,5
2,2,24,120,0,610,4,6,1,5,5,single-choice,spatial-relational,1|5,7,1/5,240120,1
2,2,24,121,1,807,4,10,3,3,7,single-choice,spatial-relational,3|7,7,3/7,240121,3
2,2,24,122,1,1175,2,12,5,5,7,single-choice,spatial-relational,5|7,7,5/7,240122,5
2,2,24,123,1,1132,1,3,1,1,2,single-choice,spatial-relational,1|2,7,1/2,240123,1
2,2,24,124,1,1173,1,5,2,2,3,single-choice,spatial-relational,2|3,7,2/3,240124,2
2,2,24,125,1,954,3,9,3,3,6,single-choice,spatial-relational,3|6,7,3/6,240125,3
2,2,24,126,1,1481,1,7,3,3,4,single-choice,spatial-relational,3|4,7,3/4,240126,3
2,2,24,127,1,1593,3,5,1,1,4,single-choice,spatial-relational,1|4,7,1/4,240127,1
2,2,24,128,1,952,6,8,1,1,7,single-choice,spatial-relational,1|7,7,1/7,240128,1
2,2,24,129,1,1042,3,11,4,4,7,single-choice,spatial-relational,4|7,7,4/7,240129,4
2,2,24,130,0,112,5,7,1,6,6,single-choice,spatial-relational,1|6,7,1/6,240130,1
2,2,24,131,1,1439,1,11,5,5,6,single-choice,spatial-relational,5|6,7,5/6,240131,5
2,2,24,132,0,25,1,5,2,3,3,single-choice,spatial-relational,2|3,7,2/3,240132,2
2,2,24,133,1,698,1,7,3,3,4,single-choice,spatial-relational,3|4,7,3/4,240133,3
2,2,24,134,1,1528,3,5,1,1,4,single-choice,spatial-relational,1|4,7,1/4,240134,1
2,2,24,135,1,1044,2,10,4,4,6,single-choice,spatial-relational,4|6,7,4/6,240135,4
2,2,24,136,1,187,5,9,2,2,7,single-choice,spatial-relational,2|7,7,2/7,240136,2
2,2,24,137,1,1202,2,10,4,4,6,single-choice,spatial-relational,4|6,7,4/6,240137,4
2,2,24,138,0,1440,5,7,1,6,6,single-choice,spatial-relational,1|6,7,1/6,240138,1
2,2,24,139,1,1048,2,4,1,1,3,single-choice,spatial-relational,1|3,7,1/3,240139,1
2,2,24,140,1,842,2,8,3,3,5,single-choice,spatial-relational,3|5,7,3/5,240140,3
2,2,24,141,0,96,2,6,2,4,4,single-choice,spatial-relational,2|4,7,2/4,240141,2
2,2,24,142,0,768,3,7,2,5,5,single-choice,spatial-relational,2|5,7,2/5,240142,2
2,2,24,143,1,1226,2,6,2,2,4,single-choice,spatial-relational,2|4,7,2/4,240143,2
2,2,24,144,1,1113,1,9,4,4,5,single-choice,spatial-relational,4|5,7,4/5,240144,4
2,2,24,145,1,953,2,8,3,3,5,single-choice,spatial-relational,3|5,7,3/5,240145,3
2,2,24,146,1,1587,1,3,1,1,2,single-choice,spatial-relational,1|2,7,1/2,240146,1
2,2,24,147,1,922,3,9,3,3,6,single-choice,spatial-relational,3|6,7,3/6,240147,3
2,2,24,148,0,942,3,7,2,5,5,single-choice,spatial-relational,2|5,7,2/5,240148,2
2,2,24,149,1,756,2,12,5,5,7,single-choice,spatial-relational,5|7,7,5/7,240149,5
2,2,24,150,1,137,4,8,2,2,6,single-choice,spatial-relational,2|6,7,2/6,240150,2
2,2,24,151,1,100,1,13,6,6,7,single-choice,spatial-relational,6|7,7,6/7,240151,6
2,2,24,152,1,1386,1,13,6,6,7,single-choice,spatial-relational,6|7,7,6/7,240152,6
2,2,24,153,0,839,4,6,1,5,5,single-choice,spatial-relational,1|5,7,1/5,240153,1
2,2,24,154,1,720,4,10,3,3,7,single-choice,spatial-relational,3|7,7,3/7,240154,3
2,2,24,155,1,1254,6,8,1,1,7,single-choice,spatial-relational,1|7,7,1/7,240155,1
2,2,24,156,1,868,2,8,3,3,5,single-choice,spatial-relational,3|5,7,3/5,240156,3
2,2,24,157,1,1038,6,8,1,1,7,single-choice,spatial-relational,1|7,7,1/7,240157,1
2,2,24,158,1,978,4,8,2,2,6,single-choice,spatial-relational,2|6,7,2/6,240158,2
2,2,24,159,1,145,4,10,3,3,7,single-choice,spatial-relational,3|7,7,3/7,240159,3
2,2,24,160,1,920,4,10,3,3,7,single-choice,spatial-relational,3|7,7,3/7,240160,3
2,2,24,161,1,2163,3,5,1,1,4,single-choice,spatial-relational,1|4,7,1/4,240161,1
2,2,24,162,1,1071,3,7,2,2,5,single-choice,spatial-relational,2|5,7,2/5,240162,2
2,2,24,163,1,980,2,12,5,5,7,single-choice,spatial-relational,5|7,7,5/7,240163,5
2,2,24,164,1,1832,6,8,1,1,7,single-choice,spatial-relational,1|7,7,1/7,240164,1
2,2,24,165,1,940,5,7,1,1,6,single-choice,spatial-relational,1|6,7,1/6,240165,1
2,2,24,166,1,1754,1,3,1,1,2,single-choice,spatial-relational,1|2,7,1/2,240166,1
2,2,24,167,0,164,5,9,2,7,7,single-choice,spatial-relational,2|7,7,2/7,240167,2
2,2,24,168,1,1388,2,4,1,1,3,single-choice,spatial-relational,1|3,7,1/3,240168,1
2,2,24,169,1,817,3,11,4,4,7,single-choice,spatial-relational,4|7,7,4/7,240169,4
2,2,24,170,0,152,3,7,2,5,5,single-choice,spatial-relational,2|5,7,2/5,240170,2
2,2,24,171,1,1156,2,12,5,5,7,single-choice,spatial-relational,5|7,7,5/7,240171,5
2,2,24,172,0,141,1,13,6,7,7,single-choice,spatial-relational,6|7,7,6/7,240172,6
2,2,24,173,1,816,1,7,3,3,4,single-choice,spatial-relational,3|4,7,3/4,240173,3
2,2,24,174,1,1252,3,11,4,4,7,single-choice,spatial-relational,4|7,7,4/7,240174,4
2,2,24,175,0,172,1,5,2,3,3,single-choice,spatial-relational,2|3,7,2/3,240175,2
2,2,24,176,1,1296,2,6,2,2,4,single-choice,spatial-relational,2|4,7,2/4,240176,2
2,2,24,177,1,110,2,6,2,2,4,single-choice,spatial-relational,2|4,7,2/4,240177,2
2,2,24,178,1,247,1,9,4,4,5,single-choice,spatial-relational,4|5,7,4/5,240178,4
2,2,24,179,1,135,1,7,3,3,4,single-choice,spatial-relational,3|4,7,3/4,240179,3
2,2,24,180,0,120,2,10,4,6,6,single-choice,spatial-relational,4|6,7,4/6,240180,4
2,2,24,181,0,870,1,3,1,2,2,single-choice,spatial-relational,1|2,7,1/2,240181,1
2,2,24,182,1,970,5,7,1,1,6,single-choice,spatial-relational,1|6,7,1/6,240182,1
2,2,24,183,1,120,5,9,2,2,7,single-choice,spatial-relational,2|7,7,2/7,240183,2
2,2,24,184,1,140,1,5,2,2,3,single-choice,spatial-relational,2|3,7,2/3,240184,2
2,2,24,185,1,1153,3,5,1,1,4,single-choice,spatial-relational,1|4,7,1/4,240185,1
2,2,24,186,1,1039,4,6,1,1,5,single-choice,spatial-relational,1|5,7,1/5,240186,1
2,2,24,187,1,103,1,13,6,6,7,single-choice,spatial-relational,6|7,7,6/7,240187,6
2,2,24,188,1,1097,3,9,3,3,6,single-choice,spatial-relational,3|6,7,3/6,240188,3
2,2,24,189,1,1302,1,9,4,4,5,single-choice,spatial-relational,4|5,7,4/5,240189,4
2,2,24,190,1,1089,2,10,4,4,6,single-choice,spatial-relational,4|6,7,4/6,240190,4
2,2,24,191,1,1055,1,11,5,5,6,single-choice,spatial-relational,5|6,7,5/6,240191,5
2,2,24,192,1,979,1,11,5,5,6,single-choice,spatial-relational,5|6,7,5/6,240192,5
2,2,24,193,1,61,2,8,3,3,5,single-choice,spatial-relational,3|5,7,3/5,240193,3
2,2,24,194,1,59,2,4,1,1,3,single-choice,spatial-relational,1|3,7,1/3,240194,1
2,2,24,195,1,1272,4,8,2,2,6,single-choice,spatial-relational,2|6,7,2/6,240195,2
2,2,24,196,0,130,3,9,3,6,6,single-choice,spatial-relational,3|6,7,3/6,240196,3
2,2,24,197,1,1012,4,6,1,1,5,single-choice,spatial-relational,1|5,7,1/5,240197,1
2,2,24,198,1,147,1,7,3,3,4,single-choice,spatial-relational,3|4,7,3/4,240198,3
2,2,24,199,0,128,4,8,2,6,6,single-choice,spatial-relational,2|6,7,2/6,240199,2
2,2,24,200,1,851,6,8,1,1,7,single-choice,spatial-relational,1|7,7,1/7,240200,1
2,2,24,201,1,862,3,11,4,4,7,single-choice,spatial-relational,4|7,7,4/7,240201,4
2,2,24,202,1,1018,1,11,5,5,6,single-choice,spatial-relational,5|6,7,5/6,240202,5
2,2,24,203,1,942,1,11,5,5,6,single-choice,spatial-relational,5|6,7,5/6,240203,5
2,2,24,204,1,1673,1,3,1,1,2,single-choice,spatial-relational,1|2,7,1/2,240204,1
2,2,24,205,1,1046,6,8,1,1,7,single-choice,spatial-relational,1|7,7,1/7,240205,1
2,2,24,206,1,1017,5,7,1,1,6,single-choice,spatial-relational,1|6,7,1/6,240206,1
2,2,24,207,1,1143,3,7,2,2,5,single-choice,spatial-relational,2|5,7,2/5,240207,2
2,2,24,208,0,148,5,9,2,7,7,single-choice,spatial-relational,2|7,7,2/7,240208,2
2,2,24,209,1,1412,2,4,1,1,3,single-choice,spatial-relational,1|3,7,1/3,240209,1
2,2,24,210,1,182,1,5,2,2,3,single-choice,spatial-relational,2|3,7,2/3,240210,2
2,2,24,211,1,1021,2,10,4,4,6,single-choice,spatial-relational,4|6,7,4/6,240211,4
2,2,24,212,1,1031,1,13,6,6,7,single-choice,spatial-relational,6|7,7,6/7,240212,6
2,2,24,213,1,971,3,11,4,4,7,single-choice,spatial-relational,4|7,7,4/7,240213,4
2,2,24,214,0,1270,1,5,2,3,3,single-choice,spatial-relational,2|3,7,2/3,240214,2
2,2,24,215,1,832,3,5,1,1,4,single-choice,spatial-relational,1|4,7,1/4,240215,1
2,2,24,216,1,910,2,12,5,5,7,single-choice,spatial-relational,5|7,7,5/7,240216,5
2,2,24,217,1,1142,4,8,2,2,6,single-choice,spatial-relational,2|6,7,2/6,240217,2
2,2,24,218,0,101,3,7,2,5,5,single-choice,spatial-relational,2|5,7,2/5,240218,2
2,2,24,219,1,1144,2,8,3,3,5,single-choice,spatial-relational,3|5,7,3/5,240219,3
2,2,24,220,0,172,2,6,2,4,4,single-choice,spatial-relational,2|4,7,2/4,240220,2
2,2,24,221,1,862,1,13,6,6,7,single-choice,spatial-relational,6|7,7,6/7,240221,6
2,2,24,222,1,1440,4,6,1,1,5,single-choice,spatial-relational,1|5,7,1/5,240222,1
2,2,24,223,1,906,1,9,4,4,5,single-choice,spatial-relational,4|5,7,4/5,240223,4
2,2,24,224,1,857,3,9,3,3,6,single-choice,spatial-relational,3|6,7,3/6,240224,3
2,2,24,225,1,1281,2,4,1,1,3,single-choice,spatial-relational,1|3,7,1/3,240225,1
2,2,24,226,1,1720,3,5,1,1,4,single-choice,spatial-relational,1|4,7,1/4,240226,1
2,2,24,227,1,173,5,9,2,2,7,single-choice,spatial-relational,2|7,7,2/7,240227,2
2,2,24,228,1,862,4,10,3,3,7,single-choice,spatial-relational,3|7,7,3/7,240228,3
2,2,24,229,1,1350,3,9,3,3,6,single-choice,spatial-relational,3|6,7,3/6,240229,3
2,2,24,230,1,833,2,10,4,4,6,single-choice,spatial-relational,4|6,7,4/6,240230,4
2,2,24,231,0,1325,1,9,4,5,5,single-choice,spatial-relational,4|5,7,4/5,240231,4
2,2,24,232,1,697,1,7,3,3,4,single-choice,spatial-relational,3|4,7,3/4,240232,3
2,2,24,233,1,1374,4,6,1,1,5,single-choice,spatial-relational,1|5,7,1/5,240233,1
2,2,24,234,1,906,4,10,3,3,7,single-choice,spatial-relational,3|7,7,3/7,240234,3
2,2,24,235,1,1158,1,3,1,1,2,single-choice,spatial-relational,1|2,7,1/2,240235,1
2,2,24,236,1,981,2,8,3,3,5,single-choice,spatial-relational,3|5,7,3/5,240236,3
2,2,24,237,1,1067,2,6,2,2,4,single-choice,spatial-relational,2|4,7,2/4,240237,2
2,2,24,238,0,1127,2,12,5,7,7,single-choice,spatial-relational,5|7,7,5/7,240238,5
2,2,24,239,1,1035,5,7,1,1,6,single-choice,spatial-relational,1|6,7,1/6,240239,1
2,2,24,240,0,961,1,9,4,5,5,single-choice,spatial-relational,4|5,7,4/5,240240,4
2,2,24,241,1,959,1,3,1,1,2,single-choice,spatial-relational,1|2,7,1/2,240241,1
2,2,24,242,1,993,5,7,1,1,6,single-choice,spatial-relational,1|6,7,1/6,240242,1
2,2,24,243,1,900,4,8,2,2,6,single-choice,spatial-relational,2|6,7,2/6,240243,2
2,2,24,244,1,955,2,12,5,5,7,single-choice,spatial-relational,5|7,7,5/7,240244,5
2,2,24,245,1,1097,1,3,1,1,2,single-choice,spatial-relational,1|2,7,1/2,240245,1
2,2,24,246,1,861,3,9,3,3,6,single-choice,spatial-relational,3|6,7,3/6,240246,3
2,2,24,247,1,881,6,8,1,1,7,single-choice,spatial-relational,1|7,7,1/7,240247,1
2,2,24,248,1,774,3,9,3,3,6,single-choice,spatial-relational,3|6,7,3/6,240248,3
2,2,24,249,1,929,1,9,4,4,5,single-choice,spatial-relational,4|5,7,4/5,240249,4
2,2,24,250,1,1120,1,5,2,2,3,single-choice,spatial-relational,2|3,7,2/3,240250,2
2,2,24,251,1,926,4,8,2,2,6,single-choice,spatial-relational,2|6,7,2/6,240251,2
2,2,24,252,1,831,2,12,5,5,7,single-choice,spatial-relational,5|7,7,5/7,240252,5
2,2,24,253,1,786,4,10,3,3,7,single-choice,spatial-relational,3|7,7,3/7,240253,3
2,2,24,254,0,143,3,5,1,4,4,single-choice,spatial-relational,1|4,7,1/4,240254,1
2,2,24,255,1,710,3,11,4,4,7,single-choice,spatial-relational,4|7,7,4/7,240255,4
2,2,24,256,1,1306,5,7,1,1,6,single-choice,spatial-relational,1|6,7,1/6,240256,1
2,2,24,257,1,701,1,7,3,3,4,single-choice,spatial-relational,3|4,7,3/4,240257,3
2,2,24,258,1,1051,2,4,1,1,3,single-choice,spatial-relational,1|3,7,1/3,240258,1
2,2,24,259,1,1077,3,7,2,2,5,single-choice,spatial-relational,2|5,7,2/5,240259,2
2,2,24,260,1,834,1,13,6,6,7,single-choice,spatial-relational,6|7,7,6/7,240260,6
2,2,24,261,1,1541,6,8,1,1,7,single-choice,spatial-relational,1|7,7,1/7,240261,1
2,2,24,262,1,951,1,5,2,2,3,single-choice,spatial-relational,2|3,7,2/3,240262,2
2,2,24,263,1,865,4,10,3,3,7,single-choice,spatial-relational,3|7,7,3/7,240263,3
2,2,24,264,1,1067,2,10,4,4,6,single-choice,spatial-relational,4|6,7,4/6,240264,4
2,2,24,265,1,1039,1,13,6,6,7,single-choice,spatial-relational,6|7,7,6/7,240265,6
2,2,24,266,1,1272,3,5,1,1,4,single-choice,spatial-relational,1|4,7,1/4,240266,1
2,2,24,267,0,172,3,7,2,5,5,single-choice,spatial-relational,2|5,7,2/5,240267,2
2,2,24,268,1,1060,2,4,1,1,3,single-choice,spatial-relational,1|3,7,1/3,240268,1
2,2,24,269,0,190,2,6,2,4,4,single-choice,spatial-relational,2|4,7,2/4,240269,2
2,2,24,270,1,805,1,11,5,5,6,single-choice,spatial-relational,5|6,7,5/6,240270,5
2,2,24,271,1,1148,5,9,2,2,7,single-choice,spatial-relational,2|7,7,2/7,240271,2
2,2,24,272,1,1157,2,6,2,2,4,single-choice,spatial-relational,2|4,7,2/4,240272,2
2,2,24,273,1,855,2,10,4,4,6,single-choice,spatial-relational,4|6,7,4/6,240273,4
2,2,24,274,1,1045,1,7,3,3,4,single-choice,spatial-relational,3|4,7,3/4,240274,3
2,2,24,275,1,1101,4,6,1,1,5,single-choice,spatial-relational,1|5,7,1/5,240275,1
2,2,24,276,0,90,1,11,5,6,6,single-choice,spatial-relational,5|6,7,5/6,240276,5
2,2,24,277,1,1017,4,6,1,1,5,single-choice,spatial-relational,1|5,7,1/5,240277,1
2,2,24,278,1,907,2,8,3,3,5,single-choice,spatial-relational,3|5,7,3/5,240278,3
2,2,24,279,1,1062,5,9,2,2,7,single-choice,spatial-relational,2|7,7,2/7,240279,2
2,2,24,280,1,795,2,8,3,3,5,single-choice,spatial-relational,3|5,7,3/5,240280,3
2,2,24,281,1,1034,3,11,4,4,7,single-choice,spatial-relational,4|7,7,4/7,240281,4
2,2,24,282,0,132,3,5,1,4,4,single-choice,spatial-relational,1|4,7,1/4,240282,1
2,2,24,283,1,972,4,6,1,1,5,single-choice,spatial-relational,1|5,7,1/5,240283,1
2,2,24,284,0,146,2,12,5,7,7,single-choice,spatial-relational,5|7,7,5/7,240284,5
2,2,24,285,1,814,1,7,3,3,4,single-choice,spatial-relational,3|4,7,3/4,240285,3
2,2,24,286,1,1062,1,13,6,6,7,single-choice,spatial-relational,6|7,7,6/7,240286,6
2,2,24,287,1,142,1,3,1,1,2,single-choice,spatial-relational,1|2,7,1/2,240287,1
2,2,24,288,1,807,1,9,4,4,5,single-choice,spatial-relational,4|5,7,4/5,240288,4
2,2,24,289,1,946,1,9,4,4,5,single-choice,spatial-relational,4|5,7,4/5,240289,4
2,2,24,290,1,1162,2,4,1,1,3,single-choice,spatial-relational,1|3,7,1/3,240290,1
2,2,24,291,1,1022,3,7,2,2,5,single-choice,spatial-relational,2|5,7,2/5,240291,2
2,2,24,292,0,122,1,7,3,4,4,single-choice,spatial-relational,3|4,7,3/4,240292,3
2,2,24,293,1,943,2,6,2,2,4,single-choice,spatial-relational,2|4,7,2/4,240293,2
2,2,24,294,0,136,3,9,3,6,6,single-choice,spatial-relational,3|6,7,3/6,240294,3
2,2,24,295,1,1120,4,8,2,2,6,single-choice,spatial-relational,2|6,7,2/6,240295,2
2,2,24,296,0,121,5,9,2,7,7,single-choice,spatial-relational,2|7,7,2/7,240296,2
2,2,24,297,1,840,1,11,5,5,6,single-choice,spatial-relational,5|6,7,5/6,240297,5
2,2,24,298,1,1190,2,10,4,4,6,single-choice,spatial-relational,4|6,7,4/6,240298,4
2,2,24,299,1,983,2,8,3,3,5,single-choice,spatial-relational,3|5,7,3/5,240299,3
2,2,24,300,1,858,1,5,2,2,3,single-choice,spatial-relational,2|3,7,2/3,240300,2
2,2,24,301,1,917,6,8,1,1,7,single-choice,spatial-relational,1|7,7,1/7,240301,1
2,2,24,302,1,1000,2,10,4,4,6,single-choice,spatial-relational,4|6,7,4/6,240302,4
2,2,24,303,1,939,2,8,3,3,5,single-choice,spatial-relational,3|5,7,3/5,240303,3
2,2,24,304,1,980,1,13,6,6,7,single-choice,spatial-relational,6|7,7,6/7,240304,6
2,2,24,305,1,1281,4,6,1,1,5,single-choice,spatial-relational,1|5,7,1/5,240305,1
2,2,24,306,1,1091,2,12,5,5,7,single-choice,spatial-relational,5|7,7,5/7,240306,5
2,2,24,307,1,976,3,11,4,4,7,single-choice,spatial-relational,4|7,7,4/7,240307,4
2,2,24,308,1,1114,3,9,3,3,6,single-choice,spatial-relational,3|6,7,3/6,240308,3
2,2,24,309,0,2616,2,4,1,3,3,single-choice,spatial-relational,1|3,7,1/3,240309,1
2,2,24,310,1,764,6,8,1,1,7,single-choice,spatial-relational,1|7,7,1/7,240310,1
2,2,24,311,1,937,2,6,2,2,4,single-choice,spatial-relational,2|4,7,2/4,240311,2
2,2,24,312,1,1001,4,8,2,2,6,single-choice,spatial-relational,2|6,7,2/6,240312,2
2,2,24,313,1,1882,1,3,1,1,2,single-choice,spatial-relational,1|2,7,1/2,240313,1
2,2,24,314,1,935,5,7,1,1,6,single-choice,spatial-relational,1|6,7,1/6,240314,1
2,2,24,315,1,882,4,10,3,3,7,single-choice,spatial-relational,3|7,7,3/7,240315,3
2,2,24,316,1,1055,5,7,1,1,6,single-choice,spatial-relational,1|6,7,1/6,240316,1
2,2,24,317,1,813,4,10,3,3,7,single-choice,spatial-relational,3|7,7,3/7,240317,3
2,2,24,318,1,1189,3,7,2,2,5,single-choice,spatial-relational,2|5,7,2/5,240318,2
2,2,24,319,1,871,3,11,4,4,7,single-choice,spatial-relational,4|7,7,4/7,240319,4
2,2,24,320,1,123,3,5,1,1,4,single-choice,spatial-relational,1|4,7,1/4,240320,1
2,2,24,321,1,910,5,9,2,2,7,single-choice,spatial-relational,2|7,7,2/7,240321,2
2,2,24,322,1,108,1,5,2,2,3,single-choice,spatial-relational,2|3,7,2/3,240322,2
2,2,24,323,0,151,1,11,5,6,6,single-choice,spatial-relational,5|6,7,5/6,240323,5
2,2,24,324,1,938,5,9,2,2,7,single-choice,spatial-relational,2|7,7,2/7,240324,2
2,2,24,325,1,1099,2,4,1,1,3,single-choice,spatial-relational,1|3,7,1/3,240325,1
2,2,24,326,1,939,3,7,2,2,5,single-choice,spatial-relational,2|5,7,2/5,240326,2
2,2,24,327,1,1125,1,3,1,1,2,single-choice,spatial-relational,1|2,7,1/2,240327,1
2,2,24,328,0,122,2,10,4,6,6,single-choice,spatial-relational,4|6,7,4/6,240328,4
2,2,24,329,1,884,2,12,5,5,7,single-choice,spatial-relational,5|7,7,5/7,240329,5
2,2,24,330,1,95,2,8,3,3,5,single-choice,spatial-relational,3|5,7,3/5,240330,3
2,2,24,331,1,837,1,11,5,5,6,single-choice,spatial-relational,5|6,7,5/6,240331,5
2,2,24,332,1,1017,4,6,1,1,5,single-choice,spatial-relational,1|5,7,1/5,240332,1
2,2,24,333,1,819,3,9,3,3,6,single-choice,spatial-relational,3|6,7,3/6,240333,3
2,2,24,334,1,1190,2,6,2,2,4,single-choice,spatial-relational,2|4,7,2/4,240334,2
2,2,24,335,1,951,1,5,2,2,3,single-choice,spatial-relational,2|3,7,2/3,240335,2
2,2,24,336,0,1040,2,6,2,4,4,single-choice,spatial-relational,2|4,7,2/4,240336,2
2,2,24,337,1,1113,6,8,1,1,7,single-choice,spatial-relational,1|7,7,1/7,240337,1
2,2,24,338,1,899,4,8,2,2,6,single-choice,spatial-relational,2|6,7,2/6,240338,2
2,2,24,339,1,965,5,9,2,2,7,single-choice,spatial-relational,2|7,7,2/7,240339,2
2,2,24,340,1,1386,6,8,1,1,7,single-choice,spatial-relational,1|7,7,1/7,240340,1
2,2,24,341,1,921,1,9,4,4,5,single-choice,spatial-relational,4|5,7,4/5,240341,4
2,2,24,342,0,161,4,8,2,6,6,single-choice,spatial-relational,2|6,7,2/6,240342,2
2,2,24,343,1,1244,1,3,1,1,2,single-choice,spatial-relational,1|2,7,1/2,240343,1
2,2,24,344,1,793,4,10,3,3,7,single-choice,spatial-relational,3|7,7,3/7,240344,3
2,2,24,345,1,844,2,10,4,4,6,single-choice,spatial-relational,4|6,7,4/6,240345,4
2,2,24,346,0,1088,4,6,1,5,5,single-choice,spatial-relational,1|5,7,1/5,240346,1
2,2,24,347,1,1266,1,5,2,2,3,single-choice,spatial-relational,2|3,7,2/3,240347,2
2,2,24,348,0,161,1,13,6,7,7,single-choice,spatial-relational,6|7,7,6/7,240348,6
2,2,24,349,1,838,4,10,3,3,7,single-choice,spatial-relational,3|7,7,3/7,240349,3
2,2,24,350,0,153,2,8,3,5,5,single-choice,spatial-relational,3|5,7,3/5,240350,3
2,2,24,351,1,795,2,12,5,5,7,single-choice,spatial-relational,5|7,7,5/7,240351,5
2,2,24,352,1,134,1,7,3,3,4,single-choice,spatial-relational,3|4,7,3/4,240352,3
2,2,24,353,1,1004,3,9,3,3,6,single-choice,spatial-relational,3|6,7,3/6,240353,3
2,2,24,354,0,1081,1,7,3,4,4,single-choice,spatial-relational,3|4,7,3/4,240354,3
2,2,24,355,1,890,5,7,1,1,6,single-choice,spatial-relational,1|6,7,1/6,240355,1
2,2,24,356,1,1046,1,13,6,6,7,single-choice,spatial-relational,6|7,7,6/7,240356,6
2,2,24,357,0,81,3,11,4,7,7,single-choice,spatial-relational,4|7,7,4/7,240357,4
2,2,24,358,1,1195,3,7,2,2,5,single-choice,spatial-relational,2|5,7,2/5,240358,2
2,2,24,359,1,1061,3,5,1,1,4,single-choice,spatial-relational,1|4,7,1/4,240359,1
2,2,24,360,1,1057,2,4,1,1,3,single-choice,spatial-relational,1|3,7,1/3,240360,1
2,2,24,361,0,1079,3,5,1,4,4,single-choice,spatial-relational,1|4,7,1/4,240361,1
2,2,24,362,1,5,1,11,5,5,6,single-choice,spatial-relational,5|6,7,5/6,240362,5
2,2,24,363,0,122,1,9,4,5,5,single-choice,spatial-relational,4|5,7,4/5,240363,4
2,2,24,364,1,1101,3,11,4,4,7,single-choice,spatial-relational,4|7,7,4/7,240364,4
2,2,24,365,1,1067,5,7,1,1,6,single-choice,spatial-relational,1|6,7,1/6,240365,1
2,2,24,366,1,1113,3,5,1,1,4,single-choice,spatial-relational,1|4,7,1/4,240366,1
2,2,24,367,0,112,3,7,2,5,5,single-choice,spatial-relational,2|5,7,2/5,240367,2
2,2,24,368,0,813,1,9,4,5,5,single-choice,spatial-relational,4|5,7,4/5,240368,4
2,2,24,369,1,1432,3,11,4,4,7,single-choice,spatial-relational,4|7,7,4/7,240369,4
2,2,24,370,0,1386,1,5,2,3,3,single-choice,spatial-relational,2|3,7,2/3,240370,2
2,2,24,371,1,1012,1,3,1,1,2,single-choice,spatial-relational,1|2,7,1/2,240371,1
2,2,24,372,1,776,4,10,3,3,7,single-choice,spatial-relational,3|7,7,3/7,240372,3
2,2,24,373,1,1336,5,9,2,2,7,single-choice,spatial-relational,2|7,7,2/7,240373,2
2,2,24,374,0,189,5,7,1,6,6,single-choice,spatial-relational,1|6,7,1/6,240374,1
2,2,24,375,1,1007,3,7,2,2,5,single-choice,spatial-relational,2|5,7,2/5,240375,2
2,2,24,376,1,163,3,11,4,4,7,single-choice,spatial-relational,4|7,7,4/7,240376,4
2,2,24,377,1,1377,2,6,2,2,4,single-choice,spatial-relational,2|4,7,2/4,240377,2
2,2,24,378,1,1029,3,9,3,3,6,single-choice,spatial-relational,3|6,7,3/6,240378,3
2,2,24,379,1,957,1,11,5,5,6,single-choice,spatial-relational,5|6,7,5/6,240379,5
2,2,24,380,1,983,2,8,3,3,5,single-choice,spatial-relational,3|5,7,3/5,240380,3
2,2,24,381,1,1111,4,10,3,3,7,single-choice,spatial-relational,3|7,7,3/7,240381,3
2,2,24,382,1,1457,3,5,1,1,4,single-choice,spatial-relational,1|4,7,1/4,240382,1
2,2,24,383,1,804,3,9,3,3,6,single-choice,spatial-relational,3|6,7,3/6,240383,3
2,2,24,384,1,1133,1,7,3,3,4,single-choice,spatial-relational,3|4,7,3/4,240384,3
2,2,24,385,1,1636,4,6,1,1,5,single-choice,spatial-relational,1|5,7,1/5,240385,1
2,2,24,386,1,931,4,8,2,2,6,single-choice,spatial-relational,2|6,7,2/6,240386,2
2,2,24,387,1,155,6,8,1,1,7,single-choice,spatial-relational,1|7,7,1/7,240387,1
2,2,24,388,1,112,4,6,1,1,5,single-choice,spatial-relational,1|5,7,1/5,240388,1
2,2,24,389,1,1055,5,7,1,1,6,single-choice,spatial-relational,1|6,7,1/6,240389,1
2,2,24,390,1,845,2,12,5,5,7,single-choice,spatial-relational,5|7,7,5/7,240390,5
2,2,24,391,0,1364,2,4,1,3,3,single-choice,spatial-relational,1|3,7,1/3,240391,1
2,2,24,392,1,1473,2,10,4,4,6,single-choice,spatial-relational,4|6,7,4/6,240392,4
2,2,24,393,1,129,1,9,4,4,5,single-choice,spatial-relational,4|5,7,4/5,240393,4
2,2,24,394,1,1037,1,13,6,6,7,single-choice,spatial-relational,6|7,7,6/7,240394,6
2,2,24,395,1,835,1,7,3,3,4,single-choice,spatial-relational,3|4,7,3/4,240395,3
2,2,24,396,1,1132,2,4,1,1,3,single-choice,spatial-relational,1|3,7,1/3,240396,1
2,2,24,397,1,129,1,3,1,1,2,single-choice,spatial-relational,1|2,7,1/2,240397,1
2,2,24,398,0,110,6,8,1,7,7,single-choice,spatial-relational,1|7,7,1/7,240398,1
2,2,24,399,1,816,1,13,6,6,7,single-choice,spatial-relational,6|7,7,6/7,240399,6
2,2,24,400,1,1161,4,8,2,2,6,single-choice,spatial-relational,2|6,7,2/6,240400,2
2,2,24,401,1,858,2,6,2,2,4,single-choice,spatial-relational,2|4,7,2/4,240401,2
2,2,24,402,1,1075,2,12,5,5,7,single-choice,spatial-relational,5|7,7,5/7,240402,5
2,2,24,403,1,1158,2,10,4,4,6,single-choice,spatial-relational,4|6,7,4/6,240403,4
2,2,24,404,0,1228,1,5,2,3,3,single-choice,spatial-relational,2|3,7,2/3,240404,2
2,2,24,405,1,970,5,9,2,2,7,single-choice,spatial-relational,2|7,7,2/7,240405,2
2,2,24,406,0,126,2,8,3,5,5,single-choice,spatial-relational,3|5,7,3/5,240406,3
2,2,24,407,1,862,1,11,5,5,6,single-choice,spatial-relational,5|6,7,5/6,240407,5
2,2,24,408,1,998,3,7,2,2,5,single-choice,spatial-relational,2|5,7,2/5,240408,2
2,2,24,409,1,981,2,12,5,5,7,single-choice,spatial-relational,5|7,7,5/7,240409,5
2,2,24,410,1,4255,4,10,3,3,7,single-choice,spatial-relational,3|7,7,3/7,240410,3
2,2,24,411,0,151,4,6,1,5,5,single-choice,spatial-relational,1|5,7,1/5,240411,1
2,2,24,412,0,1039,2,10,4,6,6,single-choice,spatial-relational,4|6,7,4/6,240412,4
2,2,24,413,1,939,2,6,2,2,4,single-choice,spatial-relational,2|4,7,2/4,240413,2
2,2,24,414,1,986,6,8,1,1,7,single-choice,spatial-relational,1|7,7,1/7,240414,1
2,2,24,415,0,660,4,6,1,5,5,single-choice,spatial-relational,1|5,7,1/5,240415,1
2,2,24,416,1,944,1,7,3,3,4,single-choice,spatial-relational,3|4,7,3/4,240416,3
2,2,24,417,1,1326,2,8,3,3,5,single-choice,spatial-relational,3|5,7,3/5,240417,3
2,2,24,418,1,1106,1,9,4,4,5,single-choice,spatial-relational,4|5,7,4/5,240418,4
2,2,24,419,1,1014,1,5,2,2,3,single-choice,spatial-relational,2|3,7,2/3,240419,2
2,2,24,420,0,1075,3,5,1,4,4,single-choice,spatial-relational,1|4,7,1/4,240420,1
2,2,24,421,1,1210,5,7,1,1,6,single-choice,spatial-relational,1|6,7,1/6,240421,1
2,2,24,422,1,136,2,8,3,3,5,single-choice,spatial-relational,3|5,7,3/5,240422,3
2,2,24,423,1,959,1,11,5,5,6,single-choice,spatial-relational,5|6,7,5/6,240423,5
2,2,24,424,1,109,3,11,4,4,7,single-choice,spatial-relational,4|7,7,4/7,240424,4
2,2,24,425,1,1079,3,9,3,3,6,single-choice,spatial-relational,3|6,7,3/6,240425,3
2,2,24,426,1,91,2,4,1,1,3,single-choice,spatial-relational,1|3,7,1/3,240426,1
2,2,24,427,1,1097,1,3,1,1,2,single-choice,spatial-relational,1|2,7,1/2,240427,1
2,2,24,428,1,1314,2,12,5,5,7,single-choice,spatial-relational,5|7,7,5/7,240428,5
2,2,24,429,1,1033,1,5,2,2,3,single-choice,spatial-relational,2|3,7,2/3,240429,2
2,2,24,430,1,900,1,9,4,4,5,single-choice,spatial-relational,4|5,7,4/5,240430,4
2,2,24,431,1,1119,3,5,1,1,4,single-choice,spatial-relational,1|4,7,1/4,240431,1
2,2,24,432,1,1186,1,11,5,5,6,single-choice,spatial-relational,5|6,7,5/6,240432,5
2,2,24,433,1,1159,2,10,4,4,6,single-choice,spatial-relational,4|6,7,4/6,240433,4
2,2,24,434,1,1172,5,9,2,2,7,single-choice,spatial-relational,2|7,7,2/7,240434,2
2,2,24,435,1,1050,4,8,2,2,6,single-choice,spatial-relational,2|6,7,2/6,240435,2
2,2,24,436,1,1127,1,3,1,1,2,single-choice,spatial-relational,1|2,7,1/2,240436,1
2,2,24,437,1,858,1,13,6,6,7,single-choice,spatial-relational,6|7,7,6/7,240437,6
2,2,24,438,0,1246,2,4,1,3,3,single-choice,spatial-relational,1|3,7,1/3,240438,1
2,2,24,439,0,601,3,7,2,5,5,single-choice,spatial-relational,2|5,7,2/5,240439,2
2,2,24,440,1,942,2,6,2,2,4,single-choice,spatial-relational,2|4,7,2/4,240440,2
2,2,24,441,1,1229,1,7,3,3,4,single-choice,spatial-relational,3|4,7,3/4,240441,3
2,2,24,442,1,866,5,9,2,2,7,single-choice,spatial-relational,2|7,7,2/7,240442,2
2,2,24,443,1,1138,3,11,4,4,7,single-choice,spatial-relational,4|7,7,4/7,240443,4
2,2,24,444,1,887,1,13,6,6,7,single-choice,spatial-relational,6|7,7,6/7,240444,6
2,2,24,445,1,897,4,10,3,3,7,single-choice,spatial-relational,3|7,7,3/7,240445,3
2,2,24,446,1,954,3,9,3,3,6,single-choice,spatial-relational,3|6,7,3/6,240446,3
2,2,24,447,1,1305,4,8,2,2,6,single-choice,spatial-relational,2|6,7,2/6,240447,2
2,2,24,448,1,928,5,7,1,1,6,single-choice,spatial-relational,1|6,7,1/6,240448,1
2,2,24,449,1,1331,6,8,1,1,7,single-choice,spatial-relational,1|7,7,1/7,240449,1
2,2,24,450,1,877,2,10,4,4,6,single-choice,spatial-relational,4|6,7,4/6,240450,4
2,2,24,451,1,1104,4,6,1,1,5,single-choice,spatial-relational,1|5,7,1/5,240451,1
2,2,24,452,0,158,2,12,5,7,7,single-choice,spatial-relational,5|7,7,5/7,240452,5
2,2,24,453,1,789,1,7,3,3,4,single-choice,spatial-relational,3|4,7,3/4,240453,3
2,2,24,454,1,1322,4,6,1,1,5,single-choice,spatial-relational,1|5,7,1/5,240454,1
2,2,24,455,1,737,4,10,3,3,7,single-choice,spatial-relational,3|7,7,3/7,240455,3
2,2,24,456,0,146,3,5,1,4,4,single-choice,spatial-relational,1|4,7,1/4,240456,1
2,2,24,457,0,1617,1,9,4,5,5,single-choice,spatial-relational,4|5,7,4/5,240457,4
2,2,24,458,1,1067,2,6,2,2,4,single-choice,spatial-relational,2|4,7,2/4,240458,2
2,2,24,459,1,1005,3,11,4,4,7,single-choice,spatial-relational,4|7,7,4/7,240459,4
2,2,24,460,1,969,1,11,5,5,6,single-choice,spatial-relational,5|6,7,5/6,240460,5
2,2,24,461,1,1569,1,5,2,2,3,single-choice,spatial-relational,2|3,7,2/3,240461,2
2,2,24,462,1,944,1,3,1,1,2,single-choice,spatial-relational,1|2,7,1/2,240462,1
2,2,24,463,1,951,5,7,1,1,6,single-choice,spatial-relational,1|6,7,1/6,240463,1
2,2,24,464,1,927,3,9,3,3,6,single-choice,spatial-relational,3|6,7,3/6,240464,3
2,2,24,465,1,1171,5,9,2,2,7,single-choice,spatial-relational,2|7,7,2/7,240465,2
2,2,24,466,1,113,1,9,4,4,5,single-choice,spatial-relational,4|5,7,4/5,240466,4
2,2,24,467,1,109,1,13,6,6,7,single-choice,spatial-relational,6|7,7,6/7,240467,6
2,2,24,468,0,150,4,8,2,6,6,single-choice,spatial-relational,2|6,7,2/6,240468,2
2,2,24,469,1,1595,3,7,2,2,5,single-choice,spatial-relational,2|5,7,2/5,240469,2
2,2,24,470,1,894,3,9,3,3,6,single-choice,spatial-relational,3|6,7,3/6,240470,3
2,2,24,471,1,918,2,10,4,4,6,single-choice,spatial-relational,4|6,7,4/6,240471,4
2,2,24,472,1,978,2,6,2,2,4,single-choice,spatial-relational,2|4,7,2/4,240472,2
2,2,24,473,1,918,2,8,3,3,5,single-choice,spatial-relational,3|5,7,3/5,240473,3
2,2,24,474,1,1818,1,3,1,1,2,single-choice,spatial-relational,1|2,7,1/2,240474,1
2,2,24,475,1,849,5,9,2,2,7,single-choice,spatial-relational,2|7,7,2/7,240475,2
2,2,24,476,1,1101,2,12,5,5,7,single-choice,spatial-relational,5|7,7,5/7,240476,5
2,2,24,477,0,113,2,8,3,5,5,single-choice,spatial-relational,3|5,7,3/5,240477,3
2,2,24,478,1,904,1,13,6,6,7,single-choice,spatial-relational,6|7,7,6/7,240478,6
2,2,24,479,1,1222,3,5,1,1,4,single-choice,spatial-relational,1|4,7,1/4,240479,1
2,2,24,480,1,1015,3,7,2,2,5,single-choice,spatial-relational,2|5,7,2/5,240480,2
2,2,24,481,1,1209,6,8,1,1,7,single-choice,spatial-relational,1|7,7,1/7,240481,1
2,2,24,482,1,808,1,7,3,3,4,single-choice,spatial-relational,3|4,7,3/4,240482,3
2,2,24,483,1,171,2,4,1,1,3,single-choice,spatial-relational,1|3,7,1/3,240483,1
2,2,24,484,1,1137,3,11,4,4,7,single-choice,spatial-relational,4|7,7,4/7,240484,4
2,2,24,485,1,1074,2,4,1,1,3,single-choice,spatial-relational,1|3,7,1/3,240485,1
2,2,24,486,1,205,4,8,2,2,6,single-choice,spatial-relational,2|6,7,2/6,240486,2
2,2,24,487,1,909,1,5,2,2,3,single-choice,spatial-relational,2|3,7,2/3,240487,2
2,2,24,488,1,1253,1,11,5,5,6,single-choice,spatial-relational,5|6,7,5/6,240488,5
2,2,24,489,1,979,5,7,1,1,6,single-choice,spatial-relational,1|6,7,1/6,240489,1
2,2,24,490,1,15391,6,8,1,1,7,single-choice,spatial-relational,1|7,7,1/7,240490,1
2,2,24,491,0,110,4,10,3,7,7,single-choice,spatial-relational,3|7,7,3/7,240491,3
2,2,24,492,1,947,5,7,1,1,6,single-choice,spatial-relational,1|6,7,1/6,240492,1
2,2,24,493,1,1060,3,7,2,2,5,single-choice,spatial-relational,2|5,7,2/5,240493,2
2,2,24,494,1,987,1,13,6,6,7,single-choice,spatial-relational,6|7,7,6/7,240494,6
2,2,24,495,1,992,1,3,1,1,2,single-choice,spatial-relational,1|2,7,1/2,240495,1
2,2,24,496,1,873,4,8,2,2,6,single-choice,spatial-relational,2|6,7,2/6,240496,2
2,2,24,497,1,980,6,8,1,1,7,single-choice,spatial-relational,1|7,7,1/7,240497,1
2,2,24,498,1,788,4,10,3,3,7,single-choice,spatial-relational,3|7,7,3/7,240498,3
2,2,24,499,1,1858,3,9,3,3,6,single-choice,spatial-relational,3|6,7,3/6,240499,3
2,2,24,500,1,1121,2,12,5,5,7,single-choice,spatial-relational,5|7,7,5/7,240500,5
2,2,24,501,1,1546,1,9,4,4,5,single-choice,spatial-relational,4|5,7,4/5,240501,4
2,2,24,502,1,895,6,8,1,1,7,single-choice,spatial-relational,1|7,7,1/7,240502,1
2,2,24,503,1,1179,1,7,3,3,4,single-choice,spatial-relational,3|4,7,3/4,240503,3
2,2,24,504,1,1012,2,12,5,5,7,single-choice,spatial-relational,5|7,7,5/7,240504,5
2,2,24,505,1,1771,2,6,2,2,4,single-choice,spatial-relational,2|4,7,2/4,240505,2
2,2,24,506,1,2110,4,6,1,1,5,single-choice,spatial-relational,1|5,7,1/5,240506,1
2,2,24,507,1,860,1,7,3,3,4,single-choice,spatial-relational,3|4,7,3/4,240507,3
2,2,24,508,1,153,1,9,4,4,5,single-choice,spatial-relational,4|5,7,4/5,240508,4
2,2,24,509,0,129,1,11,5,6,6,single-choice,spatial-relational,5|6,7,5/6,240509,5
2,2,24,510,1,886,2,10,4,4,6,single-choice,spatial-relational,4|6,7,4/6,240510,4
2,2,24,511,1,1393,2,10,4,4,6,single-choice,spatial-relational,4|6,7,4/6,240511,4
2,2,24,512,1,1215,4,8,2,2,6,single-choice,spatial-relational,2|6,7,2/6,240512,2
2,2,24,513,1,889,5,9,2,2,7,single-choice,spatial-relational,2|7,7,2/7,240513,2
2,2,24,514,1,1167,2,4,1,1,3,single-choice,spatial-relational,1|3,7,1/3,240514,1
2,2,24,515,1,896,3,11,4,4,7,single-choice,spatial-relational,4|7,7,4/7,240515,4
2,2,24,516,1,1232,2,8,3,3,5,single-choice,spatial-relational,3|5,7,3/5,240516,3
2,2,24,517,1,149,4,10,3,3,7,single-choice,spatial-relational,3|7,7,3/7,240517,3
2,2,24,518,0,147,1,5,2,3,3,single-choice,spatial-relational,2|3,7,2/3,240518,2
2,2,24,519,1,1149,2,8,3,3,5,single-choice,spatial-relational,3|5,7,3/5,240519,3
2,2,24,520,1,1530,3,5,1,1,4,single-choice,spatial-relational,1|4,7,1/4,240520,1
2,2,24,521,1,1128,1,3,1,1,2,single-choice,spatial-relational,1|2,7,1/2,240521,1
2,2,24,522,1,1047,1,5,2,2,3,single-choice,spatial-relational,2|3,7,2/3,240522,2
2,2,24,523,1,900,5,7,1,1,6,single-choice,spatial-relational,1|6,7,1/6,240523,1
2,2,24,524,1,802,1,11,5,5,6,single-choice,spatial-relational,5|6,7,5/6,240524,5
2,2,24,525,0,84,2,4,1,3,3,single-choice,spatial-relational,1|3,7,1/3,240525,1
2,2,24,526,1,1097,3,5,1,1,4,single-choice,spatial-relational,1|4,7,1/4,240526,1
2,2,24,527,1,122,3,11,4,4,7,single-choice,spatial-relational,4|7,7,4/7,240527,4
2,2,24,528,1,1055,3,7,2,2,5,single-choice,spatial-relational,2|5,7,2/5,240528,2
2,2,24,529,1,982,4,6,1,1,5,single-choice,spatial-relational,1|5,7,1/5,240529,1
2,2,24,530,0,142,1,13,6,7,7,single-choice,spatial-relational,6|7,7,6/7,240530,6
2,2,24,531,1,1135,3,9,3,3,6,single-choice,spatial-relational,3|6,7,3/6,240531,3
2,2,24,532,0,169,5,9,2,7,7,single-choice,spatial-relational,2|7,7,2/7,240532,2
2,2,24,533,1,932,2,6,2,2,4,single-choice,spatial-relational,2|4,7,2/4,240533,2
2,2,24,534,1,1054,3,5,1,1,4,single-choice,spatial-relational,1|4,7,1/4,240534,1
2,2,24,535,1,941,4,6,1,1,5,single-choice,spatial-relational,1|5,7,1/5,240535,1
2,2,24,536,1,782,1,13,6,6,7,single-choice,spatial-relational,6|7,7,6/7,240536,6
2,2,24,537,1,1048,1,3,1,1,2,single-choice,spatial-relational,1|2,7,1/2,240537,1
2,2,24,538,1,942,3,7,2,2,5,single-choice,spatial-relational,2|5,7,2/5,240538,2
2,2,24,539,1,1184,4,6,1,1,5,single-choice,spatial-relational,1|5,7,1/5,240539,1
2,2,24,540,1,1087,6,8,1,1,7,single-choice,spatial-relational,1|7,7,1/7,240540,1
2,2,24,541,1,775,3,11,4,4,7,single-choice,spatial-relational,4|7,7,4/7,240541,4
2,2,24,542,1,1142,1,9,4,4,5,single-choice,spatial-relational,4|5,7,4/5,240542,4
2,2,24,543,1,978,5,9,2,2,7,single-choice,spatial-relational,2|7,7,2/7,240543,2
2,2,24,544,1,1144,1,7,3,3,4,single-choice,spatial-relational,3|4,7,3/4,240544,3
2,2,24,545,1,215,2,6,2,2,4,single-choice,spatial-relational,2|4,7,2/4,240545,2
2,2,24,546,1,1112,6,8,1,1,7,single-choice,spatial-relational,1|7,7,1/7,240546,1
2,2,24,547,1,924,2,8,3,3,5,single-choice,spatial-relational,3|5,7,3/5,240547,3
2,2,24,548,1,877,2,6,2,2,4,single-choice,spatial-relational,2|4,7,2/4,240548,2
2,2,24,549,1,914,3,11,4,4,7,single-choice,spatial-relational,4|7,7,4/7,240549,4
2,2,24,550,1,1021,4,8,2,2,6,single-choice,spatial-relational,2|6,7,2/6,240550,2
2,2,24,551,1,97281,3,7,2,2,5,single-choice,spatial-relational,2|5,7,2/5,240551,2
2,2,24,552,1,1244,1,3,1,1,2,single-choice,spatial-relational,1|2,7,1/2,240552,1
2,2,24,553,1,688,2,12,5,5,7,single-choice,spatial-relational,5|7,7,5/7,240553,5
2,2,24,554,1,862,1,13,6,6,7,single-choice,spatial-relational,6|7,7,6/7,240554,6
2,2,24,555,1,1014,4,10,3,3,7,single-choice,spatial-relational,3|7,7,3/7,240555,3
2,2,24,556,1,915,5,7,1,1,6,single-choice,spatial-relational,1|6,7,1/6,240556,1
2,2,24,557,1,179,1,11,5,5,6,single-choice,spatial-relational,5|6,7,5/6,240557,5
2,2,24,558,1,798,3,9,3,3,6,single-choice,spatial-relational,3|6,7,3/6,240558,3
2,2,24,559,1,1152,2,4,1,1,3,single-choice,spatial-relational,1|3,7,1/3,240559,1
2,2,24,560,1,903,1,7,3,3,4,single-choice,spatial-relational,3|4,7,3/4,240560,3
2,2,24,561,1,952,4,10,3,3,7,single-choice,spatial-relational,3|7,7,3/7,240561,3
2,2,24,562,1,995,1,5,2,2,3,single-choice,spatial-relational,2|3,7,2/3,240562,2
2,2,24,563,1,5242,2,8,3,3,5,single-choice,spatial-relational,3|5,7,3/5,240563,3
2,2,24,564,1,1103,1,9,4,4,5,single-choice,spatial-relational,4|5,7,4/5,240564,4
2,2,24,565,0,173,2,12,5,7,7,single-choice,spatial-relational,5|7,7,5/7,240565,5
2,2,24,566,1,1032,3,5,1,1,4,single-choice,spatial-relational,1|4,7,1/4,240566,1
2,2,24,567,1,938,3,9,3,3,6,single-choice,spatial-relational,3|6,7,3/6,240567,3
2,2,24,568,1,964,2,10,4,4,6,single-choice,spatial-relational,4|6,7,4/6,240568,4
2,2,24,569,1,280,4,8,2,2,6,single-choice,spatial-relational,2|6,7,2/6,240569,2
2,2,24,570,0,1136,2,4,1,3,3,single-choice,spatial-relational,1|3,7,1/3,240570,1
2,2,24,571,0,50,2,10,4,6,6,single-choice,spatial-relational,4|6,7,4/6,240571,4
2,2,24,572,1,1062,5,7,1,1,6,single-choice,spatial-relational,1|6,7,1/6,240572,1
2,2,24,573,0,145,1,11,5,6,6,single-choice,spatial-relational,5|6,7,5/6,240573,5
2,2,24,574,1,1073,1,5,2,2,3,single-choice,spatial-relational,2|3,7,2/3,240574,2
2,2,24,575,1,1014,5,9,2,2,7,single-choice,spatial-relational,2|7,7,2/7,240575,2
2,2,24,576,1,1041,6,8,1,1,7,single-choice,spatial-relational,1|7,7,1/7,240576,1
2,2,24,577,1,860,5,9,2,2,7,single-choice,spatial-relational,2|7,7,2/7,240577,2
2,2,24,578,0,924,3,7,2,5,5,single-choice,spatial-relational,2|5,7,2/5,240578,2
2,2,24,579,1,1227,6,8,1,1,7,single-choice,spatial-relational,1|7,7,1/7,240579,1
2,2,24,580,1,845,1,7,3,3,4,single-choice,spatial-relational,3|4,7,3/4,240580,3
2,2,24,581,1,1126,2,12,5,5,7,single-choice,spatial-relational,5|7,7,5/7,240581,5
2,2,24,582,1,875,1,13,6,6,7,single-choice,spatial-relational,6|7,7,6/7,240582,6
2,2,24,583,1,946,5,9,2,2,7,single-choice,spatial-relational,2|7,7,2/7,240583,2
2,2,24,584,1,2159,1,9,4,4,5,single-choice,spatial-relational,4|5,7,4/5,240584,4
2,2,24,585,0,123,1,5,2,3,3,single-choice,spatial-relational,2|3,7,2/3,240585,2
2,2,24,586,1,1143,1,11,5,5,6,single-choice,spatial-relational,5|6,7,5/6,240586,5
2,2,24,587,1,1209,1,13,6,6,7,single-choice,spatial-relational,6|7,7,6/7,240587,6
2,2,24,588,1,1261,2,12,5,5,7,single-choice,spatial-relational,5|7,7,5/7,240588,5
2,2,24,589,1,1012,2,4,1,1,3,single-choice,spatial-relational,1|3,7,1/3,240589,1
2,2,24,590,0,51,4,10,3,7,7,single-choice,spatial-relational,3|7,7,3/7,240590,3
2,2,24,591,0,5,4,8,2,6,6,single-choice,spatial-relational,2|6,7,2/6,240591,2
2,2,24,592,0,51,3,11,4,7,7,single-choice,spatial-relational,4|7,7,4/7,240592,4
2,2,24,593,1,1768,1,9,4,4,5,single-choice,spatial-relational,4|5,7,4/5,240593,4
2,2,24,594,1,115,2,8,3,3,5,single-choice,spatial-relational,3|5,7,3/5,240594,3
2,2,24,595,0,936,1,3,1,2,2,single-choice,spatial-relational,1|2,7,1/2,240595,1
2,2,24,596,1,1073,2,6,2,2,4,single-choice,spatial-relational,2|4,7,2/4,240596,2
2,2,24,597,1,139,2,6,2,2,4,single-choice,spatial-relational,2|4,7,2/4,240597,2
2,2,24,598,1,199,5,7,1,1,6,single-choice,spatial-relational,1|6,7,1/6,240598,1
2,2,24,599,1,932,2,10,4,4,6,single-choice,spatial-relational,4|6,7,4/6,240599,4
2,2,24,600,1,188,3,5,1,1,4,single-choice,spatial-relational,1|4,7,1/4,240600,1
2,2,24,601,1,745,3,9,3,3,6,single-choice,spatial-relational,3|6,7,3/6,240601,3
2,2,24,602,1,267775,2,4,1,1,3,single-choice,spatial-relational,1|3,7,1/3,240602,1
2,2,24,603,1,1097,3,7,2,2,5,single-choice,spatial-relational,2|5,7,2/5,240603,2
2,2,24,604,1,1144,2,8,3,3,5,single-choice,spatial-relational,3|5,7,3/5,240604,3
2,2,24,605,1,1156,1,3,1,1,2,single-choice,spatial-relational,1|2,7,1/2,240605,1
2,2,24,606,1,710,4,10,3,3,7,single-choice,spatial-relational,3|7,7,3/7,240606,3
2,2,24,607,1,1053,3,11,4,4,7,single-choice,spatial-relational,4|7,7,4/7,240607,4
2,2,24,608,1,943,5,7,1,1,6,single-choice,spatial-relational,1|6,7,1/6,240608,1
2,2,24,609,1,1249,2,10,4,4,6,single-choice,spatial-relational,4|6,7,4/6,240609,4
2,2,24,610,1,984,1,11,5,5,6,single-choice,spatial-relational,5|6,7,5/6,240610,5
2,2,24,611,1,869,1,7,3,3,4,single-choice,spatial-relational,3|4,7,3/4,240611,3
2,2,24,612,1,958,1,5,2,2,3,single-choice,spatial-relational,2|3,7,2/3,240612,2
2,2,24,613,1,1222,4,6,1,1,5,single-choice,spatial-relational,1|5,7,1/5,240613,1
2,2,24,614,1,12816,3,5,1,1,4,single-choice,spatial-relational,1|4,7,1/4,240614,1
2,2,24,615,0,148,3,9,3,6,6,single-choice,spatial-relational,3|6,7,3/6,240615,3
2,2,24,616,1,1086,4,6,1,1,5,single-choice,spatial-relational,1|5,7,1/5,240616,1
2,2,24,617,1,896,4,8,2,2,6,single-choice,spatial-relational,2|6,7,2/6,240617,2
2,2,24,618,1,1014,4,6,1,1,5,single-choice,spatial-relational,1|5,7,1/5,240618,1
2,2,24,619,1,1120,2,4,1,1,3,single-choice,spatial-relational,1|3,7,1/3,240619,1
2,2,24,620,1,1024,2,10,4,4,6,single-choice,spatial-relational,4|6,7,4/6,240620,4
2,2,24,621,1,1138,1,9,4,4,5,single-choice,spatial-relational,4|5,7,4/5,240621,4
2,2,24,622,1,882,1,9,4,4,5,single-choice,spatial-relational,4|5,7,4/5,240622,4
2,2,24,623,1,1006,5,9,2,2,7,single-choice,spatial-relational,2|7,7,2/7,240623,2
2,2,24,624,0,165,2,8,3,5,5,single-choice,spatial-relational,3|5,7,3/5,240624,3
2,2,24,625,1,1267,3,11,4,4,7,single-choice,spatial-relational,4|7,7,4/7,240625,4
2,2,24,626,1,1253,1,11,5,5,6,single-choice,spatial-relational,5|6,7,5/6,240626,5
2,2,24,627,1,2344,2,6,2,2,4,single-choice,spatial-relational,2|4,7,2/4,240627,2
2,2,24,628,1,1127,1,5,2,2,3,single-choice,spatial-relational,2|3,7,2/3,240628,2
2,2,24,629,1,1246,6,8,1,1,7,single-choice,spatial-relational,1|7,7,1/7,240629,1
3,2,24,1,0,1193,4,8,2,6,6,single-choice,spatial-relational,2|6,7,2/6,240001,2
3,2,24,2,0,789,2,4,1,3,3,single-choice,spatial-relational,1|3,7,1/3,240002,1
3,2,24,3,1,1306,2,4,1,1,3,single-choice,spatial-relational,1|3,7,1/3,240003,1
3,2,24,4,0,113,1,9,4,5,5,single-choice,spatial-relational,4|5,7,4/5,240004,4
3,2,24,5,1,1332,4,8,2,2,6,single-choice,spatial-relational,2|6,7,2/6,240005,2
3,2,24,6,1,130,3,11,4,4,7,single-choice,spatial-relational,4|7,7,4/7,240006,4
3,2,24,7,1,133,1,13,6,6,7,single-choice,spatial-relational,6|7,7,6/7,240007,6
3,2,24,8,1,77,4,10,3,3,7,single-choice,spatial-relational,3|7,7,3/7,240008,3
3,2,24,9,0,1003,5,7,1,6,6,single-choice,spatial-relational,1|6,7,1/6,240009,1
3,2,24,10,1,1516,1,5,2,2,3,single-choice,spatial-relational,2|3,7,2/3,240010,2
3,2,24,11,1,115,2,12,5,5,7,single-choice,spatial-relational,5|7,7,5/7,240011,5
3,2,24,12,0,80,1,11,5,6,6,single-choice,spatial-relational,5|6,7,5/6,240012,5
3,2,24,13,1,1046,3,5,1,1,4,single-choice,spatial-relational,1|4,7,1/4,240013,1
3,2,24,14,1,141,5,9,2,2,7,single-choice,spatial-relational,2|7,7,2/7,240014,2
3,2,24,15,1,1081,6,8,1,1,7,single-choice,spatial-relational,1|7,7,1/7,240015,1
3,2,24,16,0,51,6,8,1,7,7,single-choice,spatial-relational,1|7,7,1/7,240016,1
3,2,24,17,1,919,2,12,5,5,7,single-choice,spatial-relational,5|7,7,5/7,240017,5
3,2,24,18,1,1103,1,11,5,5,6,single-choice,spatial-relational,5|6,7,5/6,240018,5
3,2,24,19,0,228,1,3,1,2,2,single-choice,spatial-relational,1|2,7,1/2,240019,1
3,2,24,20,1,1760,2,6,2,2,4,single-choice,spatial-relational,2|4,7,2/4,240020,2
3,2,24,21,1,1429,3,9,3,3,6,single-choice,spatial-relational,3|6,7,3/6,240021,3
3,2,24,22,1,1112,1,7,3,3,4,single-choice,spatial-relational,3|4,7,3/4,240022,3
3,2,24,23,1,948,3,11,4,4,7,single-choice,spatial-relational,4|7,7,4/7,240023,4
3,2,24,24,0,1040,1,3,1,2,2,single-choice,spatial-relational,1|2,7,1/2,240024,1
3,2,24,25,1,1153,3,7,2,2,5,single-choice,spatial-relational,2|5,7,2/5,240025,2
3,2,24,26,1,1244,1,13,6,6,7,single-choice,spatial-relational,6|7,7,6/7,240026,6
3,2,24,27,1,1416,4,10,3,3,7,single-choice,spatial-relational,3|7,7,3/7,240027,3
3,2,24,28,1,1547,5,7,1,1,6,single-choice,spatial-relational,1|6,7,1/6,240028,1
3,2,24,29,1,972,2,10,4,4,6,single-choice,spatial-relational,4|6,7,4/6,240029,4
3,2,24,30,1,216,1,7,3,3,4,single-choice,spatial-relational,3|4,7,3/4,240030,3
3,2,24,31,0,105,1,5,2,3,3,single-choice,spatial-relational,2|3,7,2/3,240031,2
3,2,24,32,1,1274,2,10,4,4,6,single-choice,spatial-relational,4|6,7,4/6,240032,4
3,2,24,33,1,1170,3,7,2,2,5,single-choice,spatial-relational,2|5,7,2/5,240033,2
3,2,24,34,0,153,4,6,1,5,5,single-choice,spatial-relational,1|5,7,1/5,240034,1
3,2,24,35,1,1278,1,9,4,4,5,single-choice,spatial-relational,4|5,7,4/5,240035,4
3,2,24,36,1,84,2,8,3,3,5,single-choice,spatial-relational,3|5,7,3/5,240036,3
3,2,24,37,1,157,4,6,1,1,5,single-choice,spatial-relational,1|5,7,1/5,240037,1
3,2,24,38,1,1263,2,6,2,2,4,single-choice,spatial-relational,2|4,7,2/4,240038,2
3,2,24,39,1,1039,3,5,1,1,4,single-choice,spatial-relational,1|4,7,1/4,240039,1
3,2,24,40,1,1333,2,8,3,3,5,single-choice,spatial-relational,3|5,7,3/5,240040,3
3,2,24,41,1,1237,3,9,3,3,6,single-choice,spatial-relational,3|6,7,3/6,240041,3
3,2,24,42,1,1364,5,9,2,2,7,single-choice,spatial-relational,2|7,7,2/7,240042,2
3,2,24,43,1,1098,2,8,3,3,5,single-choice,spatial-relational,3|5,7,3/5,240043,3
3,2,24,44,1,2149,5,7,1,1,6,single-choice,spatial-relational,1|6,7,1/6,240044,1
3,2,24,45,1,113,4,10,3,3,7,single-choice,spatial-relational,3|7,7,3/7,240045,3
3,2,24,46,0,128,1,3,1,2,2,single-choice,spatial-relational,1|2,7,1/2,240046,1
3,2,24,47,1,970,3,9,3,3,6,single-choice,spatial-relational,3|6,7,3/6,240047,3
3,2,24,48,0,171,6,8,1,7,7,single-choice,spatial-relational,1|7,7,1/7,240048,1
3,2,24,49,1,1019,2,12,5,5,7,single-choice,spatial-relational,5|7,7,5/7,240049,5
3,2,24,50,1,1816,4,6,1,1,5,single-choice,spatial-relational,1|5,7,1/5,240050,1
3,2,24,51,0,1163,2,6,2,4,4,single-choice,spatial-relational,2|4,7,2/4,240051,2
3,2,24,52,1,1291,1,9,4,4,5,single-choice,spatial-relational,4|5,7,4/5,240052,4
3,2,24,53,1,1203,2,8,3,3,5,single-choice,spatial-relational,3|5,7,3/5,240053,3
3,2,24,54,1,912,3,11,4,4,7,single-choice,spatial-relational,4|7,7,4/7,240054,4
3,2,24,55,1,992,1,13,6,6,7,single-choice,spatial-relational,6|7,7,6/7,240055,6
3,2,24,56,1,1075,1,11,5,5,6,single-choice,spatial-relational,5|6,7,5/6,240056,5
3,2,24,57,1,987,1,7,3,3,4,single-choice,spatial-relational,3|4,7,3/4,240057,3
3,2,24,58,1,1121,2,4,1,1,3,single-choice,spatial-relational,1|3,7,1/3,240058,1
3,2,24,59,0,63,3,11,4,7,7,single-choice,spatial-relational,4|7,7,4/7,240059,4
3,2,24,60,1,852,1,7,3,3,4,single-choice,spatial-relational,3|4,7,3/4,240060,3
3,2,24,61,1,917,2,10,4,4,6,single-choice,spatial-relational,4|6,7,4/6,240061,4
3,2,24,62,1,1154,3,5,1,1,4,single-choice,spatial-relational,1|4,7,1/4,240062,1
3,2,24,63,1,952,4,6,1,1,5,single-choice,spatial-relational,1|5,7,1/5,240063,1
3,2,24,64,0,1297,1,3,1,2,2,single-choice,spatial-relational,1|2,7,1/2,240064,1
3,2,24,65,1,952,2,12,5,5,7,single-choice,spatial-relational,5|7,7,5/7,240065,5
3,2,24,66,1,110,4,8,2,2,6,single-choice,spatial-relational,2|6,7,2/6,240066,2
3,2,24,67,0,66,4,10,3,7,7,single-choice,spatial-relational,3|7,7,3/7,240067,3
3,2,24,68,0,134,2,4,1,3,3,single-choice,spatial-relational,1|3,7,1/3,240068,1
3,2,24,69,1,1187,3,7,2,2,5,single-choice,spatial-relational,2|5,7,2/5,240069,2
3,2,24,70,1,1118,3,9,3,3,6,single-choice,spatial-relational,3|6,7,3/6,240070,3
3,2,24,71,1,1009,6,8,1,1,7,single-choice,spatial-relational,1|7,7,1/7,240071,1
3,2,24,72,1,1034,1,5,2,2,3,single-choice,spatial-relational,2|3,7,2/3,240072,2
3,2,24,73,1,1225,2,6,2,2,4,single-choice,spatial-relational,2|4,7,2/4,240073,2
3,2,24,74,1,946,3,7,2,2,5,single-choice,spatial-relational,2|5,7,2/5,240074,2
3,2,24,75,1,1029,1,5,2,2,3,single-choice,spatial-relational,2|3,7,2/3,240075,2
3,2,24,76,1,1118,2,10,4,4,6,single-choice,spatial-relational,4|6,7,4/6,240076,4
3,2,24,77,0,2085,1,9,4,5,5,single-choice,spatial-relational,4|5,7,4/5,240077,4
3,2,24,78,1,919,4,8,2,2,6,single-choice,spatial-relational,2|6,7,2/6,240078,2
3,2,24,79,1,140,5,9,2,2,7,single-choice,spatial-relational,2|7,7,2/7,240079,2
3,2,24,80,1,878,5,9,2,2,7,single-choice,spatial-relational,2|7,7,2/7,240080,2
3,2,24,81,1,1218,1,11,5,5,6,single-choice,spatial-relational,5|6,7,5/6,240081,5
3,2,24,82,1,1623,5,7,1,1,6,single-choice,spatial-relational,1|6,7,1/6,240082,1
3,2,24,83,1,695,1,13,6,6,7,single-choice,spatial-relational,6|7,7,6/7,240083,6
3,2,24,84,1,1164,3,5,1,1,4,single-choice,spatial-relational,1|4,7,1/4,240084,1
3,2,24,85,1,825,2,6,2,2,4,single-choice,spatial-relational,2|4,7,2/4,240085,2
3,2,24,86,1,1299,2,4,1,1,3,single-choice,spatial-relational,1|3,7,1/3,240086,1
3,2,24,87,1,1027,2,10,4,4,6,single-choice,spatial-relational,4|6,7,4/6,240087,4
3,2,24,88,0,143,5,9,2,7,7,single-choice,spatial-relational,2|7,7,2/7,240088,2
3,2,24,89,1,1012,4,6,1,1,5,single-choice,spatial-relational,1|5,7,1/5,240089,1
3,2,24,90,1,884,3,9,3,3,6,single-choice,spatial-relational,3|6,7,3/6,240090,3
3,2,24,91,1,935,3,11,4,4,7,single-choice,spatial-relational,4|7,7,4/7,240091,4
3,2,24,92,1,173,1,5,2,2,3,single-choice,spatial-relational,2|3,7,2/3,240092,2
3,2,24,93,1,1324,6,8,1,1,7,single-choice,spatial-relational,1|7,7,1/7,240093,1
3,2,24,94,1,861,4,8,2,2,6,single-choice,spatial-relational,2|6,7,2/6,240094,2
3,2,24,95,1,892,1,11,5,5,6,single-choice,spatial-relational,5|6,7,5/6,240095,5
3,2,24,96,1,1408,3,5,1,1,4,single-choice,spatial-relational,1|4,7,1/4,240096,1
3,2,24,97,1,794,1,13,6,6,7,single-choice,spatial-relational,6|7,7,6/7,240097,6
3,2,24,98,0,1466,1,11,5,6,6,single-choice,spatial-relational,5|6,7,5/6,240098,5
3,2,24,99,1,1811,1,9,4,4,5,single-choice,spatial-relational,4|5,7,4/5,240099,4
3,2,24,100,1,967,6,8,1,1,7,single-choice,spatial-relational,1|7,7,1/7,240100,1
3,2,24,101,1,805,2,10,4,4,6,single-choice,spatial-relational,4|6,7,4/6,240101,4
3,2,24,102,1,930,3,11,4,4,7,single-choice,spatial-relational,4|7,7,4/7,240102,4
3,2,24,103,1,1069,4,6,1,1,5,single-choice,spatial-relational,1|5,7,1/5,240103,1
3,2,24,104,1,106,3,7,2,2,5,single-choice,spatial-relational,2|5,7,2/5,240104,2
3,2,24,105,1,1324,2,4,1,1,3,single-choice,spatial-relational,1|3,7,1/3,240105,1
3,2,24,106,1,729,4,10,3,3,7,single-choice,spatial-relational,3|7,7,3/7,240106,3
3,2,24,107,1,862,1,7,3,3,4,single-choice,spatial-relational,3|4,7,3/4,240107,3
3,2,24,108,1,1059,5,7,1,1,6,single-choice,spatial-relational,1|6,7,1/6,240108,1
3,2,24,109,1,1314,1,5,2,2,3,single-choice,spatial-relational,2|3,7,2/3,240109,2
3,2,24,110,1,114,1,3,1,1,2,single-choice,spatial-relational,1|2,7,1/2,240110,1
3,2,24,111,1,714,4,10,3,3,7,single-choice,spatial-relational,3|7,7,3/7,240111,3
3,2,24,112,1,1465,3,9,3,3,6,single-choice,spatial-relational,3|6,7,3/6,240112,3
3,2,24,113,0,962,2,8,3,5,5,single-choice,spatial-relational,3|5,7,3/5,240113,3
3,2,24,114,1,1146,1,3,1,1,2,single-choice,spatial-relational,1|2,7,1/2,240114,1
3,2,24,115,1,886,5,9,2,2,7,single-choice,spatial-relational,2|7,7,2/7,240115,2
3,2,24,116,1,1258,3,7,2,2,5,single-choice,spatial-relational,2|5,7,2/5,240116,2
3,2,24,117,1,863,2,8,3,3,5,single-choice,spatial-relational,3|5,7,3/5,240117,3
3,2,24,118,1,925,2,12,5,5,7,single-choice,spatial-relational,5|7,7,5/7,240118,5
3,2,24,119,1,1077,1,9,4,4,5,single-choice,spatial-relational,4|5,7,4/5,240119,4
3,2,24,120,1,921,2,12,5,5,7,single-choice,spatial-relational,5|7,7,5/7,240120,5
3,2,24,121,0,132,2,6,2,4,4,single-choice,spatial-relational,2|4,7,2/4,240121,2
3,2,24,122,1,962,3,5,1,1,4,single-choice,spatial-relational,1|4,7,1/4,240122,1
3,2,24,123,1,871,1,13,6,6,7,single-choice,spatial-relational,6|7,7,6/7,240123,6
3,2,24,124,1,162,4,8,2,2,6,single-choice,spatial-relational,2|6,7,2/6,240124,2
3,2,24,125,1,1143,1,7,3,3,4,single-choice,spatial-relational,3|4,7,3/4,240125,3
3,2,24,126,1,1078,5,7,1,1,6,single-choice,spatial-relational,1|6,7,1/6,240126,1
3,2,24,127,1,867,1,5,2,2,3,single-choice,spatial-relational,2|3,7,2/3,240127,2
3,2,24,128,1,1375,2,10,4,4,6,single-choice,spatial-relational,4|6,7,4/6,240128,4
3,2,24,129,1,922,6,8,1,1,7,single-choice,spatial-relational,1|7,7,1/7,240129,1
3,2,24,130,1,765,2,12,5,5,7,single-choice,spatial-relational,5|7,7,5/7,240130,5
3,2,24,131,1,1027,2,8,3,3,5,single-choice,spatial-relational,3|5,7,3/5,240131,3
3,2,24,132,1,860,1,7,3,3,4,single-choice,spatial-relational,3|4,7,3/4,240132,3
3,2,24,133,0,77,5,9,2,7,7,single-choice,spatial-relational,2|7,7,2/7,240133,2
3,2,24,134,1,868,1,13,6,6,7,single-choice,spatial-relational,6|7,7,6/7,240134,6
3,2,24,135,0,66,1,9,4,5,5,single-choice,spatial-relational,4|5,7,4/5,240135,4
3,2,24,136,1,1010,1,5,2,2,3,single-choice,spatial-relational,2|3,7,2/3,240136,2
3,2,24,137,0,900,1,3,1,2,2,single-choice,spatial-relational,1|2,7,1/2,240137,1
3,2,24,138,1,935,5,7,1,1,6,single-choice,spatial-relational,1|6,7,1/6,240138,1
3,2,24,139,1,932,6,8,1,1,7,single-choice,spatial-relational,1|7,7,1/7,240139,1
3,2,24,140,1,1040,3,7,2,2,5,single-choice,spatial-relational,2|5,7,2/5,240140,2
3,2,24,141,1,148,3,9,3,3,6,single-choice,spatial-relational,3|6,7,3/6,240141,3
3,2,24,142,0,94,4,8,2,6,6,single-choice,spatial-relational,2|6,7,2/6,240142,2
3,2,24,143,1,980,2,6,2,2,4,single-choice,spatial-relational,2|4,7,2/4,240143,2
3,2,24,144,1,836,4,10,3,3,7,single-choice,spatial-relational,3|7,7,3/7,240144,3
3,2,24,145,1,960,2,4,1,1,3,single-choice,spatial-relational,1|3,7,1/3,240145,1
3,2,24,146,1,156,4,6,1,1,5,single-choice,spatial-relational,1|5,7,1/5,240146,1
3,2,24,147,1,797,3,11,4,4,7,single-choice,spatial-relational,4|7,7,4/7,240147,4
3,2,24,148,1,1126,3,5,1,1,4,single-choice,spatial-relational,1|4,7,1/4,240148,1
3,2,24,149,1,868,1,11,5,5,6,single-choice,spatial-relational,5|6,7,5/6,240149,5
3,2,24,150,1,1097,1,13,6,6,7,single-choice,spatial-relational,6|7,7,6/7,240150,6
3,2,24,151,1,1758,4,6,1,1,5,single-choice,spatial-relational,1|5,7,1/5,240151,1
3,2,24,152,1,975,1,11,5,5,6,single-choice,spatial-relational,5|6,7,5/6,240152,5
3,2,24,153,1,1039,2,8,3,3,5,single-choice,spatial-relational,3|5,7,3/5,240153,3
3,2,24,154,1,141,3,11,4,4,7,single-choice,spatial-relational,4|7,7,4/7,240154,4
3,2,24,155,0,115,4,10,3,7,7,single-choice,spatial-relational,3|7,7,3/7,240155,3
3,2,24,156,1,921,1,9,4,4,5,single-choice,spatial-relational,4|5,7,4/5,240156,4
3,2,24,157,1,962,2,12,5,5,7,single-choice,spatial-relational,5|7,7,5/7,240157,5
3,2,24,158,1,1448,3,5,1,1,4,single-choice,spatial-relational,1|4,7,1/4,240158,1
3,2,24,159,1,120,2,10,4,4,6,single-choice,spatial-relational,4|6,7,4/6,240159,4
3,2,24,160,1,1061,5,7,1,1,6,single-choice,spatial-relational,1|6,7,1/6,240160,1
3,2,24,161,1,105,2,4,1,1,3,single-choice,spatial-relational,1|3,7,1/3,240161,1
3,2,24,162,1,96,5,9,2,2,7,single-choice,spatial-relational,2|7,7,2/7,240162,2
3,2,24,163,1,840,2,6,2,2,4,single-choice,spatial-relational,2|4,7,2/4,240163,2
3,2,24,164,1,1038,1,3,1,1,2,single-choice,spatial-relational,1|2,7,1/2,240164,1
3,2,24,165,1,1249,3,7,2,2,5,single-choice,spatial-relational,2|5,7,2/5,240165,2
3,2,24,166,1,943,3,9,3,3,6,single-choice,spatial-relational,3|6,7,3/6,240166,3
3,2,24,167,0,64,1,7,3,4,4,single-choice,spatial-relational,3|4,7,3/4,240167,3
3,2,24,168,1,800,4,8,2,2,6,single-choice,spatial-relational,2|6,7,2/6,240168,2
3,2,24,169,1,1259,3,7,2,2,5,single-choice,spatial-relational,2|5,7,2/5,240169,2
3,2,24,170,1,779,4,10,3,3,7,single-choice,spatial-relational,3|7,7,3/7,240170,3
3,2,24,171,1,992,2,12,5,5,7,single-choice,spatial-relational,5|7,7,5/7,240171,5
3,2,24,172,1,1319,5,7,1,1,6,single-choice,spatial-relational,1|6,7,1/6,240172,1
3,2,24,173,1,800,3,9,3,3,6,single-choice,spatial-relational,3|6,7,3/6,240173,3
3,2,24,174,1,1159,6,8,1,1,7,single-choice,spatial-relational,1|7,7,1/7,240174,1
3,2,24,175,1,1648,2,4,1,1,3,single-choice,spatial-relational,1|3,7,1/3,240175,1
3,2,24,176,1,940,4,6,1,1,5,single-choice,spatial-relational,1|5,7,1/5,240176,1
3,2,24,177,1,808,1,9,4,4,5,single-choice,spatial-relational,4|5,7,4/5,240177,4
3,2,24,178,1,1033,3,11,4,4,7,single-choice,spatial-relational,4|7,7,4/7,240178,4
3,2,24,179,1,1007,3,5,1,1,4,single-choice,spatial-relational,1|4,7,1/4,240179,1
3,2,24,180,1,657,3,11,4,4,7,single-choice,spatial-relational,4|7,7,4/7,240180,4
3,2,24,181,1,1178,2,4,1,1,3,single-choice,spatial-relational,1|3,7,1/3,240181,1
3,2,24,182,1,1064,1,7,3,3,4,single-choice,spatial-relational,3|4,7,3/4,240182,3
3,2,24,183,1,1260,2,6,2,2,4,single-choice,spatial-relational,2|4,7,2/4,240183,2
3,2,24,184,1,926,1,11,5,5,6,single-choice,spatial-relational,5|6,7,5/6,240184,5
3,2,24,185,1,1860,2,10,4,4,6,single-choice,spatial-relational,4|6,7,4/6,240185,4
3,2,24,186,1,745,1,7,3,3,4,single-choice,spatial-relational,3|4,7,3/4,240186,3
3,2,24,187,1,1012,1,9,4,4,5,single-choice,spatial-relational,4|5,7,4/5,240187,4
3,2,24,188,1,1028,2,6,2,2,4,single-choice,spatial-relational,2|4,7,2/4,240188,2
3,2,24,189,1,1181,6,8,1,1,7,single-choice,spatial-relational,1|7,7,1/7,240189,1
3,2,24,190,1,727,2,12,5,5,7,single-choice,spatial-relational,5|7,7,5/7,240190,5
3,2,24,191,1,863,4,10,3,3,7,single-choice,spatial-relational,3|7,7,3/7,240191,3
3,2,24,192,1,46,1,11,5,5,6,single-choice,spatial-relational,5|6,7,5/6,240192,5
3,2,24,193,1,1006,4,8,2,2,6,single-choice,spatial-relational,2|6,7,2/6,240193,2
3,2,24,194,1,1143,3,5,1,1,4,single-choice,spatial-relational,1|4,7,1/4,240194,1
3,2,24,195,0,689,2,8,3,5,5,single-choice,spatial-relational,3|5,7,3/5,240195,3
3,2,24,196,1,956,1,3,1,1,2,single-choice,spatial-relational,1|2,7,1/2,240196,1
3,2,24,197,0,150,3,9,3,6,6,single-choice,spatial-relational,3|6,7,3/6,240197,3
3,2,24,198,1,1037,4,6,1,1,5,single-choice,spatial-relational,1|5,7,1/5,240198,1
3,2,24,199,1,1301,1,13,6,6,7,single-choice,spatial-relational,6|7,7,6/7,240199,6
3,2,24,200,0,131,2,10,4,6,6,single-choice,spatial-relational,4|6,7,4/6,240200,4
3,2,24,201,1,1305,5,7,1,1,6,single-choice,spatial-relational,1|6,7,1/6,240201,1
3,2,24,202,1,101,1,5,2,2,3,single-choice,spatial-relational,2|3,7,2/3,240202,2
3,2,24,203,1,1274,2,8,3,3,5,single-choice,spatial-relational,3|5,7,3/5,240203,3
3,2,24,204,1,964,5,9,2,2,7,single-choice,spatial-relational,2|7,7,2/7,240204,2
3,2,24,205,1,959,1,13,6,6,7,single-choice,spatial-relational,6|7,7,6/7,240205,6
3,2,24,206,1,946,1,5,2,2,3,single-choice,spatial-relational,2|3,7,2/3,240206,2
3,2,24,207,1,893,4,8,2,2,6,single-choice,spatial-relational,2|6,7,2/6,240207,2
3,2,24,208,1,1090,3,7,2,2,5,single-choice,spatial-relational,2|5,7,2/5,240208,2
3,2,24,209,1,1033,5,9,2,2,7,single-choice,spatial-relational,2|7,7,2/7,240209,2
3,2,24,210,1,1287,1,3,1,1,2,single-choice,spatial-relational,1|2,7,1/2,240210,1
3,2,24,211,0,1600,3,5,1,4,4,single-choice,spatial-relational,1|4,7,1/4,240211,1
3,2,24,212,1,799,2,6,2,2,4,single-choice,spatial-relational,2|4,7,2/4,240212,2
3,2,24,213,1,875,4,6,1,1,5,single-choice,spatial-relational,1|5,7,1/5,240213,1
3,2,24,214,1,179,4,8,2,2,6,single-choice,spatial-relational,2|6,7,2/6,240214,2
3,2,24,215,0,143,4,10,3,7,7,single-choice,spatial-relational,3|7,7,3/7,240215,3
3,2,24,216,1,860,3,9,3,3,6,single-choice,spatial-relational,3|6,7,3/6,240216,3
3,2,24,217,0,103,6,8,1,7,7,single-choice,spatial-relational,1|7,7,1/7,240217,1
3,2,24,218,1,1431,1,5,2,2,3,single-choice,spatial-relational,2|3,7,2/3,240218,2
3,2,24,219,1,915,6,8,1,1,7,single-choice,spatial-relational,1|7,7,1/7,240219,1
3,2,24,220,1,1217,2,10,4,4,6,single-choice,spatial-relational,4|6,7,4/6,240220,4
3,2,24,221,1,803,3,11,4,4,7,single-choice,spatial-relational,4|7,7,4/7,240221,4
3,2,24,222,1,1060,3,9,3,3,6,single-choice,spatial-relational,3|6,7,3/6,240222,3
3,2,24,223,1,893,1,9,4,4,5,single-choice,spatial-relational,4|5,7,4/5,240223,4
3,2,24,224,1,1219,5,9,2,2,7,single-choice,spatial-relational,2|7,7,2/7,240224,2
3,2,24,225,1,923,2,4,1,1,3,single-choice,spatial-relational,1|3,7,1/3,240225,1
3,2,24,226,1,821,3,11,4,4,7,single-choice,spatial-relational,4|7,7,4/7,240226,4
3,2,24,227,1,1273,1,7,3,3,4,single-choice,spatial-relational,3|4,7,3/4,240227,3
3,2,24,228,1,1109,1,3,1,1,2,single-choice,spatial-relational,1|2,7,1/2,240228,1
3,2,24,229,1,1234,1,11,5,5,6,single-choice,spatial-relational,5|6,7,5/6,240229,5
3,2,24,230,1,800,1,13,6,6,7,single-choice,spatial-relational,6|7,7,6/7,240230,6
3,2,24,231,1,1019,1,13,6,6,7,single-choice,spatial-relational,6|7,7,6/7,240231,6
3,2,24,232,1,813,5,9,2,2,7,single-choice,spatial-relational,2|7,7,2/7,240232,2
3,2,24,233,1,918,2,8,3,3,5,single-choice,spatial-relational,3|5,7,3/5,240233,3
3,2,24,234,1,1094,2,6,2,2,4,single-choice,spatial-relational,2|4,7,2/4,240234,2
3,2,24,235,1,1039,1,9,4,4,5,single-choice,spatial-relational,4|5,7,4/5,240235,4
3,2,24,236,1,1293,3,7,2,2,5,single-choice,spatial-relational,2|5,7,2/5,240236,2
3,2,24,237,1,893,5,7,1,1,6,single-choice,spatial-relational,1|6,7,1/6,240237,1
3,2,24,238,1,1062,2,4,1,1,3,single-choice,spatial-relational,1|3,7,1/3,240238,1
3,2,24,239,1,1062,1,11,5,5,6,single-choice,spatial-relational,5|6,7,5/6,240239,5
3,2,24,240,1,879,1,7,3,3,4,single-choice,spatial-relational,3|4,7,3/4,240240,3
3,2,24,241,1,1065,1,3,1,1,2,single-choice,spatial-relational,1|2,7,1/2,240241,1
3,2,24,242,1,1126,1,5,2,2,3,single-choice,spatial-relational,2|3,7,2/3,240242,2
3,2,24,243,1,994,4,6,1,1,5,single-choice,spatial-relational,1|5,7,1/5,240243,1
3,2,24,244,1,1093,4,10,3,3,7,single-choice,spatial-relational,3|7,7,3/7,240244,3
3,2,24,245,1,1153,3,5,1,1,4,single-choice,spatial-relational,1|4,7,1/4,240245,1
3,2,24,246,1,1041,5,7,1,1,6,single-choice,spatial-relational,1|6,7,1/6,240246,1
3,2,24,247,0,130,4,8,2,6,6,single-choice,spatial-relational,2|6,7,2/6,240247,2
3,2,24,248,1,774,2,10,4,4,6,single-choice,spatial-relational,4|6,7,4/6,240248,4
3,2,24,249,1,891,2,12,5,5,7,single-choice,spatial-relational,5|7,7,5/7,240249,5
3,2,24,250,1,1062,2,8,3,3,5,single-choice,spatial-relational,3|5,7,3/5,240250,3
3,2,24,251,1,1012,3,7,2,2,5,single-choice,spatial-relational,2|5,7,2/5,240251,2
3,2,24,252,1,890,2,12,5,5,7,single-choice,spatial-relational,5|7,7,5/7,240252,5
3,2,24,253,1,984,1,9,4,4,5,single-choice,spatial-relational,4|5,7,4/5,240253,4
3,2,24,254,1,1216,2,4,1,1,3,single-choice,spatial-relational,1|3,7,1/3,240254,1
3,2,24,255,1,1080,2,6,2,2,4,single-choice,spatial-relational,2|4,7,2/4,240255,2
3,2,24,256,1,1122,5,7,1,1,6,single-choice,spatial-relational,1|6,7,1/6,240256,1
3,2,24,257,1,678,3,11,4,4,7,single-choice,spatial-relational,4|7,7,4/7,240257,4
3,2,24,258,1,953,1,11,5,5,6,single-choice,spatial-relational,5|6,7,5/6,240258,5
3,2,24,259,0,89,3,7,2,5,5,single-choice,spatial-relational,2|5,7,2/5,240259,2
3,2,24,260,1,846,5,9,2,2,7,single-choice,spatial-relational,2|7,7,2/7,240260,2
3,2,24,261,1,997,1,5,2,2,3,single-choice,spatial-relational,2|3,7,2/3,240261,2
3,2,24,262,1,1130,2,4,1,1,3,single-choice,spatial-relational,1|3,7,1/3,240262,1
3,2,24,263,1,802,1,7,3,3,4,single-choice,spatial-relational,3|4,7,3/4,240263,3
3,2,24,264,1,930,6,8,1,1,7,single-choice,spatial-relational,1|7,7,1/7,240264,1
3,2,24,265,0,886,2,10,4,6,6,single-choice,spatial-relational,4|6,7,4/6,240265,4
3,2,24,266,1,914,2,8,3,3,5,single-choice,spatial-relational,3|5,7,3/5,240266,3
3,2,24,267,1,1121,3,5,1,1,4,single-choice,spatial-relational,1|4,7,1/4,240267,1
3,2,24,268,1,971,4,6,1,1,5,single-choice,spatial-relational,1|5,7,1/5,240268,1
3,2,24,269,1,803,4,10,3,3,7,single-choice,spatial-relational,3|7,7,3/7,240269,3
3,2,24,270,1,1294,2,8,3,3,5,single-choice,spatial-relational,3|5,7,3/5,240270,3
3,2,24,271,1,115,6,8,1,1,7,single-choice,spatial-relational,1|7,7,1/7,240271,1
3,2,24,272,1,116,1,13,6,6,7,single-choice,spatial-relational,6|7,7,6/7,240272,6
3,2,24,273,1,901,3,9,3,3,6,single-choice,spatial-relational,3|6,7,3/6,240273,3
3,2,24,274,1,1183,1,13,6,6,7,single-choice,spatial-relational,6|7,7,6/7,240274,6
3,2,24,275,1,1305,1,3,1,1,2,single-choice,spatial-relational,1|2,7,1/2,240275,1
3,2,24,276,1,921,4,8,2,2,6,single-choice,spatial-relational,2|6,7,2/6,240276,2
3,2,24,277,1,1059,4,10,3,3,7,single-choice,spatial-relational,3|7,7,3/7,240277,3
3,2,24,278,1,749,1,11,5,5,6,single-choice,spatial-relational,5|6,7,5/6,240278,5
3,2,24,279,1,1464,3,5,1,1,4,single-choice,spatial-relational,1|4,7,1/4,240279,1
3,2,24,280,1,916,2,12,5,5,7,single-choice,spatial-relational,5|7,7,5/7,240280,5
3,2,24,281,0,79,1,5,2,3,3,single-choice,spatial-relational,2|3,7,2/3,240281,2
3,2,24,282,1,1516,4,6,1,1,5,single-choice,spatial-relational,1|5,7,1/5,240282,1
3,2,24,283,0,37,5,7,1,6,6,single-choice,spatial-relational,1|6,7,1/6,240283,1
3,2,24,284,1,904,5,9,2,2,7,single-choice,spatial-relational,2|7,7,2/7,240284,2
3,2,24,285,1,807,1,9,4,4,5,single-choice,spatial-relational,4|5,7,4/5,240285,4
3,2,24,286,1,907,1,7,3,3,4,single-choice,spatial-relational,3|4,7,3/4,240286,3
3,2,24,287,1,1048,3,11,4,4,7,single-choice,spatial-relational,4|7,7,4/7,240287,4
3,2,24,288,1,1252,3,7,2,2,5,single-choice,spatial-relational,2|5,7,2/5,240288,2
3,2,24,289,1,773,2,12,5,5,7,single-choice,spatial-relational,5|7,7,5/7,240289,5
3,2,24,290,1,1549,4,8,2,2,6,single-choice,spatial-relational,2|6,7,2/6,240290,2
3,2,24,291,1,867,2,10,4,4,6,single-choice,spatial-relational,4|6,7,4/6,240291,4
3,2,24,292,1,1015,2,6,2,2,4,single-choice,spatial-relational,2|4,7,2/4,240292,2
3,2,24,293,1,889,3,9,3,3,6,single-choice,spatial-relational,3|6,7,3/6,240293,3
3,2,24,294,1,1160,1,3,1,1,2,single-choice,spatial-relational,1|2,7,1/2,240294,1
3,2,24,295,0,102,4,8,2,6,6,single-choice,spatial-relational,2|6,7,2/6,240295,2
3,2,24,296,1,755,2,10,4,4,6,single-choice,spatial-relational,4|6,7,4/6,240296,4
3,2,24,297,1,968,1,11,5,5,6,single-choice,spatial-relational,5|6,7,5/6,240297,5
3,2,24,298,1,859,1,7,3,3,4,single-choice,spatial-relational,3|4,7,3/4,240298,3
3,2,24,299,0,122,1,5,2,3,3,single-choice,spatial-relational,2|3,7,2/3,240299,2
3,2,24,300,1,865,4,10,3,3,7,single-choice,spatial-relational,3|7,7,3/7,240300,3
3,2,24,301,1,911,1,7,3,3,4,single-choice,spatial-relational,3|4,7,3/4,240301,3
3,2,24,302,1,1068,1,5,2,2,3,single-choice,spatial-relational,2|3,7,2/3,240302,2
3,2,24,303,1,1131,1,11,5,5,6,single-choice,spatial-relational,5|6,7,5/6,240303,5
3,2,24,304,1,1100,2,8,3,3,5,single-choice,spatial-relational,3|5,7,3/5,240304,3
3,2,24,305,1,1037,1,13,6,6,7,single-choice,spatial-relational,6|7,7,6/7,240305,6
3,2,24,306,1,1086,3,9,3,3,6,single-choice,spatial-relational,3|6,7,3/6,240306,3
3,2,24,307,0,1246,2,8,3,5,5,single-choice,spatial-relational,3|5,7,3/5,240307,3
3,2,24,308,1,1130,4,6,1,1,5,single-choice,spatial-relational,1|5,7,1/5,240308,1
3,2,24,309,1,1180,2,6,2,2,4,single-choice,spatial-relational,2|4,7,2/4,240309,2
3,2,24,310,1,982,1,9,4,4,5,single-choice,spatial-relational,4|5,7,4/5,240310,4
3,2,24,311,1,1142,1,13,6,6,7,single-choice,spatial-relational,6|7,7,6/7,240311,6
3,2,24,312,1,1048,5,7,1,1,6,single-choice,spatial-relational,1|6,7,1/6,240312,1
3,2,24,313,1,1149,2,4,1,1,3,single-choice,spatial-relational,1|3,7,1/3,240313,1
3,2,24,314,1,1091,1,3,1,1,2,single-choice,spatial-relational,1|2,7,1/2,240314,1
3,2,24,315,1,1063,2,6,2,2,4,single-choice,spatial-relational,2|4,7,2/4,240315,2
3,2,24,316,1,992,3,5,1,1,4,single-choice,spatial-relational,1|4,7,1/4,240316,1
3,2,24,317,1,995,5,7,1,1,6,single-choice,spatial-relational,1|6,7,1/6,240317,1
3,2,24,318,1,844,3,9,3,3,6,single-choice,spatial-relational,3|6,7,3/6,240318,3
3,2,24,319,1,1234,3,7,2,2,5,single-choice,spatial-relational,2|5,7,2/5,240319,2
3,2,24,320,1,1021,2,10,4,4,6,single-choice,spatial-relational,4|6,7,4/6,240320,4
3,2,24,321,1,1168,4,8,2,2,6,single-choice,spatial-relational,2|6,7,2/6,240321,2
3,2,24,322,0,1571,3,7,2,5,5,single-choice,spatial-relational,2|5,7,2/5,240322,2
3,2,24,323,1,724,4,10,3,3,7,single-choice,spatial-relational,3|7,7,3/7,240323,3
3,2,24,324,1,89,4,6,1,1,5,single-choice,spatial-relational,1|5,7,1/5,240324,1
3,2,24,325,0,71,5,9,2,7,7,single-choice,spatial-relational,2|7,7,2/7,240325,2
3,2,24,326,1,858,6,8,1,1,7,single-choice,spatial-relational,1|7,7,1/7,240326,1
3,2,24,327,0,114,2,12,5,7,7,single-choice,spatial-relational,5|7,7,5/7,240327,5
3,2,24,328,1,1059,2,12,5,5,7,single-choice,spatial-relational,5|7,7,5/7,240328,5
3,2,24,329,1,974,3,11,4,4,7,single-choice,spatial-relational,4|7,7,4/7,240329,4
3,2,24,330,1,1197,1,3,1,1,2,single-choice,spatial-relational,1|2,7,1/2,240330,1
3,2,24,331,1,1266,2,4,1,1,3,single-choice,spatial-relational,1|3,7,1/3,240331,1
3,2,24,332,1,798,6,8,1,1,7,single-choice,spatial-relational,1|7,7,1/7,240332,1
3,2,24,333,1,758,1,9,4,4,5,single-choice,spatial-relational,4|5,7,4/5,240333,4
3,2,24,334,1,1120,3,5,1,1,4,single-choice,spatial-relational,1|4,7,1/4,240334,1
3,2,24,335,1,33,3,11,4,4,7,single-choice,spatial-relational,4|7,7,4/7,240335,4
3,2,24,336,0,1472,5,9,2,7,7,single-choice,spatial-relational,2|7,7,2/7,240336,2
3,2,24,337,1,792,3,11,4,4,7,single-choice,spatial-relational,4|7,7,4/7,240337,4
3,2,24,338,1,1071,4,6,1,1,5,single-choice,spatial-relational,1|5,7,1/5,240338,1
3,2,24,339,1,921,5,7,1,1,6,single-choice,spatial-relational,1|6,7,1/6,240339,1
3,2,24,340,0,742,2,4,1,3,3,single-choice,spatial-relational,1|3,7,1/3,240340,1
3,2,24,341,1,1147,2,8,3,3,5,single-choice,spatial-relational,3|5,7,3/5,240341,3
3,2,24,342,1,959,1,7,3,3,4,single-choice,spatial-relational,3|4,7,3/4,240342,3
3,2,24,343,1,900,5,7,1,1,6,single-choice,spatial-relational,1|6,7,1/6,240343,1
3,2,24,344,1,885,2,12,5,5,7,single-choice,spatial-relational,5|7,7,5/7,240344,5
3,2,24,345,1,1096,4,8,2,2,6,single-choice,spatial-relational,2|6,7,2/6,240345,2
3,2,24,346,1,849,5,9,2,2,7,single-choice,spatial-relational,2|7,7,2/7,240346,2
3,2,24,347,1,1450,3,7,2,2,5,single-choice,spatial-relational,2|5,7,2/5,240347,2
3,2,24,348,1,916,1,7,3,3,4,single-choice,spatial-relational,3|4,7,3/4,240348,3
3,2,24,349,1,961,4,10,3,3,7,single-choice,spatial-relational,3|7,7,3/7,240349,3
3,2,24,350,1,774,1,13,6,6,7,single-choice,spatial-relational,6|7,7,6/7,240350,6
3,2,24,351,1,896,1,9,4,4,5,single-choice,spatial-relational,4|5,7,4/5,240351,4
3,2,24,352,1,1810,3,7,2,2,5,single-choice,spatial-relational,2|5,7,2/5,240352,2
3,2,24,353,1,1195,2,10,4,4,6,single-choice,spatial-relational,4|6,7,4/6,240353,4
3,2,24,354,1,1131,2,10,4,4,6,single-choice,spatial-relational,4|6,7,4/6,240354,4
3,2,24,355,1,1060,6,8,1,1,7,single-choice,spatial-relational,1|7,7,1/7,240355,1
3,2,24,356,1,1751,1,5,2,2,3,single-choice,spatial-relational,2|3,7,2/3,240356,2
3,2,24,357,1,1410,1,9,4,4,5,single-choice,spatial-relational,4|5,7,4/5,240357,4
3,2,24,358,1,1031,2,4,1,1,3,single-choice,spatial-relational,1|3,7,1/3,240358,1
3,2,24,359,1,813,1,11,5,5,6,single-choice,spatial-relational,5|6,7,5/6,240359,5
3,2,24,360,1,1124,3,5,1,1,4,single-choice,spatial-relational,1|4,7,1/4,240360,1
3,2,24,361,1,73,2,6,2,2,4,single-choice,spatial-relational,2|4,7,2/4,240361,2
3,2,24,362,1,893,1,11,5,5,6,single-choice,spatial-relational,5|6,7,5/6,240362,5
3,2,24,363,1,1048,2,12,5,5,7,single-choice,spatial-relational,5|7,7,5/7,240363,5
3,2,24,364,0,972,1,3,1,2,2,single-choice,spatial-relational,1|2,7,1/2,240364,1
3,2,24,365,1,899,3,5,1,1,4,single-choice,spatial-relational,1|4,7,1/4,240365,1
3,2,24,366,1,955,1,5,2,2,3,single-choice,spatial-relational,2|3,7,2/3,240366,2
3,2,24,367,1,1060,2,8,3,3,5,single-choice,spatial-relational,3|5,7,3/5,240367,3
3,2,24,368,1,115,3,9,3,3,6,single-choice,spatial-relational,3|6,7,3/6,240368,3
3,2,24,369,1,77,1,3,1,1,2,single-choice,spatial-relational,1|2,7,1/2,240369,1
3,2,24,370,1,943,3,11,4,4,7,single-choice,spatial-relational,4|7,7,4/7,240370,4
3,2,24,371,1,802,4,10,3,3,7,single-choice,spatial-relational,3|7,7,3/7,240371,3
3,2,24,372,1,1111,3,9,3,3,6,single-choice,spatial-relational,3|6,7,3/6,240372,3
3,2,24,373,1,1018,4,6,1,1,5,single-choice,spatial-relational,1|5,7,1/5,240373,1
3,2,24,374,1,871,1,13,6,6,7,single-choice,spatial-relational,6|7,7,6/7,240374,6
3,2,24,375,1,1171,5,9,2,2,7,single-choice,spatial-relational,2|7,7,2/7,240375,2
3,2,24,376,1,864,2,6,2,2,4,single-choice,spatial-relational,2|4,7,2/4,240376,2
3,2,24,377,1,964,4,8,2,2,6,single-choice,spatial-relational,2|6,7,2/6,240377,2
3,2,24,378,1,1083,6,8,1,1,7,single-choice,spatial-relational,1|7,7,1/7,240378,1
3,2,24,379,1,1353,2,8,3,3,5,single-choice,spatial-relational,3|5,7,3/5,240379,3
3,2,24,380,1,1330,2,10,4,4,6,single-choice,spatial-relational,4|6,7,4/6,240380,4
3,2,24,381,1,1090,1,7,3,3,4,single-choice,spatial-relational,3|4,7,3/4,240381,3
3,2,24,382,1,76,2,10,4,4,6,single-choice,spatial-relational,4|6,7,4/6,240382,4
3,2,24,383,1,758,1,9,4,4,5,single-choice,spatial-relational,4|5,7,4/5,240383,4
3,2,24,384,0,1541,2,6,2,4,4,single-choice,spatial-relational,2|4,7,2/4,240384,2
3,2,24,385,1,819,5,7,1,1,6,single-choice,spatial-relational,1|6,7,1/6,240385,1
3,2,24,386,0,24,1,3,1,2,2,single-choice,spatial-relational,1|2,7,1/2,240386,1
3,2,24,387,1,859,2,12,5,5,7,single-choice,spatial-relational,5|7,7,5/7,240387,5
3,2,24,388,1,970,2,12,5,5,7,single-choice,spatial-relational,5|7,7,5/7,240388,5
3,2,24,389,1,1196,1,3,1,1,2,single-choice,spatial-relational,1|2,7,1/2,240389,1
3,2,24,390,0,74,3,7,2,5,5,single-choice,spatial-relational,2|5,7,2/5,240390,2
3,2,24,391,1,937,4,8,2,2,6,single-choice,spatial-relational,2|6,7,2/6,240391,2
3,2,24,392,1,816,3,11,4,4,7,single-choice,spatial-relational,4|7,7,4/7,240392,4
3,2,24,393,1,1079,2,4,1,1,3,single-choice,spatial-relational,1|3,7,1/3,240393,1
3,2,24,394,0,838,1,9,4,5,5,single-choice,spatial-relational,4|5,7,4/5,240394,4
3,2,24,395,1,1018,2,4,1,1,3,single-choice,spatial-relational,1|3,7,1/3,240395,1
3,2,24,396,1,865,5,9,2,2,7,single-choice,spatial-relational,2|7,7,2/7,240396,2
3,2,24,397,1,1055,1,13,6,6,7,single-choice,spatial-relational,6|7,7,6/7,240397,6
3,2,24,398,1,1091,6,8,1,1,7,single-choice,spatial-relational,1|7,7,1/7,240398,1
3,2,24,399,1,804,4,10,3,3,7,single-choice,spatial-relational,3|7,7,3/7,240399,3
3,2,24,400,1,1131,1,11,5,5,6,single-choice,spatial-relational,5|6,7,5/6,240400,5
3,2,24,401,1,1532,4,6,1,1,5,single-choice,spatial-relational,1|5,7,1/5,240401,1
3,2,24,402,1,850,1,13,6,6,7,single-choice,spatial-relational,6|7,7,6/7,240402,6
3,2,24,403,1,990,2,6,2,2,4,single-choice,spatial-relational,2|4,7,2/4,240403,2
3,2,24,404,0,57,1,11,5,6,6,single-choice,spatial-relational,5|6,7,5/6,240404,5
3,2,24,405,1,960,5,9,2,2,7,single-choice,spatial-relational,2|7,7,2/7,240405,2
3,2,24,406,1,755,4,10,3,3,7,single-choice,spatial-relational,3|7,7,3/7,240406,3
3,2,24,407,1,1153,1,5,2,2,3,single-choice,spatial-relational,2|3,7,2/3,240407,2
3,2,24,408,1,825,3,9,3,3,6,single-choice,spatial-relational,3|6,7,3/6,240408,3
3,2,24,409,0,95,1,7,3,4,4,single-choice,spatial-relational,3|4,7,3/4,240409,3
3,2,24,410,1,914,2,8,3,3,5,single-choice,spatial-relational,3|5,7,3/5,240410,3
3,2,24,411,1,943,6,8,1,1,7,single-choice,spatial-relational,1|7,7,1/7,240411,1
3,2,24,412,1,1079,3,5,1,1,4,single-choice,spatial-relational,1|4,7,1/4,240412,1
3,2,24,413,1,924,4,8,2,2,6,single-choice,spatial-relational,2|6,7,2/6,240413,2
3,2,24,414,1,944,3,7,2,2,5,single-choice,spatial-relational,2|5,7,2/5,240414,2
3,2,24,415,1,1475,1,5,2,2,3,single-choice,spatial-relational,2|3,7,2/3,240415,2
3,2,24,416,0,125,3,11,4,7,7,single-choice,spatial-relational,4|7,7,4/7,240416,4
3,2,24,417,1,850,4,6,1,1,5,single-choice,spatial-relational,1|5,7,1/5,240417,1
3,2,24,418,1,935,5,7,1,1,6,single-choice,spatial-relational,1|6,7,1/6,240418,1
3,2,24,419,0,109,3,9,3,6,6,single-choice,spatial-relational,3|6,7,3/6,240419,3
3,2,24,420,1,854,3,5,1,1,4,single-choice,spatial-relational,1|4,7,1/4,240420,1
3,2,24,421,1,1072,3,7,2,2,5,single-choice,spatial-relational,2|5,7,2/5,240421,2
3,2,24,422,1,858,3,11,4,4,7,single-choice,spatial-relational,4|7,7,4/7,240422,4
3,2,24,423,1,715,1,7,3,3,4,single-choice,spatial-relational,3|4,7,3/4,240423,3
3,2,24,424,1,103,4,8,2,2,6,single-choice,spatial-relational,2|6,7,2/6,240424,2
3,2,24,425,1,915,6,8,1,1,7,single-choice,spatial-relational,1|7,7,1/7,240425,1
3,2,24,426,1,964,6,8,1,1,7,single-choice,spatial-relational,1|7,7,1/7,240426,1
3,2,24,427,0,97,2,4,1,3,3,single-choice,spatial-relational,1|3,7,1/3,240427,1
3,2,24,428,1,957,2,6,2,2,4,single-choice,spatial-relational,2|4,7,2/4,240428,2
3,2,24,429,1,1105,1,3,1,1,2,single-choice,spatial-relational,1|2,7,1/2,240429,1
3,2,24,430,1,878,1,9,4,4,5,single-choice,spatial-relational,4|5,7,4/5,240430,4
3,2,24,431,1,965,1,13,6,6,7,single-choice,spatial-relational,6|7,7,6/7,240431,6
3,2,24,432,1,1124,4,8,2,2,6,single-choice,spatial-relational,2|6,7,2/6,240432,2
3,2,24,433,1,1019,2,12,5,5,7,single-choice,spatial-relational,5|7,7,5/7,240433,5
3,2,24,434,0,2284,1,5,2,3,3,single-choice,spatial-relational,2|3,7,2/3,240434,2
3,2,24,435,1,751,3,9,3,3,6,single-choice,spatial-relational,3|6,7,3/6,240435,3
3,2,24,436,0,1016,2,8,3,5,5,single-choice,spatial-relational,3|5,7,3/5,240436,3
3,2,24,437,1,931,3,5,1,1,4,single-choice,spatial-relational,1|4,7,1/4,240437,1
3,2,24,438,0,126,4,6,1,5,5,single-choice,spatial-relational,1|5,7,1/5,240438,1
3,2,24,439,1,1009,4,10,3,3,7,single-choice,spatial-relational,3|7,7,3/7,240439,3
3,2,24,440,1,1246,1,11,5,5,6,single-choice,spatial-relational,5|6,7,5/6,240440,5
3,2,24,441,1,837,2,10,4,4,6,single-choice,spatial-relational,4|6,7,4/6,240441,4
3,2,24,442,1,81,2,6,2,2,4,single-choice,spatial-relational,2|4,7,2/4,240442,2
3,2,24,443,1,1178,3,11,4,4,7,single-choice,spatial-relational,4|7,7,4/7,240443,4
3,2,24,444,1,1180,2,10,4,4,6,single-choice,spatial-relational,4|6,7,4/6,240444,4
3,2,24,445,1,1277,1,3,1,1,2,single-choice,spatial-relational,1|2,7,1/2,240445,1
3,2,24,446,1,924,1,7,3,3,4,single-choice,spatial-relational,3|4,7,3/4,240446,3
3,2,24,447,1,1054,3,9,3,3,6,single-choice,spatial-relational,3|6,7,3/6,240447,3
3,2,24,448,1,1343,4,10,3,3,7,single-choice,spatial-relational,3|7,7,3/7,240448,3
3,2,24,449,1,1098,5,7,1,1,6,single-choice,spatial-relational,1|6,7,1/6,240449,1
3,2,24,450,1,85,4,6,1,1,5,single-choice,spatial-relational,1|5,7,1/5,240450,1
3,2,24,451,0,75,5,9,2,7,7,single-choice,spatial-relational,2|7,7,2/7,240451,2
3,2,24,452,1,1112,5,9,2,2,7,single-choice,spatial-relational,2|7,7,2/7,240452,2
3,2,24,453,1,893,5,7,1,1,6,single-choice,spatial-relational,1|6,7,1/6,240453,1
3,2,24,454,1,1534,1,13,6,6,7,single-choice,spatial-relational,6|7,7,6/7,240454,6
3,2,24,455,1,770,1,11,5,5,6,single-choice,spatial-relational,5|6,7,5/6,240455,5
3,2,24,456,1,1116,3,5,1,1,4,single-choice,spatial-relational,1|4,7,1/4,240456,1
3,2,24,457,1,70,2,4,1,1,3,single-choice,spatial-relational,1|3,7,1/3,240457,1
3,2,24,458,1,942,2,8,3,3,5,single-choice,spatial-relational,3|5,7,3/5,240458,3
3,2,24,459,1,1673,1,9,4,4,5,single-choice,spatial-relational,4|5,7,4/5,240459,4
3,2,24,460,1,1708,1,5,2,2,3,single-choice,spatial-relational,2|3,7,2/3,240460,2
3,2,24,461,1,730,2,12,5,5,7,single-choice,spatial-relational,5|7,7,5/7,240461,5
3,2,24,462,1,1106,3,7,2,2,5,single-choice,spatial-relational,2|5,7,2/5,240462,2
3,2,24,463,1,1128,6,8,1,1,7,single-choice,spatial-relational,1|7,7,1/7,240463,1
3,2,24,464,1,944,1,3,1,1,2,single-choice,spatial-relational,1|2,7,1/2,240464,1
3,2,24,465,1,768,2,8,3,3,5,single-choice,spatial-relational,3|5,7,3/5,240465,3
3,2,24,466,1,1048,2,10,4,4,6,single-choice,spatial-relational,4|6,7,4/6,240466,4
3,2,24,467,1,764,4,10,3,3,7,single-choice,spatial-relational,3|7,7,3/7,240467,3
3,2,24,468,1,1084,3,11,4,4,7,single-choice,spatial-relational,4|7,7,4/7,240468,4
3,2,24,469,0,60,3,9,3,6,6,single-choice,spatial-relational,3|6,7,3/6,240469,3
3,2,24,470,1,978,1,9,4,4,5,single-choice,spatial-relational,4|5,7,4/5,240470,4
3,2,24,471,1,1294,5,9,2,2,7,single-choice,spatial-relational,2|7,7,2/7,240471,2
3,2,24,472,1,895,3,7,2,2,5,single-choice,spatial-relational,2|5,7,2/5,240472,2
3,2,24,473,1,819,2,12,5,5,7,single-choice,spatial-relational,5|7,7,5/7,240473,5
3,2,24,474,1,1075,1,13,6,6,7,single-choice,spatial-relational,6|7,7,6/7,240474,6
3,2,24,475,1,1238,1,3,1,1,2,single-choice,spatial-relational,1|2,7,1/2,240475,1
3,2,24,476,0,80,3,11,4,7,7,single-choice,spatial-relational,4|7,7,4/7,240476,4
3,2,24,477,1,1014,1,5,2,2,3,single-choice,spatial-relational,2|3,7,2/3,240477,2
3,2,24,478,1,1284,6,8,1,1,7,single-choice,spatial-relational,1|7,7,1/7,240478,1
3,2,24,479,1,1205,1,9,4,4,5,single-choice,spatial-relational,4|5,7,4/5,240479,4
3,2,24,480,1,1106,1,13,6,6,7,single-choice,spatial-relational,6|7,7,6/7,240480,6
3,2,24,481,1,1110,4,8,2,2,6,single-choice,spatial-relational,2|6,7,2/6,240481,2
3,2,24,482,1,955,1,7,3,3,4,single-choice,spatial-relational,3|4,7,3/4,240482,3
3,2,24,483,0,110,3,5,1,4,4,single-choice,spatial-relational,1|4,7,1/4,240483,1
3,2,24,484,1,1011,3,5,1,1,4,single-choice,spatial-relational,1|4,7,1/4,240484,1
3,2,24,485,1,1031,4,6,1,1,5,single-choice,spatial-relational,1|5,7,1/5,240485,1
3,2,24,486,0,155,2,4,1,3,3,single-choice,spatial-relational,1|3,7,1/3,240486,1
3,2,24,487,1,834,4,10,3,3,7,single-choice,spatial-relational,3|7,7,3/7,240487,3
3,2,24,488,1,1152,5,9,2,2,7,single-choice,spatial-relational,2|7,7,2/7,240488,2
3,2,24,489,0,124,3,7,2,5,5,single-choice,spatial-relational,2|5,7,2/5,240489,2
3,2,24,490,1,835,1,7,3,3,4,single-choice,spatial-relational,3|4,7,3/4,240490,3
3,2,24,491,1,1813,2,8,3,3,5,single-choice,spatial-relational,3|5,7,3/5,240491,3
3,2,24,492,1,1789,1,11,5,5,6,single-choice,spatial-relational,5|6,7,5/6,240492,5
3,2,24,493,0,1067,2,6,2,4,4,single-choice,spatial-relational,2|4,7,2/4,240493,2
3,2,24,494,1,1080,2,12,5,5,7,single-choice,spatial-relational,5|7,7,5/7,240494,5
3,2,24,495,0,114,2,6,2,4,4,single-choice,spatial-relational,2|4,7,2/4,240495,2
3,2,24,496,1,876,4,8,2,2,6,single-choice,spatial-relational,2|6,7,2/6,240496,2
3,2,24,497,1,967,5,7,1,1,6,single-choice,spatial-relational,1|6,7,1/6,240497,1
3,2,24,498,1,1246,2,4,1,1,3,single-choice,spatial-relational,1|3,7,1/3,240498,1
3,2,24,499,1,827,1,11,5,5,6,single-choice,spatial-relational,5|6,7,5/6,240499,5
3,2,24,500,1,1052,3,9,3,3,6,single-choice,spatial-relational,3|6,7,3/6,240500,3
3,2,24,501,1,1649,2,10,4,4,6,single-choice,spatial-relational,4|6,7,4/6,240501,4
3,2,24,502,1,1964,5,7,1,1,6,single-choice,spatial-relational,1|6,7,1/6,240502,1
3,2,24,503,1,991,1,5,2,2,3,single-choice,spatial-relational,2|3,7,2/3,240503,2
3,2,24,504,1,1194,4,6,1,1,5,single-choice,spatial-relational,1|5,7,1/5,240504,1
3,2,24,505,1,909,2,10,4,4,6,single-choice,spatial-relational,4|6,7,4/6,240505,4
3,2,24,506,1,142,5,7,1,1,6,single-choice,spatial-relational,1|6,7,1/6,240506,1
3,2,24,507,1,803,2,8,3,3,5,single-choice,spatial-relational,3|5,7,3/5,240507,3
3,2,24,508,1,959,1,3,1,1,2,single-choice,spatial-relational,1|2,7,1/2,240508,1
3,2,24,509,0,105,2,12,5,7,7,single-choice,spatial-relational,5|7,7,5/7,240509,5
3,2,24,510,1,938,2,6,2,2,4,single-choice,spatial-relational,2|4,7,2/4,240510,2
3,2,24,511,1,1334,5,7,1,1,6,single-choice,spatial-relational,1|6,7,1/6,240511,1
3,2,24,512,1,1364,1,11,5,5,6,single-choice,spatial-relational,5|6,7,5/6,240512,5
3,2,24,513,0,1275,1,3,1,2,2,single-choice,spatial-relational,1|2,7,1/2,240513,1
3,2,24,514,1,1123,3,9,3,3,6,single-choice,spatial-relational,3|6,7,3/6,240514,3
3,2,24,515,1,954,1,11,5,5,6,single-choice,spatial-relational,5|6,7,5/6,240515,5
3,2,24,516,1,868,5,9,2,2,7,single-choice,spatial-relational,2|7,7,2/7,240516,2
3,2,24,517,0,1090,3,5,1,4,4,single-choice,spatial-relational,1|4,7,1/4,240517,1
3,2,24,518,1,760,4,10,3,3,7,single-choice,spatial-relational,3|7,7,3/7,240518,3
3,2,24,519,1,1104,3,5,1,1,4,single-choice,spatial-relational,1|4,7,1/4,240519,1
3,2,24,520,1,1088,3,7,2,2,5,single-choice,spatial-relational,2|5,7,2/5,240520,2
3,2,24,521,1,911,2,12,5,5,7,single-choice,spatial-relational,5|7,7,5/7,240521,5
3,2,24,522,1,1105,4,6,1,1,5,single-choice,spatial-relational,1|5,7,1/5,240522,1
3,2,24,523,1,1067,4,8,2,2,6,single-choice,spatial-relational,2|6,7,2/6,240523,2
3,2,24,524,1,983,3,7,2,2,5,single-choice,spatial-relational,2|5,7,2/5,240524,2
3,2,24,525,1,905,3,9,3,3,6,single-choice,spatial-relational,3|6,7,3/6,240525,3
3,2,24,526,1,1065,2,4,1,1,3,single-choice,spatial-relational,1|3,7,1/3,240526,1
3,2,24,527,1,985,1,7,3,3,4,single-choice,spatial-relational,3|4,7,3/4,240527,3
3,2,24,528,0,82,6,8,1,7,7,single-choice,spatial-relational,1|7,7,1/7,240528,1
3,2,24,529,1,1080,5,9,2,2,7,single-choice,spatial-relational,2|7,7,2/7,240529,2
3,2,24,530,1,828,3,11,4,4,7,single-choice,spatial-relational,4|7,7,4/7,240530,4
3,2,24,531,1,179,1,5,2,2,3,single-choice,spatial-relational,2|3,7,2/3,240531,2
3,2,24,532,1,1315,4,6,1,1,5,single-choice,spatial-relational,1|5,7,1/5,240532,1
3,2,24,533,1,918,1,9,4,4,5,single-choice,spatial-relational,4|5,7,4/5,240533,4
3,2,24,534,1,1243,4,10,3,3,7,single-choice,spatial-relational,3|7,7,3/7,240534,3
3,2,24,535,0,992,2,8,3,5,5,single-choice,spatial-relational,3|5,7,3/5,240535,3
3,2,24,536,1,1082,1,13,6,6,7,single-choice,spatial-relational,6|7,7,6/7,240536,6
3,2,24,537,1,79,2,4,1,1,3,single-choice,spatial-relational,1|3,7,1/3,240537,1
3,2,24,538,0,104,1,7,3,4,4,single-choice,spatial-relational,3|4,7,3/4,240538,3
3,2,24,539,1,1339,1,5,2,2,3,single-choice,spatial-relational,2|3,7,2/3,240539,2
3,2,24,540,1,863,6,8,1,1,7,single-choice,spatial-relational,1|7,7,1/7,240540,1
3,2,24,541,1,702,1,13,6,6,7,single-choice,spatial-relational,6|7,7,6/7,240541,6
3,2,24,542,1,1038,3,11,4,4,7,single-choice,spatial-relational,4|7,7,4/7,240542,4
3,2,24,543,1,1053,4,8,2,2,6,single-choice,spatial-relational,2|6,7,2/6,240543,2
3,2,24,544,1,142,2,6,2,2,4,single-choice,spatial-relational,2|4,7,2/4,240544,2
3,2,24,545,1,1214,2,10,4,4,6,single-choice,spatial-relational,4|6,7,4/6,240545,4
3,2,24,546,1,1078,1,9,4,4,5,single-choice,spatial-relational,4|5,7,4/5,240546,4
3,2,24,547,1,1271,1,7,3,3,4,single-choice,spatial-relational,3|4,7,3/4,240547,3
3,2,24,548,1,1323,3,7,2,2,5,single-choice,spatial-relational,2|5,7,2/5,240548,2
3,2,24,549,1,898,5,7,1,1,6,single-choice,spatial-relational,1|6,7,1/6,240549,1
3,2,24,550,1,1553,3,9,3,3,6,single-choice,spatial-relational,3|6,7,3/6,240550,3
3,2,24,551,1,941,2,12,5,5,7,single-choice,spatial-relational,5|7,7,5/7,240551,5
3,2,24,552,1,1150,6,8,1,1,7,single-choice,spatial-relational,1|7,7,1/7,240552,1
3,2,24,553,0,1047,5,9,2,7,7,single-choice,spatial-relational,2|7,7,2/7,240553,2
3,2,24,554,1,849,4,10,3,3,7,single-choice,spatial-relational,3|7,7,3/7,240554,3
3,2,24,555,1,120,3,9,3,3,6,single-choice,spatial-relational,3|6,7,3/6,240555,3
3,2,24,556,0,144,4,6,1,5,5,single-choice,spatial-relational,1|5,7,1/5,240556,1
3,2,24,557,1,855,1,11,5,5,6,single-choice,spatial-relational,5|6,7,5/6,240557,5
3,2,24,558,1,1510,3,5,1,1,4,single-choice,spatial-relational,1|4,7,1/4,240558,1
3,2,24,559,0,98,1,9,4,5,5,single-choice,spatial-relational,4|5,7,4/5,240559,4
3,2,24,560,1,1139,1,13,6,6,7,single-choice,spatial-relational,6|7,7,6/7,240560,6
3,2,24,561,1,956,1,13,6,6,7,single-choice,spatial-relational,6|7,7,6/7,240561,6
3,2,24,562,1,759,2,8,3,3,5,single-choice,spatial-relational,3|5,7,3/5,240562,3
3,2,24,563,1,1014,1,7,3,3,4,single-choice,spatial-relational,3|4,7,3/4,240563,3
3,2,24,564,1,1040,4,8,2,2,6,single-choice,spatial-relational,2|6,7,2/6,240564,2
3,2,24,565,1,990,2,6,2,2,4,single-choice,spatial-relational,2|4,7,2/4,240565,2
3,2,24,566,0,127,2,4,1,3,3,single-choice,spatial-relational,1|3,7,1/3,240566,1
3,2,24,567,1,1384,4,8,2,2,6,single-choice,spatial-relational,2|6,7,2/6,240567,2
3,2,24,568,0,815,2,6,2,4,4,single-choice,spatial-relational,2|4,7,2/4,240568,2
3,2,24,569,1,1242,2,10,4,4,6,single-choice,spatial-relational,4|6,7,4/6,240569,4
3,2,24,570,1,1044,2,4,1,1,3,single-choice,spatial-relational,1|3,7,1/3,240570,1
3,2,24,571,1,1136,5,7,1,1,6,single-choice,spatial-relational,1|6,7,1/6,240571,1
3,2,24,572,1,958,5,9,2,2,7,single-choice,spatial-relational,2|7,7,2/7,240572,2
3,2,24,573,1,807,2,8,3,3,5,single-choice,spatial-relational,3|5,7,3/5,240573,3
3,2,24,574,1,999,3,5,1,1,4,single-choice,spatial-relational,1|4,7,1/4,240574,1
3,2,24,575,1,812,6,8,1,1,7,single-choice,spatial-relational,1|7,7,1/7,240575,1
3,2,24,576,0,249,1,3,1,2,2,single-choice,spatial-relational,1|2,7,1/2,240576,1
3,2,24,577,1,1162,2,12,5,5,7,single-choice,spatial-relational,5|7,7,5/7,240577,5
3,2,24,578,1,1284,3,11,4,4,7,single-choice,spatial-relational,4|7,7,4/7,240578,4
3,2,24,579,1,1218,1,3,1,1,2,single-choice,spatial-relational,1|2,7,1/2,240579,1
3,2,24,580,0,780,1,9,4,5,5,single-choice,spatial-relational,4|5,7,4/5,240580,4
3,2,24,581,1,916,3,11,4,4,7,single-choice,spatial-relational,4|7,7,4/7,240581,4
3,2,24,582,1,121,4,6,1,1,5,single-choice,spatial-relational,1|5,7,1/5,240582,1
3,2,24,583,1,708,4,10,3,3,7,single-choice,spatial-relational,3|7,7,3/7,240583,3
3,2,24,584,1,988,2,10,4,4,6,single-choice,spatial-relational,4|6,7,4/6,240584,4
3,2,24,585,1,954,3,7,2,2,5,single-choice,spatial-relational,2|5,7,2/5,240585,2
3,2,24,586,1,871,1,5,2,2,3,single-choice,spatial-relational,2|3,7,2/3,240586,2
3,2,24,587,1,1031,1,5,2,2,3,single-choice,spatial-relational,2|3,7,2/3,240587,2
3,2,24,588,1,1330,1,11,5,5,6,single-choice,spatial-relational,5|6,7,5/6,240588,5
3,2,24,589,1,1293,5,7,1,1,6,single-choice,spatial-relational,1|6,7,1/6,240589,1
3,2,24,590,1,1024,2,6,2,2,4,single-choice,spatial-relational,2|4,7,2/4,240590,2
3,2,24,591,1,884,2,10,4,4,6,single-choice,spatial-relational,4|6,7,4/6,240591,4
3,2,24,592,1,868,2,8,3,3,5,single-choice,spatial-relational,3|5,7,3/5,240592,3
3,2,24,593,0,97,1,13,6,7,7,single-choice,spatial-relational,6|7,7,6/7,240593,6
3,2,24,594,1,25478,4,10,3,3,7,single-choice,spatial-relational,3|7,7,3/7,240594,3
3,2,24,595,1,1076,1,11,5,5,6,single-choice,spatial-relational,5|6,7,5/6,240595,5
3,2,24,596,1,899,3,9,3,3,6,single-choice,spatial-relational,3|6,7,3/6,240596,3
3,2,24,597,1,990,5,9,2,2,7,single-choice,spatial-relational,2|7,7,2/7,240597,2
3,2,24,598,1,122,3,7,2,2,5,single-choice,spatial-relational,2|5,7,2/5,240598,2
3,2,24,599,1,1017,3,7,2,2,5,single-choice,spatial-relational,2|5,7,2/5,240599,2
3,2,24,600,0,716,4,6,1,5,5,single-choice,spatial-relational,1|5,7,1/5,240600,1
1,3,21,1,1,2333,1,9,4,4,5,single-choice,spatial-relational,4|5,7,4/5,210001,4
1,3,21,2,1,1193,1,3,1,1,2,single-choice,spatial-relational,1|2,7,1/2,210002,1
1,3,21,3,0,1078,1,9,4,5,5,single-choice,spatial-relational,4|5,7,4/5,210003,4
1,3,21,4,0,1029,1,13,6,7,7,single-choice,spatial-relational,6|7,7,6/7,210004,6
1,3,21,5,1,665,1,11,5,5,6,single-choice,spatial-relational,5|6,7,5/6,210005,5
1,3,21,6,1,491,1,5,2,2,3,single-choice,spatial-relational,2|3,7,2/3,210006,2
1,3,21,7,1,580,1,5,2,2,3,single-choice,spatial-relational,2|3,7,2/3,210007,2
1,3,21,8,0,443,1,11,5,6,6,single-choice,spatial-relational,5|6,7,5/6,210008,5
1,3,21,9,0,513,1,3,1,2,2,single-choice,spatial-relational,1|2,7,1/2,210009,1
1,3,21,10,1,1718,1,13,6,6,7,single-choice,spatial-relational,6|7,7,6/7,210010,6
1,3,21,11,1,423,1,7,3,3,4,single-choice,spatial-relational,3|4,7,3/4,210011,3
1,3,21,12,0,1030,1,7,3,4,4,single-choice,spatial-relational,3|4,7,3/4,210012,3
1,3,21,13,1,383,1,11,5,5,6,single-choice,spatial-relational,5|6,7,5/6,210013,5
1,3,21,14,0,423,1,7,3,4,4,single-choice,spatial-relational,3|4,7,3/4,210014,3
1,3,21,15,1,802,1,9,4,4,5,single-choice,spatial-relational,4|5,7,4/5,210015,4
1,3,21,16,0,411,1,3,1,2,2,single-choice,spatial-relational,1|2,7,1/2,210016,1
1,3,21,17,1,376,1,7,3,3,4,single-choice,spatial-relational,3|4,7,3/4,210017,3
1,3,21,18,1,491,1,5,2,2,3,single-choice,spatial-relational,2|3,7,2/3,210018,2
1,3,21,19,0,451,1,11,5,6,6,single-choice,spatial-relational,5|6,7,5/6,210019,5
1,3,21,20,1,431,1,5,2,2,3,single-choice,spatial-relational,2|3,7,2/3,210020,2
1,3,21,21,0,575,1,3,1,2,2,single-choice,spatial-relational,1|2,7,1/2,210021,1
1,3,21,22,0,423,1,9,4,5,5,single-choice,spatial-relational,4|5,7,4/5,210022,4
1,3,21,23,1,597,1,13,6,6,7,single-choice,spatial-relational,6|7,7,6/7,210023,6
1,3,21,24,1,420,1,13,6,6,7,single-choice,spatial-relational,6|7,7,6/7,210024,6
1,3,21,25,0,453,1,9,4,5,5,single-choice,spatial-relational,4|5,7,4/5,210025,4
1,3,21,26,1,623,1,11,5,5,6,single-choice,spatial-relational,5|6,7,5/6,210026,5
1,3,21,27,1,392,1,5,2,2,3,single-choice,spatial-relational,2|3,7,2/3,210027,2
1,3,21,28,1,489,1,3,1,1,2,single-choice,spatial-relational,1|2,7,1/2,210028,1
1,3,21,29,1,557,1,9,4,4,5,single-choice,spatial-relational,4|5,7,4/5,210029,4
1,3,21,30,0,552,1,3,1,2,2,single-choice,spatial-relational,1|2,7,1/2,210030,1
1,3,21,31,0,483,1,13,6,7,7,single-choice,spatial-relational,6|7,7,6/7,210031,6
1,3,21,32,0,549,1,13,6,7,7,single-choice,spatial-relational,6|7,7,6/7,210032,6
1,3,21,33,1,494,1,7,3,3,4,single-choice,spatial-relational,3|4,7,3/4,210033,3
1,3,21,34,1,663,1,5,2,2,3,single-choice,spatial-relational,2|3,7,2/3,210034,2
1,3,21,35,1,580,1,7,3,3,4,single-choice,spatial-relational,3|4,7,3/4,210035,3
1,3,21,36,0,635,1,11,5,6,6,single-choice,spatial-relational,5|6,7,5/6,210036,5
1,3,21,37,0,581,1,7,3,4,4,single-choice,spatial-relational,3|4,7,3/4,210037,3
1,3,21,38,0,562,1,9,4,5,5,single-choice,spatial-relational,4|5,7,4/5,210038,4
1,3,21,39,0,846,1,7,3,4,4,single-choice,spatial-relational,3|4,7,3/4,210039,3
1,3,21,40,1,483,1,3,1,1,2,single-choice,spatial-relational,1|2,7,1/2,210040,1
1,3,21,41,0,670,1,5,2,3,3,single-choice,spatial-relational,2|3,7,2/3,210041,2
1,3,21,42,1,474,1,11,5,5,6,single-choice,spatial-relational,5|6,7,5/6,210042,5
1,3,21,43,1,411,1,5,2,2,3,single-choice,spatial-relational,2|3,7,2/3,210043,2
1,3,21,44,1,1317,1,13,6,6,7,single-choice,spatial-relational,6|7,7,6/7,210044,6
1,3,21,45,0,639,1,9,4,5,5,single-choice,spatial-relational,4|5,7,4/5,210045,4
1,3,21,46,1,464,1,13,6,6,7,single-choice,spatial-relational,6|7,7,6/7,210046,6
1,3,21,47,1,663,1,11,5,5,6,single-choice,spatial-relational,5|6,7,5/6,210047,5
1,3,21,48,0,554,1,3,1,2,2,single-choice,spatial-relational,1|2,7,1/2,210048,1
1,3,21,49,0,489,1,5,2,3,3,single-choice,spatial-relational,2|3,7,2/3,210049,2
1,3,21,50,1,539,1,11,5,5,6,single-choice,spatial-relational,5|6,7,5/6,210050,5
1,3,21,51,0,539,1,7,3,4,4,single-choice,spatial-relational,3|4,7,3/4,210051,3
1,3,21,52,1,970,1,3,1,1,2,single-choice,spatial-relational,1|2,7,1/2,210052,1
1,3,21,53,0,636,1,13,6,7,7,single-choice,spatial-relational,6|7,7,6/7,210053,6
1,3,21,54,1,553,1,9,4,4,5,single-choice,spatial-relational,4|5,7,4/5,210054,4
1,3,21,55,0,641,1,9,4,5,5,single-choice,spatial-relational,4|5,7,4/5,210055,4
1,3,21,56,0,653,1,3,1,2,2,single-choice,spatial-relational,1|2,7,1/2,210056,1
1,3,21,57,0,486,1,13,6,7,7,single-choice,spatial-relational,6|7,7,6/7,210057,6
1,3,21,58,0,60,1,11,5,6,6,single-choice,spatial-relational,5|6,7,5/6,210058,5
1,3,21,59,0,456,1,7,3,4,4,single-choice,spatial-relational,3|4,7,3/4,210059,3
1,3,21,60,1,381,1,5,2,2,3,single-choice,spatial-relational,2|3,7,2/3,210060,2
1,3,21,61,0,458,1,3,1,2,2,single-choice,spatial-relational,1|2,7,1/2,210061,1
1,3,21,62,1,444,1,11,5,5,6,single-choice,spatial-relational,5|6,7,5/6,210062,5
1,3,21,63,0,652,1,13,6,7,7,single-choice,spatial-relational,6|7,7,6/7,210063,6
1,3,21,64,1,2690,1,9,4,4,5,single-choice,spatial-relational,4|5,7,4/5,210064,4
1,3,21,65,1,941,1,3,1,1,2,single-choice,spatial-relational,1|2,7,1/2,210065,1
1,3,21,66,0,573,1,13,6,7,7,single-choice,spatial-relational,6|7,7,6/7,210066,6
1,3,21,67,1,709,1,11,5,5,6,single-choice,spatial-relational,5|6,7,5/6,210067,5
1,3,21,68,0,681,1,7,3,4,4,single-choice,spatial-relational,3|4,7,3/4,210068,3
1,3,21,69,0,465,1,7,3,4,4,single-choice,spatial-relational,3|4,7,3/4,210069,3
1,3,21,70,1,426,1,5,2,2,3,single-choice,spatial-relational,2|3,7,2/3,210070,2
1,3,21,71,1,767,1,5,2,2,3,single-choice,spatial-relational,2|3,7,2/3,210071,2
1,3,21,72,0,533,1,9,4,5,5,single-choice,spatial-relational,4|5,7,4/5,210072,4
1,3,21,73,1,775,1,13,6,6,7,single-choice,spatial-relational,6|7,7,6/7,210073,6
1,3,21,74,1,586,1,7,3,3,4,single-choice,spatial-relational,3|4,7,3/4,210074,3
1,3,21,75,0,513,1,9,4,5,5,single-choice,spatial-relational,4|5,7,4/5,210075,4
1,3,21,76,0,1199,1,11,5,6,6,single-choice,spatial-relational,5|6,7,5/6,210076,5
1,3,21,77,0,694,1,3,1,2,2,single-choice,spatial-relational,1|2,7,1/2,210077,1
1,3,21,78,0,620,1,13,6,7,7,single-choice,spatial-relational,6|7,7,6/7,210078,6
1,3,21,79,1,365,1,5,2,2,3,single-choice,spatial-relational,2|3,7,2/3,210079,2
1,3,21,80,0,615,1,5,2,3,3,single-choice,spatial-relational,2|3,7,2/3,210080,2
1,3,21,81,1,565,1,11,5,5,6,single-choice,spatial-relational,5|6,7,5/6,210081,5
1,3,21,82,1,701,1,7,3,3,4,single-choice,spatial-relational,3|4,7,3/4,210082,3
1,3,21,83,1,971,1,9,4,4,5,single-choice,spatial-relational,4|5,7,4/5,210083,4
1,3,21,84,0,556,1,3,1,2,2,single-choice,spatial-relational,1|2,7,1/2,210084,1
1,3,21,85,1,681,1,9,4,4,5,single-choice,spatial-relational,4|5,7,4/5,210085,4
1,3,21,86,1,521,1,11,5,5,6,single-choice,spatial-relational,5|6,7,5/6,210086,5
1,3,21,87,1,599,1,13,6,6,7,single-choice,spatial-relational,6|7,7,6/7,210087,6
1,3,21,88,1,612,1,3,1,1,2,single-choice,spatial-relational,1|2,7,1/2,210088,1
1,3,21,89,0,632,1,11,5,6,6,single-choice,spatial-relational,5|6,7,5/6,210089,5
1,3,21,90,0,542,1,7,3,4,4,single-choice,spatial-relational,3|4,7,3/4,210090,3
1,3,21,91,0,755,1,5,2,3,3,single-choice,spatial-relational,2|3,7,2/3,210091,2
1,3,21,92,0,642,1,13,6,7,7,single-choice,spatial-relational,6|7,7,6/7,210092,6
1,3,21,93,0,724,1,3,1,2,2,single-choice,spatial-relational,1|2,7,1/2,210093,1
1,3,21,94,0,631,1,9,4,5,5,single-choice,spatial-relational,4|5,7,4/5,210094,4
1,3,21,95,1,633,1,7,3,3,4,single-choice,spatial-relational,3|4,7,3/4,210095,3
1,3,21,96,1,483,1,5,2,2,3,single-choice,spatial-relational,2|3,7,2/3,210096,2
1,3,21,97,1,713,1,7,3,3,4,single-choice,spatial-relational,3|4,7,3/4,210097,3
1,3,21,98,1,662,1,9,4,4,5,single-choice,spatial-relational,4|5,7,4/5,210098,4
1,3,21,99,1,641,1,11,5,5,6,single-choice,spatial-relational,5|6,7,5/6,210099,5
1,3,21,100,0,562,1,7,3,4,4,single-choice,spatial-relational,3|4,7,3/4,210100,3
1,3,21,101,0,572,1,13,6,7,7,single-choice,spatial-relational,6|7,7,6/7,210101,6
1,3,21,102,1,536,1,5,2,2,3,single-choice,spatial-relational,2|3,7,2/3,210102,2
1,3,21,103,1,624,1,13,6,6,7,single-choice,spatial-relational,6|7,7,6/7,210103,6
1,3,21,104,1,779,1,3,1,1,2,single-choice,spatial-relational,1|2,7,1/2,210104,1
1,3,21,105,1,761,1,3,1,1,2,single-choice,spatial-relational,1|2,7,1/2,210105,1
1,3,21,106,1,761,1,5,2,2,3,single-choice,spatial-relational,2|3,7,2/3,210106,2
1,3,21,107,0,665,1,11,5,6,6,single-choice,spatial-relational,5|6,7,5/6,210107,5
1,3,21,108,0,554,1,9,4,5,5,single-choice,spatial-relational,4|5,7,4/5,210108,4
1,3,21,109,0,456,1,11,5,6,6,single-choice,spatial-relational,5|6,7,5/6,210109,5
1,3,21,110,1,732,1,9,4,4,5,single-choice,spatial-relational,4|5,7,4/5,210110,4
1,3,21,111,0,482,1,9,4,5,5,single-choice,spatial-relational,4|5,7,4/5,210111,4
1,3,21,112,1,673,1,13,6,6,7,single-choice,spatial-relational,6|7,7,6/7,210112,6
1,3,21,113,1,686,1,3,1,1,2,single-choice,spatial-relational,1|2,7,1/2,210113,1
1,3,21,114,0,642,1,11,5,6,6,single-choice,spatial-relational,5|6,7,5/6,210114,5
1,3,21,115,1,532,1,3,1,1,2,single-choice,spatial-relational,1|2,7,1/2,210115,1
1,3,21,116,1,596,1,5,2,2,3,single-choice,spatial-relational,2|3,7,2/3,210116,2
1,3,21,117,0,698,1,13,6,7,7,single-choice,spatial-relational,6|7,7,6/7,210117,6
1,3,21,118,1,1082,1,7,3,3,4,single-choice,spatial-relational,3|4,7,3/4,210118,3
1,3,21,119,1,462,1,5,2,2,3,single-choice,spatial-relational,2|3,7,2/3,210119,2
1,3,21,120,0,592,1,7,3,4,4,single-choice,spatial-relational,3|4,7,3/4,210120,3
1,3,21,121,1,504,1,3,1,1,2,single-choice,spatial-relational,1|2,7,1/2,210121,1
1,3,21,122,0,1407,1,3,1,2,2,single-choice,spatial-relational,1|2,7,1/2,210122,1
1,3,21,123,1,819,1,9,4,4,5,single-choice,spatial-relational,4|5,7,4/5,210123,4
1,3,21,124,1,534,1,9,4,4,5,single-choice,spatial-relational,4|5,7,4/5,210124,4
1,3,21,125,1,695,1,13,6,6,7,single-choice,spatial-relational,6|7,7,6/7,210125,6
1,3,21,126,0,635,1,7,3,4,4,single-choice,spatial-relational,3|4,7,3/4,210126,3
1,3,21,127,1,793,1,11,5,5,6,single-choice,spatial-relational,5|6,7,5/6,210127,5
1,3,21,128,1,602,1,7,3,3,4,single-choice,spatial-relational,3|4,7,3/4,210128,3
1,3,21,129,1,831,1,5,2,2,3,single-choice,spatial-relational,2|3,7,2/3,210129,2
1,3,21,130,0,744,1,5,2,3,3,single-choice,spatial-relational,2|3,7,2/3,210130,2
1,3,21,131,1,695,1,13,6,6,7,single-choice,spatial-relational,6|7,7,6/7,210131,6
1,3,21,132,0,773,1,11,5,6,6,single-choice,spatial-relational,5|6,7,5/6,210132,5
1,3,21,133,0,623,1,13,6,7,7,single-choice,spatial-relational,6|7,7,6/7,210133,6
1,3,21,134,0,604,1,5,2,3,3,single-choice,spatial-relational,2|3,7,2/3,210134,2
1,3,21,135,0,606,1,9,4,5,5,single-choice,spatial-relational,4|5,7,4/5,210135,4
1,3,21,136,0,764,1,3,1,2,2,single-choice,spatial-relational,1|2,7,1/2,210136,1
1,3,21,137,0,732,1,7,3,4,4,single-choice,spatial-relational,3|4,7,3/4,210137,3
1,3,21,138,1,583,1,11,5,5,6,single-choice,spatial-relational,5|6,7,5/6,210138,5
1,3,21,139,1,726,1,9,4,4,5,single-choice,spatial-relational,4|5,7,4/5,210139,4
1,3,21,140,0,599,1,7,3,4,4,single-choice,spatial-relational,3|4,7,3/4,210140,3
1,3,21,141,1,609,1,11,5,5,6,single-choice,spatial-relational,5|6,7,5/6,210141,5
1,3,21,142,1,826,1,13,6,6,7,single-choice,spatial-relational,6|7,7,6/7,210142,6
1,3,21,143,1,676,1,3,1,1,2,single-choice,spatial-relational,1|2,7,1/2,210143,1
1,3,21,144,1,783,1,5,2,2,3,single-choice,spatial-relational,2|3,7,2/3,210144,2
1,3,21,145,1,828,1,9,4,4,5,single-choice,spatial-relational,4|5,7,4/5,210145,4
1,3,21,146,0,901,1,3,1,2,2,single-choice,spatial-relational,1|2,7,1/2,210146,1
1,3,21,147,0,630,1,7,3,4,4,single-choice,spatial-relational,3|4,7,3/4,210147,3
1,3,21,148,1,602,1,9,4,4,5,single-choice,spatial-relational,4|5,7,4/5,210148,4
1,3,21,149,0,763,1,5,2,3,3,single-choice,spatial-relational,2|3,7,2/3,210149,2
1,3,21,150,1,533,1,11,5,5,6,single-choice,spatial-relational,5|6,7,5/6,210150,5
1,3,21,151,0,784,1,13,6,7,7,single-choice,spatial-relational,6|7,7,6/7,210151,6
1,3,21,152,0,821,1,3,1,2,2,single-choice,spatial-relational,1|2,7,1/2,210152,1
1,3,21,153,0,48,1,11,5,6,6,single-choice,spatial-relational,5|6,7,5/6,210153,5
1,3,21,154,0,750,1,5,2,3,3,single-choice,spatial-relational,2|3,7,2/3,210154,2
1,3,21,155,0,577,1,7,3,4,4,single-choice,spatial-relational,3|4,7,3/4,210155,3
1,3,21,156,1,691,1,13,6,6,7,single-choice,spatial-relational,6|7,7,6/7,210156,6
1,3,21,157,0,547,1,9,4,5,5,single-choice,spatial-relational,4|5,7,4/5,210157,4
1,3,21,158,0,467,1,7,3,4,4,single-choice,spatial-relational,3|4,7,3/4,210158,3
1,3,21,159,1,525,1,11,5,5,6,single-choice,spatial-relational,5|6,7,5/6,210159,5
1,3,21,160,0,873,1,5,2,3,3,single-choice,spatial-relational,2|3,7,2/3,210160,2
1,3,21,161,1,573,1,11,5,5,6,single-choice,spatial-relational,5|6,7,5/6,210161,5
1,3,21,162,0,665,1,5,2,3,3,single-choice,spatial-relational,2|3,7,2/3,210162,2
1,3,21,163,0,537,1,9,4,5,5,single-choice,spatial-relational,4|5,7,4/5,210163,4
1,3,21,164,0,41,1,3,1,2,2,single-choice,spatial-relational,1|2,7,1/2,210164,1
1,3,21,165,1,666,1,13,6,6,7,single-choice,spatial-relational,6|7,7,6/7,210165,6
1,3,21,166,1,732,1,13,6,6,7,single-choice,spatial-relational,6|7,7,6/7,210166,6
1,3,21,167,1,609,1,3,1,1,2,single-choice,spatial-relational,1|2,7,1/2,210167,1
1,3,21,168,0,638,1,7,3,4,4,single-choice,spatial-relational,3|4,7,3/4,210168,3
1,3,21,169,1,637,1,13,6,6,7,single-choice,spatial-relational,6|7,7,6/7,210169,6
1,3,21,170,0,560,1,7,3,4,4,single-choice,spatial-relational,3|4,7,3/4,210170,3
1,3,21,171,1,582,1,3,1,1,2,single-choice,spatial-relational,1|2,7,1/2,210171,1
1,3,21,172,1,987,1,3,1,1,2,single-choice,spatial-relational,1|2,7,1/2,210172,1
1,3,21,173,0,639,1,11,5,6,6,single-choice,spatial-relational,5|6,7,5/6,210173,5
1,3,21,174,0,513,1,9,4,5,5,single-choice,spatial-relational,4|5,7,4/5,210174,4
1,3,21,175,1,623,1,11,5,5,6,single-choice,spatial-relational,5|6,7,5/6,210175,5
1,3,21,176,0,540,1,7,3,4,4,single-choice,spatial-relational,3|4,7,3/4,210176,3
1,3,21,177,0,601,1,5,2,3,3,single-choice,spatial-relational,2|3,7,2/3,210177,2
1,3,21,178,1,482,1,9,4,4,5,single-choice,spatial-relational,4|5,7,4/5,210178,4
1,3,21,179,1,849,1,13,6,6,7,single-choice,spatial-relational,6|7,7,6/7,210179,6
1,3,21,180,0,821,1,5,2,3,3,single-choice,spatial-relational,2|3,7,2/3,210180,2
1,3,21,181,1,831,1,3,1,1,2,single-choice,spatial-relational,1|2,7,1/2,210181,1
1,3,21,182,1,671,1,11,5,5,6,single-choice,spatial-relational,5|6,7,5/6,210182,5
1,3,21,183,0,482,1,9,4,5,5,single-choice,spatial-relational,4|5,7,4/5,210183,4
1,3,21,184,1,483,1,13,6,6,7,single-choice,spatial-relational,6|7,7,6/7,210184,6
1,3,21,185,0,612,1,7,3,4,4,single-choice,spatial-relational,3|4,7,3/4,210185,3
1,3,21,186,0,484,1,9,4,5,5,single-choice,spatial-relational,4|5,7,4/5,210186,4
1,3,21,187,0,627,1,5,2,3,3,single-choice,spatial-relational,2|3,7,2/3,210187,2
1,3,21,188,1,593,1,3,1,1,2,single-choice,spatial-relational,1|2,7,1/2,210188,1
1,3,21,189,0,570,1,7,3,4,4,single-choice,spatial-relational,3|4,7,3/4,210189,3
1,3,21,190,0,711,1,11,5,6,6,single-choice,spatial-relational,5|6,7,5/6,210190,5
1,3,21,191,1,744,1,13,6,6,7,single-choice,spatial-relational,6|7,7,6/7,210191,6
1,3,21,192,0,751,1,5,2,3,3,single-choice,spatial-relational,2|3,7,2/3,210192,2
1,3,21,193,0,40,1,3,1,2,2,single-choice,spatial-relational,1|2,7,1/2,210193,1
1,3,21,194,0,681,1,5,2,3,3,single-choice,spatial-relational,2|3,7,2/3,210194,2
1,3,21,195,1,567,1,3,1,1,2,single-choice,spatial-relational,1|2,7,1/2,210195,1
1,3,21,196,1,632,1,13,6,6,7,single-choice,spatial-relational,6|7,7,6/7,210196,6
1,3,21,197,1,535,1,13,6,6,7,single-choice,spatial-relational,6|7,7,6/7,210197,6
1,3,21,198,0,834,1,11,5,6,6,single-choice,spatial-relational,5|6,7,5/6,210198,5
1,3,21,199,0,606,1,9,4,5,5,single-choice,spatial-relational,4|5,7,4/5,210199,4
1,3,21,200,0,930,1,7,3,4,4,single-choice,spatial-relational,3|4,7,3/4,210200,3
1,3,21,201,0,1193,1,11,5,6,6,single-choice,spatial-relational,5|6,7,5/6,210201,5
1,3,21,202,0,454,1,7,3,4,4,single-choice,spatial-relational,3|4,7,3/4,210202,3
1,3,21,203,0,732,1,5,2,3,3,single-choice,spatial-relational,2|3,7,2/3,210203,2
1,3,21,204,1,815,1,9,4,4,5,single-choice,spatial-relational,4|5,7,4/5,210204,4
1,3,21,205,1,633,1,13,6,6,7,single-choice,spatial-relational,6|7,7,6/7,210205,6
1,3,21,206,1,686,1,7,3,3,4,single-choice,spatial-relational,3|4,7,3/4,210206,3
1,3,21,207,0,700,1,5,2,3,3,single-choice,spatial-relational,2|3,7,2/3,210207,2
1,3,21,208,0,519,1,7,3,4,4,single-choice,spatial-relational,3|4,7,3/4,210208,3
1,3,21,209,0,525,1,9,4,5,5,single-choice,spatial-relational,4|5,7,4/5,210209,4
1,3,21,210,1,814,1,3,1,1,2,single-choice,spatial-relational,1|2,7,1/2,210210,1
1,3,21,211,1,523,1,3,1,1,2,single-choice,spatial-relational,1|2,7,1/2,210211,1
1,3,21,212,0,596,1,9,4,5,5,single-choice,spatial-relational,4|5,7,4/5,210212,4
1,3,21,213,0,470,1,11,5,6,6,single-choice,spatial-relational,5|6,7,5/6,210213,5
1,3,21,214,1,481,1,13,6,6,7,single-choice,spatial-relational,6|7,7,6/7,210214,6
1,3,21,215,0,674,1,11,5,6,6,single-choice,spatial-relational,5|6,7,5/6,210215,5
1,3,21,216,0,775,1,5,2,3,3,single-choice,spatial-relational,2|3,7,2/3,210216,2
1,3,21,217,0,1033,1,7,3,4,4,single-choice,spatial-relational,3|4,7,3/4,210217,3
1,3,21,218,1,588,1,3,1,1,2,single-choice,spatial-relational,1|2,7,1/2,210218,1
1,3,21,219,0,547,1,11,5,6,6,single-choice,spatial-relational,5|6,7,5/6,210219,5
1,3,21,220,0,811,1,5,2,3,3,single-choice,spatial-relational,2|3,7,2/3,210220,2
1,3,21,221,0,654,1,3,1,2,2,single-choice,spatial-relational,1|2,7,1/2,210221,1
1,3,21,222,0,922,1,9,4,5,5,single-choice,spatial-relational,4|5,7,4/5,210222,4
1,3,21,223,0,725,1,7,3,4,4,single-choice,spatial-relational,3|4,7,3/4,210223,3
1,3,21,224,1,967,1,13,6,6,7,single-choice,spatial-relational,6|7,7,6/7,210224,6
1,3,21,225,0,659,1,11,5,6,6,single-choice,spatial-relational,5|6,7,5/6,210225,5
1,3,21,226,1,554,1,13,6,6,7,single-choice,spatial-relational,6|7,7,6/7,210226,6
1,3,21,227,0,690,1,9,4,5,5,single-choice,spatial-relational,4|5,7,4/5,210227,4
1,3,21,228,0,655,1,5,2,3,3,single-choice,spatial-relational,2|3,7,2/3,210228,2
1,3,21,229,1,1371,1,7,3,3,4,single-choice,spatial-relational,3|4,7,3/4,210229,3
1,3,21,230,0,772,1,9,4,5,5,single-choice,spatial-relational,4|5,7,4/5,210230,4
1,3,21,231,1,554,1,3,1,1,2,single-choice,spatial-relational,1|2,7,1/2,210231,1
1,3,21,232,0,984,1,7,3,4,4,single-choice,spatial-relational,3|4,7,3/4,210232,3
1,3,21,233,0,764,1,5,2,3,3,single-choice,spatial-relational,2|3,7,2/3,210233,2
1,3,21,234,1,703,1,3,1,1,2,single-choice,spatial-relational,1|2,7,1/2,210234,1
1,3,21,235,1,630,1,13,6,6,7,single-choice,spatial-relational,6|7,7,6/7,210235,6
1,3,21,236,0,716,1,11,5,6,6,single-choice,spatial-relational,5|6,7,5/6,210236,5
1,3,21,237,0,482,1,11,5,6,6,single-choice,spatial-relational,5|6,7,5/6,210237,5
1,3,21,238,0,705,1,9,4,5,5,single-choice,spatial-relational,4|5,7,4/5,210238,4
1,3,21,239,0,627,1,5,2,3,3,single-choice,spatial-relational,2|3,7,2/3,210239,2
1,3,21,240,1,545,1,13,6,6,7,single-choice,spatial-relational,6|7,7,6/7,210240,6
1,3,21,241,1,928,1,3,1,1,2,single-choice,spatial-relational,1|2,7,1/2,210241,1
1,3,21,242,0,720,1,5,2,3,3,single-choice,spatial-relational,2|3,7,2/3,210242,2
1,3,21,243,1,558,1,13,6,6,7,single-choice,spatial-relational,6|7,7,6/7,210243,6
1,3,21,244,1,597,1,3,1,1,2,single-choice,spatial-relational,1|2,7,1/2,210244,1
1,3,21,245,0,1271,1,9,4,5,5,single-choice,spatial-relational,4|5,7,4/5,210245,4
1,3,21,246,1,740,1,7,3,3,4,single-choice,spatial-relational,3|4,7,3/4,210246,3
1,3,21,247,1,625,1,13,6,6,7,single-choice,spatial-relational,6|7,7,6/7,210247,6
1,3,21,248,1,1037,1,7,3,3,4,single-choice,spatial-relational,3|4,7,3/4,210248,3
1,3,21,249,0,782,1,9,4,5,5,single-choice,spatial-relational,4|5,7,4/5,210249,4
1,3,21,250,0,583,1,11,5,6,6,single-choice,spatial-relational,5|6,7,5/6,210250,5
1,3,21,251,0,767,1,5,2,3,3,single-choice,spatial-relational,2|3,7,2/3,210251,2
1,3,21,252,0,561,1,11,5,6,6,single-choice,spatial-relational,5|6,7,5/6,210252,5
1,3,21,253,0,540,1,11,5,6,6,single-choice,spatial-relational,5|6,7,5/6,210253,5
1,3,21,254,0,1270,1,5,2,3,3,single-choice,spatial-relational,2|3,7,2/3,210254,2
1,3,21,255,1,694,1,13,6,6,7,single-choice,spatial-relational,6|7,7,6/7,210255,6
1,3,21,256,1,836,1,7,3,3,4,single-choice,spatial-relational,3|4,7,3/4,210256,3
1,3,21,257,0,721,1,11,5,6,6,single-choice,spatial-relational,5|6,7,5/6,210257,5
1,3,21,258,0,1279,1,7,3,4,4,single-choice,spatial-relational,3|4,7,3/4,210258,3
1,3,21,259,0,983,1,9,4,5,5,single-choice,spatial-relational,4|5,7,4/5,210259,4
1,3,21,260,1,1105,1,3,1,1,2,single-choice,spatial-relational,1|2,7,1/2,210260,1
1,3,21,261,0,604,1,9,4,5,5,single-choice,spatial-relational,4|5,7,4/5,210261,4
1,3,21,262,1,638,1,13,6,6,7,single-choice,spatial-relational,6|7,7,6/7,210262,6
1,3,21,263,0,673,1,5,2,3,3,single-choice,spatial-relational,2|3,7,2/3,210263,2
1,3,21,264,1,1061,1,3,1,1,2,single-choice,spatial-relational,1|2,7,1/2,210264,1
1,3,21,265,1,839,1,9,4,4,5,single-choice,spatial-relational,4|5,7,4/5,210265,4
1,3,21,266,0,586,1,11,5,6,6,single-choice,spatial-relational,5|6,7,5/6,210266,5
1,3,21,267,1,1190,1,7,3,3,4,single-choice,spatial-relational,3|4,7,3/4,210267,3
1,3,21,268,1,1057,1,7,3,3,4,single-choice,spatial-relational,3|4,7,3/4,210268,3
1,3,21,269,1,672,1,3,1,1,2,single-choice,spatial-relational,1|2,7,1/2,210269,1
1,3,21,270,1,682,1,13,6,6,7,single-choice,spatial-relational,6|7,7,6/7,210270,6
1,3,21,271,1,643,1,13,6,6,7,single-choice,spatial-relational,6|7,7,6/7,210271,6
1,3,21,272,0,722,1,5,2,3,3,single-choice,spatial-relational,2|3,7,2/3,210272,2
1,3,21,273,0,585,1,11,5,6,6,single-choice,spatial-relational,5|6,7,5/6,210273,5
1,3,21,274,0,631,1,5,2,3,3,single-choice,spatial-relational,2|3,7,2/3,210274,2
1,3,21,275,1,931,1,3,1,1,2,single-choice,spatial-relational,1|2,7,1/2,210275,1
1,3,21,276,1,841,1,9,4,4,5,single-choice,spatial-relational,4|5,7,4/5,210276,4
1,3,21,277,1,662,1,7,3,3,4,single-choice,spatial-relational,3|4,7,3/4,210277,3
1,3,21,278,0,681,1,11,5,6,6,single-choice,spatial-relational,5|6,7,5/6,210278,5
1,3,21,279,0,750,1,3,1,2,2,single-choice,spatial-relational,1|2,7,1/2,210279,1
1,3,21,280,1,778,1,13,6,6,7,single-choice,spatial-relational,6|7,7,6/7,210280,6
1,3,21,281,1,467,1,13,6,6,7,single-choice,spatial-relational,6|7,7,6/7,210281,6
1,3,21,282,1,764,1,3,1,1,2,single-choice,spatial-relational,1|2,7,1/2,210282,1
1,3,21,283,0,560,1,11,5,6,6,single-choice,spatial-relational,5|6,7,5/6,210283,5
1,3,21,284,0,674,1,9,4,5,5,single-choice,spatial-relational,4|5,7,4/5,210284,4
1,3,21,285,0,670,1,5,2,3,3,single-choice,spatial-relational,2|3,7,2/3,210285,2
1,3,21,286,0,479,1,7,3,4,4,single-choice,spatial-relational,3|4,7,3/4,210286,3
1,3,21,287,1,780,1,9,4,4,5,single-choice,spatial-relational,4|5,7,4/5,210287,4
1,3,21,288,0,858,1,5,2,3,3,single-choice,spatial-relational,2|3,7,2/3,210288,2
1,3,21,289,0,575,1,11,5,6,6,single-choice,spatial-relational,5|6,7,5/6,210289,5
1,3,21,290,0,771,1,7,3,4,4,single-choice,spatial-relational,3|4,7,3/4,210290,3
1,3,21,291,1,714,1,7,3,3,4,single-choice,spatial-relational,3|4,7,3/4,210291,3
1,3,21,292,1,1108,1,3,1,1,2,single-choice,spatial-relational,1|2,7,1/2,210292,1
1,3,21,293,0,712,1,11,5,6,6,single-choice,spatial-relational,5|6,7,5/6,210293,5
1,3,21,294,0,977,1,9,4,5,5,single-choice,spatial-relational,4|5,7,4/5,210294,4
1,3,21,295,0,599,1,5,2,3,3,single-choice,spatial-relational,2|3,7,2/3,210295,2
1,3,21,296,1,1079,1,13,6,6,7,single-choice,spatial-relational,6|7,7,6/7,210296,6
1,3,21,297,1,1341,1,3,1,1,2,single-choice,spatial-relational,1|2,7,1/2,210297,1
1,3,21,298,1,861,1,9,4,4,5,single-choice,spatial-relational,4|5,7,4/5,210298,4
1,3,21,299,1,825,1,13,6,6,7,single-choice,spatial-relational,6|7,7,6/7,210299,6
1,3,21,300,0,753,1,5,2,3,3,single-choice,spatial-relational,2|3,7,2/3,210300,2
1,3,21,301,1,663,1,13,6,6,7,single-choice,spatial-relational,6|7,7,6/7,210301,6
1,3,21,302,1,729,1,9,4,4,5,single-choice,spatial-relational,4|5,7,4/5,210302,4
1,3,21,303,1,876,1,3,1,1,2,single-choice,spatial-relational,1|2,7,1/2,210303,1
1,3,21,304,0,695,1,7,3,4,4,single-choice,spatial-relational,3|4,7,3/4,210304,3
1,3,21,305,1,694,1,3,1,1,2,single-choice,spatial-relational,1|2,7,1/2,210305,1
1,3,21,306,1,818,1,7,3,3,4,single-choice,spatial-relational,3|4,7,3/4,210306,3
1,3,21,307,1,842,1,9,4,4,5,single-choice,spatial-relational,4|5,7,4/5,210307,4
1,3,21,308,0,552,1,11,5,6,6,single-choice,spatial-relational,5|6,7,5/6,210308,5
1,3,21,309,0,844,1,5,2,3,3,single-choice,spatial-relational,2|3,7,2/3,210309,2
1,3,21,310,0,543,1,5,2,3,3,single-choice,spatial-relational,2|3,7,2/3,210310,2
1,3,21,311,0,760,1,11,5,6,6,single-choice,spatial-relational,5|6,7,5/6,210311,5
1,3,21,312,1,423,1,13,6,6,7,single-choice,spatial-relational,6|7,7,6/7,210312,6
1,3,21,313,1,854,1,7,3,3,4,single-choice,spatial-relational,3|4,7,3/4,210313,3
1,3,21,314,1,533,1,13,6,6,7,single-choice,spatial-relational,6|7,7,6/7,210314,6
1,3,21,315,0,641,1,5,2,3,3,single-choice,spatial-relational,2|3,7,2/3,210315,2
1,3,21,316,1,751,1,3,1,1,2,single-choice,spatial-relational,1|2,7,1/2,210316,1
1,3,21,317,0,693,1,11,5,6,6,single-choice,spatial-relational,5|6,7,5/6,210317,5
1,3,21,318,1,685,1,9,4,4,5,single-choice,spatial-relational,4|5,7,4/5,210318,4
1,3,21,319,0,724,1,11,5,6,6,single-choice,spatial-relational,5|6,7,5/6,210319,5
1,3,21,320,0,644,1,5,2,3,3,single-choice,spatial-relational,2|3,7,2/3,210320,2
1,3,21,321,1,764,1,9,4,4,5,single-choice,spatial-relational,4|5,7,4/5,210321,4
1,3,21,322,1,813,1,7,3,3,4,single-choice,spatial-relational,3|4,7,3/4,210322,3
1,3,21,323,1,845,1,13,6,6,7,single-choice,spatial-relational,6|7,7,6/7,210323,6
1,3,21,324,1,724,1,3,1,1,2,single-choice,spatial-relational,1|2,7,1/2,210324,1
1,3,21,325,0,719,1,11,5,6,6,single-choice,spatial-relational,5|6,7,5/6,210325,5
1,3,21,326,0,631,1,7,3,4,4,single-choice,spatial-relational,3|4,7,3/4,210326,3
1,3,21,327,1,972,1,13,6,6,7,single-choice,spatial-relational,6|7,7,6/7,210327,6
1,3,21,328,0,490,1,11,5,6,6,single-choice,spatial-relational,5|6,7,5/6,210328,5
1,3,21,329,1,927,1,3,1,1,2,single-choice,spatial-relational,1|2,7,1/2,210329,1
1,3,21,330,0,947,1,7,3,4,4,single-choice,spatial-relational,3|4,7,3/4,210330,3
1,3,21,331,1,766,1,9,4,4,5,single-choice,spatial-relational,4|5,7,4/5,210331,4
1,3,21,332,0,708,1,5,2,3,3,single-choice,spatial-relational,2|3,7,2/3,210332,2
1,3,21,333,1,483,1,9,4,4,5,single-choice,spatial-relational,4|5,7,4/5,210333,4
1,3,21,334,1,675,1,13,6,6,7,single-choice,spatial-relational,6|7,7,6/7,210334,6
1,3,21,335,0,618,1,5,2,3,3,single-choice,spatial-relational,2|3,7,2/3,210335,2
1,3,21,336,1,599,1,3,1,1,2,single-choice,spatial-relational,1|2,7,1/2,210336,1
1,3,21,337,1,755,1,9,4,4,5,single-choice,spatial-relational,4|5,7,4/5,210337,4
1,3,21,338,1,799,1,9,4,4,5,single-choice,spatial-relational,4|5,7,4/5,210338,4
1,3,21,339,1,774,1,3,1,1,2,single-choice,spatial-relational,1|2,7,1/2,210339,1
1,3,21,340,0,662,1,11,5,6,6,single-choice,spatial-relational,5|6,7,5/6,210340,5
1,3,21,341,0,44,1,5,2,3,3,single-choice,spatial-relational,2|3,7,2/3,210341,2
1,3,21,342,0,447,1,7,3,4,4,single-choice,spatial-relational,3|4,7,3/4,210342,3
1,3,21,343,1,67,1,7,3,3,4,single-choice,spatial-relational,3|4,7,3/4,210343,3
1,3,21,344,1,1937,1,13,6,6,7,single-choice,spatial-relational,6|7,7,6/7,210344,6
1,3,21,345,0,951,1,3,1,2,2,single-choice,spatial-relational,1|2,7,1/2,210345,1
1,3,21,346,1,773,1,13,6,6,7,single-choice,spatial-relational,6|7,7,6/7,210346,6
1,3,21,347,0,772,1,11,5,6,6,single-choice,spatial-relational,5|6,7,5/6,210347,5
1,3,21,348,0,753,1,5,2,3,3,single-choice,spatial-relational,2|3,7,2/3,210348,2
1,3,21,349,0,595,1,11,5,6,6,single-choice,spatial-relational,5|6,7,5/6,210349,5
1,3,21,350,0,761,1,7,3,4,4,single-choice,spatial-relational,3|4,7,3/4,210350,3
1,3,21,351,0,849,1,3,1,2,2,single-choice,spatial-relational,1|2,7,1/2,210351,1
1,3,21,352,0,792,1,11,5,6,6,single-choice,spatial-relational,5|6,7,5/6,210352,5
1,3,21,353,1,899,1,13,6,6,7,single-choice,spatial-relational,6|7,7,6/7,210353,6
1,3,21,354,1,765,1,9,4,4,5,single-choice,spatial-relational,4|5,7,4/5,210354,4
1,3,21,355,0,625,1,5,2,3,3,single-choice,spatial-relational,2|3,7,2/3,210355,2
1,3,21,356,1,715,1,9,4,4,5,single-choice,spatial-relational,4|5,7,4/5,210356,4
1,3,21,357,0,877,1,7,3,4,4,single-choice,spatial-relational,3|4,7,3/4,210357,3
1,3,21,358,0,743,1,5,2,3,3,single-choice,spatial-relational,2|3,7,2/3,210358,2
1,3,21,359,1,579,1,13,6,6,7,single-choice,spatial-relational,6|7,7,6/7,210359,6
1,3,21,360,1,673,1,3,1,1,2,single-choice,spatial-relational,1|2,7,1/2,210360,1
1,3,21,361,0,662,1,11,5,6,6,single-choice,spatial-relational,5|6,7,5/6,210361,5
1,3,21,362,0,734,1,5,2,3,3,single-choice,spatial-relational,2|3,7,2/3,210362,2
1,3,21,363,0,689,1,11,5,6,6,single-choice,spatial-relational,5|6,7,5/6,210363,5
1,3,21,364,1,811,1,9,4,4,5,single-choice,spatial-relational,4|5,7,4/5,210364,4
1,3,21,365,0,865,1,13,6,7,7,single-choice,spatial-relational,6|7,7,6/7,210365,6
1,3,21,366,1,49,1,7,3,3,4,single-choice,spatial-relational,3|4,7,3/4,210366,3
1,3,21,367,0,615,1,7,3,4,4,single-choice,spatial-relational,3|4,7,3/4,210367,3
1,3,21,368,0,695,1,5,2,3,3,single-choice,spatial-relational,2|3,7,2/3,210368,2
1,3,21,369,1,1082,1,3,1,1,2,single-choice,spatial-relational,1|2,7,1/2,210369,1
1,3,21,370,1,646,1,3,1,1,2,single-choice,spatial-relational,1|2,7,1/2,210370,1
1,3,21,371,1,1092,1,13,6,6,7,single-choice,spatial-relational,6|7,7,6/7,210371,6
1,3,21,372,1,623,1,9,4,4,5,single-choice,spatial-relational,4|5,7,4/5,210372,4
1,3,21,373,0,919,1,7,3,4,4,single-choice,spatial-relational,3|4,7,3/4,210373,3
1,3,21,374,1,1607,1,3,1,1,2,single-choice,spatial-relational,1|2,7,1/2,210374,1
1,3,21,375,0,563,1,5,2,3,3,single-choice,spatial-relational,2|3,7,2/3,210375,2
1,3,21,376,0,553,1,11,5,6,6,single-choice,spatial-relational,5|6,7,5/6,210376,5
1,3,21,377,0,673,1,5,2,3,3,single-choice,spatial-relational,2|3,7,2/3,210377,2
1,3,21,378,1,516,1,13,6,6,7,single-choice,spatial-relational,6|7,7,6/7,210378,6
1,3,21,379,1,721,1,9,4,4,5,single-choice,spatial-relational,4|5,7,4/5,210379,4
1,3,21,380,1,658,1,13,6,6,7,single-choice,spatial-relational,6|7,7,6/7,210380,6
1,3,21,381,1,1279,1,3,1,1,2,single-choice,spatial-relational,1|2,7,1/2,210381,1
1,3,21,382,0,755,1,11,5,6,6,single-choice,spatial-relational,5|6,7,5/6,210382,5
1,3,21,383,1,1351,1,9,4,4,5,single-choice,spatial-relational,4|5,7,4/5,210383,4
1,3,21,384,0,650,1,7,3,4,4,single-choice,spatial-relational,3|4,7,3/4,210384,3
1,3,21,385,1,882,1,13,6,6,7,single-choice,spatial-relational,6|7,7,6/7,210385,6
1,3,21,386,1,689,1,9,4,4,5,single-choice,spatial-relational,4|5,7,4/5,210386,4
1,3,21,387,0,692,1,5,2,3,3,single-choice,spatial-relational,2|3,7,2/3,210387,2
1,3,21,388,1,867,1,3,1,1,2,single-choice,spatial-relational,1|2,7,1/2,210388,1
1,3,21,389,1,743,1,13,6,6,7,single-choice,spatial-relational,6|7,7,6/7,210389,6
1,3,21,390,0,673,1,11,5,6,6,single-choice,spatial-relational,5|6,7,5/6,210390,5
1,3,21,391,0,584,1,7,3,4,4,single-choice,spatial-relational,3|4,7,3/4,210391,3
1,3,21,392,0,608,1,11,5,6,6,single-choice,spatial-relational,5|6,7,5/6,210392,5
1,3,21,393,0,1385,1,5,2,3,3,single-choice,spatial-relational,2|3,7,2/3,210393,2
1,3,21,394,1,601,1,3,1,1,2,single-choice,spatial-relational,1|2,7,1/2,210394,1
1,3,21,395,0,718,1,7,3,4,4,single-choice,spatial-relational,3|4,7,3/4,210395,3
1,3,21,396,1,40,1,9,4,4,5,single-choice,spatial-relational,4|5,7,4/5,210396,4
1,3,21,397,1,1247,1,5,2,2,3,single-choice,spatial-relational,2|3,7,2/3,210397,2
1,3,21,398,1,748,1,9,4,4,5,single-choice,spatial-relational,4|5,7,4/5,210398,4
1,3,21,399,1,842,1,3,1,1,2,single-choice,spatial-relational,1|2,7,1/2,210399,1
1,3,21,400,1,877,1,13,6,6,7,single-choice,spatial-relational,6|7,7,6/7,210400,6
1,3,21,401,0,705,1,11,5,6,6,single-choice,spatial-relational,5|6,7,5/6,210401,5
1,3,21,402,0,600,1,11,5,6,6,single-choice,spatial-relational,5|6,7,5/6,210402,5
1,3,21,403,1,642,1,9,4,4,5,single-choice,spatial-relational,4|5,7,4/5,210403,4
1,3,21,404,0,849,1,7,3,4,4,single-choice,spatial-relational,3|4,7,3/4,210404,3
1,3,21,405,0,939,1,13,6,7,7,single-choice,spatial-relational,6|7,7,6/7,210405,6
1,3,21,406,0,40,1,7,3,4,4,single-choice,spatial-relational,3|4,7,3/4,210406,3
1,3,21,407,1,1778,1,5,2,2,3,single-choice,spatial-relational,2|3,7,2/3,210407,2
1,3,21,408,1,791,1,3,1,1,2,single-choice,spatial-relational,1|2,7,1/2,210408,1
1,3,21,409,0,881,1,13,6,7,7,single-choice,spatial-relational,6|7,7,6/7,210409,6
1,3,21,410,0,544,1,5,2,3,3,single-choice,spatial-relational,2|3,7,2/3,210410,2
1,3,21,411,1,781,1,9,4,4,5,single-choice,spatial-relational,4|5,7,4/5,210411,4
1,3,21,412,0,696,1,7,3,4,4,single-choice,spatial-relational,3|4,7,3/4,210412,3
1,3,21,413,0,671,1,7,3,4,4,single-choice,spatial-relational,3|4,7,3/4,210413,3
1,3,21,414,0,498,1,11,5,6,6,single-choice,spatial-relational,5|6,7,5/6,210414,5
1,3,21,415,1,752,1,9,4,4,5,single-choice,spatial-relational,4|5,7,4/5,210415,4
1,3,21,416,1,953,1,5,2,2,3,single-choice,spatial-relational,2|3,7,2/3,210416,2
1,3,21,417,1,912,1,3,1,1,2,single-choice,spatial-relational,1|2,7,1/2,210417,1
1,3,21,418,0,721,1,13,6,7,7,single-choice,spatial-relational,6|7,7,6/7,210418,6
1,3,21,419,1,608,1,3,1,1,2,single-choice,spatial-relational,1|2,7,1/2,210419,1
1,3,21,420,0,773,1,11,5,6,6,single-choice,spatial-relational,5|6,7,5/6,210420,5
1,3,21,421,0,598,1,7,3,4,4,single-choice,spatial-relational,3|4,7,3/4,210421,3
1,3,21,422,0,725,1,5,2,3,3,single-choice,spatial-relational,2|3,7,2/3,210422,2
1,3,21,423,0,815,1,3,1,2,2,single-choice,spatial-relational,1|2,7,1/2,210423,1
1,3,21,424,1,2102,1,11,5,5,6,single-choice,spatial-relational,5|6,7,5/6,210424,5
1,3,21,425,1,623,1,9,4,4,5,single-choice,spatial-relational,4|5,7,4/5,210425,4
1,3,21,426,1,654,1,13,6,6,7,single-choice,spatial-relational,6|7,7,6/7,210426,6
1,3,21,427,1,758,1,9,4,4,5,single-choice,spatial-relational,4|5,7,4/5,210427,4
1,3,21,428,0,609,1,5,2,3,3,single-choice,spatial-relational,2|3,7,2/3,210428,2
1,3,21,429,0,898,1,7,3,4,4,single-choice,spatial-relational,3|4,7,3/4,210429,3
1,3,21,430,1,660,1,13,6,6,7,single-choice,spatial-relational,6|7,7,6/7,210430,6
1,3,21,431,0,741,1,11,5,6,6,single-choice,spatial-relational,5|6,7,5/6,210431,5
1,3,21,432,1,643,1,3,1,1,2,single-choice,spatial-relational,1|2,7,1/2,210432,1
1,3,21,433,0,841,1,13,6,7,7,single-choice,spatial-relational,6|7,7,6/7,210433,6
1,3,21,434,0,614,1,7,3,4,4,single-choice,spatial-relational,3|4,7,3/4,210434,3
1,3,21,435,0,818,1,5,2,3,3,single-choice,spatial-relational,2|3,7,2/3,210435,2
1,3,21,436,1,593,1,3,1,1,2,single-choice,spatial-relational,1|2,7,1/2,210436,1
1,3,21,437,0,674,1,11,5,6,6,single-choice,spatial-relational,5|6,7,5/6,210437,5
1,3,21,438,0,521,1,5,2,3,3,single-choice,spatial-relational,2|3,7,2/3,210438,2
1,3,21,439,1,834,1,3,1,1,2,single-choice,spatial-relational,1|2,7,1/2,210439,1
1,3,21,440,1,746,1,9,4,4,5,single-choice,spatial-relational,4|5,7,4/5,210440,4
1,3,21,441,0,676,1,11,5,6,6,single-choice,spatial-relational,5|6,7,5/6,210441,5
1,3,21,442,1,533,1,9,4,4,5,single-choice,spatial-relational,4|5,7,4/5,210442,4
1,3,21,443,0,846,1,13,6,7,7,single-choice,spatial-relational,6|7,7,6/7,210443,6
1,3,21,444,0,732,1,7,3,4,4,single-choice,spatial-relational,3|4,7,3/4,210444,3
1,3,21,445,0,704,1,11,5,6,6,single-choice,spatial-relational,5|6,7,5/6,210445,5
1,3,21,446,0,460,1,7,3,4,4,single-choice,spatial-relational,3|4,7,3/4,210446,3
1,3,21,447,0,756,1,7,3,4,4,single-choice,spatial-relational,3|4,7,3/4,210447,3
1,3,21,448,1,955,1,13,6,6,7,single-choice,spatial-relational,6|7,7,6/7,210448,6
1,3,21,449,0,717,1,11,5,6,6,single-choice,spatial-relational,5|6,7,5/6,210449,5
1,3,21,450,0,747,1,5,2,3,3,single-choice,spatial-relational,2|3,7,2/3,210450,2
1,3,21,451,0,612,1,9,4,5,5,single-choice,spatial-relational,4|5,7,4/5,210451,4
1,3,21,452,0,745,1,13,6,7,7,single-choice,spatial-relational,6|7,7,6/7,210452,6
1,3,21,453,1,1139,1,3,1,1,2,single-choice,spatial-relational,1|2,7,1/2,210453,1
1,3,21,454,1,575,1,3,1,1,2,single-choice,spatial-relational,1|2,7,1/2,210454,1
1,3,21,455,0,723,1,5,2,3,3,single-choice,spatial-relational,2|3,7,2/3,210455,2
1,3,21,456,0,654,1,9,4,5,5,single-choice,spatial-relational,4|5,7,4/5,210456,4
1,3,21,457,1,655,1,9,4,4,5,single-choice,spatial-relational,4|5,7,4/5,210457,4
1,3,21,458,1,981,1,5,2,2,3,single-choice,spatial-relational,2|3,7,2/3,210458,2
1,3,21,459,1,769,1,3,1,1,2,single-choice,spatial-relational,1|2,7,1/2,210459,1
1,3,21,460,0,545,1,7,3,4,4,single-choice,spatial-relational,3|4,7,3/4,210460,3
1,3,21,461,0,623,1,11,5,6,6,single-choice,spatial-relational,5|6,7,5/6,210461,5
1,3,21,462,0,902,1,7,3,4,4,single-choice,spatial-relational,3|4,7,3/4,210462,3
1,3,21,463,0,580,1,5,2,3,3,single-choice,spatial-relational,2|3,7,2/3,210463,2
1,3,21,464,1,573,1,3,1,1,2,single-choice,spatial-relational,1|2,7,1/2,210464,1
1,3,21,465,1,565,1,13,6,6,7,single-choice,spatial-relational,6|7,7,6/7,210465,6
1,3,21,466,1,1371,1,9,4,4,5,single-choice,spatial-relational,4|5,7,4/5,210466,4
1,3,21,467,0,1259,1,13,6,7,7,single-choice,spatial-relational,6|7,7,6/7,210467,6
1,3,21,468,0,721,1,11,5,6,6,single-choice,spatial-relational,5|6,7,5/6,210468,5
1,3,21,469,1,871,1,3,1,1,2,single-choice,spatial-relational,1|2,7,1/2,210469,1
1,3,21,470,0,552,1,7,3,4,4,single-choice,spatial-relational,3|4,7,3/4,210470,3
1,3,21,471,0,2461,1,9,4,5,5,single-choice,spatial-relational,4|5,7,4/5,210471,4
1,3,21,472,1,881,1,13,6,6,7,single-choice,spatial-relational,6|7,7,6/7,210472,6
1,3,21,473,1,624,1,3,1,1,2,single-choice,spatial-relational,1|2,7,1/2,210473,1
1,3,21,474,0,719,1,5,2,3,3,single-choice,spatial-relational,2|3,7,2/3,210474,2
1,3,21,475,1,678,1,7,3,3,4,single-choice,spatial-relational,3|4,7,3/4,210475,3
1,3,21,476,0,708,1,11,5,6,6,single-choice,spatial-relational,5|6,7,5/6,210476,5
1,3,21,477,0,552,1,5,2,3,3,single-choice,spatial-relational,2|3,7,2/3,210477,2
1,3,21,478,1,1099,1,13,6,6,7,single-choice,spatial-relational,6|7,7,6/7,210478,6
1,3,21,479,1,693,1,9,4,4,5,single-choice,spatial-relational,4|5,7,4/5,210479,4
1,3,21,480,0,674,1,11,5,6,6,single-choice,spatial-relational,5|6,7,5/6,210480,5
1,3,21,481,0,952,1,11,5,6,6,single-choice,spatial-relational,5|6,7,5/6,210481,5
1,3,21,482,1,658,1,9,4,4,5,single-choice,spatial-relational,4|5,7,4/5,210482,4
1,3,21,483,0,959,1,13,6,7,7,single-choice,spatial-relational,6|7,7,6/7,210483,6
1,3,21,484,1,755,1,3,1,1,2,single-choice,spatial-relational,1|2,7,1/2,210484,1
1,3,21,485,0,760,1,13,6,7,7,single-choice,spatial-relational,6|7,7,6/7,210485,6
1,3,21,486,0,631,1,9,4,5,5,single-choice,spatial-relational,4|5,7,4/5,210486,4
1,3,21,487,0,689,1,5,2,3,3,single-choice,spatial-relational,2|3,7,2/3,210487,2
1,3,21,488,0,877,1,5,2,3,3,single-choice,spatial-relational,2|3,7,2/3,210488,2
1,3,21,489,0,1224,1,11,5,6,6,single-choice,spatial-relational,5|6,7,5/6,210489,5
1,3,21,490,1,732,1,3,1,1,2,single-choice,spatial-relational,1|2,7,1/2,210490,1
1,3,21,491,0,632,1,7,3,4,4,single-choice,spatial-relational,3|4,7,3/4,210491,3
1,3,21,492,0,764,1,7,3,4,4,single-choice,spatial-relational,3|4,7,3/4,210492,3
1,3,21,493,1,767,1,13,6,6,7,single-choice,spatial-relational,6|7,7,6/7,210493,6
1,3,21,494,0,908,1,7,3,4,4,single-choice,spatial-relational,3|4,7,3/4,210494,3
1,3,21,495,1,1191,1,13,6,6,7,single-choice,spatial-relational,6|7,7,6/7,210495,6
1,3,21,496,1,705,1,9,4,4,5,single-choice,spatial-relational,4|5,7,4/5,210496,4
1,3,21,497,0,654,1,11,5,6,6,single-choice,spatial-relational,5|6,7,5/6,210497,5
1,3,21,498,1,914,1,9,4,4,5,single-choice,spatial-relational,4|5,7,4/5,210498,4
1,3,21,499,0,825,1,3,1,2,2,single-choice,spatial-relational,1|2,7,1/2,210499,1
1,3,21,500,0,779,1,5,2,3,3,single-choice,spatial-relational,2|3,7,2/3,210500,2
1,3,21,501,1,513,1,3,1,1,2,single-choice,spatial-relational,1|2,7,1/2,210501,1
1,3,21,502,0,639,1,5,2,3,3,single-choice,spatial-relational,2|3,7,2/3,210502,2
1,3,21,503,0,942,1,11,5,6,6,single-choice,spatial-relational,5|6,7,5/6,210503,5
1,3,21,504,0,470,1,7,3,4,4,single-choice,spatial-relational,3|4,7,3/4,210504,3
1,3,21,505,1,657,1,13,6,6,7,single-choice,spatial-relational,6|7,7,6/7,210505,6
1,3,21,506,1,731,1,9,4,4,5,single-choice,spatial-relational,4|5,7,4/5,210506,4
1,3,21,507,1,553,1,9,4,4,5,single-choice,spatial-relational,4|5,7,4/5,210507,4
1,3,21,508,1,947,1,5,2,2,3,single-choice,spatial-relational,2|3,7,2/3,210508,2
1,3,21,509,0,505,1,7,3,4,4,single-choice,spatial-relational,3|4,7,3/4,210509,3
1,3,21,510,0,643,1,11,5,6,6,single-choice,spatial-relational,5|6,7,5/6,210510,5
1,3,21,511,0,713,1,5,2,3,3,single-choice,spatial-relational,2|3,7,2/3,210511,2
1,3,21,512,0,571,1,7,3,4,4,single-choice,spatial-relational,3|4,7,3/4,210512,3
1,3,21,513,0,688,1,11,5,6,6,single-choice,spatial-relational,5|6,7,5/6,210513,5
1,3,21,514,0,776,1,3,1,2,2,single-choice,spatial-relational,1|2,7,1/2,210514,1
1,3,21,515,1,654,1,3,1,1,2,single-choice,spatial-relational,1|2,7,1/2,210515,1
1,3,21,516,1,595,1,13,6,6,7,single-choice,spatial-relational,6|7,7,6/7,210516,6
1,3,21,517,1,822,1,13,6,6,7,single-choice,spatial-relational,6|7,7,6/7,210517,6
1,3,21,518,1,565,1,13,6,6,7,single-choice,spatial-relational,6|7,7,6/7,210518,6
1,3,21,519,1,835,1,3,1,1,2,single-choice,spatial-relational,1|2,7,1/2,210519,1
1,3,21,520,0,1278,1,9,4,5,5,single-choice,spatial-relational,4|5,7,4/5,210520,4
1,3,21,521,0,820,1,5,2,3,3,single-choice,spatial-relational,2|3,7,2/3,210521,2
1,3,21,522,1,505,1,3,1,1,2,single-choice,spatial-relational,1|2,7,1/2,210522,1
1,3,21,523,1,646,1,9,4,4,5,single-choice,spatial-relational,4|5,7,4/5,210523,4
1,3,21,524,0,794,1,7,3,4,4,single-choice,spatial-relational,3|4,7,3/4,210524,3
1,3,21,525,0,793,1,11,5,6,6,single-choice,spatial-relational,5|6,7,5/6,210525,5
1,3,21,526,0,451,1,7,3,4,4,single-choice,spatial-relational,3|4,7,3/4,210526,3
1,3,21,527,0,553,1,11,5,6,6,single-choice,spatial-relational,5|6,7,5/6,210527,5
1,3,21,528,0,505,1,5,2,3,3,single-choice,spatial-relational,2|3,7,2/3,210528,2
1,3,21,529,0,953,1,5,2,3,3,single-choice,spatial-relational,2|3,7,2/3,210529,2
1,3,21,530,0,716,1,3,1,2,2,single-choice,spatial-relational,1|2,7,1/2,210530,1
1,3,21,531,1,752,1,13,6,6,7,single-choice,spatial-relational,6|7,7,6/7,210531,6
1,3,21,532,1,601,1,9,4,4,5,single-choice,spatial-relational,4|5,7,4/5,210532,4
1,3,21,533,0,687,1,11,5,6,6,single-choice,spatial-relational,5|6,7,5/6,210533,5
1,3,21,534,0,868,1,11,5,6,6,single-choice,spatial-relational,5|6,7,5/6,210534,5
1,3,21,535,0,550,1,7,3,4,4,single-choice,spatial-relational,3|4,7,3/4,210535,3
1,3,21,536,1,875,1,9,4,4,5,single-choice,spatial-relational,4|5,7,4/5,210536,4
1,3,21,537,0,1529,1,13,6,7,7,single-choice,spatial-relational,6|7,7,6/7,210537,6
1,3,21,538,1,762,1,7,3,3,4,single-choice,spatial-relational,3|4,7,3/4,210538,3
1,3,21,539,0,1038,1,3,1,2,2,single-choice,spatial-relational,1|2,7,1/2,210539,1
1,3,21,540,0,778,1,5,2,3,3,single-choice,spatial-relational,2|3,7,2/3,210540,2
1,3,21,541,0,652,1,7,3,4,4,single-choice,spatial-relational,3|4,7,3/4,210541,3
1,3,21,542,1,842,1,3,1,1,2,single-choice,spatial-relational,1|2,7,1/2,210542,1
1,3,21,543,1,538,1,3,1,1,2,single-choice,spatial-relational,1|2,7,1/2,210543,1
1,3,21,544,0,793,1,5,2,3,3,single-choice,spatial-relational,2|3,7,2/3,210544,2
1,3,21,545,1,834,1,9,4,4,5,single-choice,spatial-relational,4|5,7,4/5,210545,4
1,3,21,546,0,728,1,11,5,6,6,single-choice,spatial-relational,5|6,7,5/6,210546,5
1,3,21,547,1,927,1,13,6,6,7,single-choice,spatial-relational,6|7,7,6/7,210547,6
1,3,21,548,1,804,1,9,4,4,5,single-choice,spatial-relational,4|5,7,4/5,210548,4
1,3,21,549,0,920,1,13,6,7,7,single-choice,spatial-relational,6|7,7,6/7,210549,6
1,3,21,550,0,728,1,11,5,6,6,single-choice,spatial-relational,5|6,7,5/6,210550,5
1,3,21,551,0,680,1,5,2,3,3,single-choice,spatial-relational,2|3,7,2/3,210551,2
1,3,21,552,0,533,1,7,3,4,4,single-choice,spatial-relational,3|4,7,3/4,210552,3
1,3,21,553,0,804,1,5,2,3,3,single-choice,spatial-relational,2|3,7,2/3,210553,2
1,3,21,554,1,835,1,3,1,1,2,single-choice,spatial-relational,1|2,7,1/2,210554,1
1,3,21,555,0,580,1,11,5,6,6,single-choice,spatial-relational,5|6,7,5/6,210555,5
1,3,21,556,0,716,1,11,5,6,6,single-choice,spatial-relational,5|6,7,5/6,210556,5
1,3,21,557,1,912,1,9,4,4,5,single-choice,spatial-relational,4|5,7,4/5,210557,4
1,3,21,558,0,791,1,13,6,7,7,single-choice,spatial-relational,6|7,7,6/7,210558,6
1,3,21,559,1,705,1,7,3,3,4,single-choice,spatial-relational,3|4,7,3/4,210559,3
1,3,21,560,0,650,1,7,3,4,4,single-choice,spatial-relational,3|4,7,3/4,210560,3
1,3,21,561,0,40,1,13,6,7,7,single-choice,spatial-relational,6|7,7,6/7,210561,6
1,3,21,562,1,604,1,3,1,1,2,single-choice,spatial-relational,1|2,7,1/2,210562,1
1,3,21,563,1,1040,1,9,4,4,5,single-choice,spatial-relational,4|5,7,4/5,210563,4
1,3,21,564,1,951,1,5,2,2,3,single-choice,spatial-relational,2|3,7,2/3,210564,2
1,3,21,565,1,1007,1,5,2,2,3,single-choice,spatial-relational,2|3,7,2/3,210565,2
1,3,21,566,0,872,1,3,1,2,2,single-choice,spatial-relational,1|2,7,1/2,210566,1
1,3,21,567,0,591,1,7,3,4,4,single-choice,spatial-relational,3|4,7,3/4,210567,3
1,3,21,568,0,766,1,5,2,3,3,single-choice,spatial-relational,2|3,7,2/3,210568,2
1,3,21,569,1,1210,1,11,5,5,6,single-choice,spatial-relational,5|6,7,5/6,210569,5
1,3,21,570,1,860,1,11,5,5,6,single-choice,spatial-relational,5|6,7,5/6,210570,5
1,3,21,571,0,751,1,13,6,7,7,single-choice,spatial-relational,6|7,7,6/7,210571,6
1,3,21,572,1,761,1,3,1,1,2,single-choice,spatial-relational,1|2,7,1/2,210572,1
1,3,21,573,1,775,1,9,4,4,5,single-choice,spatial-relational,4|5,7,4/5,210573,4
1,3,21,574,0,509,1,7,3,4,4,single-choice,spatial-relational,3|4,7,3/4,210574,3
1,3,21,575,1,761,1,13,6,6,7,single-choice,spatial-relational,6|7,7,6/7,210575,6
1,3,21,576,1,560,1,9,4,4,5,single-choice,spatial-relational,4|5,7,4/5,210576,4
1,3,21,577,1,791,1,13,6,6,7,single-choice,spatial-relational,6|7,7,6/7,210577,6
1,3,21,578,0,782,1,7,3,4,4,single-choice,spatial-relational,3|4,7,3/4,210578,3
1,3,21,579,1,687,1,9,4,4,5,single-choice,spatial-relational,4|5,7,4/5,210579,4
1,3,21,580,0,612,1,7,3,4,4,single-choice,spatial-relational,3|4,7,3/4,210580,3
1,3,21,581,0,735,1,5,2,3,3,single-choice,spatial-relational,2|3,7,2/3,210581,2
1,3,21,582,0,720,1,3,1,2,2,single-choice,spatial-relational,1|2,7,1/2,210582,1
1,3,21,583,0,740,1,11,5,6,6,single-choice,spatial-relational,5|6,7,5/6,210583,5
1,3,21,584,0,774,1,13,6,7,7,single-choice,spatial-relational,6|7,7,6/7,210584,6
1,3,21,585,0,604,1,5,2,3,3,single-choice,spatial-relational,2|3,7,2/3,210585,2
1,3,21,586,0,713,1,11,5,6,6,single-choice,spatial-relational,5|6,7,5/6,210586,5
1,3,21,587,0,623,1,9,4,5,5,single-choice,spatial-relational,4|5,7,4/5,210587,4
1,3,21,588,1,575,1,3,1,1,2,single-choice,spatial-relational,1|2,7,1/2,210588,1
1,3,21,589,1,765,1,3,1,1,2,single-choice,spatial-relational,1|2,7,1/2,210589,1
1,3,21,590,0,672,1,11,5,6,6,single-choice,spatial-relational,5|6,7,5/6,210590,5
1,3,21,591,1,705,1,13,6,6,7,single-choice,spatial-relational,6|7,7,6/7,210591,6
1,3,21,592,0,937,1,11,5,6,6,single-choice,spatial-relational,5|6,7,5/6,210592,5
1,3,21,593,1,615,1,13,6,6,7,single-choice,spatial-relational,6|7,7,6/7,210593,6
1,3,21,594,0,642,1,7,3,4,4,single-choice,spatial-relational,3|4,7,3/4,210594,3
1,3,21,595,0,597,1,5,2,3,3,single-choice,spatial-relational,2|3,7,2/3,210595,2
1,3,21,596,0,1061,1,9,4,5,5,single-choice,spatial-relational,4|5,7,4/5,210596,4
1,3,21,597,1,833,1,9,4,4,5,single-choice,spatial-relational,4|5,7,4/5,210597,4
1,3,21,598,1,777,1,7,3,3,4,single-choice,spatial-relational,3|4,7,3/4,210598,3
1,3,21,599,1,623,1,3,1,1,2,single-choice,spatial-relational,1|2,7,1/2,210599,1
1,3,21,600,0,748,1,5,2,3,3,single-choice,spatial-relational,2|3,7,2/3,210600,2
2,3,21,1,0,1011,1,3,1,2,2,single-choice,spatial-relational,1|2,7,1/2,210001,1
2,3,21,2,1,19867,1,3,1,1,2,single-choice,spatial-relational,1|2,7,1/2,210002,1
2,3,21,3,1,874,1,9,4,4,5,single-choice,spatial-relational,4|5,7,4/5,210003,4
2,3,21,4,0,672,1,7,3,4,4,single-choice,spatial-relational,3|4,7,3/4,210004,3
2,3,21,5,1,651,1,9,4,4,5,single-choice,spatial-relational,4|5,7,4/5,210005,4
2,3,21,6,0,519,1,11,5,6,6,single-choice,spatial-relational,5|6,7,5/6,210006,5
2,3,21,7,0,545,1,11,5,6,6,single-choice,spatial-relational,5|6,7,5/6,210007,5
2,3,21,8,0,580,1,5,2,3,3,single-choice,spatial-relational,2|3,7,2/3,210008,2
2,3,21,9,1,1227,1,13,6,6,7,single-choice,spatial-relational,6|7,7,6/7,210009,6
2,3,21,10,0,518,1,5,2,3,3,single-choice,spatial-relational,2|3,7,2/3,210010,2
2,3,21,11,0,459,1,7,3,4,4,single-choice,spatial-relational,3|4,7,3/4,210011,3
2,3,21,12,1,631,1,13,6,6,7,single-choice,spatial-relational,6|7,7,6/7,210012,6
2,3,21,13,0,1249,1,5,2,3,3,single-choice,spatial-relational,2|3,7,2/3,210013,2
2,3,21,14,0,611,1,11,5,6,6,single-choice,spatial-relational,5|6,7,5/6,210014,5
2,3,21,15,0,532,1,9,4,5,5,single-choice,spatial-relational,4|5,7,4/5,210015,4
2,3,21,16,0,441,1,5,2,3,3,single-choice,spatial-relational,2|3,7,2/3,210016,2
2,3,21,17,0,564,1,11,5,6,6,single-choice,spatial-relational,5|6,7,5/6,210017,5
2,3,21,18,1,478,1,3,1,1,2,single-choice,spatial-relational,1|2,7,1/2,210018,1
2,3,21,19,0,619,1,7,3,4,4,single-choice,spatial-relational,3|4,7,3/4,210019,3
2,3,21,20,1,591,1,13,6,6,7,single-choice,spatial-relational,6|7,7,6/7,210020,6
2,3,21,21,0,585,1,3,1,2,2,single-choice,spatial-relational,1|2,7,1/2,210021,1
2,3,21,22,0,457,1,7,3,4,4,single-choice,spatial-relational,3|4,7,3/4,210022,3
2,3,21,23,0,665,1,9,4,5,5,single-choice,spatial-relational,4|5,7,4/5,210023,4
2,3,21,24,1,499,1,13,6,6,7,single-choice,spatial-relational,6|7,7,6/7,210024,6
2,3,21,25,0,506,1,7,3,4,4,single-choice,spatial-relational,3|4,7,3/4,210025,3
2,3,21,26,1,600,1,9,4,4,5,single-choice,spatial-relational,4|5,7,4/5,210026,4
2,3,21,27,1,501,1,13,6,6,7,single-choice,spatial-relational,6|7,7,6/7,210027,6
2,3,21,28,1,647,1,9,4,4,5,single-choice,spatial-relational,4|5,7,4/5,210028,4
2,3,21,29,0,999,1,5,2,3,3,single-choice,spatial-relational,2|3,7,2/3,210029,2
2,3,21,30,1,550,1,13,6,6,7,single-choice,spatial-relational,6|7,7,6/7,210030,6
2,3,21,31,1,646,1,3,1,1,2,single-choice,spatial-relational,1|2,7,1/2,210031,1
2,3,21,32,0,564,1,11,5,6,6,single-choice,spatial-relational,5|6,7,5/6,210032,5
2,3,21,33,0,583,1,11,5,6,6,single-choice,spatial-relational,5|6,7,5/6,210033,5
2,3,21,34,0,594,1,3,1,2,2,single-choice,spatial-relational,1|2,7,1/2,210034,1
2,3,21,35,0,556,1,5,2,3,3,single-choice,spatial-relational,2|3,7,2/3,210035,2
2,3,21,36,0,553,1,7,3,4,4,single-choice,spatial-relational,3|4,7,3/4,210036,3
2,3,21,37,1,659,1,13,6,6,7,single-choice,spatial-relational,6|7,7,6/7,210037,6
2,3,21,38,0,884,1,7,3,4,4,single-choice,spatial-relational,3|4,7,3/4,210038,3
2,3,21,39,0,550,1,3,1,2,2,single-choice,spatial-relational,1|2,7,1/2,210039,1
2,3,21,40,1,686,1,3,1,1,2,single-choice,spatial-relational,1|2,7,1/2,210040,1
2,3,21,41,0,483,1,9,4,5,5,single-choice,spatial-relational,4|5,7,4/5,210041,4
2,3,21,42,0,564,1,11,5,6,6,single-choice,spatial-relational,5|6,7,5/6,210042,5
2,3,21,43,1,455,1,9,4,4,5,single-choice,spatial-relational,4|5,7,4/5,210043,4
2,3,21,44,0,486,1,7,3,4,4,single-choice,spatial-relational,3|4,7,3/4,210044,3
2,3,21,45,1,611,1,13,6,6,7,single-choice,spatial-relational,6|7,7,6/7,210045,6
2,3,21,46,0,567,1,5,2,3,3,single-choice,spatial-relational,2|3,7,2/3,210046,2
2,3,21,47,0,489,1,11,5,6,6,single-choice,spatial-relational,5|6,7,5/6,210047,5
2,3,21,48,0,736,1,5,2,3,3,single-choice,spatial-relational,2|3,7,2/3,210048,2
2,3,21,49,0,609,1,3,1,2,2,single-choice,spatial-relational,1|2,7,1/2,210049,1
2,3,21,50,1,776,1,9,4,4,5,single-choice,spatial-relational,4|5,7,4/5,210050,4
2,3,21,51,0,746,1,5,2,3,3,single-choice,spatial-relational,2|3,7,2/3,210051,2
2,3,21,52,0,436,1,7,3,4,4,single-choice,spatial-relational,3|4,7,3/4,210052,3
2,3,21,53,0,697,1,9,4,5,5,single-choice,spatial-relational,4|5,7,4/5,210053,4
2,3,21,54,0,494,1,7,3,4,4,single-choice,spatial-relational,3|4,7,3/4,210054,3
2,3,21,55,0,490,1,5,2,3,3,single-choice,spatial-relational,2|3,7,2/3,210055,2
2,3,21,56,0,502,1,11,5,6,6,single-choice,spatial-relational,5|6,7,5/6,210056,5
2,3,21,57,1,479,1,3,1,1,2,single-choice,spatial-relational,1|2,7,1/2,210057,1
2,3,21,58,1,463,1,13,6,6,7,single-choice,spatial-relational,6|7,7,6/7,210058,6
2,3,21,59,0,552,1,11,5,6,6,single-choice,spatial-relational,5|6,7,5/6,210059,5
2,3,21,60,1,527,1,13,6,6,7,single-choice,spatial-relational,6|7,7,6/7,210060,6
2,3,21,61,1,631,1,9,4,4,5,single-choice,spatial-relational,4|5,7,4/5,210061,4
2,3,21,62,0,669,1,5,2,3,3,single-choice,spatial-relational,2|3,7,2/3,210062,2
2,3,21,63,1,866,1,9,4,4,5,single-choice,spatial-relational,4|5,7,4/5,210063,4
2,3,21,64,1,603,1,13,6,6,7,single-choice,spatial-relational,6|7,7,6/7,210064,6
2,3,21,65,0,588,1,7,3,4,4,single-choice,spatial-relational,3|4,7,3/4,210065,3
2,3,21,66,0,463,1,11,5,6,6,single-choice,spatial-relational,5|6,7,5/6,210066,5
2,3,21,67,1,165,1,3,1,1,2,single-choice,spatial-relational,1|2,7,1/2,210067,1
2,3,21,68,1,730,1,3,1,1,2,single-choice,spatial-relational,1|2,7,1/2,210068,1
2,3,21,69,0,689,1,5,2,3,3,single-choice,spatial-relational,2|3,7,2/3,210069,2
2,3,21,70,0,537,1,11,5,6,6,single-choice,spatial-relational,5|6,7,5/6,210070,5
2,3,21,71,0,599,1,7,3,4,4,single-choice,spatial-relational,3|4,7,3/4,210071,3
2,3,21,72,1,670,1,13,6,6,7,single-choice,spatial-relational,6|7,7,6/7,210072,6
2,3,21,73,1,650,1,13,6,6,7,single-choice,spatial-relational,6|7,7,6/7,210073,6
2,3,21,74,1,525,1,13,6,6,7,single-choice,spatial-relational,6|7,7,6/7,210074,6
2,3,21,75,1,1278,1,5,2,2,3,single-choice,spatial-relational,2|3,7,2/3,210075,2
2,3,21,76,0,716,1,7,3,4,4,single-choice,spatial-relational,3|4,7,3/4,210076,3
2,3,21,77,1,751,1,7,3,3,4,single-choice,spatial-relational,3|4,7,3/4,210077,3
2,3,21,78,0,584,1,11,5,6,6,single-choice,spatial-relational,5|6,7,5/6,210078,5
2,3,21,79,1,501,1,9,4,4,5,single-choice,spatial-relational,4|5,7,4/5,210079,4
2,3,21,80,1,634,1,3,1,1,2,single-choice,spatial-relational,1|2,7,1/2,210080,1
2,3,21,81,1,684,1,9,4,4,5,single-choice,spatial-relational,4|5,7,4/5,210081,4
2,3,21,82,1,699,1,3,1,1,2,single-choice,spatial-relational,1|2,7,1/2,210082,1
2,3,21,83,0,742,1,5,2,3,3,single-choice,spatial-relational,2|3,7,2/3,210083,2
2,3,21,84,0,474,1,11,5,6,6,single-choice,spatial-relational,5|6,7,5/6,210084,5
2,3,21,85,1,494,1,13,6,6,7,single-choice,spatial-relational,6|7,7,6/7,210085,6
2,3,21,86,0,640,1,5,2,3,3,single-choice,spatial-relational,2|3,7,2/3,210086,2
2,3,21,87,1,751,1,9,4,4,5,single-choice,spatial-relational,4|5,7,4/5,210087,4
2,3,21,88,1,790,1,3,1,1,2,single-choice,spatial-relational,1|2,7,1/2,210088,1
2,3,21,89,0,502,1,11,5,6,6,single-choice,spatial-relational,5|6,7,5/6,210089,5
2,3,21,90,1,607,1,13,6,6,7,single-choice,spatial-relational,6|7,7,6/7,210090,6
2,3,21,91,0,661,1,11,5,6,6,single-choice,spatial-relational,5|6,7,5/6,210091,5
2,3,21,92,0,799,1,5,2,3,3,single-choice,spatial-relational,2|3,7,2/3,210092,2
2,3,21,93,1,757,1,3,1,1,2,single-choice,spatial-relational,1|2,7,1/2,210093,1
2,3,21,94,0,619,1,7,3,4,4,single-choice,spatial-relational,3|4,7,3/4,210094,3
2,3,21,95,0,440,1,7,3,4,4,single-choice,spatial-relational,3|4,7,3/4,210095,3
2,3,21,96,1,881,1,9,4,4,5,single-choice,spatial-relational,4|5,7,4/5,210096,4
2,3,21,97,0,568,1,5,2,3,3,single-choice,spatial-relational,2|3,7,2/3,210097,2
2,3,21,98,0,776,1,9,4,5,5,single-choice,spatial-relational,4|5,7,4/5,210098,4
2,3,21,99,1,760,1,3,1,1,2,single-choice,spatial-relational,1|2,7,1/2,210099,1
2,3,21,100,1,572,1,13,6,6,7,single-choice,spatial-relational,6|7,7,6/7,210100,6
2,3,21,101,0,937,1,7,3,4,4,single-choice,spatial-relational,3|4,7,3/4,210101,3
2,3,21,102,1,665,1,3,1,1,2,single-choice,spatial-relational,1|2,7,1/2,210102,1
2,3,21,103,0,642,1,11,5,6,6,single-choice,spatial-relational,5|6,7,5/6,210103,5
2,3,21,104,1,659,1,13,6,6,7,single-choice,spatial-relational,6|7,7,6/7,210104,6
2,3,21,105,0,591,1,7,3,4,4,single-choice,spatial-relational,3|4,7,3/4,210105,3
2,3,21,106,0,502,1,11,5,6,6,single-choice,spatial-relational,5|6,7,5/6,210106,5
2,3,21,107,1,659,1,9,4,4,5,single-choice,spatial-relational,4|5,7,4/5,210107,4
2,3,21,108,0,709,1,5,2,3,3,single-choice,spatial-relational,2|3,7,2/3,210108,2
2,3,21,109,1,813,1,9,4,4,5,single-choice,spatial-relational,4|5,7,4/5,210109,4
2,3,21,110,1,733,1,3,1,1,2,single-choice,spatial-relational,1|2,7,1/2,210110,1
2,3,21,111,0,502,1,11,5,6,6,single-choice,spatial-relational,5|6,7,5/6,210111,5
2,3,21,112,0,534,1,11,5,6,6,single-choice,spatial-relational,5|6,7,5/6,210112,5
2,3,21,113,1,486,1,13,6,6,7,single-choice,spatial-relational,6|7,7,6/7,210113,6
2,3,21,114,0,693,1,5,2,3,3,single-choice,spatial-relational,2|3,7,2/3,210114,2
2,3,21,115,1,823,1,13,6,6,7,single-choice,spatial-relational,6|7,7,6/7,210115,6
2,3,21,116,0,874,1,7,3,4,4,single-choice,spatial-relational,3|4,7,3/4,210116,3
2,3,21,117,0,783,1,3,1,2,2,single-choice,spatial-relational,1|2,7,1/2,210117,1
2,3,21,118,0,693,1,5,2,3,3,single-choice,spatial-relational,2|3,7,2/3,210118,2
2,3,21,119,1,792,1,9,4,4,5,single-choice,spatial-relational,4|5,7,4/5,210119,4
2,3,21,120,0,544,1,7,3,4,4,single-choice,spatial-relational,3|4,7,3/4,210120,3
2,3,21,121,0,871,1,7,3,4,4,single-choice,spatial-relational,3|4,7,3/4,210121,3
2,3,21,122,1,758,1,13,6,6,7,single-choice,spatial-relational,6|7,7,6/7,210122,6
2,3,21,123,0,537,1,11,5,6,6,single-choice,spatial-relational,5|6,7,5/6,210123,5
2,3,21,124,0,779,1,5,2,3,3,single-choice,spatial-relational,2|3,7,2/3,210124,2
2,3,21,125,0,597,1,11,5,6,6,single-choice,spatial-relational,5|6,7,5/6,210125,5
2,3,21,126,1,571,1,13,6,6,7,single-choice,spatial-relational,6|7,7,6/7,210126,6
2,3,21,127,1,811,1,3,1,1,2,single-choice,spatial-relational,1|2,7,1/2,210127,1
2,3,21,128,0,724,1,5,2,3,3,single-choice,spatial-relational,2|3,7,2/3,210128,2
2,3,21,129,0,604,1,7,3,4,4,single-choice,spatial-relational,3|4,7,3/4,210129,3
2,3,21,130,1,655,1,3,1,1,2,single-choice,spatial-relational,1|2,7,1/2,210130,1
2,3,21,131,1,681,1,9,4,4,5,single-choice,spatial-relational,4|5,7,4/5,210131,4
2,3,21,132,1,795,1,9,4,4,5,single-choice,spatial-relational,4|5,7,4/5,210132,4
2,3,21,133,1,1186,1,5,2,2,3,single-choice,spatial-relational,2|3,7,2/3,210133,2
2,3,21,134,1,646,1,3,1,1,2,single-choice,spatial-relational,1|2,7,1/2,210134,1
2,3,21,135,0,525,1,7,3,4,4,single-choice,spatial-relational,3|4,7,3/4,210135,3
2,3,21,136,0,552,1,11,5,6,6,single-choice,spatial-relational,5|6,7,5/6,210136,5
2,3,21,137,1,709,1,3,1,1,2,single-choice,spatial-relational,1|2,7,1/2,210137,1
2,3,21,138,1,682,1,13,6,6,7,single-choice,spatial-relational,6|7,7,6/7,210138,6
2,3,21,139,0,860,1,7,3,4,4,single-choice,spatial-relational,3|4,7,3/4,210139,3
2,3,21,140,1,657,1,5,2,2,3,single-choice,spatial-relational,2|3,7,2/3,210140,2
2,3,21,141,1,611,1,9,4,4,5,single-choice,spatial-relational,4|5,7,4/5,210141,4
2,3,21,142,1,748,1,9,4,4,5,single-choice,spatial-relational,4|5,7,4/5,210142,4
2,3,21,143,1,934,1,13,6,6,7,single-choice,spatial-relational,6|7,7,6/7,210143,6
2,3,21,144,0,644,1,11,5,6,6,single-choice,spatial-relational,5|6,7,5/6,210144,5
2,3,21,145,1,705,1,3,1,1,2,single-choice,spatial-relational,1|2,7,1/2,210145,1
2,3,21,146,0,662,1,5,2,3,3,single-choice,spatial-relational,2|3,7,2/3,210146,2
2,3,21,147,1,593,1,13,6,6,7,single-choice,spatial-relational,6|7,7,6/7,210147,6
2,3,21,148,0,849,1,11,5,6,6,single-choice,spatial-relational,5|6,7,5/6,210148,5
2,3,21,149,0,480,1,5,2,3,3,single-choice,spatial-relational,2|3,7,2/3,210149,2
2,3,21,150,1,674,1,7,3,3,4,single-choice,spatial-relational,3|4,7,3/4,210150,3
2,3,21,151,1,811,1,9,4,4,5,single-choice,spatial-relational,4|5,7,4/5,210151,4
2,3,21,152,0,563,1,7,3,4,4,single-choice,spatial-relational,3|4,7,3/4,210152,3
2,3,21,153,1,778,1,13,6,6,7,single-choice,spatial-relational,6|7,7,6/7,210153,6
2,3,21,154,1,2546,1,9,4,4,5,single-choice,spatial-relational,4|5,7,4/5,210154,4
2,3,21,155,1,780,1,3,1,1,2,single-choice,spatial-relational,1|2,7,1/2,210155,1
2,3,21,156,0,541,1,11,5,6,6,single-choice,spatial-relational,5|6,7,5/6,210156,5
2,3,21,157,1,566,1,13,6,6,7,single-choice,spatial-relational,6|7,7,6/7,210157,6
2,3,21,158,1,730,1,9,4,4,5,single-choice,spatial-relational,4|5,7,4/5,210158,4
2,3,21,159,1,741,1,13,6,6,7,single-choice,spatial-relational,6|7,7,6/7,210159,6
2,3,21,160,0,654,1,5,2,3,3,single-choice,spatial-relational,2|3,7,2/3,210160,2
2,3,21,161,1,736,1,9,4,4,5,single-choice,spatial-relational,4|5,7,4/5,210161,4
2,3,21,162,0,661,1,11,5,6,6,single-choice,spatial-relational,5|6,7,5/6,210162,5
2,3,21,163,0,563,1,3,1,2,2,single-choice,spatial-relational,1|2,7,1/2,210163,1
2,3,21,164,0,593,1,11,5,6,6,single-choice,spatial-relational,5|6,7,5/6,210164,5
2,3,21,165,1,574,1,3,1,1,2,single-choice,spatial-relational,1|2,7,1/2,210165,1
2,3,21,166,0,570,1,7,3,4,4,single-choice,spatial-relational,3|4,7,3/4,210166,3
2,3,21,167,0,708,1,7,3,4,4,single-choice,spatial-relational,3|4,7,3/4,210167,3
2,3,21,168,0,711,1,5,2,3,3,single-choice,spatial-relational,2|3,7,2/3,210168,2
2,3,21,169,1,572,1,5,2,2,3,single-choice,spatial-relational,2|3,7,2/3,210169,2
2,3,21,170,0,665,1,9,4,5,5,single-choice,spatial-relational,4|5,7,4/5,210170,4
2,3,21,171,1,607,1,9,4,4,5,single-choice,spatial-relational,4|5,7,4/5,210171,4
2,3,21,172,0,594,1,11,5,6,6,single-choice,spatial-relational,5|6,7,5/6,210172,5
2,3,21,173,1,498,1,13,6,6,7,single-choice,spatial-relational,6|7,7,6/7,210173,6
2,3,21,174,0,608,1,7,3,4,4,single-choice,spatial-relational,3|4,7,3/4,210174,3
2,3,21,175,0,630,1,11,5,6,6,single-choice,spatial-relational,5|6,7,5/6,210175,5
2,3,21,176,1,1239,1,13,6,6,7,single-choice,spatial-relational,6|7,7,6/7,210176,6
2,3,21,177,1,792,1,3,1,1,2,single-choice,spatial-relational,1|2,7,1/2,210177,1
2,3,21,178,0,818,1,7,3,4,4,single-choice,spatial-relational,3|4,7,3/4,210178,3
2,3,21,179,1,981,1,3,1,1,2,single-choice,spatial-relational,1|2,7,1/2,210179,1
2,3,21,180,0,513,1,5,2,3,3,single-choice,spatial-relational,2|3,7,2/3,210180,2
2,3,21,181,0,478,1,11,5,6,6,single-choice,spatial-relational,5|6,7,5/6,210181,5
2,3,21,182,0,620,1,11,5,6,6,single-choice,spatial-relational,5|6,7,5/6,210182,5
2,3,21,183,0,435,1,3,1,2,2,single-choice,spatial-relational,1|2,7,1/2,210183,1
2,3,21,184,1,744,1,7,3,3,4,single-choice,spatial-relational,3|4,7,3/4,210184,3
2,3,21,185,1,607,1,13,6,6,7,single-choice,spatial-relational,6|7,7,6/7,210185,6
2,3,21,186,1,740,1,9,4,4,5,single-choice,spatial-relational,4|5,7,4/5,210186,4
2,3,21,187,0,921,1,3,1,2,2,single-choice,spatial-relational,1|2,7,1/2,210187,1
2,3,21,188,0,502,1,5,2,3,3,single-choice,spatial-relational,2|3,7,2/3,210188,2
2,3,21,189,0,480,1,7,3,4,4,single-choice,spatial-relational,3|4,7,3/4,210189,3
2,3,21,190,0,806,1,5,2,3,3,single-choice,spatial-relational,2|3,7,2/3,210190,2
2,3,21,191,1,815,1,9,4,4,5,single-choice,spatial-relational,4|5,7,4/5,210191,4
2,3,21,192,1,1031,1,13,6,6,7,single-choice,spatial-relational,6|7,7,6/7,210192,6
2,3,21,193,0,665,1,7,3,4,4,single-choice,spatial-relational,3|4,7,3/4,210193,3
2,3,21,194,0,467,1,5,2,3,3,single-choice,spatial-relational,2|3,7,2/3,210194,2
2,3,21,195,0,849,1,7,3,4,4,single-choice,spatial-relational,3|4,7,3/4,210195,3
2,3,21,196,0,475,1,3,1,2,2,single-choice,spatial-relational,1|2,7,1/2,210196,1
2,3,21,197,1,636,1,3,1,1,2,single-choice,spatial-relational,1|2,7,1/2,210197,1
2,3,21,198,0,583,1,11,5,6,6,single-choice,spatial-relational,5|6,7,5/6,210198,5
2,3,21,199,1,574,1,13,6,6,7,single-choice,spatial-relational,6|7,7,6/7,210199,6
2,3,21,200,1,908,1,13,6,6,7,single-choice,spatial-relational,6|7,7,6/7,210200,6
2,3,21,201,0,731,1,11,5,6,6,single-choice,spatial-relational,5|6,7,5/6,210201,5
2,3,21,202,0,885,1,5,2,3,3,single-choice,spatial-relational,2|3,7,2/3,210202,2
2,3,21,203,1,752,1,9,4,4,5,single-choice,spatial-relational,4|5,7,4/5,210203,4
2,3,21,204,1,707,1,9,4,4,5,single-choice,spatial-relational,4|5,7,4/5,210204,4
2,3,21,205,0,833,1,5,2,3,3,single-choice,spatial-relational,2|3,7,2/3,210205,2
2,3,21,206,1,756,1,3,1,1,2,single-choice,spatial-relational,1|2,7,1/2,210206,1
2,3,21,207,0,631,1,11,5,6,6,single-choice,spatial-relational,5|6,7,5/6,210207,5
2,3,21,208,0,599,1,13,6,7,7,single-choice,spatial-relational,6|7,7,6/7,210208,6
2,3,21,209,1,536,1,9,4,4,5,single-choice,spatial-relational,4|5,7,4/5,210209,4
2,3,21,210,1,620,1,13,6,6,7,single-choice,spatial-relational,6|7,7,6/7,210210,6
2,3,21,211,0,720,1,5,2,3,3,single-choice,spatial-relational,2|3,7,2/3,210211,2
2,3,21,212,1,698,1,9,4,4,5,single-choice,spatial-relational,4|5,7,4/5,210212,4
2,3,21,213,1,1147,1,3,1,1,2,single-choice,spatial-relational,1|2,7,1/2,210213,1
2,3,21,214,0,579,1,7,3,4,4,single-choice,spatial-relational,3|4,7,3/4,210214,3
2,3,21,215,0,462,1,7,3,4,4,single-choice,spatial-relational,3|4,7,3/4,210215,3
2,3,21,216,0,509,1,11,5,6,6,single-choice,spatial-relational,5|6,7,5/6,210216,5
2,3,21,217,1,943,1,9,4,4,5,single-choice,spatial-relational,4|5,7,4/5,210217,4
2,3,21,218,1,880,1,5,2,2,3,single-choice,spatial-relational,2|3,7,2/3,210218,2
2,3,21,219,0,525,1,7,3,4,4,single-choice,spatial-relational,3|4,7,3/4,210219,3
2,3,21,220,0,860,1,5,2,3,3,single-choice,spatial-relational,2|3,7,2/3,210220,2
2,3,21,221,0,631,1,11,5,6,6,single-choice,spatial-relational,5|6,7,5/6,210221,5
2,3,21,222,1,697,1,13,6,6,7,single-choice,spatial-relational,6|7,7,6/7,210222,6
2,3,21,223,0,737,1,11,5,6,6,single-choice,spatial-relational,5|6,7,5/6,210223,5
2,3,21,224,1,722,1,9,4,4,5,single-choice,spatial-relational,4|5,7,4/5,210224,4
2,3,21,225,1,748,1,3,1,1,2,single-choice,spatial-relational,1|2,7,1/2,210225,1
2,3,21,226,1,966,1,13,6,6,7,single-choice,spatial-relational,6|7,7,6/7,210226,6
2,3,21,227,0,748,1,7,3,4,4,single-choice,spatial-relational,3|4,7,3/4,210227,3
2,3,21,228,0,961,1,3,1,2,2,single-choice,spatial-relational,1|2,7,1/2,210228,1
2,3,21,229,0,791,1,11,5,6,6,single-choice,spatial-relational,5|6,7,5/6,210229,5
2,3,21,230,1,1041,1,5,2,2,3,single-choice,spatial-relational,2|3,7,2/3,210230,2
2,3,21,231,1,795,1,13,6,6,7,single-choice,spatial-relational,6|7,7,6/7,210231,6
2,3,21,232,0,694,1,5,2,3,3,single-choice,spatial-relational,2|3,7,2/3,210232,2
2,3,21,233,1,574,1,3,1,1,2,single-choice,spatial-relational,1|2,7,1/2,210233,1
2,3,21,234,1,784,1,9,4,4,5,single-choice,spatial-relational,4|5,7,4/5,210234,4
2,3,21,235,0,619,1,11,5,6,6,single-choice,spatial-relational,5|6,7,5/6,210235,5
2,3,21,236,1,733,1,3,1,1,2,single-choice,spatial-relational,1|2,7,1/2,210236,1
2,3,21,237,0,880,1,7,3,4,4,single-choice,spatial-relational,3|4,7,3/4,210237,3
2,3,21,238,1,504,1,9,4,4,5,single-choice,spatial-relational,4|5,7,4/5,210238,4
2,3,21,239,1,630,1,13,6,6,7,single-choice,spatial-relational,6|7,7,6/7,210239,6
2,3,21,240,0,709,1,7,3,4,4,single-choice,spatial-relational,3|4,7,3/4,210240,3
2,3,21,241,0,806,1,5,2,3,3,single-choice,spatial-relational,2|3,7,2/3,210241,2
2,3,21,242,1,634,1,3,1,1,2,single-choice,spatial-relational,1|2,7,1/2,210242,1
2,3,21,243,1,670,1,3,1,1,2,single-choice,spatial-relational,1|2,7,1/2,210243,1
2,3,21,244,0,497,1,7,3,4,4,single-choice,spatial-relational,3|4,7,3/4,210244,3
2,3,21,245,0,670,1,11,5,6,6,single-choice,spatial-relational,5|6,7,5/6,210245,5
2,3,21,246,1,623,1,9,4,4,5,single-choice,spatial-relational,4|5,7,4/5,210246,4
2,3,21,247,1,646,1,13,6,6,7,single-choice,spatial-relational,6|7,7,6/7,210247,6
2,3,21,248,0,834,1,13,6,7,7,single-choice,spatial-relational,6|7,7,6/7,210248,6
2,3,21,249,0,594,1,11,5,6,6,single-choice,spatial-relational,5|6,7,5/6,210249,5
2,3,21,250,1,792,1,9,4,4,5,single-choice,spatial-relational,4|5,7,4/5,210250,4
2,3,21,251,0,961,1,7,3,4,4,single-choice,spatial-relational,3|4,7,3/4,210251,3
2,3,21,252,1,1303,1,5,2,2,3,single-choice,spatial-relational,2|3,7,2/3,210252,2
2,3,21,253,0,552,1,11,5,6,6,single-choice,spatial-relational,5|6,7,5/6,210253,5
2,3,21,254,0,623,1,13,6,7,7,single-choice,spatial-relational,6|7,7,6/7,210254,6
2,3,21,255,1,2391,1,5,2,2,3,single-choice,spatial-relational,2|3,7,2/3,210255,2
2,3,21,256,0,463,1,7,3,4,4,single-choice,spatial-relational,3|4,7,3/4,210256,3
2,3,21,257,0,575,1,5,2,3,3,single-choice,spatial-relational,2|3,7,2/3,210257,2
2,3,21,258,0,507,1,7,3,4,4,single-choice,spatial-relational,3|4,7,3/4,210258,3
2,3,21,259,1,513,1,13,6,6,7,single-choice,spatial-relational,6|7,7,6/7,210259,6
2,3,21,260,0,1153,1,3,1,2,2,single-choice,spatial-relational,1|2,7,1/2,210260,1
2,3,21,261,1,634,1,9,4,4,5,single-choice,spatial-relational,4|5,7,4/5,210261,4
2,3,21,262,1,693,1,9,4,4,5,single-choice,spatial-relational,4|5,7,4/5,210262,4
2,3,21,263,0,488,1,11,5,6,6,single-choice,spatial-relational,5|6,7,5/6,210263,5
2,3,21,264,0,525,1,3,1,2,2,single-choice,spatial-relational,1|2,7,1/2,210264,1
2,3,21,265,0,627,1,13,6,7,7,single-choice,spatial-relational,6|7,7,6/7,210265,6
2,3,21,266,0,1298,1,11,5,6,6,single-choice,spatial-relational,5|6,7,5/6,210266,5
2,3,21,267,1,692,1,9,4,4,5,single-choice,spatial-relational,4|5,7,4/5,210267,4
2,3,21,268,0,1156,1,5,2,3,3,single-choice,spatial-relational,2|3,7,2/3,210268,2
2,3,21,269,1,704,1,7,3,3,4,single-choice,spatial-relational,3|4,7,3/4,210269,3
2,3,21,270,0,694,1,3,1,2,2,single-choice,spatial-relational,1|2,7,1/2,210270,1
2,3,21,271,0,576,1,5,2,3,3,single-choice,spatial-relational,2|3,7,2/3,210271,2
2,3,21,272,1,633,1,3,1,1,2,single-choice,spatial-relational,1|2,7,1/2,210272,1
2,3,21,273,0,455,1,7,3,4,4,single-choice,spatial-relational,3|4,7,3/4,210273,3
2,3,21,274,1,36,1,13,6,6,7,single-choice,spatial-relational,6|7,7,6/7,210274,6
2,3,21,275,0,600,1,11,5,6,6,single-choice,spatial-relational,5|6,7,5/6,210275,5
2,3,21,276,0,670,1,9,4,5,5,single-choice,spatial-relational,4|5,7,4/5,210276,4
2,3,21,277,0,721,1,7,3,4,4,single-choice,spatial-relational,3|4,7,3/4,210277,3
2,3,21,278,1,696,1,13,6,6,7,single-choice,spatial-relational,6|7,7,6/7,210278,6
2,3,21,279,0,720,1,5,2,3,3,single-choice,spatial-relational,2|3,7,2/3,210279,2
2,3,21,280,0,482,1,7,3,4,4,single-choice,spatial-relational,3|4,7,3/4,210280,3
2,3,21,281,1,718,1,9,4,4,5,single-choice,spatial-relational,4|5,7,4/5,210281,4
2,3,21,282,0,690,1,11,5,6,6,single-choice,spatial-relational,5|6,7,5/6,210282,5
2,3,21,283,1,634,1,3,1,1,2,single-choice,spatial-relational,1|2,7,1/2,210283,1
2,3,21,284,0,571,1,11,5,6,6,single-choice,spatial-relational,5|6,7,5/6,210284,5
2,3,21,285,1,686,1,3,1,1,2,single-choice,spatial-relational,1|2,7,1/2,210285,1
2,3,21,286,0,584,1,5,2,3,3,single-choice,spatial-relational,2|3,7,2/3,210286,2
2,3,21,287,0,760,1,9,4,5,5,single-choice,spatial-relational,4|5,7,4/5,210287,4
2,3,21,288,1,585,1,13,6,6,7,single-choice,spatial-relational,6|7,7,6/7,210288,6
2,3,21,289,0,802,1,5,2,3,3,single-choice,spatial-relational,2|3,7,2/3,210289,2
2,3,21,290,0,583,1,7,3,4,4,single-choice,spatial-relational,3|4,7,3/4,210290,3
2,3,21,291,1,705,1,13,6,6,7,single-choice,spatial-relational,6|7,7,6/7,210291,6
2,3,21,292,0,767,1,7,3,4,4,single-choice,spatial-relational,3|4,7,3/4,210292,3
2,3,21,293,1,880,1,11,5,5,6,single-choice,spatial-relational,5|6,7,5/6,210293,5
2,3,21,294,1,701,1,3,1,1,2,single-choice,spatial-relational,1|2,7,1/2,210294,1
2,3,21,295,1,687,1,3,1,1,2,single-choice,spatial-relational,1|2,7,1/2,210295,1
2,3,21,296,0,680,1,5,2,3,3,single-choice,spatial-relational,2|3,7,2/3,210296,2
2,3,21,297,0,775,1,9,4,5,5,single-choice,spatial-relational,4|5,7,4/5,210297,4
2,3,21,298,1,783,1,9,4,4,5,single-choice,spatial-relational,4|5,7,4/5,210298,4
2,3,21,299,1,889,1,11,5,5,6,single-choice,spatial-relational,5|6,7,5/6,210299,5
2,3,21,300,0,705,1,13,6,7,7,single-choice,spatial-relational,6|7,7,6/7,210300,6
2,3,21,301,0,754,1,11,5,6,6,single-choice,spatial-relational,5|6,7,5/6,210301,5
2,3,21,302,0,898,1,13,6,7,7,single-choice,spatial-relational,6|7,7,6/7,210302,6
2,3,21,303,0,514,1,5,2,3,3,single-choice,spatial-relational,2|3,7,2/3,210303,2
2,3,21,304,0,798,1,7,3,4,4,single-choice,spatial-relational,3|4,7,3/4,210304,3
2,3,21,305,0,764,1,13,6,7,7,single-choice,spatial-relational,6|7,7,6/7,210305,6
2,3,21,306,1,1203,1,9,4,4,5,single-choice,spatial-relational,4|5,7,4/5,210306,4
2,3,21,307,1,760,1,9,4,4,5,single-choice,spatial-relational,4|5,7,4/5,210307,4
2,3,21,308,1,884,1,5,2,2,3,single-choice,spatial-relational,2|3,7,2/3,210308,2
2,3,21,309,1,870,1,3,1,1,2,single-choice,spatial-relational,1|2,7,1/2,210309,1
2,3,21,310,1,557,1,3,1,1,2,single-choice,spatial-relational,1|2,7,1/2,210310,1
2,3,21,311,0,908,1,11,5,6,6,single-choice,spatial-relational,5|6,7,5/6,210311,5
2,3,21,312,0,576,1,7,3,4,4,single-choice,spatial-relational,3|4,7,3/4,210312,3
2,3,21,313,1,710,1,9,4,4,5,single-choice,spatial-relational,4|5,7,4/5,210313,4
2,3,21,314,0,884,1,7,3,4,4,single-choice,spatial-relational,3|4,7,3/4,210314,3
2,3,21,315,1,872,1,3,1,1,2,single-choice,spatial-relational,1|2,7,1/2,210315,1
2,3,21,316,1,757,1,5,2,2,3,single-choice,spatial-relational,2|3,7,2/3,210316,2
2,3,21,317,0,624,1,5,2,3,3,single-choice,spatial-relational,2|3,7,2/3,210317,2
2,3,21,318,0,731,1,13,6,7,7,single-choice,spatial-relational,6|7,7,6/7,210318,6
2,3,21,319,1,587,1,3,1,1,2,single-choice,spatial-relational,1|2,7,1/2,210319,1
2,3,21,320,1,595,1,13,6,6,7,single-choice,spatial-relational,6|7,7,6/7,210320,6
2,3,21,321,0,1472,1,11,5,6,6,single-choice,spatial-relational,5|6,7,5/6,210321,5
2,3,21,322,0,510,1,7,3,4,4,single-choice,spatial-relational,3|4,7,3/4,210322,3
2,3,21,323,1,762,1,9,4,4,5,single-choice,spatial-relational,4|5,7,4/5,210323,4
2,3,21,324,0,999,1,11,5,6,6,single-choice,spatial-relational,5|6,7,5/6,210324,5
2,3,21,325,1,572,1,3,1,1,2,single-choice,spatial-relational,1|2,7,1/2,210325,1
2,3,21,326,0,1550,1,7,3,4,4,single-choice,spatial-relational,3|4,7,3/4,210326,3
2,3,21,327,0,552,1,7,3,4,4,single-choice,spatial-relational,3|4,7,3/4,210327,3
2,3,21,328,1,901,1,11,5,5,6,single-choice,spatial-relational,5|6,7,5/6,210328,5
2,3,21,329,0,596,1,5,2,3,3,single-choice,spatial-relational,2|3,7,2/3,210329,2
2,3,21,330,0,850,1,9,4,5,5,single-choice,spatial-relational,4|5,7,4/5,210330,4
2,3,21,331,1,760,1,3,1,1,2,single-choice,spatial-relational,1|2,7,1/2,210331,1
2,3,21,332,1,756,1,13,6,6,7,single-choice,spatial-relational,6|7,7,6/7,210332,6
2,3,21,333,1,729,1,9,4,4,5,single-choice,spatial-relational,4|5,7,4/5,210333,4
2,3,21,334,0,811,1,5,2,3,3,single-choice,spatial-relational,2|3,7,2/3,210334,2
2,3,21,335,0,770,1,13,6,7,7,single-choice,spatial-relational,6|7,7,6/7,210335,6
2,3,21,336,0,975,1,11,5,6,6,single-choice,spatial-relational,5|6,7,5/6,210336,5
2,3,21,337,1,705,1,9,4,4,5,single-choice,spatial-relational,4|5,7,4/5,210337,4
2,3,21,338,1,1230,1,11,5,5,6,single-choice,spatial-relational,5|6,7,5/6,210338,5
2,3,21,339,0,920,1,13,6,7,7,single-choice,spatial-relational,6|7,7,6/7,210339,6
2,3,21,340,1,702,1,3,1,1,2,single-choice,spatial-relational,1|2,7,1/2,210340,1
2,3,21,341,0,646,1,7,3,4,4,single-choice,spatial-relational,3|4,7,3/4,210341,3
2,3,21,342,0,783,1,5,2,3,3,single-choice,spatial-relational,2|3,7,2/3,210342,2
2,3,21,343,0,1092,1,7,3,4,4,single-choice,spatial-relational,3|4,7,3/4,210343,3
2,3,21,344,0,574,1,5,2,3,3,single-choice,spatial-relational,2|3,7,2/3,210344,2
2,3,21,345,1,991,1,11,5,5,6,single-choice,spatial-relational,5|6,7,5/6,210345,5
2,3,21,346,1,732,1,9,4,4,5,single-choice,spatial-relational,4|5,7,4/5,210346,4
2,3,21,347,0,908,1,3,1,2,2,single-choice,spatial-relational,1|2,7,1/2,210347,1
2,3,21,348,0,671,1,13,6,7,7,single-choice,spatial-relational,6|7,7,6/7,210348,6
2,3,21,349,1,740,1,3,1,1,2,single-choice,spatial-relational,1|2,7,1/2,210349,1
2,3,21,350,0,691,1,5,2,3,3,single-choice,spatial-relational,2|3,7,2/3,210350,2
2,3,21,351,0,576,1,7,3,4,4,single-choice,spatial-relational,3|4,7,3/4,210351,3
2,3,21,352,0,1035,1,11,5,6,6,single-choice,spatial-relational,5|6,7,5/6,210352,5
2,3,21,353,1,751,1,9,4,4,5,single-choice,spatial-relational,4|5,7,4/5,210353,4
2,3,21,354,1,1022,1,7,3,3,4,single-choice,spatial-relational,3|4,7,3/4,210354,3
2,3,21,355,0,743,1,9,4,5,5,single-choice,spatial-relational,4|5,7,4/5,210355,4
2,3,21,356,1,612,1,3,1,1,2,single-choice,spatial-relational,1|2,7,1/2,210356,1
2,3,21,357,0,663,1,13,6,7,7,single-choice,spatial-relational,6|7,7,6/7,210357,6
2,3,21,358,0,1396,1,11,5,6,6,single-choice,spatial-relational,5|6,7,5/6,210358,5
2,3,21,359,1,675,1,13,6,6,7,single-choice,spatial-relational,6|7,7,6/7,210359,6
2,3,21,360,1,854,1,5,2,2,3,single-choice,spatial-relational,2|3,7,2/3,210360,2
2,3,21,361,0,708,1,13,6,7,7,single-choice,spatial-relational,6|7,7,6/7,210361,6
2,3,21,362,0,759,1,9,4,5,5,single-choice,spatial-relational,4|5,7,4/5,210362,4
2,3,21,363,0,832,1,11,5,6,6,single-choice,spatial-relational,5|6,7,5/6,210363,5
2,3,21,364,1,1119,1,13,6,6,7,single-choice,spatial-relational,6|7,7,6/7,210364,6
2,3,21,365,0,986,1,5,2,3,3,single-choice,spatial-relational,2|3,7,2/3,210365,2
2,3,21,366,1,929,1,5,2,2,3,single-choice,spatial-relational,2|3,7,2/3,210366,2
2,3,21,367,0,654,1,7,3,4,4,single-choice,spatial-relational,3|4,7,3/4,210367,3
2,3,21,368,1,820,1,3,1,1,2,single-choice,spatial-relational,1|2,7,1/2,210368,1
2,3,21,369,0,578,1,11,5,6,6,single-choice,spatial-relational,5|6,7,5/6,210369,5
2,3,21,370,1,1060,1,3,1,1,2,single-choice,spatial-relational,1|2,7,1/2,210370,1
2,3,21,371,0,1426,1,7,3,4,4,single-choice,spatial-relational,3|4,7,3/4,210371,3
2,3,21,372,1,796,1,9,4,4,5,single-choice,spatial-relational,4|5,7,4/5,210372,4
2,3,21,373,0,1087,1,11,5,6,6,single-choice,spatial-relational,5|6,7,5/6,210373,5
2,3,21,374,0,728,1,11,5,6,6,single-choice,spatial-relational,5|6,7,5/6,210374,5
2,3,21,375,0,551,1,5,2,3,3,single-choice,spatial-relational,2|3,7,2/3,210375,2
2,3,21,376,1,941,1,13,6,6,7,single-choice,spatial-relational,6|7,7,6/7,210376,6
2,3,21,377,1,846,1,5,2,2,3,single-choice,spatial-relational,2|3,7,2/3,210377,2
2,3,21,378,1,849,1,9,4,4,5,single-choice,spatial-relational,4|5,7,4/5,210378,4
2,3,21,379,1,698,1,9,4,4,5,single-choice,spatial-relational,4|5,7,4/5,210379,4
2,3,21,380,0,881,1,3,1,2,2,single-choice,spatial-relational,1|2,7,1/2,210380,1
2,3,21,381,1,1140,1,7,3,3,4,single-choice,spatial-relational,3|4,7,3/4,210381,3
2,3,21,382,1,1004,1,13,6,6,7,single-choice,spatial-relational,6|7,7,6/7,210382,6
2,3,21,383,0,802,1,3,1,2,2,single-choice,spatial-relational,1|2,7,1/2,210383,1
2,3,21,384,0,602,1,7,3,4,4,single-choice,spatial-relational,3|4,7,3/4,210384,3
2,3,21,385,1,646,1,3,1,1,2,single-choice,spatial-relational,1|2,7,1/2,210385,1
2,3,21,386,0,771,1,11,5,6,6,single-choice,spatial-relational,5|6,7,5/6,210386,5
2,3,21,387,0,552,1,11,5,6,6,single-choice,spatial-relational,5|6,7,5/6,210387,5
2,3,21,388,1,832,1,13,6,6,7,single-choice,spatial-relational,6|7,7,6/7,210388,6
2,3,21,389,0,595,1,5,2,3,3,single-choice,spatial-relational,2|3,7,2/3,210389,2
2,3,21,390,1,920,1,5,2,2,3,single-choice,spatial-relational,2|3,7,2/3,210390,2
2,3,21,391,1,886,1,9,4,4,5,single-choice,spatial-relational,4|5,7,4/5,210391,4
2,3,21,392,1,2341,1,7,3,3,4,single-choice,spatial-relational,3|4,7,3/4,210392,3
2,3,21,393,0,1439,1,7,3,4,4,single-choice,spatial-relational,3|4,7,3/4,210393,3
2,3,21,394,1,1523,1,13,6,6,7,single-choice,spatial-relational,6|7,7,6/7,210394,6
2,3,21,395,1,766,1,9,4,4,5,single-choice,spatial-relational,4|5,7,4/5,210395,4
2,3,21,396,0,793,1,3,1,2,2,single-choice,spatial-relational,1|2,7,1/2,210396,1
2,3,21,397,1,762,1,5,2,2,3,single-choice,spatial-relational,2|3,7,2/3,210397,2
2,3,21,398,0,759,1,7,3,4,4,single-choice,spatial-relational,3|4,7,3/4,210398,3
2,3,21,399,0,653,1,11,5,6,6,single-choice,spatial-relational,5|6,7,5/6,210399,5
2,3,21,400,0,783,1,3,1,2,2,single-choice,spatial-relational,1|2,7,1/2,210400,1
2,3,21,401,0,838,1,11,5,6,6,single-choice,spatial-relational,5|6,7,5/6,210401,5
2,3,21,402,1,743,1,13,6,6,7,single-choice,spatial-relational,6|7,7,6/7,210402,6
2,3,21,403,1,726,1,3,1,1,2,single-choice,spatial-relational,1|2,7,1/2,210403,1
2,3,21,404,1,752,1,9,4,4,5,single-choice,spatial-relational,4|5,7,4/5,210404,4
2,3,21,405,1,649,1,9,4,4,5,single-choice,spatial-relational,4|5,7,4/5,210405,4
2,3,21,406,1,861,1,5,2,2,3,single-choice,spatial-relational,2|3,7,2/3,210406,2
2,3,21,407,1,802,1,13,6,6,7,single-choice,spatial-relational,6|7,7,6/7,210407,6
2,3,21,408,0,693,1,7,3,4,4,single-choice,spatial-relational,3|4,7,3/4,210408,3
2,3,21,409,0,48,1,3,1,2,2,single-choice,spatial-relational,1|2,7,1/2,210409,1
2,3,21,410,0,741,1,7,3,4,4,single-choice,spatial-relational,3|4,7,3/4,210410,3
2,3,21,411,0,824,1,3,1,2,2,single-choice,spatial-relational,1|2,7,1/2,210411,1
2,3,21,412,1,743,1,13,6,6,7,single-choice,spatial-relational,6|7,7,6/7,210412,6
2,3,21,413,0,744,1,5,2,3,3,single-choice,spatial-relational,2|3,7,2/3,210413,2
2,3,21,414,1,765,1,9,4,4,5,single-choice,spatial-relational,4|5,7,4/5,210414,4
2,3,21,415,0,613,1,7,3,4,4,single-choice,spatial-relational,3|4,7,3/4,210415,3
2,3,21,416,0,949,1,9,4,5,5,single-choice,spatial-relational,4|5,7,4/5,210416,4
2,3,21,417,0,642,1,11,5,6,6,single-choice,spatial-relational,5|6,7,5/6,210417,5
2,3,21,418,1,885,1,13,6,6,7,single-choice,spatial-relational,6|7,7,6/7,210418,6
2,3,21,419,0,574,1,11,5,6,6,single-choice,spatial-relational,5|6,7,5/6,210419,5
2,3,21,420,1,902,1,5,2,2,3,single-choice,spatial-relational,2|3,7,2/3,210420,2
2,3,21,421,0,689,1,5,2,3,3,single-choice,spatial-relational,2|3,7,2/3,210421,2
2,3,21,422,1,658,1,9,4,4,5,single-choice,spatial-relational,4|5,7,4/5,210422,4
2,3,21,423,1,748,1,13,6,6,7,single-choice,spatial-relational,6|7,7,6/7,210423,6
2,3,21,424,0,746,1,11,5,6,6,single-choice,spatial-relational,5|6,7,5/6,210424,5
2,3,21,425,1,569,1,9,4,4,5,single-choice,spatial-relational,4|5,7,4/5,210425,4
2,3,21,426,0,4759,1,5,2,3,3,single-choice,spatial-relational,2|3,7,2/3,210426,2
2,3,21,427,1,611,1,13,6,6,7,single-choice,spatial-relational,6|7,7,6/7,210427,6
2,3,21,428,1,749,1,3,1,1,2,single-choice,spatial-relational,1|2,7,1/2,210428,1
2,3,21,429,0,844,1,3,1,2,2,single-choice,spatial-relational,1|2,7,1/2,210429,1
2,3,21,430,0,662,1,11,5,6,6,single-choice,spatial-relational,5|6,7,5/6,210430,5
2,3,21,431,0,529,1,7,3,4,4,single-choice,spatial-relational,3|4,7,3/4,210431,3
2,3,21,432,0,768,1,7,3,4,4,single-choice,spatial-relational,3|4,7,3/4,210432,3
2,3,21,433,1,606,1,13,6,6,7,single-choice,spatial-relational,6|7,7,6/7,210433,6
2,3,21,434,0,701,1,5,2,3,3,single-choice,spatial-relational,2|3,7,2/3,210434,2
2,3,21,435,1,506,1,9,4,4,5,single-choice,spatial-relational,4|5,7,4/5,210435,4
2,3,21,436,0,590,1,3,1,2,2,single-choice,spatial-relational,1|2,7,1/2,210436,1
2,3,21,437,1,536,1,3,1,1,2,single-choice,spatial-relational,1|2,7,1/2,210437,1
2,3,21,438,0,610,1,11,5,6,6,single-choice,spatial-relational,5|6,7,5/6,210438,5
2,3,21,439,0,793,1,7,3,4,4,single-choice,spatial-relational,3|4,7,3/4,210439,3
2,3,21,440,1,1922,1,5,2,2,3,single-choice,spatial-relational,2|3,7,2/3,210440,2
2,3,21,441,0,559,1,7,3,4,4,single-choice,spatial-relational,3|4,7,3/4,210441,3
2,3,21,442,0,502,1,11,5,6,6,single-choice,spatial-relational,5|6,7,5/6,210442,5
2,3,21,443,1,735,1,13,6,6,7,single-choice,spatial-relational,6|7,7,6/7,210443,6
2,3,21,444,1,933,1,9,4,4,5,single-choice,spatial-relational,4|5,7,4/5,210444,4
2,3,21,445,0,725,1,5,2,3,3,single-choice,spatial-relational,2|3,7,2/3,210445,2
2,3,21,446,0,1010,1,9,4,5,5,single-choice,spatial-relational,4|5,7,4/5,210446,4
2,3,21,447,1,583,1,3,1,1,2,single-choice,spatial-relational,1|2,7,1/2,210447,1
2,3,21,448,1,578,1,13,6,6,7,single-choice,spatial-relational,6|7,7,6/7,210448,6
2,3,21,449,1,856,1,7,3,3,4,single-choice,spatial-relational,3|4,7,3/4,210449,3
2,3,21,450,0,1596,1,3,1,2,2,single-choice,spatial-relational,1|2,7,1/2,210450,1
2,3,21,451,0,657,1,11,5,6,6,single-choice,spatial-relational,5|6,7,5/6,210451,5
2,3,21,452,1,865,1,9,4,4,5,single-choice,spatial-relational,4|5,7,4/5,210452,4
2,3,21,453,0,814,1,13,6,7,7,single-choice,spatial-relational,6|7,7,6/7,210453,6
2,3,21,454,0,724,1,5,2,3,3,single-choice,spatial-relational,2|3,7,2/3,210454,2
2,3,21,455,0,524,1,11,5,6,6,single-choice,spatial-relational,5|6,7,5/6,210455,5
2,3,21,456,1,1345,1,7,3,3,4,single-choice,spatial-relational,3|4,7,3/4,210456,3
2,3,21,457,1,543,1,3,1,1,2,single-choice,spatial-relational,1|2,7,1/2,210457,1
2,3,21,458,1,720,1,5,2,2,3,single-choice,spatial-relational,2|3,7,2/3,210458,2
2,3,21,459,1,643,1,7,3,3,4,single-choice,spatial-relational,3|4,7,3/4,210459,3
2,3,21,460,0,537,1,11,5,6,6,single-choice,spatial-relational,5|6,7,5/6,210460,5
2,3,21,461,1,530,1,5,2,2,3,single-choice,spatial-relational,2|3,7,2/3,210461,2
2,3,21,462,0,593,1,13,6,7,7,single-choice,spatial-relational,6|7,7,6/7,210462,6
2,3,21,463,0,736,1,9,4,5,5,single-choice,spatial-relational,4|5,7,4/5,210463,4
2,3,21,464,0,1070,1,11,5,6,6,single-choice,spatial-relational,5|6,7,5/6,210464,5
2,3,21,465,1,630,1,13,6,6,7,single-choice,spatial-relational,6|7,7,6/7,210465,6
2,3,21,466,1,789,1,7,3,3,4,single-choice,spatial-relational,3|4,7,3/4,210466,3
2,3,21,467,1,705,1,9,4,4,5,single-choice,spatial-relational,4|5,7,4/5,210467,4
2,3,21,468,1,751,1,3,1,1,2,single-choice,spatial-relational,1|2,7,1/2,210468,1
2,3,21,469,1,897,1,9,4,4,5,single-choice,spatial-relational,4|5,7,4/5,210469,4
2,3,21,470,0,687,1,5,2,3,3,single-choice,spatial-relational,2|3,7,2/3,210470,2
2,3,21,471,0,752,1,9,4,5,5,single-choice,spatial-relational,4|5,7,4/5,210471,4
2,3,21,472,0,785,1,11,5,6,6,single-choice,spatial-relational,5|6,7,5/6,210472,5
2,3,21,473,0,677,1,13,6,7,7,single-choice,spatial-relational,6|7,7,6/7,210473,6
2,3,21,474,0,762,1,7,3,4,4,single-choice,spatial-relational,3|4,7,3/4,210474,3
2,3,21,475,0,959,1,7,3,4,4,single-choice,spatial-relational,3|4,7,3/4,210475,3
2,3,21,476,1,652,1,5,2,2,3,single-choice,spatial-relational,2|3,7,2/3,210476,2
2,3,21,477,1,735,1,3,1,1,2,single-choice,spatial-relational,1|2,7,1/2,210477,1
2,3,21,478,1,622,1,3,1,1,2,single-choice,spatial-relational,1|2,7,1/2,210478,1
2,3,21,479,0,789,1,11,5,6,6,single-choice,spatial-relational,5|6,7,5/6,210479,5
2,3,21,480,0,606,1,13,6,7,7,single-choice,spatial-relational,6|7,7,6/7,210480,6
2,3,21,481,1,610,1,13,6,6,7,single-choice,spatial-relational,6|7,7,6/7,210481,6
2,3,21,482,0,725,1,11,5,6,6,single-choice,spatial-relational,5|6,7,5/6,210482,5
2,3,21,483,0,612,1,5,2,3,3,single-choice,spatial-relational,2|3,7,2/3,210483,2
2,3,21,484,1,512,1,3,1,1,2,single-choice,spatial-relational,1|2,7,1/2,210484,1
2,3,21,485,0,510,1,11,5,6,6,single-choice,spatial-relational,5|6,7,5/6,210485,5
2,3,21,486,1,696,1,9,4,4,5,single-choice,spatial-relational,4|5,7,4/5,210486,4
2,3,21,487,0,681,1,5,2,3,3,single-choice,spatial-relational,2|3,7,2/3,210487,2
2,3,21,488,0,535,1,3,1,2,2,single-choice,spatial-relational,1|2,7,1/2,210488,1
2,3,21,489,1,686,1,7,3,3,4,single-choice,spatial-relational,3|4,7,3/4,210489,3
2,3,21,490,1,710,1,13,6,6,7,single-choice,spatial-relational,6|7,7,6/7,210490,6
2,3,21,491,1,729,1,9,4,4,5,single-choice,spatial-relational,4|5,7,4/5,210491,4
2,3,21,492,0,1229,1,7,3,4,4,single-choice,spatial-relational,3|4,7,3/4,210492,3
2,3,21,493,1,769,1,5,2,2,3,single-choice,spatial-relational,2|3,7,2/3,210493,2
2,3,21,494,0,881,1,11,5,6,6,single-choice,spatial-relational,5|6,7,5/6,210494,5
2,3,21,495,0,525,1,5,2,3,3,single-choice,spatial-relational,2|3,7,2/3,210495,2
2,3,21,496,1,822,1,7,3,3,4,single-choice,spatial-relational,3|4,7,3/4,210496,3
2,3,21,497,0,785,1,7,3,4,4,single-choice,spatial-relational,3|4,7,3/4,210497,3
2,3,21,498,1,574,1,3,1,1,2,single-choice,spatial-relational,1|2,7,1/2,210498,1
2,3,21,499,1,777,1,9,4,4,5,single-choice,spatial-relational,4|5,7,4/5,210499,4
2,3,21,500,1,978,1,13,6,6,7,single-choice,spatial-relational,6|7,7,6/7,210500,6
2,3,21,501,1,876,1,3,1,1,2,single-choice,spatial-relational,1|2,7,1/2,210501,1
2,3,21,502,0,792,1,9,4,5,5,single-choice,spatial-relational,4|5,7,4/5,210502,4
2,3,21,503,1,721,1,13,6,6,7,single-choice,spatial-relational,6|7,7,6/7,210503,6
2,3,21,504,0,740,1,11,5,6,6,single-choice,spatial-relational,5|6,7,5/6,210504,5
2,3,21,505,0,632,1,13,6,7,7,single-choice,spatial-relational,6|7,7,6/7,210505,6
2,3,21,506,1,723,1,9,4,4,5,single-choice,spatial-relational,4|5,7,4/5,210506,4
2,3,21,507,0,662,1,5,2,3,3,single-choice,spatial-relational,2|3,7,2/3,210507,2
2,3,21,508,1,681,1,3,1,1,2,single-choice,spatial-relational,1|2,7,1/2,210508,1
2,3,21,509,0,918,1,7,3,4,4,single-choice,spatial-relational,3|4,7,3/4,210509,3
2,3,21,510,1,795,1,5,2,2,3,single-choice,spatial-relational,2|3,7,2/3,210510,2
2,3,21,511,0,727,1,9,4,5,5,single-choice,spatial-relational,4|5,7,4/5,210511,4
2,3,21,512,0,538,1,11,5,6,6,single-choice,spatial-relational,5|6,7,5/6,210512,5
2,3,21,513,1,1687,1,13,6,6,7,single-choice,spatial-relational,6|7,7,6/7,210513,6
2,3,21,514,0,932,1,7,3,4,4,single-choice,spatial-relational,3|4,7,3/4,210514,3
2,3,21,515,0,794,1,11,5,6,6,single-choice,spatial-relational,5|6,7,5/6,210515,5
2,3,21,516,0,1278,1,3,1,2,2,single-choice,spatial-relational,1|2,7,1/2,210516,1
2,3,21,517,0,674,1,13,6,7,7,single-choice,spatial-relational,6|7,7,6/7,210517,6
2,3,21,518,1,595,1,3,1,1,2,single-choice,spatial-relational,1|2,7,1/2,210518,1
2,3,21,519,1,690,1,3,1,1,2,single-choice,spatial-relational,1|2,7,1/2,210519,1
2,3,21,520,0,562,1,5,2,3,3,single-choice,spatial-relational,2|3,7,2/3,210520,2
2,3,21,521,0,485,1,11,5,6,6,single-choice,spatial-relational,5|6,7,5/6,210521,5
2,3,21,522,0,985,1,11,5,6,6,single-choice,spatial-relational,5|6,7,5/6,210522,5
2,3,21,523,1,40,1,7,3,3,4,single-choice,spatial-relational,3|4,7,3/4,210523,3
2,3,21,524,1,761,1,5,2,2,3,single-choice,spatial-relational,2|3,7,2/3,210524,2
2,3,21,525,1,734,1,7,3,3,4,single-choice,spatial-relational,3|4,7,3/4,210525,3
2,3,21,526,1,703,1,9,4,4,5,single-choice,spatial-relational,4|5,7,4/5,210526,4
2,3,21,527,0,750,1,13,6,7,7,single-choice,spatial-relational,6|7,7,6/7,210527,6
2,3,21,528,0,716,1,9,4,5,5,single-choice,spatial-relational,4|5,7,4/5,210528,4
3,3,21,1,0,705,1,3,1,2,2,single-choice,spatial-relational,1|2,7,1/2,210001,1
3,3,21,2,0,432,1,7,3,4,4,single-choice,spatial-relational,3|4,7,3/4,210002,3
3,3,21,3,0,44,1,5,2,3,3,single-choice,spatial-relational,2|3,7,2/3,210003,2
3,3,21,4,1,414,1,3,1,1,2,single-choice,spatial-relational,1|2,7,1/2,210004,1
3,3,21,5,0,593,1,9,4,5,5,single-choice,spatial-relational,4|5,7,4/5,210005,4
3,3,21,6,0,499,1,11,5,6,6,single-choice,spatial-relational,5|6,7,5/6,210006,5
3,3,21,7,0,529,1,9,4,5,5,single-choice,spatial-relational,4|5,7,4/5,210007,4
3,3,21,8,1,608,1,13,6,6,7,single-choice,spatial-relational,6|7,7,6/7,210008,6
3,3,21,9,0,418,1,11,5,6,6,single-choice,spatial-relational,5|6,7,5/6,210009,5
3,3,21,10,0,737,1,5,2,3,3,single-choice,spatial-relational,2|3,7,2/3,210010,2
3,3,21,11,0,603,1,7,3,4,4,single-choice,spatial-relational,3|4,7,3/4,210011,3
3,3,21,12,0,611,1,13,6,7,7,single-choice,spatial-relational,6|7,7,6/7,210012,6
3,3,21,13,0,861,1,11,5,6,6,single-choice,spatial-relational,5|6,7,5/6,210013,5
3,3,21,14,1,483,1,13,6,6,7,single-choice,spatial-relational,6|7,7,6/7,210014,6
3,3,21,15,0,803,1,5,2,3,3,single-choice,spatial-relational,2|3,7,2/3,210015,2
3,3,21,16,0,667,1,9,4,5,5,single-choice,spatial-relational,4|5,7,4/5,210016,4
3,3,21,17,1,443,1,5,2,2,3,single-choice,spatial-relational,2|3,7,2/3,210017,2
3,3,21,18,0,427,1,11,5,6,6,single-choice,spatial-relational,5|6,7,5/6,210018,5
3,3,21,19,0,583,1,3,1,2,2,single-choice,spatial-relational,1|2,7,1/2,210019,1
3,3,21,20,0,462,1,3,1,2,2,single-choice,spatial-relational,1|2,7,1/2,210020,1
3,3,21,21,1,611,1,7,3,3,4,single-choice,spatial-relational,3|4,7,3/4,210021,3
3,3,21,22,0,1051,1,7,3,4,4,single-choice,spatial-relational,3|4,7,3/4,210022,3
3,3,21,23,1,580,1,13,6,6,7,single-choice,spatial-relational,6|7,7,6/7,210023,6
3,3,21,24,1,894,1,9,4,4,5,single-choice,spatial-relational,4|5,7,4/5,210024,4
3,3,21,25,1,763,1,7,3,3,4,single-choice,spatial-relational,3|4,7,3/4,210025,3
3,3,21,26,1,596,1,13,6,6,7,single-choice,spatial-relational,6|7,7,6/7,210026,6
3,3,21,27,0,474,1,3,1,2,2,single-choice,spatial-relational,1|2,7,1/2,210027,1
3,3,21,28,1,451,1,3,1,1,2,single-choice,spatial-relational,1|2,7,1/2,210028,1
3,3,21,29,0,483,1,11,5,6,6,single-choice,spatial-relational,5|6,7,5/6,210029,5
3,3,21,30,1,427,1,5,2,2,3,single-choice,spatial-relational,2|3,7,2/3,210030,2
3,3,21,31,0,609,1,7,3,4,4,single-choice,spatial-relational,3|4,7,3/4,210031,3
3,3,21,32,0,553,1,11,5,6,6,single-choice,spatial-relational,5|6,7,5/6,210032,5
3,3,21,33,1,764,1,13,6,6,7,single-choice,spatial-relational,6|7,7,6/7,210033,6
3,3,21,34,1,1028,1,5,2,2,3,single-choice,spatial-relational,2|3,7,2/3,210034,2
3,3,21,35,0,830,1,9,4,5,5,single-choice,spatial-relational,4|5,7,4/5,210035,4
3,3,21,36,0,511,1,9,4,5,5,single-choice,spatial-relational,4|5,7,4/5,210036,4
3,3,21,37,0,431,1,3,1,2,2,single-choice,spatial-relational,1|2,7,1/2,210037,1
3,3,21,38,1,530,1,7,3,3,4,single-choice,spatial-relational,3|4,7,3/4,210038,3
3,3,21,39,0,636,1,13,6,7,7,single-choice,spatial-relational,6|7,7,6/7,210039,6
3,3,21,40,0,505,1,11,5,6,6,single-choice,spatial-relational,5|6,7,5/6,210040,5
3,3,21,41,1,481,1,3,1,1,2,single-choice,spatial-relational,1|2,7,1/2,210041,1
3,3,21,42,0,545,1,5,2,3,3,single-choice,spatial-relational,2|3,7,2/3,210042,2
3,3,21,43,0,533,1,7,3,4,4,single-choice,spatial-relational,3|4,7,3/4,210043,3
3,3,21,44,0,494,1,9,4,5,5,single-choice,spatial-relational,4|5,7,4/5,210044,4
3,3,21,45,0,921,1,11,5,6,6,single-choice,spatial-relational,5|6,7,5/6,210045,5
3,3,21,46,1,829,1,9,4,4,5,single-choice,spatial-relational,4|5,7,4/5,210046,4
3,3,21,47,1,779,1,5,2,2,3,single-choice,spatial-relational,2|3,7,2/3,210047,2
3,3,21,48,0,1106,1,13,6,7,7,single-choice,spatial-relational,6|7,7,6/7,210048,6
3,3,21,49,0,1148,1,11,5,6,6,single-choice,spatial-relational,5|6,7,5/6,210049,5
3,3,21,50,1,530,1,7,3,3,4,single-choice,spatial-relational,3|4,7,3/4,210050,3
3,3,21,51,0,658,1,5,2,3,3,single-choice,spatial-relational,2|3,7,2/3,210051,2
3,3,21,52,1,873,1,13,6,6,7,single-choice,spatial-relational,6|7,7,6/7,210052,6
3,3,21,53,0,860,1,3,1,2,2,single-choice,spatial-relational,1|2,7,1/2,210053,1
3,3,21,54,1,1022,1,9,4,4,5,single-choice,spatial-relational,4|5,7,4/5,210054,4
3,3,21,55,1,568,1,3,1,1,2,single-choice,spatial-relational,1|2,7,1/2,210055,1
3,3,21,56,1,432,1,5,2,2,3,single-choice,spatial-relational,2|3,7,2/3,210056,2
3,3,21,57,1,709,1,13,6,6,7,single-choice,spatial-relational,6|7,7,6/7,210057,6
3,3,21,58,0,880,1,9,4,5,5,single-choice,spatial-relational,4|5,7,4/5,210058,4
3,3,21,59,0,1230,1,11,5,6,6,single-choice,spatial-relational,5|6,7,5/6,210059,5
3,3,21,60,0,590,1,7,3,4,4,single-choice,spatial-relational,3|4,7,3/4,210060,3
3,3,21,61,0,38,1,13,6,7,7,single-choice,spatial-relational,6|7,7,6/7,210061,6
3,3,21,62,1,1082,1,13,6,6,7,single-choice,spatial-relational,6|7,7,6/7,210062,6
3,3,21,63,1,810,1,9,4,4,5,single-choice,spatial-relational,4|5,7,4/5,210063,4
3,3,21,64,1,942,1,5,2,2,3,single-choice,spatial-relational,2|3,7,2/3,210064,2
3,3,21,65,0,1378,1,7,3,4,4,single-choice,spatial-relational,3|4,7,3/4,210065,3
3,3,21,66,0,1089,1,11,5,6,6,single-choice,spatial-relational,5|6,7,5/6,210066,5
3,3,21,67,1,424,1,5,2,2,3,single-choice,spatial-relational,2|3,7,2/3,210067,2
3,3,21,68,1,992,1,7,3,3,4,single-choice,spatial-relational,3|4,7,3/4,210068,3
3,3,21,69,0,708,1,3,1,2,2,single-choice,spatial-relational,1|2,7,1/2,210069,1
3,3,21,70,1,1054,1,9,4,4,5,single-choice,spatial-relational,4|5,7,4/5,210070,4
3,3,21,71,0,1238,1,11,5,6,6,single-choice,spatial-relational,5|6,7,5/6,210071,5
3,3,21,72,1,424,1,3,1,1,2,single-choice,spatial-relational,1|2,7,1/2,210072,1
3,3,21,73,0,707,1,13,6,7,7,single-choice,spatial-relational,6|7,7,6/7,210073,6
3,3,21,74,0,455,1,3,1,2,2,single-choice,spatial-relational,1|2,7,1/2,210074,1
3,3,21,75,0,1289,1,11,5,6,6,single-choice,spatial-relational,5|6,7,5/6,210075,5
3,3,21,76,1,584,1,13,6,6,7,single-choice,spatial-relational,6|7,7,6/7,210076,6
3,3,21,77,1,756,1,9,4,4,5,single-choice,spatial-relational,4|5,7,4/5,210077,4
3,3,21,78,1,1141,1,5,2,2,3,single-choice,spatial-relational,2|3,7,2/3,210078,2
3,3,21,79,0,1355,1,11,5,6,6,single-choice,spatial-relational,5|6,7,5/6,210079,5
3,3,21,80,1,1052,1,9,4,4,5,single-choice,spatial-relational,4|5,7,4/5,210080,4
3,3,21,81,0,811,1,7,3,4,4,single-choice,spatial-relational,3|4,7,3/4,210081,3
3,3,21,82,0,834,1,7,3,4,4,single-choice,spatial-relational,3|4,7,3/4,210082,3
3,3,21,83,1,455,1,3,1,1,2,single-choice,spatial-relational,1|2,7,1/2,210083,1
3,3,21,84,1,1393,1,5,2,2,3,single-choice,spatial-relational,2|3,7,2/3,210084,2
3,3,21,85,1,1320,1,13,6,6,7,single-choice,spatial-relational,6|7,7,6/7,210085,6
3,3,21,86,0,724,1,13,6,7,7,single-choice,spatial-relational,6|7,7,6/7,210086,6
3,3,21,87,1,732,1,11,5,5,6,single-choice,spatial-relational,5|6,7,5/6,210087,5
3,3,21,88,0,1154,1,7,3,4,4,single-choice,spatial-relational,3|4,7,3/4,210088,3
3,3,21,89,0,454,1,5,2,3,3,single-choice,spatial-relational,2|3,7,2/3,210089,2
3,3,21,90,1,512,1,5,2,2,3,single-choice,spatial-relational,2|3,7,2/3,210090,2
3,3,21,91,0,881,1,7,3,4,4,single-choice,spatial-relational,3|4,7,3/4,210091,3
3,3,21,92,1,445,1,3,1,1,2,single-choice,spatial-relational,1|2,7,1/2,210092,1
3,3,21,93,0,1288,1,11,5,6,6,single-choice,spatial-relational,5|6,7,5/6,210093,5
3,3,21,94,1,883,1,9,4,4,5,single-choice,spatial-relational,4|5,7,4/5,210094,4
3,3,21,95,0,537,1,3,1,2,2,single-choice,spatial-relational,1|2,7,1/2,210095,1
3,3,21,96,1,1005,1,9,4,4,5,single-choice,spatial-relational,4|5,7,4/5,210096,4
3,3,21,97,1,463,1,3,1,1,2,single-choice,spatial-relational,1|2,7,1/2,210097,1
3,3,21,98,0,656,1,13,6,7,7,single-choice,spatial-relational,6|7,7,6/7,210098,6
3,3,21,99,1,869,1,13,6,6,7,single-choice,spatial-relational,6|7,7,6/7,210099,6
3,3,21,100,1,1221,1,5,2,2,3,single-choice,spatial-relational,2|3,7,2/3,210100,2
3,3,21,101,0,963,1,7,3,4,4,single-choice,spatial-relational,3|4,7,3/4,210101,3
3,3,21,102,1,427,1,5,2,2,3,single-choice,spatial-relational,2|3,7,2/3,210102,2
3,3,21,103,0,712,1,3,1,2,2,single-choice,spatial-relational,1|2,7,1/2,210103,1
3,3,21,104,1,1008,1,9,4,4,5,single-choice,spatial-relational,4|5,7,4/5,210104,4
3,3,21,105,0,650,1,7,3,4,4,single-choice,spatial-relational,3|4,7,3/4,210105,3
3,3,21,106,1,744,1,11,5,5,6,single-choice,spatial-relational,5|6,7,5/6,210106,5
3,3,21,107,0,634,1,11,5,6,6,single-choice,spatial-relational,5|6,7,5/6,210107,5
3,3,21,108,1,912,1,9,4,4,5,single-choice,spatial-relational,4|5,7,4/5,210108,4
3,3,21,109,0,912,1,7,3,4,4,single-choice,spatial-relational,3|4,7,3/4,210109,3
3,3,21,110,1,825,1,7,3,3,4,single-choice,spatial-relational,3|4,7,3/4,210110,3
3,3,21,111,1,744,1,3,1,1,2,single-choice,spatial-relational,1|2,7,1/2,210111,1
3,3,21,112,1,771,1,5,2,2,3,single-choice,spatial-relational,2|3,7,2/3,210112,2
3,3,21,113,0,1642,1,11,5,6,6,single-choice,spatial-relational,5|6,7,5/6,210113,5
3,3,21,114,0,442,1,3,1,2,2,single-choice,spatial-relational,1|2,7,1/2,210114,1
3,3,21,115,0,908,1,9,4,5,5,single-choice,spatial-relational,4|5,7,4/5,210115,4
3,3,21,116,0,598,1,13,6,7,7,single-choice,spatial-relational,6|7,7,6/7,210116,6
3,3,21,117,0,40,1,9,4,5,5,single-choice,spatial-relational,4|5,7,4/5,210117,4
3,3,21,118,0,1040,1,13,6,7,7,single-choice,spatial-relational,6|7,7,6/7,210118,6
3,3,21,119,1,545,1,5,2,2,3,single-choice,spatial-relational,2|3,7,2/3,210119,2
3,3,21,120,1,733,1,11,5,5,6,single-choice,spatial-relational,5|6,7,5/6,210120,5
3,3,21,121,1,986,1,11,5,5,6,single-choice,spatial-relational,5|6,7,5/6,210121,5
3,3,21,122,0,999,1,11,5,6,6,single-choice,spatial-relational,5|6,7,5/6,210122,5
3,3,21,123,0,591,1,13,6,7,7,single-choice,spatial-relational,6|7,7,6/7,210123,6
3,3,21,124,1,752,1,9,4,4,5,single-choice,spatial-relational,4|5,7,4/5,210124,4
3,3,21,125,1,1002,1,5,2,2,3,single-choice,spatial-relational,2|3,7,2/3,210125,2
3,3,21,126,1,755,1,5,2,2,3,single-choice,spatial-relational,2|3,7,2/3,210126,2
3,3,21,127,0,1021,1,3,1,2,2,single-choice,spatial-relational,1|2,7,1/2,210127,1
3,3,21,128,1,1081,1,7,3,3,4,single-choice,spatial-relational,3|4,7,3/4,210128,3
3,3,21,129,0,762,1,13,6,7,7,single-choice,spatial-relational,6|7,7,6/7,210129,6
3,3,21,130,0,891,1,7,3,4,4,single-choice,spatial-relational,3|4,7,3/4,210130,3
3,3,21,131,0,1094,1,3,1,2,2,single-choice,spatial-relational,1|2,7,1/2,210131,1
3,3,21,132,0,924,1,9,4,5,5,single-choice,spatial-relational,4|5,7,4/5,210132,4
3,3,21,133,1,791,1,11,5,5,6,single-choice,spatial-relational,5|6,7,5/6,210133,5
3,3,21,134,1,784,1,3,1,1,2,single-choice,spatial-relational,1|2,7,1/2,210134,1
3,3,21,135,1,1078,1,7,3,3,4,single-choice,spatial-relational,3|4,7,3/4,210135,3
3,3,21,136,0,905,1,9,4,5,5,single-choice,spatial-relational,4|5,7,4/5,210136,4
3,3,21,137,1,650,1,13,6,6,7,single-choice,spatial-relational,6|7,7,6/7,210137,6
3,3,21,138,0,1658,1,7,3,4,4,single-choice,spatial-relational,3|4,7,3/4,210138,3
3,3,21,139,1,932,1,9,4,4,5,single-choice,spatial-relational,4|5,7,4/5,210139,4
3,3,21,140,1,1277,1,5,2,2,3,single-choice,spatial-relational,2|3,7,2/3,210140,2
3,3,21,141,1,809,1,5,2,2,3,single-choice,spatial-relational,2|3,7,2/3,210141,2
3,3,21,142,0,1407,1,11,5,6,6,single-choice,spatial-relational,5|6,7,5/6,210142,5
3,3,21,143,0,593,1,13,6,7,7,single-choice,spatial-relational,6|7,7,6/7,210143,6
3,3,21,144,1,1098,1,3,1,1,2,single-choice,spatial-relational,1|2,7,1/2,210144,1
3,3,21,145,0,814,1,3,1,2,2,single-choice,spatial-relational,1|2,7,1/2,210145,1
3,3,21,146,0,867,1,3,1,2,2,single-choice,spatial-relational,1|2,7,1/2,210146,1
3,3,21,147,0,716,1,9,4,5,5,single-choice,spatial-relational,4|5,7,4/5,210147,4
3,3,21,148,0,601,1,13,6,7,7,single-choice,spatial-relational,6|7,7,6/7,210148,6
3,3,21,149,0,900,1,5,2,3,3,single-choice,spatial-relational,2|3,7,2/3,210149,2
3,3,21,150,1,438,1,5,2,2,3,single-choice,spatial-relational,2|3,7,2/3,210150,2
3,3,21,151,1,978,1,13,6,6,7,single-choice,spatial-relational,6|7,7,6/7,210151,6
3,3,21,152,0,1032,1,11,5,6,6,single-choice,spatial-relational,5|6,7,5/6,210152,5
3,3,21,153,0,57,1,7,3,4,4,single-choice,spatial-relational,3|4,7,3/4,210153,3
3,3,21,154,1,685,1,7,3,3,4,single-choice,spatial-relational,3|4,7,3/4,210154,3
3,3,21,155,0,974,1,9,4,5,5,single-choice,spatial-relational,4|5,7,4/5,210155,4
3,3,21,156,1,701,1,11,5,5,6,single-choice,spatial-relational,5|6,7,5/6,210156,5
3,3,21,157,0,792,1,7,3,4,4,single-choice,spatial-relational,3|4,7,3/4,210157,3
3,3,21,158,1,424,1,5,2,2,3,single-choice,spatial-relational,2|3,7,2/3,210158,2
3,3,21,159,0,658,1,13,6,7,7,single-choice,spatial-relational,6|7,7,6/7,210159,6
3,3,21,160,1,995,1,13,6,6,7,single-choice,spatial-relational,6|7,7,6/7,210160,6
3,3,21,161,1,903,1,3,1,1,2,single-choice,spatial-relational,1|2,7,1/2,210161,1
3,3,21,162,1,896,1,11,5,5,6,single-choice,spatial-relational,5|6,7,5/6,210162,5
3,3,21,163,0,1599,1,11,5,6,6,single-choice,spatial-relational,5|6,7,5/6,210163,5
3,3,21,164,0,473,1,5,2,3,3,single-choice,spatial-relational,2|3,7,2/3,210164,2
3,3,21,165,0,759,1,9,4,5,5,single-choice,spatial-relational,4|5,7,4/5,210165,4
3,3,21,166,0,408,1,7,3,4,4,single-choice,spatial-relational,3|4,7,3/4,210166,3
3,3,21,167,1,807,1,9,4,4,5,single-choice,spatial-relational,4|5,7,4/5,210167,4
3,3,21,168,0,775,1,3,1,2,2,single-choice,spatial-relational,1|2,7,1/2,210168,1
3,3,21,169,0,60,1,9,4,5,5,single-choice,spatial-relational,4|5,7,4/5,210169,4
3,3,21,170,1,950,1,13,6,6,7,single-choice,spatial-relational,6|7,7,6/7,210170,6
3,3,21,171,0,705,1,13,6,7,7,single-choice,spatial-relational,6|7,7,6/7,210171,6
3,3,21,172,0,119,1,3,1,2,2,single-choice,spatial-relational,1|2,7,1/2,210172,1
3,3,21,173,0,1163,1,7,3,4,4,single-choice,spatial-relational,3|4,7,3/4,210173,3
3,3,21,174,1,759,1,9,4,4,5,single-choice,spatial-relational,4|5,7,4/5,210174,4
3,3,21,175,1,731,1,3,1,1,2,single-choice,spatial-relational,1|2,7,1/2,210175,1
3,3,21,176,1,1080,1,11,5,5,6,single-choice,spatial-relational,5|6,7,5/6,210176,5
3,3,21,177,1,754,1,7,3,3,4,single-choice,spatial-relational,3|4,7,3/4,210177,3
3,3,21,178,1,1148,1,11,5,5,6,single-choice,spatial-relational,5|6,7,5/6,210178,5
3,3,21,179,1,1108,1,5,2,2,3,single-choice,spatial-relational,2|3,7,2/3,210179,2
3,3,21,180,1,857,1,5,2,2,3,single-choice,spatial-relational,2|3,7,2/3,210180,2
3,3,21,181,1,1043,1,7,3,3,4,single-choice,spatial-relational,3|4,7,3/4,210181,3
3,3,21,182,0,602,1,13,6,7,7,single-choice,spatial-relational,6|7,7,6/7,210182,6
3,3,21,183,1,754,1,11,5,5,6,single-choice,spatial-relational,5|6,7,5/6,210183,5
3,3,21,184,0,986,1,11,5,6,6,single-choice,spatial-relational,5|6,7,5/6,210184,5
3,3,21,185,1,853,1,9,4,4,5,single-choice,spatial-relational,4|5,7,4/5,210185,4
3,3,21,186,1,998,1,7,3,3,4,single-choice,spatial-relational,3|4,7,3/4,210186,3
3,3,21,187,1,724,1,5,2,2,3,single-choice,spatial-relational,2|3,7,2/3,210187,2
3,3,21,188,0,882,1,13,6,7,7,single-choice,spatial-relational,6|7,7,6/7,210188,6
3,3,21,189,0,710,1,9,4,5,5,single-choice,spatial-relational,4|5,7,4/5,210189,4
3,3,21,190,0,445,1,3,1,2,2,single-choice,spatial-relational,1|2,7,1/2,210190,1
3,3,21,191,1,644,1,5,2,2,3,single-choice,spatial-relational,2|3,7,2/3,210191,2
3,3,21,192,0,682,1,3,1,2,2,single-choice,spatial-relational,1|2,7,1/2,210192,1
3,3,21,193,0,442,1,3,1,2,2,single-choice,spatial-relational,1|2,7,1/2,210193,1
3,3,21,194,1,471,1,5,2,2,3,single-choice,spatial-relational,2|3,7,2/3,210194,2
3,3,21,195,0,1392,1,7,3,4,4,single-choice,spatial-relational,3|4,7,3/4,210195,3
3,3,21,196,0,457,1,5,2,3,3,single-choice,spatial-relational,2|3,7,2/3,210196,2
3,3,21,197,0,1012,1,9,4,5,5,single-choice,spatial-relational,4|5,7,4/5,210197,4
3,3,21,198,1,549,1,3,1,1,2,single-choice,spatial-relational,1|2,7,1/2,210198,1
3,3,21,199,1,818,1,9,4,4,5,single-choice,spatial-relational,4|5,7,4/5,210199,4
3,3,21,200,1,863,1,7,3,3,4,single-choice,spatial-relational,3|4,7,3/4,210200,3
3,3,21,201,1,992,1,11,5,5,6,single-choice,spatial-relational,5|6,7,5/6,210201,5
3,3,21,202,0,734,1,13,6,7,7,single-choice,spatial-relational,6|7,7,6/7,210202,6
3,3,21,203,0,626,1,13,6,7,7,single-choice,spatial-relational,6|7,7,6/7,210203,6
3,3,21,204,0,1471,1,11,5,6,6,single-choice,spatial-relational,5|6,7,5/6,210204,5
3,3,21,205,0,1214,1,7,3,4,4,single-choice,spatial-relational,3|4,7,3/4,210205,3
3,3,21,206,0,584,1,13,6,7,7,single-choice,spatial-relational,6|7,7,6/7,210206,6
3,3,21,207,0,40,1,11,5,6,6,single-choice,spatial-relational,5|6,7,5/6,210207,5
3,3,21,208,1,1232,1,11,5,5,6,single-choice,spatial-relational,5|6,7,5/6,210208,5
3,3,21,209,1,845,1,5,2,2,3,single-choice,spatial-relational,2|3,7,2/3,210209,2
3,3,21,210,1,850,1,9,4,4,5,single-choice,spatial-relational,4|5,7,4/5,210210,4
3,3,21,211,0,791,1,3,1,2,2,single-choice,spatial-relational,1|2,7,1/2,210211,1
3,3,21,212,1,139,1,13,6,6,7,single-choice,spatial-relational,6|7,7,6/7,210212,6
3,3,21,213,0,869,1,9,4,5,5,single-choice,spatial-relational,4|5,7,4/5,210213,4
3,3,21,214,1,791,1,5,2,2,3,single-choice,spatial-relational,2|3,7,2/3,210214,2
3,3,21,215,0,961,1,7,3,4,4,single-choice,spatial-relational,3|4,7,3/4,210215,3
3,3,21,216,1,447,1,3,1,1,2,single-choice,spatial-relational,1|2,7,1/2,210216,1
3,3,21,217,0,762,1,9,4,5,5,single-choice,spatial-relational,4|5,7,4/5,210217,4
3,3,21,218,1,1231,1,11,5,5,6,single-choice,spatial-relational,5|6,7,5/6,210218,5
3,3,21,219,1,1380,1,11,5,5,6,single-choice,spatial-relational,5|6,7,5/6,210219,5
3,3,21,220,1,813,1,9,4,4,5,single-choice,spatial-relational,4|5,7,4/5,210220,4
3,3,21,221,0,857,1,13,6,7,7,single-choice,spatial-relational,6|7,7,6/7,210221,6
3,3,21,222,0,483,1,3,1,2,2,single-choice,spatial-relational,1|2,7,1/2,210222,1
3,3,21,223,0,994,1,7,3,4,4,single-choice,spatial-relational,3|4,7,3/4,210223,3
3,3,21,224,0,760,1,3,1,2,2,single-choice,spatial-relational,1|2,7,1/2,210224,1
3,3,21,225,0,451,1,5,2,3,3,single-choice,spatial-relational,2|3,7,2/3,210225,2
3,3,21,226,1,1293,1,5,2,2,3,single-choice,spatial-relational,2|3,7,2/3,210226,2
3,3,21,227,1,790,1,13,6,6,7,single-choice,spatial-relational,6|7,7,6/7,210227,6
3,3,21,228,1,1078,1,7,3,3,4,single-choice,spatial-relational,3|4,7,3/4,210228,3
3,3,21,229,0,1050,1,3,1,2,2,single-choice,spatial-relational,1|2,7,1/2,210229,1
3,3,21,230,0,870,1,9,4,5,5,single-choice,spatial-relational,4|5,7,4/5,210230,4
3,3,21,231,1,52,1,7,3,3,4,single-choice,spatial-relational,3|4,7,3/4,210231,3
3,3,21,232,1,1017,1,5,2,2,3,single-choice,spatial-relational,2|3,7,2/3,210232,2
3,3,21,233,1,897,1,5,2,2,3,single-choice,spatial-relational,2|3,7,2/3,210233,2
3,3,21,234,0,806,1,3,1,2,2,single-choice,spatial-relational,1|2,7,1/2,210234,1
3,3,21,235,1,1122,1,11,5,5,6,single-choice,spatial-relational,5|6,7,5/6,210235,5
3,3,21,236,1,791,1,11,5,5,6,single-choice,spatial-relational,5|6,7,5/6,210236,5
3,3,21,237,0,1338,1,7,3,4,4,single-choice,spatial-relational,3|4,7,3/4,210237,3
3,3,21,238,0,900,1,13,6,7,7,single-choice,spatial-relational,6|7,7,6/7,210238,6
3,3,21,239,1,56,1,13,6,6,7,single-choice,spatial-relational,6|7,7,6/7,210239,6
3,3,21,240,1,832,1,9,4,4,5,single-choice,spatial-relational,4|5,7,4/5,210240,4
3,3,21,241,0,1132,1,9,4,5,5,single-choice,spatial-relational,4|5,7,4/5,210241,4
3,3,21,242,0,40,1,3,1,2,2,single-choice,spatial-relational,1|2,7,1/2,210242,1
3,3,21,243,1,40,1,5,2,2,3,single-choice,spatial-relational,2|3,7,2/3,210243,2
3,3,21,244,1,1399,1,7,3,3,4,single-choice,spatial-relational,3|4,7,3/4,210244,3
3,3,21,245,1,802,1,11,5,5,6,single-choice,spatial-relational,5|6,7,5/6,210245,5
3,3,21,246,0,818,1,9,4,5,5,single-choice,spatial-relational,4|5,7,4/5,210246,4
3,3,21,247,1,847,1,3,1,1,2,single-choice,spatial-relational,1|2,7,1/2,210247,1
3,3,21,248,0,781,1,13,6,7,7,single-choice,spatial-relational,6|7,7,6/7,210248,6
3,3,21,249,1,963,1,11,5,5,6,single-choice,spatial-relational,5|6,7,5/6,210249,5
3,3,21,250,1,833,1,7,3,3,4,single-choice,spatial-relational,3|4,7,3/4,210250,3
3,3,21,251,1,939,1,13,6,6,7,single-choice,spatial-relational,6|7,7,6/7,210251,6
3,3,21,252,1,760,1,5,2,2,3,single-choice,spatial-relational,2|3,7,2/3,210252,2
3,3,21,253,1,811,1,5,2,2,3,single-choice,spatial-relational,2|3,7,2/3,210253,2
3,3,21,254,1,897,1,3,1,1,2,single-choice,spatial-relational,1|2,7,1/2,210254,1
3,3,21,255,0,584,1,13,6,7,7,single-choice,spatial-relational,6|7,7,6/7,210255,6
3,3,21,256,1,40,1,11,5,5,6,single-choice,spatial-relational,5|6,7,5/6,210256,5
3,3,21,257,0,1068,1,7,3,4,4,single-choice,spatial-relational,3|4,7,3/4,210257,3
3,3,21,258,0,898,1,9,4,5,5,single-choice,spatial-relational,4|5,7,4/5,210258,4
3,3,21,259,1,715,1,5,2,2,3,single-choice,spatial-relational,2|3,7,2/3,210259,2
3,3,21,260,1,738,1,3,1,1,2,single-choice,spatial-relational,1|2,7,1/2,210260,1
3,3,21,261,1,734,1,13,6,6,7,single-choice,spatial-relational,6|7,7,6/7,210261,6
3,3,21,262,1,1597,1,7,3,3,4,single-choice,spatial-relational,3|4,7,3/4,210262,3
3,3,21,263,0,1034,1,11,5,6,6,single-choice,spatial-relational,5|6,7,5/6,210263,5
3,3,21,264,0,44,1,9,4,5,5,single-choice,spatial-relational,4|5,7,4/5,210264,4
3,3,21,265,0,908,1,9,4,5,5,single-choice,spatial-relational,4|5,7,4/5,210265,4
3,3,21,266,1,624,1,7,3,3,4,single-choice,spatial-relational,3|4,7,3/4,210266,3
3,3,21,267,1,693,1,7,3,3,4,single-choice,spatial-relational,3|4,7,3/4,210267,3
3,3,21,268,1,1001,1,13,6,6,7,single-choice,spatial-relational,6|7,7,6/7,210268,6
3,3,21,269,1,1078,1,13,6,6,7,single-choice,spatial-relational,6|7,7,6/7,210269,6
3,3,21,270,1,732,1,5,2,2,3,single-choice,spatial-relational,2|3,7,2/3,210270,2
3,3,21,271,1,937,1,3,1,1,2,single-choice,spatial-relational,1|2,7,1/2,210271,1
3,3,21,272,1,760,1,9,4,4,5,single-choice,spatial-relational,4|5,7,4/5,210272,4
3,3,21,273,0,1100,1,3,1,2,2,single-choice,spatial-relational,1|2,7,1/2,210273,1
3,3,21,274,1,1037,1,11,5,5,6,single-choice,spatial-relational,5|6,7,5/6,210274,5
3,3,21,275,1,1381,1,11,5,5,6,single-choice,spatial-relational,5|6,7,5/6,210275,5
3,3,21,276,0,673,1,5,2,3,3,single-choice,spatial-relational,2|3,7,2/3,210276,2
3,3,21,277,1,865,1,11,5,5,6,single-choice,spatial-relational,5|6,7,5/6,210277,5
3,3,21,278,0,709,1,5,2,3,3,single-choice,spatial-relational,2|3,7,2/3,210278,2
3,3,21,279,0,59,1,13,6,7,7,single-choice,spatial-relational,6|7,7,6/7,210279,6
3,3,21,280,1,40,1,11,5,5,6,single-choice,spatial-relational,5|6,7,5/6,210280,5
3,3,21,281,1,1263,1,7,3,3,4,single-choice,spatial-relational,3|4,7,3/4,210281,3
3,3,21,282,1,878,1,9,4,4,5,single-choice,spatial-relational,4|5,7,4/5,210282,4
3,3,21,283,0,863,1,3,1,2,2,single-choice,spatial-relational,1|2,7,1/2,210283,1
3,3,21,284,0,1111,1,9,4,5,5,single-choice,spatial-relational,4|5,7,4/5,210284,4
3,3,21,285,0,1773,1,5,2,3,3,single-choice,spatial-relational,2|3,7,2/3,210285,2
3,3,21,286,1,40,1,7,3,3,4,single-choice,spatial-relational,3|4,7,3/4,210286,3
3,3,21,287,1,920,1,3,1,1,2,single-choice,spatial-relational,1|2,7,1/2,210287,1
3,3,21,288,1,873,1,13,6,6,7,single-choice,spatial-relational,6|7,7,6/7,210288,6
3,3,21,289,1,918,1,13,6,6,7,single-choice,spatial-relational,6|7,7,6/7,210289,6
3,3,21,290,1,1241,1,9,4,4,5,single-choice,spatial-relational,4|5,7,4/5,210290,4
3,3,21,291,0,853,1,3,1,2,2,single-choice,spatial-relational,1|2,7,1/2,210291,1
3,3,21,292,0,44,1,5,2,3,3,single-choice,spatial-relational,2|3,7,2/3,210292,2
3,3,21,293,0,990,1,9,4,5,5,single-choice,spatial-relational,4|5,7,4/5,210293,4
3,3,21,294,1,787,1,7,3,3,4,single-choice,spatial-relational,3|4,7,3/4,210294,3
3,3,21,295,0,910,1,5,2,3,3,single-choice,spatial-relational,2|3,7,2/3,210295,2
3,3,21,296,1,802,1,11,5,5,6,single-choice,spatial-relational,5|6,7,5/6,210296,5
3,3,21,297,1,812,1,7,3,3,4,single-choice,spatial-relational,3|4,7,3/4,210297,3
3,3,21,298,1,744,1,13,6,6,7,single-choice,spatial-relational,6|7,7,6/7,210298,6
3,3,21,299,1,505,1,3,1,1,2,single-choice,spatial-relational,1|2,7,1/2,210299,1
3,3,21,300,1,829,1,11,5,5,6,single-choice,spatial-relational,5|6,7,5/6,210300,5
3,3,21,301,1,759,1,3,1,1,2,single-choice,spatial-relational,1|2,7,1/2,210301,1
3,3,21,302,0,706,1,13,6,7,7,single-choice,spatial-relational,6|7,7,6/7,210302,6
3,3,21,303,0,197,1,11,5,6,6,single-choice,spatial-relational,5|6,7,5/6,210303,5
3,3,21,304,1,861,1,5,2,2,3,single-choice,spatial-relational,2|3,7,2/3,210304,2
3,3,21,305,0,1142,1,11,5,6,6,single-choice,spatial-relational,5|6,7,5/6,210305,5
3,3,21,306,0,795,1,7,3,4,4,single-choice,spatial-relational,3|4,7,3/4,210306,3
3,3,21,307,1,44,1,13,6,6,7,single-choice,spatial-relational,6|7,7,6/7,210307,6
3,3,21,308,0,701,1,5,2,3,3,single-choice,spatial-relational,2|3,7,2/3,210308,2
3,3,21,309,1,563,1,3,1,1,2,single-choice,spatial-relational,1|2,7,1/2,210309,1
3,3,21,310,0,782,1,9,4,5,5,single-choice,spatial-relational,4|5,7,4/5,210310,4
3,3,21,311,0,768,1,9,4,5,5,single-choice,spatial-relational,4|5,7,4/5,210311,4
3,3,21,312,1,697,1,7,3,3,4,single-choice,spatial-relational,3|4,7,3/4,210312,3
3,3,21,313,1,822,1,9,4,4,5,single-choice,spatial-relational,4|5,7,4/5,210313,4
3,3,21,314,1,742,1,3,1,1,2,single-choice,spatial-relational,1|2,7,1/2,210314,1
3,3,21,315,1,912,1,7,3,3,4,single-choice,spatial-relational,3|4,7,3/4,210315,3
3,3,21,316,0,682,1,5,2,3,3,single-choice,spatial-relational,2|3,7,2/3,210316,2
3,3,21,317,1,1351,1,3,1,1,2,single-choice,spatial-relational,1|2,7,1/2,210317,1
3,3,21,318,1,767,1,13,6,6,7,single-choice,spatial-relational,6|7,7,6/7,210318,6
3,3,21,319,1,863,1,5,2,2,3,single-choice,spatial-relational,2|3,7,2/3,210319,2
3,3,21,320,1,1467,1,7,3,3,4,single-choice,spatial-relational,3|4,7,3/4,210320,3
3,3,21,321,0,764,1,9,4,5,5,single-choice,spatial-relational,4|5,7,4/5,210321,4
3,3,21,322,0,1300,1,11,5,6,6,single-choice,spatial-relational,5|6,7,5/6,210322,5
3,3,21,323,1,927,1,13,6,6,7,single-choice,spatial-relational,6|7,7,6/7,210323,6
3,3,21,324,0,832,1,11,5,6,6,single-choice,spatial-relational,5|6,7,5/6,210324,5
3,3,21,325,1,802,1,5,2,2,3,single-choice,spatial-relational,2|3,7,2/3,210325,2
3,3,21,326,1,811,1,9,4,4,5,single-choice,spatial-relational,4|5,7,4/5,210326,4
3,3,21,327,1,725,1,11,5,5,6,single-choice,spatial-relational,5|6,7,5/6,210327,5
3,3,21,328,0,658,1,5,2,3,3,single-choice,spatial-relational,2|3,7,2/3,210328,2
3,3,21,329,1,917,1,13,6,6,7,single-choice,spatial-relational,6|7,7,6/7,210329,6
3,3,21,330,1,856,1,7,3,3,4,single-choice,spatial-relational,3|4,7,3/4,210330,3
3,3,21,331,0,1109,1,11,5,6,6,single-choice,spatial-relational,5|6,7,5/6,210331,5
3,3,21,332,1,1071,1,7,3,3,4,single-choice,spatial-relational,3|4,7,3/4,210332,3
3,3,21,333,0,783,1,3,1,2,2,single-choice,spatial-relational,1|2,7,1/2,210333,1
3,3,21,334,1,1219,1,9,4,4,5,single-choice,spatial-relational,4|5,7,4/5,210334,4
3,3,21,335,1,709,1,3,1,1,2,single-choice,spatial-relational,1|2,7,1/2,210335,1
3,3,21,336,0,931,1,13,6,7,7,single-choice,spatial-relational,6|7,7,6/7,210336,6
3,3,21,337,1,824,1,13,6,6,7,single-choice,spatial-relational,6|7,7,6/7,210337,6
3,3,21,338,0,871,1,9,4,5,5,single-choice,spatial-relational,4|5,7,4/5,210338,4
3,3,21,339,1,1588,1,13,6,6,7,single-choice,spatial-relational,6|7,7,6/7,210339,6
3,3,21,340,1,724,1,3,1,1,2,single-choice,spatial-relational,1|2,7,1/2,210340,1
3,3,21,341,1,758,1,9,4,4,5,single-choice,spatial-relational,4|5,7,4/5,210341,4
3,3,21,342,1,1641,1,11,5,5,6,single-choice,spatial-relational,5|6,7,5/6,210342,5
3,3,21,343,1,1104,1,7,3,3,4,single-choice,spatial-relational,3|4,7,3/4,210343,3
3,3,21,344,1,694,1,5,2,2,3,single-choice,spatial-relational,2|3,7,2/3,210344,2
3,3,21,345,0,787,1,5,2,3,3,single-choice,spatial-relational,2|3,7,2/3,210345,2
3,3,21,346,1,1501,1,11,5,5,6,single-choice,spatial-relational,5|6,7,5/6,210346,5
3,3,21,347,0,729,1,3,1,2,2,single-choice,spatial-relational,1|2,7,1/2,210347,1
3,3,21,348,0,32,1,7,3,4,4,single-choice,spatial-relational,3|4,7,3/4,210348,3
3,3,21,349,1,536,1,3,1,1,2,single-choice,spatial-relational,1|2,7,1/2,210349,1
3,3,21,350,0,1190,1,11,5,6,6,single-choice,spatial-relational,5|6,7,5/6,210350,5
3,3,21,351,1,720,1,11,5,5,6,single-choice,spatial-relational,5|6,7,5/6,210351,5
3,3,21,352,0,779,1,9,4,5,5,single-choice,spatial-relational,4|5,7,4/5,210352,4
3,3,21,353,0,461,1,5,2,3,3,single-choice,spatial-relational,2|3,7,2/3,210353,2
3,3,21,354,1,59,1,7,3,3,4,single-choice,spatial-relational,3|4,7,3/4,210354,3
3,3,21,355,1,876,1,13,6,6,7,single-choice,spatial-relational,6|7,7,6/7,210355,6
3,3,21,356,1,744,1,3,1,1,2,single-choice,spatial-relational,1|2,7,1/2,210356,1
3,3,21,357,1,834,1,7,3,3,4,single-choice,spatial-relational,3|4,7,3/4,210357,3
3,3,21,358,0,730,1,5,2,3,3,single-choice,spatial-relational,2|3,7,2/3,210358,2
3,3,21,359,0,596,1,13,6,7,7,single-choice,spatial-relational,6|7,7,6/7,210359,6
3,3,21,360,1,931,1,9,4,4,5,single-choice,spatial-relational,4|5,7,4/5,210360,4
3,3,21,361,0,807,1,3,1,2,2,single-choice,spatial-relational,1|2,7,1/2,210361,1
3,3,21,362,1,1122,1,9,4,4,5,single-choice,spatial-relational,4|5,7,4/5,210362,4
3,3,21,363,1,737,1,9,4,4,5,single-choice,spatial-relational,4|5,7,4/5,210363,4
3,3,21,364,1,752,1,11,5,5,6,single-choice,spatial-relational,5|6,7,5/6,210364,5
3,3,21,365,0,685,1,13,6,7,7,single-choice,spatial-relational,6|7,7,6/7,210365,6
3,3,21,366,0,695,1,7,3,4,4,single-choice,spatial-relational,3|4,7,3/4,210366,3
3,3,21,367,1,671,1,7,3,3,4,single-choice,spatial-relational,3|4,7,3/4,210367,3
3,3,21,368,1,935,1,13,6,6,7,single-choice,spatial-relational,6|7,7,6/7,210368,6
3,3,21,369,0,884,1,11,5,6,6,single-choice,spatial-relational,5|6,7,5/6,210369,5
3,3,21,370,0,463,1,3,1,2,2,single-choice,spatial-relational,1|2,7,1/2,210370,1
3,3,21,371,1,539,1,5,2,2,3,single-choice,spatial-relational,2|3,7,2/3,210371,2
3,3,21,372,1,810,1,5,2,2,3,single-choice,spatial-relational,2|3,7,2/3,210372,2
3,3,21,373,0,686,1,13,6,7,7,single-choice,spatial-relational,6|7,7,6/7,210373,6
3,3,21,374,1,821,1,9,4,4,5,single-choice,spatial-relational,4|5,7,4/5,210374,4
3,3,21,375,0,834,1,13,6,7,7,single-choice,spatial-relational,6|7,7,6/7,210375,6
3,3,21,376,0,463,1,5,2,3,3,single-choice,spatial-relational,2|3,7,2/3,210376,2
3,3,21,377,0,681,1,9,4,5,5,single-choice,spatial-relational,4|5,7,4/5,210377,4
3,3,21,378,0,850,1,3,1,2,2,single-choice,spatial-relational,1|2,7,1/2,210378,1
3,3,21,379,1,1408,1,7,3,3,4,single-choice,spatial-relational,3|4,7,3/4,210379,3
3,3,21,380,1,800,1,11,5,5,6,single-choice,spatial-relational,5|6,7,5/6,210380,5
3,3,21,381,0,706,1,3,1,2,2,single-choice,spatial-relational,1|2,7,1/2,210381,1
3,3,21,382,1,964,1,11,5,5,6,single-choice,spatial-relational,5|6,7,5/6,210382,5
3,3,21,383,0,736,1,5,2,3,3,single-choice,spatial-relational,2|3,7,2/3,210383,2
3,3,21,384,0,130,1,7,3,4,4,single-choice,spatial-relational,3|4,7,3/4,210384,3
3,3,21,385,0,421,1,3,1,2,2,single-choice,spatial-relational,1|2,7,1/2,210385,1
3,3,21,386,1,683,1,5,2,2,3,single-choice,spatial-relational,2|3,7,2/3,210386,2
3,3,21,387,1,837,1,9,4,4,5,single-choice,spatial-relational,4|5,7,4/5,210387,4
3,3,21,388,1,1763,1,13,6,6,7,single-choice,spatial-relational,6|7,7,6/7,210388,6
3,3,21,389,1,857,1,11,5,5,6,single-choice,spatial-relational,5|6,7,5/6,210389,5
3,3,21,390,1,915,1,7,3,3,4,single-choice,spatial-relational,3|4,7,3/4,210390,3
3,3,21,391,1,791,1,7,3,3,4,single-choice,spatial-relational,3|4,7,3/4,210391,3
3,3,21,392,1,790,1,5,2,2,3,single-choice,spatial-relational,2|3,7,2/3,210392,2
3,3,21,393,1,748,1,11,5,5,6,single-choice,spatial-relational,5|6,7,5/6,210393,5
3,3,21,394,0,764,1,9,4,5,5,single-choice,spatial-relational,4|5,7,4/5,210394,4
3,3,21,395,0,694,1,13,6,7,7,single-choice,spatial-relational,6|7,7,6/7,210395,6
3,3,21,396,1,48,1,3,1,1,2,single-choice,spatial-relational,1|2,7,1/2,210396,1
3,3,21,397,1,1037,1,5,2,2,3,single-choice,spatial-relational,2|3,7,2/3,210397,2
3,3,21,398,1,792,1,3,1,1,2,single-choice,spatial-relational,1|2,7,1/2,210398,1
3,3,21,399,0,731,1,9,4,5,5,single-choice,spatial-relational,4|5,7,4/5,210399,4
3,3,21,400,1,911,1,11,5,5,6,single-choice,spatial-relational,5|6,7,5/6,210400,5
3,3,21,401,0,717,1,3,1,2,2,single-choice,spatial-relational,1|2,7,1/2,210401,1
3,3,21,402,1,195,1,13,6,6,7,single-choice,spatial-relational,6|7,7,6/7,210402,6
3,3,21,403,1,826,1,5,2,2,3,single-choice,spatial-relational,2|3,7,2/3,210403,2
3,3,21,404,1,841,1,7,3,3,4,single-choice,spatial-relational,3|4,7,3/4,210404,3
3,3,21,405,0,1059,1,11,5,6,6,single-choice,spatial-relational,5|6,7,5/6,210405,5
3,3,21,406,1,532,1,7,3,3,4,single-choice,spatial-relational,3|4,7,3/4,210406,3
3,3,21,407,0,745,1,9,4,5,5,single-choice,spatial-relational,4|5,7,4/5,210407,4
3,3,21,408,0,651,1,13,6,7,7,single-choice,spatial-relational,6|7,7,6/7,210408,6
3,3,21,409,1,629,1,5,2,2,3,single-choice,spatial-relational,2|3,7,2/3,210409,2
3,3,21,410,1,1393,1,11,5,5,6,single-choice,spatial-relational,5|6,7,5/6,210410,5
3,3,21,411,1,651,1,7,3,3,4,single-choice,spatial-relational,3|4,7,3/4,210411,3
3,3,21,412,1,942,1,13,6,6,7,single-choice,spatial-relational,6|7,7,6/7,210412,6
3,3,21,413,0,689,1,9,4,5,5,single-choice,spatial-relational,4|5,7,4/5,210413,4
3,3,21,414,0,494,1,7,3,4,4,single-choice,spatial-relational,3|4,7,3/4,210414,3
3,3,21,415,0,447,1,5,2,3,3,single-choice,spatial-relational,2|3,7,2/3,210415,2
3,3,21,416,1,438,1,3,1,1,2,single-choice,spatial-relational,1|2,7,1/2,210416,1
3,3,21,417,1,629,1,3,1,1,2,single-choice,spatial-relational,1|2,7,1/2,210417,1
3,3,21,418,1,1115,1,13,6,6,7,single-choice,spatial-relational,6|7,7,6/7,210418,6
3,3,21,419,0,1099,1,9,4,5,5,single-choice,spatial-relational,4|5,7,4/5,210419,4
3,3,21,420,0,842,1,11,5,6,6,single-choice,spatial-relational,5|6,7,5/6,210420,5
3,3,21,421,1,484,1,3,1,1,2,single-choice,spatial-relational,1|2,7,1/2,210421,1
3,3,21,422,1,1587,1,11,5,5,6,single-choice,spatial-relational,5|6,7,5/6,210422,5
3,3,21,423,1,842,1,7,3,3,4,single-choice,spatial-relational,3|4,7,3/4,210423,3
3,3,21,424,1,861,1,13,6,6,7,single-choice,spatial-relational,6|7,7,6/7,210424,6
3,3,21,425,1,830,1,5,2,2,3,single-choice,spatial-relational,2|3,7,2/3,210425,2
3,3,21,426,0,731,1,5,2,3,3,single-choice,spatial-relational,2|3,7,2/3,210426,2
3,3,21,427,0,831,1,7,3,4,4,single-choice,spatial-relational,3|4,7,3/4,210427,3
3,3,21,428,0,475,1,3,1,2,2,single-choice,spatial-relational,1|2,7,1/2,210428,1
3,3,21,429,0,880,1,9,4,5,5,single-choice,spatial-relational,4|5,7,4/5,210429,4
3,3,21,430,1,859,1,13,6,6,7,single-choice,spatial-relational,6|7,7,6/7,210430,6
3,3,21,431,0,927,1,11,5,6,6,single-choice,spatial-relational,5|6,7,5/6,210431,5
3,3,21,432,0,988,1,9,4,5,5,single-choice,spatial-relational,4|5,7,4/5,210432,4
3,3,21,433,1,739,1,5,2,2,3,single-choice,spatial-relational,2|3,7,2/3,210433,2
3,3,21,434,1,894,1,9,4,4,5,single-choice,spatial-relational,4|5,7,4/5,210434,4
3,3,21,435,1,805,1,7,3,3,4,single-choice,spatial-relational,3|4,7,3/4,210435,3
3,3,21,436,1,904,1,13,6,6,7,single-choice,spatial-relational,6|7,7,6/7,210436,6
3,3,21,437,1,1436,1,5,2,2,3,single-choice,spatial-relational,2|3,7,2/3,210437,2
3,3,21,438,0,1080,1,11,5,6,6,single-choice,spatial-relational,5|6,7,5/6,210438,5
3,3,21,439,0,640,1,7,3,4,4,single-choice,spatial-relational,3|4,7,3/4,210439,3
3,3,21,440,1,510,1,3,1,1,2,single-choice,spatial-relational,1|2,7,1/2,210440,1
3,3,21,441,0,701,1,13,6,7,7,single-choice,spatial-relational,6|7,7,6/7,210441,6
3,3,21,442,1,740,1,11,5,5,6,single-choice,spatial-relational,5|6,7,5/6,210442,5
3,3,21,443,0,1048,1,3,1,2,2,single-choice,spatial-relational,1|2,7,1/2,210443,1
3,3,21,444,0,882,1,9,4,5,5,single-choice,spatial-relational,4|5,7,4/5,210444,4
3,3,21,445,0,613,1,13,6,7,7,single-choice,spatial-relational,6|7,7,6/7,210445,6
3,3,21,446,0,52,1,3,1,2,2,single-choice,spatial-relational,1|2,7,1/2,210446,1
3,3,21,447,1,906,1,13,6,6,7,single-choice,spatial-relational,6|7,7,6/7,210447,6
3,3,21,448,0,894,1,3,1,2,2,single-choice,spatial-relational,1|2,7,1/2,210448,1
3,3,21,449,0,1380,1,11,5,6,6,single-choice,spatial-relational,5|6,7,5/6,210449,5
3,3,21,450,1,490,1,5,2,2,3,single-choice,spatial-relational,2|3,7,2/3,210450,2
3,3,21,451,1,819,1,7,3,3,4,single-choice,spatial-relational,3|4,7,3/4,210451,3
3,3,21,452,1,713,1,5,2,2,3,single-choice,spatial-relational,2|3,7,2/3,210452,2
3,3,21,453,1,790,1,7,3,3,4,single-choice,spatial-relational,3|4,7,3/4,210453,3
3,3,21,454,1,770,1,9,4,4,5,single-choice,spatial-relational,4|5,7,4/5,210454,4
3,3,21,455,1,763,1,11,5,5,6,single-choice,spatial-relational,5|6,7,5/6,210455,5
3,3,21,456,1,52,1,9,4,4,5,single-choice,spatial-relational,4|5,7,4/5,210456,4
3,3,21,457,1,814,1,11,5,5,6,single-choice,spatial-relational,5|6,7,5/6,210457,5
3,3,21,458,1,667,1,3,1,1,2,single-choice,spatial-relational,1|2,7,1/2,210458,1
3,3,21,459,1,729,1,9,4,4,5,single-choice,spatial-relational,4|5,7,4/5,210459,4
3,3,21,460,0,709,1,13,6,7,7,single-choice,spatial-relational,6|7,7,6/7,210460,6
3,3,21,461,1,579,1,7,3,3,4,single-choice,spatial-relational,3|4,7,3/4,210461,3
3,3,21,462,1,603,1,7,3,3,4,single-choice,spatial-relational,3|4,7,3/4,210462,3
3,3,21,463,1,623,1,5,2,2,3,single-choice,spatial-relational,2|3,7,2/3,210463,2
3,3,21,464,0,593,1,5,2,3,3,single-choice,spatial-relational,2|3,7,2/3,210464,2
3,3,21,465,1,48,1,3,1,1,2,single-choice,spatial-relational,1|2,7,1/2,210465,1
3,3,21,466,0,942,1,9,4,5,5,single-choice,spatial-relational,4|5,7,4/5,210466,4
3,3,21,467,1,733,1,11,5,5,6,single-choice,spatial-relational,5|6,7,5/6,210467,5
3,3,21,468,0,821,1,13,6,7,7,single-choice,spatial-relational,6|7,7,6/7,210468,6
3,3,21,469,1,721,1,5,2,2,3,single-choice,spatial-relational,2|3,7,2/3,210469,2
3,3,21,470,1,771,1,13,6,6,7,single-choice,spatial-relational,6|7,7,6/7,210470,6
3,3,21,471,1,690,1,9,4,4,5,single-choice,spatial-relational,4|5,7,4/5,210471,4
3,3,21,472,1,867,1,11,5,5,6,single-choice,spatial-relational,5|6,7,5/6,210472,5
3,3,21,473,1,833,1,13,6,6,7,single-choice,spatial-relational,6|7,7,6/7,210473,6
3,3,21,474,1,687,1,7,3,3,4,single-choice,spatial-relational,3|4,7,3/4,210474,3
3,3,21,475,1,825,1,5,2,2,3,single-choice,spatial-relational,2|3,7,2/3,210475,2
3,3,21,476,1,787,1,7,3,3,4,single-choice,spatial-relational,3|4,7,3/4,210476,3
3,3,21,477,0,743,1,9,4,5,5,single-choice,spatial-relational,4|5,7,4/5,210477,4
3,3,21,478,0,40,1,3,1,2,2,single-choice,spatial-relational,1|2,7,1/2,210478,1
3,3,21,479,1,669,1,11,5,5,6,single-choice,spatial-relational,5|6,7,5/6,210479,5
3,3,21,480,0,638,1,3,1,2,2,single-choice,spatial-relational,1|2,7,1/2,210480,1
3,3,21,481,0,546,1,5,2,3,3,single-choice,spatial-relational,2|3,7,2/3,210481,2
3,3,21,482,0,1388,1,7,3,4,4,single-choice,spatial-relational,3|4,7,3/4,210482,3
3,3,21,483,1,439,1,3,1,1,2,single-choice,spatial-relational,1|2,7,1/2,210483,1
3,3,21,484,0,765,1,9,4,5,5,single-choice,spatial-relational,4|5,7,4/5,210484,4
3,3,21,485,0,533,1,3,1,2,2,single-choice,spatial-relational,1|2,7,1/2,210485,1
3,3,21,486,1,842,1,7,3,3,4,single-choice,spatial-relational,3|4,7,3/4,210486,3
3,3,21,487,1,814,1,9,4,4,5,single-choice,spatial-relational,4|5,7,4/5,210487,4
3,3,21,488,1,638,1,11,5,5,6,single-choice,spatial-relational,5|6,7,5/6,210488,5
3,3,21,489,0,1065,1,11,5,6,6,single-choice,spatial-relational,5|6,7,5/6,210489,5
3,3,21,490,1,685,1,13,6,6,7,single-choice,spatial-relational,6|7,7,6/7,210490,6
3,3,21,491,0,677,1,5,2,3,3,single-choice,spatial-relational,2|3,7,2/3,210491,2
3,3,21,492,0,674,1,13,6,7,7,single-choice,spatial-relational,6|7,7,6/7,210492,6
3,3,21,493,1,934,1,9,4,4,5,single-choice,spatial-relational,4|5,7,4/5,210493,4
3,3,21,494,1,642,1,9,4,4,5,single-choice,spatial-relational,4|5,7,4/5,210494,4
3,3,21,495,1,728,1,3,1,1,2,single-choice,spatial-relational,1|2,7,1/2,210495,1
3,3,21,496,0,762,1,3,1,2,2,single-choice,spatial-relational,1|2,7,1/2,210496,1
3,3,21,497,0,678,1,13,6,7,7,single-choice,spatial-relational,6|7,7,6/7,210497,6
3,3,21,498,1,550,1,7,3,3,4,single-choice,spatial-relational,3|4,7,3/4,210498,3
3,3,21,499,0,635,1,5,2,3,3,single-choice,spatial-relational,2|3,7,2/3,210499,2
3,3,21,500,0,446,1,5,2,3,3,single-choice,spatial-relational,2|3,7,2/3,210500,2
3,3,21,501,1,940,1,7,3,3,4,single-choice,spatial-relational,3|4,7,3/4,210501,3
3,3,21,502,1,922,1,11,5,5,6,single-choice,spatial-relational,5|6,7,5/6,210502,5
3,3,21,503,1,651,1,11,5,5,6,single-choice,spatial-relational,5|6,7,5/6,210503,5
3,3,21,504,0,771,1,13,6,7,7,single-choice,spatial-relational,6|7,7,6/7,210504,6
3,3,21,505,1,583,1,13,6,6,7,single-choice,spatial-relational,6|7,7,6/7,210505,6
3,3,21,506,1,820,1,7,3,3,4,single-choice,spatial-relational,3|4,7,3/4,210506,3
3,3,21,507,1,725,1,11,5,5,6,single-choice,spatial-relational,5|6,7,5/6,210507,5
3,3,21,508,1,703,1,7,3,3,4,single-choice,spatial-relational,3|4,7,3/4,210508,3
3,3,21,509,0,779,1,9,4,5,5,single-choice,spatial-relational,4|5,7,4/5,210509,4
3,3,21,510,0,484,1,3,1,2,2,single-choice,spatial-relational,1|2,7,1/2,210510,1
3,3,21,511,1,1170,1,11,5,5,6,single-choice,spatial-relational,5|6,7,5/6,210511,5
3,3,21,512,1,1188,1,3,1,1,2,single-choice,spatial-relational,1|2,7,1/2,210512,1
3,3,21,513,1,762,1,9,4,4,5,single-choice,spatial-relational,4|5,7,4/5,210513,4
3,3,21,514,0,552,1,5,2,3,3,single-choice,spatial-relational,2|3,7,2/3,210514,2
3,3,21,515,0,967,1,13,6,7,7,single-choice,spatial-relational,6|7,7,6/7,210515,6
3,3,21,516,1,705,1,5,2,2,3,single-choice,spatial-relational,2|3,7,2/3,210516,2
3,3,21,517,1,807,1,9,4,4,5,single-choice,spatial-relational,4|5,7,4/5,210517,4
3,3,21,518,0,2444,1,5,2,3,3,single-choice,spatial-relational,2|3,7,2/3,210518,2
3,3,21,519,0,792,1,9,4,5,5,single-choice,spatial-relational,4|5,7,4/5,210519,4
3,3,21,520,1,681,1,7,3,3,4,single-choice,spatial-relational,3|4,7,3/4,210520,3
3,3,21,521,1,905,1,13,6,6,7,single-choice,spatial-relational,6|7,7,6/7,210521,6
3,3,21,522,1,781,1,11,5,5,6,single-choice,spatial-relational,5|6,7,5/6,210522,5
3,3,21,523,1,869,1,7,3,3,4,single-choice,spatial-relational,3|4,7,3/4,210523,3
3,3,21,524,1,928,1,11,5,5,6,single-choice,spatial-relational,5|6,7,5/6,210524,5
3,3,21,525,0,692,1,13,6,7,7,single-choice,spatial-relational,6|7,7,6/7,210525,6
3,3,21,526,1,600,1,3,1,1,2,single-choice,spatial-relational,1|2,7,1/2,210526,1
3,3,21,527,1,631,1,3,1,1,2,single-choice,spatial-relational,1|2,7,1/2,210527,1
3,3,21,528,1,744,1,5,2,2,3,single-choice,spatial-relational,2|3,7,2/3,210528,2
3,3,21,529,1,805,1,11,5,5,6,single-choice,spatial-relational,5|6,7,5/6,210529,5
3,3,21,530,1,814,1,13,6,6,7,single-choice,spatial-relational,6|7,7,6/7,210530,6
3,3,21,531,0,1675,1,7,3,4,4,single-choice,spatial-relational,3|4,7,3/4,210531,3
3,3,21,532,0,473,1,3,1,2,2,single-choice,spatial-relational,1|2,7,1/2,210532,1
3,3,21,533,1,160,1,9,4,4,5,single-choice,spatial-relational,4|5,7,4/5,210533,4
3,3,21,534,1,705,1,5,2,2,3,single-choice,spatial-relational,2|3,7,2/3,210534,2
3,3,21,535,0,1180,1,13,6,7,7,single-choice,spatial-relational,6|7,7,6/7,210535,6
3,3,21,536,1,482,1,3,1,1,2,single-choice,spatial-relational,1|2,7,1/2,210536,1
3,3,21,537,1,619,1,7,3,3,4,single-choice,spatial-relational,3|4,7,3/4,210537,3
3,3,21,538,0,603,1,5,2,3,3,single-choice,spatial-relational,2|3,7,2/3,210538,2
3,3,21,539,1,886,1,11,5,5,6,single-choice,spatial-relational,5|6,7,5/6,210539,5
3,3,21,540,1,786,1,9,4,4,5,single-choice,spatial-relational,4|5,7,4/5,210540,4
3,3,21,541,1,1272,1,5,2,2,3,single-choice,spatial-relational,2|3,7,2/3,210541,2
3,3,21,542,1,771,1,3,1,1,2,single-choice,spatial-relational,1|2,7,1/2,210542,1
3,3,21,543,1,509,1,3,1,1,2,single-choice,spatial-relational,1|2,7,1/2,210543,1
3,3,21,544,0,471,1,11,5,6,6,single-choice,spatial-relational,5|6,7,5/6,210544,5
3,3,21,545,0,923,1,13,6,7,7,single-choice,spatial-relational,6|7,7,6/7,210545,6
3,3,21,546,1,612,1,7,3,3,4,single-choice,spatial-relational,3|4,7,3/4,210546,3
3,3,21,547,0,642,1,5,2,3,3,single-choice,spatial-relational,2|3,7,2/3,210547,2
3,3,21,548,1,951,1,9,4,4,5,single-choice,spatial-relational,4|5,7,4/5,210548,4
3,3,21,549,1,730,1,13,6,6,7,single-choice,spatial-relational,6|7,7,6/7,210549,6
3,3,21,550,1,632,1,7,3,3,4,single-choice,spatial-relational,3|4,7,3/4,210550,3
3,3,21,551,1,783,1,11,5,5,6,single-choice,spatial-relational,5|6,7,5/6,210551,5
3,3,21,552,0,670,1,9,4,5,5,single-choice,spatial-relational,4|5,7,4/5,210552,4
3,3,21,553,0,828,1,11,5,6,6,single-choice,spatial-relational,5|6,7,5/6,210553,5
3,3,21,554,1,667,1,11,5,5,6,single-choice,spatial-relational,5|6,7,5/6,210554,5
3,3,21,555,1,744,1,13,6,6,7,single-choice,spatial-relational,6|7,7,6/7,210555,6
3,3,21,556,1,781,1,7,3,3,4,single-choice,spatial-relational,3|4,7,3/4,210556,3
3,3,21,557,0,616,1,5,2,3,3,single-choice,spatial-relational,2|3,7,2/3,210557,2
3,3,21,558,0,700,1,9,4,5,5,single-choice,spatial-relational,4|5,7,4/5,210558,4
3,3,21,559,0,831,1,9,4,5,5,single-choice,spatial-relational,4|5,7,4/5,210559,4
3,3,21,560,1,834,1,13,6,6,7,single-choice,spatial-relational,6|7,7,6/7,210560,6
3,3,21,561,1,726,1,5,2,2,3,single-choice,spatial-relational,2|3,7,2/3,210561,2
3,3,21,562,1,761,1,7,3,3,4,single-choice,spatial-relational,3|4,7,3/4,210562,3
3,3,21,563,0,1804,1,3,1,2,2,single-choice,spatial-relational,1|2,7,1/2,210563,1
3,3,21,564,1,682,1,3,1,1,2,single-choice,spatial-relational,1|2,7,1/2,210564,1
3,3,21,565,0,749,1,3,1,2,2,single-choice,spatial-relational,1|2,7,1/2,210565,1
3,3,21,566,0,422,1,5,2,3,3,single-choice,spatial-relational,2|3,7,2/3,210566,2
3,3,21,567,0,809,1,11,5,6,6,single-choice,spatial-relational,5|6,7,5/6,210567,5
3,3,21,568,1,483,1,5,2,2,3,single-choice,spatial-relational,2|3,7,2/3,210568,2
3,3,21,569,1,899,1,7,3,3,4,single-choice,spatial-relational,3|4,7,3/4,210569,3
3,3,21,570,1,596,1,7,3,3,4,single-choice,spatial-relational,3|4,7,3/4,210570,3
3,3,21,571,1,795,1,13,6,6,7,single-choice,spatial-relational,6|7,7,6/7,210571,6
3,3,21,572,0,606,1,3,1,2,2,single-choice,spatial-relational,1|2,7,1/2,210572,1
3,3,21,573,0,560,1,13,6,7,7,single-choice,spatial-relational,6|7,7,6/7,210573,6
3,3,21,574,1,783,1,9,4,4,5,single-choice,spatial-relational,4|5,7,4/5,210574,4
3,3,21,575,1,645,1,9,4,4,5,single-choice,spatial-relational,4|5,7,4/5,210575,4
3,3,21,576,1,931,1,11,5,5,6,single-choice,spatial-relational,5|6,7,5/6,210576,5
3,3,21,577,1,873,1,11,5,5,6,single-choice,spatial-relational,5|6,7,5/6,210577,5
3,3,21,578,1,1344,1,9,4,4,5,single-choice,spatial-relational,4|5,7,4/5,210578,4
3,3,21,579,0,19399,1,3,1,2,2,single-choice,spatial-relational,1|2,7,1/2,210579,1
3,3,21,580,0,924,1,9,4,5,5,single-choice,spatial-relational,4|5,7,4/5,210580,4
3,3,21,581,1,545,1,3,1,1,2,single-choice,spatial-relational,1|2,7,1/2,210581,1
3,3,21,582,1,798,1,5,2,2,3,single-choice,spatial-relational,2|3,7,2/3,210582,2
3,3,21,583,1,693,1,13,6,6,7,single-choice,spatial-relational,6|7,7,6/7,210583,6
3,3,21,584,0,660,1,5,2,3,3,single-choice,spatial-relational,2|3,7,2/3,210584,2
3,3,21,585,1,713,1,7,3,3,4,single-choice,spatial-relational,3|4,7,3/4,210585,3
3,3,21,586,0,1032,1,11,5,6,6,single-choice,spatial-relational,5|6,7,5/6,210586,5
3,3,21,587,0,705,1,13,6,7,7,single-choice,spatial-relational,6|7,7,6/7,210587,6
3,3,21,588,1,672,1,7,3,3,4,single-choice,spatial-relational,3|4,7,3/4,210588,3
3,3,21,589,1,633,1,7,3,3,4,single-choice,spatial-relational,3|4,7,3/4,210589,3
3,3,21,590,0,708,1,5,2,3,3,single-choice,spatial-relational,2|3,7,2/3,210590,2
3,3,21,591,0,776,1,11,5,6,6,single-choice,spatial-relational,5|6,7,5/6,210591,5
3,3,21,592,1,675,1,9,4,4,5,single-choice,spatial-relational,4|5,7,4/5,210592,4
3,3,21,593,1,671,1,3,1,1,2,single-choice,spatial-relational,1|2,7,1/2,210593,1
3,3,21,594,1,789,1,13,6,6,7,single-choice,spatial-relational,6|7,7,6/7,210594,6
3,3,21,595,0,635,1,7,3,4,4,single-choice,spatial-relational,3|4,7,3/4,210595,3
3,3,21,596,0,618,1,5,2,3,3,single-choice,spatial-relational,2|3,7,2/3,210596,2
3,3,21,597,0,522,1,3,1,2,2,single-choice,spatial-relational,1|2,7,1/2,210597,1
3,3,21,598,1,813,1,11,5,5,6,single-choice,spatial-relational,5|6,7,5/6,210598,5
3,3,21,599,1,763,1,13,6,6,7,single-choice,spatial-relational,6|7,7,6/7,210599,6
3,3,21,600,1,736,1,9,4,4,5,single-choice,spatial-relational,4|5,7,4/5,210600,4
4,3,21,1,0,1132,1,3,1,2,2,single-choice,spatial-relational,1|2,7,1/2,210001,1
4,3,21,2,1,549,1,5,2,2,3,single-choice,spatial-relational,2|3,7,2/3,210002,2
4,3,21,3,0,511,1,7,3,4,4,single-choice,spatial-relational,3|4,7,3/4,210003,3
4,3,21,4,0,705,1,11,5,6,6,single-choice,spatial-relational,5|6,7,5/6,210004,5
4,3,21,5,0,578,1,7,3,4,4,single-choice,spatial-relational,3|4,7,3/4,210005,3
4,3,21,6,0,452,1,9,4,5,5,single-choice,spatial-relational,4|5,7,4/5,210006,4
4,3,21,7,1,44,1,13,6,6,7,single-choice,spatial-relational,6|7,7,6/7,210007,6
4,3,21,8,0,527,1,11,5,6,6,single-choice,spatial-relational,5|6,7,5/6,210008,5
4,3,21,9,1,523,1,3,1,1,2,single-choice,spatial-relational,1|2,7,1/2,210009,1
4,3,21,10,0,561,1,13,6,7,7,single-choice,spatial-relational,6|7,7,6/7,210010,6
4,3,21,11,0,442,1,5,2,3,3,single-choice,spatial-relational,2|3,7,2/3,210011,2
4,3,21,12,1,631,1,9,4,4,5,single-choice,spatial-relational,4|5,7,4/5,210012,4
4,3,21,13,0,625,1,7,3,4,4,single-choice,spatial-relational,3|4,7,3/4,210013,3
4,3,21,14,0,873,1,11,5,6,6,single-choice,spatial-relational,5|6,7,5/6,210014,5
4,3,21,15,1,752,1,11,5,5,6,single-choice,spatial-relational,5|6,7,5/6,210015,5
4,3,21,16,1,697,1,13,6,6,7,single-choice,spatial-relational,6|7,7,6/7,210016,6
4,3,21,17,1,638,1,7,3,3,4,single-choice,spatial-relational,3|4,7,3/4,210017,3
4,3,21,18,1,663,1,9,4,4,5,single-choice,spatial-relational,4|5,7,4/5,210018,4
4,3,21,19,0,522,1,5,2,3,3,single-choice,spatial-relational,2|3,7,2/3,210019,2
4,3,21,20,1,528,1,3,1,1,2,single-choice,spatial-relational,1|2,7,1/2,210020,1
4,3,21,21,1,663,1,9,4,4,5,single-choice,spatial-relational,4|5,7,4/5,210021,4
4,3,21,22,0,507,1,13,6,7,7,single-choice,spatial-relational,6|7,7,6/7,210022,6
4,3,21,23,1,604,1,5,2,2,3,single-choice,spatial-relational,2|3,7,2/3,210023,2
4,3,21,24,0,717,1,3,1,2,2,single-choice,spatial-relational,1|2,7,1/2,210024,1
4,3,21,25,0,708,1,7,3,4,4,single-choice,spatial-relational,3|4,7,3/4,210025,3
4,3,21,26,1,750,1,5,2,2,3,single-choice,spatial-relational,2|3,7,2/3,210026,2
4,3,21,27,1,740,1,13,6,6,7,single-choice,spatial-relational,6|7,7,6/7,210027,6
4,3,21,28,0,729,1,11,5,6,6,single-choice,spatial-relational,5|6,7,5/6,210028,5
4,3,21,29,0,497,1,13,6,7,7,single-choice,spatial-relational,6|7,7,6/7,210029,6
4,3,21,30,0,892,1,9,4,5,5,single-choice,spatial-relational,4|5,7,4/5,210030,4
4,3,21,31,0,684,1,9,4,5,5,single-choice,spatial-relational,4|5,7,4/5,210031,4
4,3,21,32,0,698,1,11,5,6,6,single-choice,spatial-relational,5|6,7,5/6,210032,5
4,3,21,33,0,424,1,3,1,2,2,single-choice,spatial-relational,1|2,7,1/2,210033,1
4,3,21,34,0,427,1,5,2,3,3,single-choice,spatial-relational,2|3,7,2/3,210034,2
4,3,21,35,1,441,1,3,1,1,2,single-choice,spatial-relational,1|2,7,1/2,210035,1
4,3,21,36,1,556,1,7,3,3,4,single-choice,spatial-relational,3|4,7,3/4,210036,3
4,3,21,37,1,693,1,5,2,2,3,single-choice,spatial-relational,2|3,7,2/3,210037,2
4,3,21,38,0,645,1,9,4,5,5,single-choice,spatial-relational,4|5,7,4/5,210038,4
4,3,21,39,1,634,1,11,5,5,6,single-choice,spatial-relational,5|6,7,5/6,210039,5
4,3,21,40,1,862,1,7,3,3,4,single-choice,spatial-relational,3|4,7,3/4,210040,3
4,3,21,41,0,822,1,3,1,2,2,single-choice,spatial-relational,1|2,7,1/2,210041,1
4,3,21,42,1,634,1,3,1,1,2,single-choice,spatial-relational,1|2,7,1/2,210042,1
4,3,21,43,0,598,1,5,2,3,3,single-choice,spatial-relational,2|3,7,2/3,210043,2
4,3,21,44,0,732,1,7,3,4,4,single-choice,spatial-relational,3|4,7,3/4,210044,3
4,3,21,45,0,618,1,11,5,6,6,single-choice,spatial-relational,5|6,7,5/6,210045,5
4,3,21,46,1,703,1,13,6,6,7,single-choice,spatial-relational,6|7,7,6/7,210046,6
4,3,21,47,0,572,1,13,6,7,7,single-choice,spatial-relational,6|7,7,6/7,210047,6
4,3,21,48,0,520,1,9,4,5,5,single-choice,spatial-relational,4|5,7,4/5,210048,4
4,3,21,49,1,714,1,13,6,6,7,single-choice,spatial-relational,6|7,7,6/7,210049,6
4,3,21,50,0,751,1,7,3,4,4,single-choice,spatial-relational,3|4,7,3/4,210050,3
4,3,21,51,1,1113,1,11,5,5,6,single-choice,spatial-relational,5|6,7,5/6,210051,5
4,3,21,52,1,817,1,9,4,4,5,single-choice,spatial-relational,4|5,7,4/5,210052,4
4,3,21,53,0,765,1,5,2,3,3,single-choice,spatial-relational,2|3,7,2/3,210053,2
4,3,21,54,1,2061,1,13,6,6,7,single-choice,spatial-relational,6|7,7,6/7,210054,6
4,3,21,55,0,870,1,3,1,2,2,single-choice,spatial-relational,1|2,7,1/2,210055,1
4,3,21,56,1,503,1,7,3,3,4,single-choice,spatial-relational,3|4,7,3/4,210056,3
4,3,21,57,1,619,1,11,5,5,6,single-choice,spatial-relational,5|6,7,5/6,210057,5
4,3,21,58,0,915,1,9,4,5,5,single-choice,spatial-relational,4|5,7,4/5,210058,4
4,3,21,59,1,393,1,3,1,1,2,single-choice,spatial-relational,1|2,7,1/2,210059,1
4,3,21,60,1,634,1,5,2,2,3,single-choice,spatial-relational,2|3,7,2/3,210060,2
4,3,21,61,0,739,1,5,2,3,3,single-choice,spatial-relational,2|3,7,2/3,210061,2
4,3,21,62,0,443,1,11,5,6,6,single-choice,spatial-relational,5|6,7,5/6,210062,5
4,3,21,63,0,414,1,5,2,3,3,single-choice,spatial-relational,2|3,7,2/3,210063,2
4,3,21,64,0,513,1,7,3,4,4,single-choice,spatial-relational,3|4,7,3/4,210064,3
4,3,21,65,1,617,1,9,4,4,5,single-choice,spatial-relational,4|5,7,4/5,210065,4
4,3,21,66,1,954,1,11,5,5,6,single-choice,spatial-relational,5|6,7,5/6,210066,5
4,3,21,67,0,842,1,3,1,2,2,single-choice,spatial-relational,1|2,7,1/2,210067,1
4,3,21,68,1,738,1,13,6,6,7,single-choice,spatial-relational,6|7,7,6/7,210068,6
4,3,21,69,0,662,1,13,6,7,7,single-choice,spatial-relational,6|7,7,6/7,210069,6
4,3,21,70,1,475,1,3,1,1,2,single-choice,spatial-relational,1|2,7,1/2,210070,1
4,3,21,71,1,611,1,7,3,3,4,single-choice,spatial-relational,3|4,7,3/4,210071,3
4,3,21,72,1,783,1,9,4,4,5,single-choice,spatial-relational,4|5,7,4/5,210072,4
4,3,21,73,1,612,1,7,3,3,4,single-choice,spatial-relational,3|4,7,3/4,210073,3
4,3,21,74,0,1022,1,11,5,6,6,single-choice,spatial-relational,5|6,7,5/6,210074,5
4,3,21,75,1,654,1,9,4,4,5,single-choice,spatial-relational,4|5,7,4/5,210075,4
4,3,21,76,0,962,1,13,6,7,7,single-choice,spatial-relational,6|7,7,6/7,210076,6
4,3,21,77,0,449,1,3,1,2,2,single-choice,spatial-relational,1|2,7,1/2,210077,1
4,3,21,78,0,701,1,7,3,4,4,single-choice,spatial-relational,3|4,7,3/4,210078,3
4,3,21,79,1,464,1,3,1,1,2,single-choice,spatial-relational,1|2,7,1/2,210079,1
4,3,21,80,1,619,1,11,5,5,6,single-choice,spatial-relational,5|6,7,5/6,210080,5
4,3,21,81,1,682,1,5,2,2,3,single-choice,spatial-relational,2|3,7,2/3,210081,2
4,3,21,82,1,838,1,5,2,2,3,single-choice,spatial-relational,2|3,7,2/3,210082,2
4,3,21,83,1,798,1,9,4,4,5,single-choice,spatial-relational,4|5,7,4/5,210083,4
4,3,21,84,0,705,1,13,6,7,7,single-choice,spatial-relational,6|7,7,6/7,210084,6
4,3,21,85,1,611,1,11,5,5,6,single-choice,spatial-relational,5|6,7,5/6,210085,5
4,3,21,86,1,1117,1,5,2,2,3,single-choice,spatial-relational,2|3,7,2/3,210086,2
4,3,21,87,0,826,1,13,6,7,7,single-choice,spatial-relational,6|7,7,6/7,210087,6
4,3,21,88,1,652,1,9,4,4,5,single-choice,spatial-relational,4|5,7,4/5,210088,4
4,3,21,89,0,713,1,3,1,2,2,single-choice,spatial-relational,1|2,7,1/2,210089,1
4,3,21,90,0,1602,1,5,2,3,3,single-choice,spatial-relational,2|3,7,2/3,210090,2
4,3,21,91,1,1042,1,9,4,4,5,single-choice,spatial-relational,4|5,7,4/5,210091,4
4,3,21,92,1,829,1,7,3,3,4,single-choice,spatial-relational,3|4,7,3/4,210092,3
4,3,21,93,0,664,1,3,1,2,2,single-choice,spatial-relational,1|2,7,1/2,210093,1
4,3,21,94,0,754,1,11,5,6,6,single-choice,spatial-relational,5|6,7,5/6,210094,5
4,3,21,95,0,752,1,13,6,7,7,single-choice,spatial-relational,6|7,7,6/7,210095,6
4,3,21,96,0,842,1,7,3,4,4,single-choice,spatial-relational,3|4,7,3/4,210096,3
4,3,21,97,1,530,1,7,3,3,4,single-choice,spatial-relational,3|4,7,3/4,210097,3
4,3,21,98,1,713,1,9,4,4,5,single-choice,spatial-relational,4|5,7,4/5,210098,4
4,3,21,99,1,889,1,13,6,6,7,single-choice,spatial-relational,6|7,7,6/7,210099,6
4,3,21,100,0,943,1,3,1,2,2,single-choice,spatial-relational,1|2,7,1/2,210100,1
4,3,21,101,0,505,1,5,2,3,3,single-choice,spatial-relational,2|3,7,2/3,210101,2
4,3,21,102,1,1099,1,9,4,4,5,single-choice,spatial-relational,4|5,7,4/5,210102,4
4,3,21,103,0,1088,1,7,3,4,4,single-choice,spatial-relational,3|4,7,3/4,210103,3
4,3,21,104,1,526,1,3,1,1,2,single-choice,spatial-relational,1|2,7,1/2,210104,1
4,3,21,105,1,843,1,13,6,6,7,single-choice,spatial-relational,6|7,7,6/7,210105,6
4,3,21,106,0,821,1,5,2,3,3,single-choice,spatial-relational,2|3,7,2/3,210106,2
4,3,21,107,0,764,1,11,5,6,6,single-choice,spatial-relational,5|6,7,5/6,210107,5
4,3,21,108,1,662,1,11,5,5,6,single-choice,spatial-relational,5|6,7,5/6,210108,5
4,3,21,109,1,618,1,11,5,5,6,single-choice,spatial-relational,5|6,7,5/6,210109,5
4,3,21,110,0,813,1,13,6,7,7,single-choice,spatial-relational,6|7,7,6/7,210110,6
4,3,21,111,0,423,1,5,2,3,3,single-choice,spatial-relational,2|3,7,2/3,210111,2
4,3,21,112,1,544,1,7,3,3,4,single-choice,spatial-relational,3|4,7,3/4,210112,3
4,3,21,113,1,1289,1,3,1,1,2,single-choice,spatial-relational,1|2,7,1/2,210113,1
4,3,21,114,0,668,1,3,1,2,2,single-choice,spatial-relational,1|2,7,1/2,210114,1
4,3,21,115,1,762,1,7,3,3,4,single-choice,spatial-relational,3|4,7,3/4,210115,3
4,3,21,116,0,638,1,11,5,6,6,single-choice,spatial-relational,5|6,7,5/6,210116,5
4,3,21,117,1,488,1,5,2,2,3,single-choice,spatial-relational,2|3,7,2/3,210117,2
4,3,21,118,0,628,1,9,4,5,5,single-choice,spatial-relational,4|5,7,4/5,210118,4
4,3,21,119,1,994,1,13,6,6,7,single-choice,spatial-relational,6|7,7,6/7,210119,6
4,3,21,120,1,834,1,9,4,4,5,single-choice,spatial-relational,4|5,7,4/5,210120,4
4,3,21,121,0,895,1,11,5,6,6,single-choice,spatial-relational,5|6,7,5/6,210121,5
4,3,21,122,1,48,1,13,6,6,7,single-choice,spatial-relational,6|7,7,6/7,210122,6
4,3,21,123,1,1007,1,11,5,5,6,single-choice,spatial-relational,5|6,7,5/6,210123,5
4,3,21,124,1,1054,1,7,3,3,4,single-choice,spatial-relational,3|4,7,3/4,210124,3
4,3,21,125,1,685,1,3,1,1,2,single-choice,spatial-relational,1|2,7,1/2,210125,1
4,3,21,126,1,764,1,5,2,2,3,single-choice,spatial-relational,2|3,7,2/3,210126,2
4,3,21,127,1,822,1,13,6,6,7,single-choice,spatial-relational,6|7,7,6/7,210127,6
4,3,21,128,0,693,1,3,1,2,2,single-choice,spatial-relational,1|2,7,1/2,210128,1
4,3,21,129,0,791,1,9,4,5,5,single-choice,spatial-relational,4|5,7,4/5,210129,4
4,3,21,130,1,474,1,5,2,2,3,single-choice,spatial-relational,2|3,7,2/3,210130,2
4,3,21,131,0,783,1,7,3,4,4,single-choice,spatial-relational,3|4,7,3/4,210131,3
4,3,21,132,1,1300,1,9,4,4,5,single-choice,spatial-relational,4|5,7,4/5,210132,4
4,3,21,133,1,807,1,3,1,1,2,single-choice,spatial-relational,1|2,7,1/2,210133,1
4,3,21,134,1,833,1,11,5,5,6,single-choice,spatial-relational,5|6,7,5/6,210134,5
4,3,21,135,1,756,1,5,2,2,3,single-choice,spatial-relational,2|3,7,2/3,210135,2
4,3,21,136,0,807,1,13,6,7,7,single-choice,spatial-relational,6|7,7,6/7,210136,6
4,3,21,137,1,812,1,9,4,4,5,single-choice,spatial-relational,4|5,7,4/5,210137,4
4,3,21,138,0,923,1,9,4,5,5,single-choice,spatial-relational,4|5,7,4/5,210138,4
4,3,21,139,1,773,1,3,1,1,2,single-choice,spatial-relational,1|2,7,1/2,210139,1
4,3,21,140,1,689,1,13,6,6,7,single-choice,spatial-relational,6|7,7,6/7,210140,6
4,3,21,141,1,666,1,11,5,5,6,single-choice,spatial-relational,5|6,7,5/6,210141,5
4,3,21,142,1,641,1,7,3,3,4,single-choice,spatial-relational,3|4,7,3/4,210142,3
4,3,21,143,1,990,1,7,3,3,4,single-choice,spatial-relational,3|4,7,3/4,210143,3
4,3,21,144,0,564,1,5,2,3,3,single-choice,spatial-relational,2|3,7,2/3,210144,2
4,3,21,145,0,594,1,5,2,3,3,single-choice,spatial-relational,2|3,7,2/3,210145,2
4,3,21,146,0,1293,1,11,5,6,6,single-choice,spatial-relational,5|6,7,5/6,210146,5
4,3,21,147,1,631,1,3,1,1,2,single-choice,spatial-relational,1|2,7,1/2,210147,1
4,3,21,148,1,632,1,13,6,6,7,single-choice,spatial-relational,6|7,7,6/7,210148,6
4,3,21,149,1,834,1,13,6,6,7,single-choice,spatial-relational,6|7,7,6/7,210149,6
4,3,21,150,1,771,1,9,4,4,5,single-choice,spatial-relational,4|5,7,4/5,210150,4
4,3,21,151,1,889,1,11,5,5,6,single-choice,spatial-relational,5|6,7,5/6,210151,5
4,3,21,152,1,662,1,7,3,3,4,single-choice,spatial-relational,3|4,7,3/4,210152,3
4,3,21,153,1,846,1,5,2,2,3,single-choice,spatial-relational,2|3,7,2/3,210153,2
4,3,21,154,1,757,1,7,3,3,4,single-choice,spatial-relational,3|4,7,3/4,210154,3
4,3,21,155,0,626,1,9,4,5,5,single-choice,spatial-relational,4|5,7,4/5,210155,4
4,3,21,156,0,442,1,3,1,2,2,single-choice,spatial-relational,1|2,7,1/2,210156,1
4,3,21,157,1,655,1,7,3,3,4,single-choice,spatial-relational,3|4,7,3/4,210157,3
4,3,21,158,1,1082,1,11,5,5,6,single-choice,spatial-relational,5|6,7,5/6,210158,5
4,3,21,159,0,645,1,3,1,2,2,single-choice,spatial-relational,1|2,7,1/2,210159,1
4,3,21,160,1,923,1,5,2,2,3,single-choice,spatial-relational,2|3,7,2/3,210160,2
4,3,21,161,0,607,1,13,6,7,7,single-choice,spatial-relational,6|7,7,6/7,210161,6
4,3,21,162,1,555,1,7,3,3,4,single-choice,spatial-relational,3|4,7,3/4,210162,3
4,3,21,163,1,619,1,13,6,6,7,single-choice,spatial-relational,6|7,7,6/7,210163,6
4,3,21,164,1,713,1,5,2,2,3,single-choice,spatial-relational,2|3,7,2/3,210164,2
4,3,21,165,0,662,1,3,1,2,2,single-choice,spatial-relational,1|2,7,1/2,210165,1
4,3,21,166,1,759,1,9,4,4,5,single-choice,spatial-relational,4|5,7,4/5,210166,4
4,3,21,167,0,1022,1,9,4,5,5,single-choice,spatial-relational,4|5,7,4/5,210167,4
4,3,21,168,1,843,1,11,5,5,6,single-choice,spatial-relational,5|6,7,5/6,210168,5
4,3,21,169,1,1139,1,11,5,5,6,single-choice,spatial-relational,5|6,7,5/6,210169,5
4,3,21,170,1,704,1,3,1,1,2,single-choice,spatial-relational,1|2,7,1/2,210170,1
4,3,21,171,0,674,1,3,1,2,2,single-choice,spatial-relational,1|2,7,1/2,210171,1
4,3,21,172,1,901,1,5,2,2,3,single-choice,spatial-relational,2|3,7,2/3,210172,2
4,3,21,173,1,689,1,9,4,4,5,single-choice,spatial-relational,4|5,7,4/5,210173,4
4,3,21,174,1,709,1,5,2,2,3,single-choice,spatial-relational,2|3,7,2/3,210174,2
4,3,21,175,1,881,1,7,3,3,4,single-choice,spatial-relational,3|4,7,3/4,210175,3
4,3,21,176,1,677,1,9,4,4,5,single-choice,spatial-relational,4|5,7,4/5,210176,4
4,3,21,177,1,929,1,7,3,3,4,single-choice,spatial-relational,3|4,7,3/4,210177,3
4,3,21,178,1,998,1,11,5,5,6,single-choice,spatial-relational,5|6,7,5/6,210178,5
4,3,21,179,1,764,1,13,6,6,7,single-choice,spatial-relational,6|7,7,6/7,210179,6
4,3,21,180,1,717,1,13,6,6,7,single-choice,spatial-relational,6|7,7,6/7,210180,6
4,3,21,181,1,775,1,5,2,2,3,single-choice,spatial-relational,2|3,7,2/3,210181,2
4,3,21,182,1,1036,1,9,4,4,5,single-choice,spatial-relational,4|5,7,4/5,210182,4
4,3,21,183,1,1037,1,11,5,5,6,single-choice,spatial-relational,5|6,7,5/6,210183,5
4,3,21,184,1,961,1,7,3,3,4,single-choice,spatial-relational,3|4,7,3/4,210184,3
4,3,21,185,1,732,1,11,5,5,6,single-choice,spatial-relational,5|6,7,5/6,210185,5
4,3,21,186,1,745,1,3,1,1,2,single-choice,spatial-relational,1|2,7,1/2,210186,1
4,3,21,187,1,767,1,3,1,1,2,single-choice,spatial-relational,1|2,7,1/2,210187,1
4,3,21,188,1,665,1,13,6,6,7,single-choice,spatial-relational,6|7,7,6/7,210188,6
4,3,21,189,0,581,1,13,6,7,7,single-choice,spatial-relational,6|7,7,6/7,210189,6
4,3,21,190,1,780,1,5,2,2,3,single-choice,spatial-relational,2|3,7,2/3,210190,2
4,3,21,191,1,862,1,9,4,4,5,single-choice,spatial-relational,4|5,7,4/5,210191,4
4,3,21,192,1,638,1,7,3,3,4,single-choice,spatial-relational,3|4,7,3/4,210192,3
4,3,21,193,0,951,1,13,6,7,7,single-choice,spatial-relational,6|7,7,6/7,210193,6
4,3,21,194,1,814,1,9,4,4,5,single-choice,spatial-relational,4|5,7,4/5,210194,4
4,3,21,195,1,662,1,3,1,1,2,single-choice,spatial-relational,1|2,7,1/2,210195,1
4,3,21,196,1,822,1,7,3,3,4,single-choice,spatial-relational,3|4,7,3/4,210196,3
4,3,21,197,1,639,1,5,2,2,3,single-choice,spatial-relational,2|3,7,2/3,210197,2
4,3,21,198,1,795,1,9,4,4,5,single-choice,spatial-relational,4|5,7,4/5,210198,4
4,3,21,199,0,635,1,3,1,2,2,single-choice,spatial-relational,1|2,7,1/2,210199,1
4,3,21,200,1,682,1,11,5,5,6,single-choice,spatial-relational,5|6,7,5/6,210200,5
4,3,21,201,1,612,1,7,3,3,4,single-choice,spatial-relational,3|4,7,3/4,210201,3
4,3,21,202,0,587,1,13,6,7,7,single-choice,spatial-relational,6|7,7,6/7,210202,6
4,3,21,203,0,140,1,11,5,6,6,single-choice,spatial-relational,5|6,7,5/6,210203,5
4,3,21,204,0,654,1,5,2,3,3,single-choice,spatial-relational,2|3,7,2/3,210204,2
4,3,21,205,1,721,1,7,3,3,4,single-choice,spatial-relational,3|4,7,3/4,210205,3
4,3,21,206,1,679,1,13,6,6,7,single-choice,spatial-relational,6|7,7,6/7,210206,6
4,3,21,207,0,973,1,7,3,4,4,single-choice,spatial-relational,3|4,7,3/4,210207,3
4,3,21,208,0,658,1,5,2,3,3,single-choice,spatial-relational,2|3,7,2/3,210208,2
4,3,21,209,1,864,1,9,4,4,5,single-choice,spatial-relational,4|5,7,4/5,210209,4
4,3,21,210,1,683,1,3,1,1,2,single-choice,spatial-relational,1|2,7,1/2,210210,1
4,3,21,211,1,814,1,11,5,5,6,single-choice,spatial-relational,5|6,7,5/6,210211,5
4,3,21,212,1,718,1,9,4,4,5,single-choice,spatial-relational,4|5,7,4/5,210212,4
4,3,21,213,1,822,1,5,2,2,3,single-choice,spatial-relational,2|3,7,2/3,210213,2
4,3,21,214,1,861,1,11,5,5,6,single-choice,spatial-relational,5|6,7,5/6,210214,5
4,3,21,215,1,693,1,3,1,1,2,single-choice,spatial-relational,1|2,7,1/2,210215,1
4,3,21,216,0,630,1,13,6,7,7,single-choice,spatial-relational,6|7,7,6/7,210216,6
4,3,21,217,1,721,1,9,4,4,5,single-choice,spatial-relational,4|5,7,4/5,210217,4
4,3,21,218,1,766,1,3,1,1,2,single-choice,spatial-relational,1|2,7,1/2,210218,1
4,3,21,219,0,651,1,5,2,3,3,single-choice,spatial-relational,2|3,7,2/3,210219,2
4,3,21,220,1,40,1,7,3,3,4,single-choice,spatial-relational,3|4,7,3/4,210220,3
4,3,21,221,1,721,1,3,1,1,2,single-choice,spatial-relational,1|2,7,1/2,210221,1
4,3,21,222,1,800,1,5,2,2,3,single-choice,spatial-relational,2|3,7,2/3,210222,2
4,3,21,223,0,804,1,9,4,5,5,single-choice,spatial-relational,4|5,7,4/5,210223,4
4,3,21,224,1,48,1,13,6,6,7,single-choice,spatial-relational,6|7,7,6/7,210224,6
4,3,21,225,1,1103,1,7,3,3,4,single-choice,spatial-relational,3|4,7,3/4,210225,3
4,3,21,226,0,896,1,11,5,6,6,single-choice,spatial-relational,5|6,7,5/6,210226,5
4,3,21,227,1,56,1,11,5,5,6,single-choice,spatial-relational,5|6,7,5/6,210227,5
4,3,21,228,1,707,1,13,6,6,7,single-choice,spatial-relational,6|7,7,6/7,210228,6
4,3,21,229,1,768,1,3,1,1,2,single-choice,spatial-relational,1|2,7,1/2,210229,1
4,3,21,230,1,840,1,13,6,6,7,single-choice,spatial-relational,6|7,7,6/7,210230,6
4,3,21,231,0,576,1,5,2,3,3,single-choice,spatial-relational,2|3,7,2/3,210231,2
4,3,21,232,1,32,1,3,1,1,2,single-choice,spatial-relational,1|2,7,1/2,210232,1
4,3,21,233,1,704,1,9,4,4,5,single-choice,spatial-relational,4|5,7,4/5,210233,4
4,3,21,234,0,893,1,9,4,5,5,single-choice,spatial-relational,4|5,7,4/5,210234,4
4,3,21,235,0,53,1,5,2,3,3,single-choice,spatial-relational,2|3,7,2/3,210235,2
4,3,21,236,1,681,1,11,5,5,6,single-choice,spatial-relational,5|6,7,5/6,210236,5
4,3,21,237,1,793,1,13,6,6,7,single-choice,spatial-relational,6|7,7,6/7,210237,6
4,3,21,238,1,610,1,7,3,3,4,single-choice,spatial-relational,3|4,7,3/4,210238,3
4,3,21,239,1,748,1,7,3,3,4,single-choice,spatial-relational,3|4,7,3/4,210239,3
4,3,21,240,0,992,1,11,5,6,6,single-choice,spatial-relational,5|6,7,5/6,210240,5
4,3,21,241,1,783,1,13,6,6,7,single-choice,spatial-relational,6|7,7,6/7,210241,6
4,3,21,242,1,740,1,9,4,4,5,single-choice,spatial-relational,4|5,7,4/5,210242,4
4,3,21,243,1,662,1,7,3,3,4,single-choice,spatial-relational,3|4,7,3/4,210243,3
4,3,21,244,0,611,1,5,2,3,3,single-choice,spatial-relational,2|3,7,2/3,210244,2
4,3,21,245,1,767,1,11,5,5,6,single-choice,spatial-relational,5|6,7,5/6,210245,5
4,3,21,246,1,703,1,7,3,3,4,single-choice,spatial-relational,3|4,7,3/4,210246,3
4,3,21,247,1,631,1,9,4,4,5,single-choice,spatial-relational,4|5,7,4/5,210247,4
4,3,21,248,1,1232,1,11,5,5,6,single-choice,spatial-relational,5|6,7,5/6,210248,5
4,3,21,249,1,785,1,13,6,6,7,single-choice,spatial-relational,6|7,7,6/7,210249,6
4,3,21,250,1,720,1,5,2,2,3,single-choice,spatial-relational,2|3,7,2/3,210250,2
4,3,21,251,1,706,1,3,1,1,2,single-choice,spatial-relational,1|2,7,1/2,210251,1
4,3,21,252,1,664,1,3,1,1,2,single-choice,spatial-relational,1|2,7,1/2,210252,1
4,3,21,253,1,1404,1,13,6,6,7,single-choice,spatial-relational,6|7,7,6/7,210253,6
4,3,21,254,1,779,1,11,5,5,6,single-choice,spatial-relational,5|6,7,5/6,210254,5
4,3,21,255,1,685,1,11,5,5,6,single-choice,spatial-relational,5|6,7,5/6,210255,5
4,3,21,256,0,732,1,13,6,7,7,single-choice,spatial-relational,6|7,7,6/7,210256,6
4,3,21,257,0,717,1,3,1,2,2,single-choice,spatial-relational,1|2,7,1/2,210257,1
4,3,21,258,1,715,1,7,3,3,4,single-choice,spatial-relational,3|4,7,3/4,210258,3
4,3,21,259,1,684,1,7,3,3,4,single-choice,spatial-relational,3|4,7,3/4,210259,3
4,3,21,260,0,961,1,9,4,5,5,single-choice,spatial-relational,4|5,7,4/5,210260,4
4,3,21,261,0,138,1,5,2,3,3,single-choice,spatial-relational,2|3,7,2/3,210261,2
4,3,21,262,0,715,1,5,2,3,3,single-choice,spatial-relational,2|3,7,2/3,210262,2
4,3,21,263,0,1364,1,9,4,5,5,single-choice,spatial-relational,4|5,7,4/5,210263,4
4,3,21,264,1,549,1,3,1,1,2,single-choice,spatial-relational,1|2,7,1/2,210264,1
4,3,21,265,1,693,1,9,4,4,5,single-choice,spatial-relational,4|5,7,4/5,210265,4
4,3,21,266,1,1150,1,3,1,1,2,single-choice,spatial-relational,1|2,7,1/2,210266,1
4,3,21,267,1,641,1,11,5,5,6,single-choice,spatial-relational,5|6,7,5/6,210267,5
4,3,21,268,1,789,1,5,2,2,3,single-choice,spatial-relational,2|3,7,2/3,210268,2
4,3,21,269,1,747,1,7,3,3,4,single-choice,spatial-relational,3|4,7,3/4,210269,3
4,3,21,270,1,682,1,13,6,6,7,single-choice,spatial-relational,6|7,7,6/7,210270,6
4,3,21,271,1,654,1,3,1,1,2,single-choice,spatial-relational,1|2,7,1/2,210271,1
4,3,21,272,1,701,1,5,2,2,3,single-choice,spatial-relational,2|3,7,2/3,210272,2
4,3,21,273,0,705,1,11,5,6,6,single-choice,spatial-relational,5|6,7,5/6,210273,5
4,3,21,274,1,650,1,9,4,4,5,single-choice,spatial-relational,4|5,7,4/5,210274,4
4,3,21,275,1,971,1,13,6,6,7,single-choice,spatial-relational,6|7,7,6/7,210275,6
4,3,21,276,0,729,1,7,3,4,4,single-choice,spatial-relational,3|4,7,3/4,210276,3
4,3,21,277,0,191,1,11,5,6,6,single-choice,spatial-relational,5|6,7,5/6,210277,5
4,3,21,278,1,807,1,5,2,2,3,single-choice,spatial-relational,2|3,7,2/3,210278,2
4,3,21,279,1,954,1,13,6,6,7,single-choice,spatial-relational,6|7,7,6/7,210279,6
4,3,21,280,1,708,1,9,4,4,5,single-choice,spatial-relational,4|5,7,4/5,210280,4
4,3,21,281,1,681,1,13,6,6,7,single-choice,spatial-relational,6|7,7,6/7,210281,6
4,3,21,282,1,642,1,3,1,1,2,single-choice,spatial-relational,1|2,7,1/2,210282,1
4,3,21,283,1,661,1,7,3,3,4,single-choice,spatial-relational,3|4,7,3/4,210283,3
4,3,21,284,1,774,1,11,5,5,6,single-choice,spatial-relational,5|6,7,5/6,210284,5
4,3,21,285,1,669,1,9,4,4,5,single-choice,spatial-relational,4|5,7,4/5,210285,4
4,3,21,286,0,603,1,3,1,2,2,single-choice,spatial-relational,1|2,7,1/2,210286,1
4,3,21,287,0,635,1,5,2,3,3,single-choice,spatial-relational,2|3,7,2/3,210287,2
4,3,21,288,1,650,1,7,3,3,4,single-choice,spatial-relational,3|4,7,3/4,210288,3
4,3,21,289,0,623,1,13,6,7,7,single-choice,spatial-relational,6|7,7,6/7,210289,6
4,3,21,290,0,738,1,5,2,3,3,single-choice,spatial-relational,2|3,7,2/3,210290,2
4,3,21,291,1,770,1,9,4,4,5,single-choice,spatial-relational,4|5,7,4/5,210291,4
4,3,21,292,1,657,1,9,4,4,5,single-choice,spatial-relational,4|5,7,4/5,210292,4
4,3,21,293,1,672,1,7,3,3,4,single-choice,spatial-relational,3|4,7,3/4,210293,3
4,3,21,294,1,881,1,3,1,1,2,single-choice,spatial-relational,1|2,7,1/2,210294,1
4,3,21,295,1,1006,1,11,5,5,6,single-choice,spatial-relational,5|6,7,5/6,210295,5
4,3,21,296,0,603,1,5,2,3,3,single-choice,spatial-relational,2|3,7,2/3,210296,2
4,3,21,297,1,50,1,7,3,3,4,single-choice,spatial-relational,3|4,7,3/4,210297,3
4,3,21,298,1,648,1,13,6,6,7,single-choice,spatial-relational,6|7,7,6/7,210298,6
4,3,21,299,0,869,1,11,5,6,6,single-choice,spatial-relational,5|6,7,5/6,210299,5
4,3,21,300,1,1053,1,3,1,1,2,single-choice,spatial-relational,1|2,7,1/2,210300,1
4,3,21,301,1,683,1,11,5,5,6,single-choice,spatial-relational,5|6,7,5/6,210301,5
4,3,21,302,0,854,1,9,4,5,5,single-choice,spatial-relational,4|5,7,4/5,210302,4
4,3,21,303,1,733,1,5,2,2,3,single-choice,spatial-relational,2|3,7,2/3,210303,2
4,3,21,304,1,748,1,13,6,6,7,single-choice,spatial-relational,6|7,7,6/7,210304,6
4,3,21,305,1,686,1,5,2,2,3,single-choice,spatial-relational,2|3,7,2/3,210305,2
4,3,21,306,1,717,1,7,3,3,4,single-choice,spatial-relational,3|4,7,3/4,210306,3
4,3,21,307,0,592,1,3,1,2,2,single-choice,spatial-relational,1|2,7,1/2,210307,1
4,3,21,308,1,739,1,9,4,4,5,single-choice,spatial-relational,4|5,7,4/5,210308,4
4,3,21,309,0,979,1,11,5,6,6,single-choice,spatial-relational,5|6,7,5/6,210309,5
4,3,21,310,1,650,1,7,3,3,4,single-choice,spatial-relational,3|4,7,3/4,210310,3
4,3,21,311,1,708,1,13,6,6,7,single-choice,spatial-relational,6|7,7,6/7,210311,6
4,3,21,312,1,616,1,3,1,1,2,single-choice,spatial-relational,1|2,7,1/2,210312,1
4,3,21,313,1,634,1,3,1,1,2,single-choice,spatial-relational,1|2,7,1/2,210313,1
4,3,21,314,1,759,1,5,2,2,3,single-choice,spatial-relational,2|3,7,2/3,210314,2
4,3,21,315,1,845,1,5,2,2,3,single-choice,spatial-relational,2|3,7,2/3,210315,2
4,3,21,316,1,661,1,7,3,3,4,single-choice,spatial-relational,3|4,7,3/4,210316,3
4,3,21,317,1,688,1,7,3,3,4,single-choice,spatial-relational,3|4,7,3/4,210317,3
4,3,21,318,1,36,1,3,1,1,2,single-choice,spatial-relational,1|2,7,1/2,210318,1
4,3,21,319,0,783,1,11,5,6,6,single-choice,spatial-relational,5|6,7,5/6,210319,5
4,3,21,320,1,661,1,9,4,4,5,single-choice,spatial-relational,4|5,7,4/5,210320,4
4,3,21,321,0,779,1,13,6,7,7,single-choice,spatial-relational,6|7,7,6/7,210321,6
4,3,21,322,0,186,1,11,5,6,6,single-choice,spatial-relational,5|6,7,5/6,210322,5
4,3,21,323,0,51,1,9,4,5,5,single-choice,spatial-relational,4|5,7,4/5,210323,4
4,3,21,324,0,56,1,13,6,7,7,single-choice,spatial-relational,6|7,7,6/7,210324,6
4,3,21,325,1,56,1,13,6,6,7,single-choice,spatial-relational,6|7,7,6/7,210325,6
4,3,21,326,0,1119,1,9,4,5,5,single-choice,spatial-relational,4|5,7,4/5,210326,4
4,3,21,327,1,703,1,7,3,3,4,single-choice,spatial-relational,3|4,7,3/4,210327,3
4,3,21,328,1,595,1,7,3,3,4,single-choice,spatial-relational,3|4,7,3/4,210328,3
4,3,21,329,0,921,1,11,5,6,6,single-choice,spatial-relational,5|6,7,5/6,210329,5
4,3,21,330,1,709,1,11,5,5,6,single-choice,spatial-relational,5|6,7,5/6,210330,5
4,3,21,331,1,670,1,3,1,1,2,single-choice,spatial-relational,1|2,7,1/2,210331,1
4,3,21,332,1,720,1,5,2,2,3,single-choice,spatial-relational,2|3,7,2/3,210332,2
4,3,21,333,1,724,1,13,6,6,7,single-choice,spatial-relational,6|7,7,6/7,210333,6
4,3,21,334,1,902,1,3,1,1,2,single-choice,spatial-relational,1|2,7,1/2,210334,1
4,3,21,335,1,700,1,9,4,4,5,single-choice,spatial-relational,4|5,7,4/5,210335,4
4,3,21,336,1,863,1,5,2,2,3,single-choice,spatial-relational,2|3,7,2/3,210336,2
4,3,21,337,1,783,1,7,3,3,4,single-choice,spatial-relational,3|4,7,3/4,210337,3
4,3,21,338,0,572,1,5,2,3,3,single-choice,spatial-relational,2|3,7,2/3,210338,2
4,3,21,339,1,991,1,9,4,4,5,single-choice,spatial-relational,4|5,7,4/5,210339,4
4,3,21,340,1,650,1,11,5,5,6,single-choice,spatial-relational,5|6,7,5/6,210340,5
4,3,21,341,0,1055,1,13,6,7,7,single-choice,spatial-relational,6|7,7,6/7,210341,6
4,3,21,342,1,663,1,11,5,5,6,single-choice,spatial-relational,5|6,7,5/6,210342,5
4,3,21,343,1,661,1,7,3,3,4,single-choice,spatial-relational,3|4,7,3/4,210343,3
4,3,21,344,1,1763,1,3,1,1,2,single-choice,spatial-relational,1|2,7,1/2,210344,1
4,3,21,345,1,733,1,5,2,2,3,single-choice,spatial-relational,2|3,7,2/3,210345,2
4,3,21,346,0,678,1,13,6,7,7,single-choice,spatial-relational,6|7,7,6/7,210346,6
4,3,21,347,0,857,1,3,1,2,2,single-choice,spatial-relational,1|2,7,1/2,210347,1
4,3,21,348,1,875,1,9,4,4,5,single-choice,spatial-relational,4|5,7,4/5,210348,4
4,3,21,349,1,779,1,13,6,6,7,single-choice,spatial-relational,6|7,7,6/7,210349,6
4,3,21,350,1,724,1,7,3,3,4,single-choice,spatial-relational,3|4,7,3/4,210350,3
4,3,21,351,1,588,1,7,3,3,4,single-choice,spatial-relational,3|4,7,3/4,210351,3
4,3,21,352,1,826,1,5,2,2,3,single-choice,spatial-relational,2|3,7,2/3,210352,2
4,3,21,353,1,1045,1,11,5,5,6,single-choice,spatial-relational,5|6,7,5/6,210353,5
4,3,21,354,1,980,1,5,2,2,3,single-choice,spatial-relational,2|3,7,2/3,210354,2
4,3,21,355,0,1058,1,3,1,2,2,single-choice,spatial-relational,1|2,7,1/2,210355,1
4,3,21,356,0,816,1,11,5,6,6,single-choice,spatial-relational,5|6,7,5/6,210356,5
4,3,21,357,1,665,1,9,4,4,5,single-choice,spatial-relational,4|5,7,4/5,210357,4
4,3,21,358,1,711,1,9,4,4,5,single-choice,spatial-relational,4|5,7,4/5,210358,4
4,3,21,359,1,744,1,3,1,1,2,single-choice,spatial-relational,1|2,7,1/2,210359,1
4,3,21,360,0,650,1,13,6,7,7,single-choice,spatial-relational,6|7,7,6/7,210360,6
4,3,21,361,1,732,1,3,1,1,2,single-choice,spatial-relational,1|2,7,1/2,210361,1
4,3,21,362,1,798,1,5,2,2,3,single-choice,spatial-relational,2|3,7,2/3,210362,2
4,3,21,363,0,831,1,5,2,3,3,single-choice,spatial-relational,2|3,7,2/3,210363,2
4,3,21,364,0,981,1,3,1,2,2,single-choice,spatial-relational,1|2,7,1/2,210364,1
4,3,21,365,1,709,1,7,3,3,4,single-choice,spatial-relational,3|4,7,3/4,210365,3
4,3,21,366,1,1161,1,11,5,5,6,single-choice,spatial-relational,5|6,7,5/6,210366,5
4,3,21,367,1,1115,1,7,3,3,4,single-choice,spatial-relational,3|4,7,3/4,210367,3
4,3,21,368,1,814,1,9,4,4,5,single-choice,spatial-relational,4|5,7,4/5,210368,4
4,3,21,369,1,744,1,13,6,6,7,single-choice,spatial-relational,6|7,7,6/7,210369,6
4,3,21,370,1,1221,1,11,5,5,6,single-choice,spatial-relational,5|6,7,5/6,210370,5
4,3,21,371,1,1257,1,13,6,6,7,single-choice,spatial-relational,6|7,7,6/7,210371,6
4,3,21,372,0,643,1,9,4,5,5,single-choice,spatial-relational,4|5,7,4/5,210372,4
4,3,21,373,0,672,1,3,1,2,2,single-choice,spatial-relational,1|2,7,1/2,210373,1
4,3,21,374,1,682,1,3,1,1,2,single-choice,spatial-relational,1|2,7,1/2,210374,1
4,3,21,375,1,728,1,5,2,2,3,single-choice,spatial-relational,2|3,7,2/3,210375,2
4,3,21,376,1,728,1,5,2,2,3,single-choice,spatial-relational,2|3,7,2/3,210376,2
4,3,21,377,0,927,1,11,5,6,6,single-choice,spatial-relational,5|6,7,5/6,210377,5
4,3,21,378,0,48,1,13,6,7,7,single-choice,spatial-relational,6|7,7,6/7,210378,6
4,3,21,379,1,716,1,11,5,5,6,single-choice,spatial-relational,5|6,7,5/6,210379,5
4,3,21,380,0,815,1,13,6,7,7,single-choice,spatial-relational,6|7,7,6/7,210380,6
4,3,21,381,1,623,1,7,3,3,4,single-choice,spatial-relational,3|4,7,3/4,210381,3
4,3,21,382,1,654,1,9,4,4,5,single-choice,spatial-relational,4|5,7,4/5,210382,4
4,3,21,383,1,33,1,9,4,4,5,single-choice,spatial-relational,4|5,7,4/5,210383,4
4,3,21,384,1,1029,1,7,3,3,4,single-choice,spatial-relational,3|4,7,3/4,210384,3
4,3,21,385,1,1083,1,5,2,2,3,single-choice,spatial-relational,2|3,7,2/3,210385,2
4,3,21,386,1,802,1,7,3,3,4,single-choice,spatial-relational,3|4,7,3/4,210386,3
4,3,21,387,1,754,1,13,6,6,7,single-choice,spatial-relational,6|7,7,6/7,210387,6
4,3,21,388,0,681,1,5,2,3,3,single-choice,spatial-relational,2|3,7,2/3,210388,2
4,3,21,389,1,629,1,11,5,5,6,single-choice,spatial-relational,5|6,7,5/6,210389,5
4,3,21,390,1,666,1,9,4,4,5,single-choice,spatial-relational,4|5,7,4/5,210390,4
4,3,21,391,1,854,1,13,6,6,7,single-choice,spatial-relational,6|7,7,6/7,210391,6
4,3,21,392,1,704,1,3,1,1,2,single-choice,spatial-relational,1|2,7,1/2,210392,1
4,3,21,393,1,681,1,7,3,3,4,single-choice,spatial-relational,3|4,7,3/4,210393,3
4,3,21,394,0,809,1,9,4,5,5,single-choice,spatial-relational,4|5,7,4/5,210394,4
4,3,21,395,0,714,1,3,1,2,2,single-choice,spatial-relational,1|2,7,1/2,210395,1
4,3,21,396,0,973,1,11,5,6,6,single-choice,spatial-relational,5|6,7,5/6,210396,5
4,3,21,397,1,693,1,3,1,1,2,single-choice,spatial-relational,1|2,7,1/2,210397,1
4,3,21,398,1,635,1,3,1,1,2,single-choice,spatial-relational,1|2,7,1/2,210398,1
4,3,21,399,1,682,1,5,2,2,3,single-choice,spatial-relational,2|3,7,2/3,210399,2
4,3,21,400,1,756,1,11,5,5,6,single-choice,spatial-relational,5|6,7,5/6,210400,5
4,3,21,401,1,853,1,7,3,3,4,single-choice,spatial-relational,3|4,7,3/4,210401,3
4,3,21,402,1,806,1,5,2,2,3,single-choice,spatial-relational,2|3,7,2/3,210402,2
4,3,21,403,1,801,1,13,6,6,7,single-choice,spatial-relational,6|7,7,6/7,210403,6
4,3,21,404,1,1289,1,11,5,5,6,single-choice,spatial-relational,5|6,7,5/6,210404,5
4,3,21,405,0,914,1,9,4,5,5,single-choice,spatial-relational,4|5,7,4/5,210405,4
4,3,21,406,1,739,1,13,6,6,7,single-choice,spatial-relational,6|7,7,6/7,210406,6
4,3,21,407,1,703,1,9,4,4,5,single-choice,spatial-relational,4|5,7,4/5,210407,4
4,3,21,408,1,662,1,7,3,3,4,single-choice,spatial-relational,3|4,7,3/4,210408,3
4,3,21,409,0,705,1,11,5,6,6,single-choice,spatial-relational,5|6,7,5/6,210409,5
4,3,21,410,0,1029,1,9,4,5,5,single-choice,spatial-relational,4|5,7,4/5,210410,4
4,3,21,411,1,696,1,13,6,6,7,single-choice,spatial-relational,6|7,7,6/7,210411,6
4,3,21,412,1,705,1,13,6,6,7,single-choice,spatial-relational,6|7,7,6/7,210412,6
4,3,21,413,1,681,1,5,2,2,3,single-choice,spatial-relational,2|3,7,2/3,210413,2
4,3,21,414,1,952,1,11,5,5,6,single-choice,spatial-relational,5|6,7,5/6,210414,5
4,3,21,415,0,1160,1,9,4,5,5,single-choice,spatial-relational,4|5,7,4/5,210415,4
4,3,21,416,1,587,1,7,3,3,4,single-choice,spatial-relational,3|4,7,3/4,210416,3
4,3,21,417,0,559,1,3,1,2,2,single-choice,spatial-relational,1|2,7,1/2,210417,1
4,3,21,418,1,508,1,3,1,1,2,single-choice,spatial-relational,1|2,7,1/2,210418,1
4,3,21,419,1,599,1,7,3,3,4,single-choice,spatial-relational,3|4,7,3/4,210419,3
4,3,21,420,1,748,1,5,2,2,3,single-choice,spatial-relational,2|3,7,2/3,210420,2
4,3,21,421,0,814,1,9,4,5,5,single-choice,spatial-relational,4|5,7,4/5,210421,4
4,3,21,422,1,655,1,13,6,6,7,single-choice,spatial-relational,6|7,7,6/7,210422,6
4,3,21,423,1,724,1,3,1,1,2,single-choice,spatial-relational,1|2,7,1/2,210423,1
4,3,21,424,0,1050,1,11,5,6,6,single-choice,spatial-relational,5|6,7,5/6,210424,5
4,3,21,425,1,762,1,11,5,5,6,single-choice,spatial-relational,5|6,7,5/6,210425,5
4,3,21,426,0,611,1,5,2,3,3,single-choice,spatial-relational,2|3,7,2/3,210426,2
4,3,21,427,1,494,1,7,3,3,4,single-choice,spatial-relational,3|4,7,3/4,210427,3
4,3,21,428,1,693,1,13,6,6,7,single-choice,spatial-relational,6|7,7,6/7,210428,6
4,3,21,429,1,714,1,5,2,2,3,single-choice,spatial-relational,2|3,7,2/3,210429,2
4,3,21,430,1,653,1,7,3,3,4,single-choice,spatial-relational,3|4,7,3/4,210430,3
4,3,21,431,1,788,1,3,1,1,2,single-choice,spatial-relational,1|2,7,1/2,210431,1
4,3,21,432,1,685,1,9,4,4,5,single-choice,spatial-relational,4|5,7,4/5,210432,4
4,3,21,433,1,749,1,11,5,5,6,single-choice,spatial-relational,5|6,7,5/6,210433,5
4,3,21,434,1,619,1,11,5,5,6,single-choice,spatial-relational,5|6,7,5/6,210434,5
4,3,21,435,1,835,1,13,6,6,7,single-choice,spatial-relational,6|7,7,6/7,210435,6
4,3,21,436,1,619,1,7,3,3,4,single-choice,spatial-relational,3|4,7,3/4,210436,3
4,3,21,437,1,702,1,9,4,4,5,single-choice,spatial-relational,4|5,7,4/5,210437,4
4,3,21,438,1,763,1,13,6,6,7,single-choice,spatial-relational,6|7,7,6/7,210438,6
4,3,21,439,1,700,1,5,2,2,3,single-choice,spatial-relational,2|3,7,2/3,210439,2
4,3,21,440,1,607,1,7,3,3,4,single-choice,spatial-relational,3|4,7,3/4,210440,3
4,3,21,441,1,643,1,3,1,1,2,single-choice,spatial-relational,1|2,7,1/2,210441,1
4,3,21,442,1,814,1,5,2,2,3,single-choice,spatial-relational,2|3,7,2/3,210442,2
4,3,21,443,1,1288,1,9,4,4,5,single-choice,spatial-relational,4|5,7,4/5,210443,4
4,3,21,444,0,623,1,3,1,2,2,single-choice,spatial-relational,1|2,7,1/2,210444,1
4,3,21,445,0,499,1,5,2,3,3,single-choice,spatial-relational,2|3,7,2/3,210445,2
4,3,21,446,1,732,1,7,3,3,4,single-choice,spatial-relational,3|4,7,3/4,210446,3
4,3,21,447,1,695,1,13,6,6,7,single-choice,spatial-relational,6|7,7,6/7,210447,6
4,3,21,448,0,633,1,5,2,3,3,single-choice,spatial-relational,2|3,7,2/3,210448,2
4,3,21,449,1,772,1,13,6,6,7,single-choice,spatial-relational,6|7,7,6/7,210449,6
4,3,21,450,1,765,1,3,1,1,2,single-choice,spatial-relational,1|2,7,1/2,210450,1
4,3,21,451,0,1512,1,7,3,4,4,single-choice,spatial-relational,3|4,7,3/4,210451,3
4,3,21,452,1,1035,1,9,4,4,5,single-choice,spatial-relational,4|5,7,4/5,210452,4
4,3,21,453,1,681,1,9,4,4,5,single-choice,spatial-relational,4|5,7,4/5,210453,4
4,3,21,454,1,738,1,11,5,5,6,single-choice,spatial-relational,5|6,7,5/6,210454,5
4,3,21,455,1,832,1,11,5,5,6,single-choice,spatial-relational,5|6,7,5/6,210455,5
4,3,21,456,0,779,1,3,1,2,2,single-choice,spatial-relational,1|2,7,1/2,210456,1
4,3,21,457,0,52,1,11,5,6,6,single-choice,spatial-relational,5|6,7,5/6,210457,5
4,3,21,458,1,597,1,5,2,2,3,single-choice,spatial-relational,2|3,7,2/3,210458,2
4,3,21,459,0,1354,1,3,1,2,2,single-choice,spatial-relational,1|2,7,1/2,210459,1
4,3,21,460,1,483,1,3,1,1,2,single-choice,spatial-relational,1|2,7,1/2,210460,1
4,3,21,461,1,713,1,11,5,5,6,single-choice,spatial-relational,5|6,7,5/6,210461,5
4,3,21,462,1,1017,1,7,3,3,4,single-choice,spatial-relational,3|4,7,3/4,210462,3
4,3,21,463,1,619,1,7,3,3,4,single-choice,spatial-relational,3|4,7,3/4,210463,3
4,3,21,464,1,775,1,5,2,2,3,single-choice,spatial-relational,2|3,7,2/3,210464,2
4,3,21,465,0,611,1,13,6,7,7,single-choice,spatial-relational,6|7,7,6/7,210465,6
4,3,21,466,1,702,1,9,4,4,5,single-choice,spatial-relational,4|5,7,4/5,210466,4
4,3,21,467,1,726,1,9,4,4,5,single-choice,spatial-relational,4|5,7,4/5,210467,4
4,3,21,468,1,931,1,13,6,6,7,single-choice,spatial-relational,6|7,7,6/7,210468,6
4,3,21,469,0,795,1,3,1,2,2,single-choice,spatial-relational,1|2,7,1/2,210469,1
4,3,21,470,1,710,1,11,5,5,6,single-choice,spatial-relational,5|6,7,5/6,210470,5
4,3,21,471,1,861,1,5,2,2,3,single-choice,spatial-relational,2|3,7,2/3,210471,2
4,3,21,472,0,701,1,3,1,2,2,single-choice,spatial-relational,1|2,7,1/2,210472,1
4,3,21,473,1,627,1,7,3,3,4,single-choice,spatial-relational,3|4,7,3/4,210473,3
4,3,21,474,1,673,1,9,4,4,5,single-choice,spatial-relational,4|5,7,4/5,210474,4
4,3,21,475,1,685,1,7,3,3,4,single-choice,spatial-relational,3|4,7,3/4,210475,3
4,3,21,476,0,776,1,13,6,7,7,single-choice,spatial-relational,6|7,7,6/7,210476,6
4,3,21,477,1,896,1,13,6,6,7,single-choice,spatial-relational,6|7,7,6/7,210477,6
4,3,21,478,0,890,1,11,5,6,6,single-choice,spatial-relational,5|6,7,5/6,210478,5
4,3,21,479,1,504,1,5,2,2,3,single-choice,spatial-relational,2|3,7,2/3,210479,2
4,3,21,480,1,1351,1,9,4,4,5,single-choice,spatial-relational,4|5,7,4/5,210480,4
4,3,21,481,1,674,1,3,1,1,2,single-choice,spatial-relational,1|2,7,1/2,210481,1
4,3,21,482,1,1029,1,11,5,5,6,single-choice,spatial-relational,5|6,7,5/6,210482,5
4,3,21,483,1,717,1,5,2,2,3,single-choice,spatial-relational,2|3,7,2/3,210483,2
4,3,21,484,1,1268,1,7,3,3,4,single-choice,spatial-relational,3|4,7,3/4,210484,3
4,3,21,485,1,803,1,11,5,5,6,single-choice,spatial-relational,5|6,7,5/6,210485,5
4,3,21,486,1,639,1,7,3,3,4,single-choice,spatial-relational,3|4,7,3/4,210486,3
4,3,21,487,0,643,1,5,2,3,3,single-choice,spatial-relational,2|3,7,2/3,210487,2
4,3,21,488,1,623,1,13,6,6,7,single-choice,spatial-relational,6|7,7,6/7,210488,6
4,3,21,489,1,732,1,13,6,6,7,single-choice,spatial-relational,6|7,7,6/7,210489,6
4,3,21,490,1,746,1,9,4,4,5,single-choice,spatial-relational,4|5,7,4/5,210490,4
4,3,21,491,0,839,1,9,4,5,5,single-choice,spatial-relational,4|5,7,4/5,210491,4
4,3,21,492,0,715,1,3,1,2,2,single-choice,spatial-relational,1|2,7,1/2,210492,1
4,3,21,493,0,753,1,3,1,2,2,single-choice,spatial-relational,1|2,7,1/2,210493,1
4,3,21,494,0,902,1,5,2,3,3,single-choice,spatial-relational,2|3,7,2/3,210494,2
4,3,21,495,1,767,1,13,6,6,7,single-choice,spatial-relational,6|7,7,6/7,210495,6
4,3,21,496,1,760,1,7,3,3,4,single-choice,spatial-relational,3|4,7,3/4,210496,3
4,3,21,497,1,904,1,7,3,3,4,single-choice,spatial-relational,3|4,7,3/4,210497,3
4,3,21,498,0,859,1,9,4,5,5,single-choice,spatial-relational,4|5,7,4/5,210498,4
4,3,21,499,1,666,1,13,6,6,7,single-choice,spatial-relational,6|7,7,6/7,210499,6
4,3,21,500,0,721,1,3,1,2,2,single-choice,spatial-relational,1|2,7,1/2,210500,1
4,3,21,501,1,1094,1,11,5,5,6,single-choice,spatial-relational,5|6,7,5/6,210501,5
4,3,21,502,1,1102,1,11,5,5,6,single-choice,spatial-relational,5|6,7,5/6,210502,5
4,3,21,503,1,763,1,5,2,2,3,single-choice,spatial-relational,2|3,7,2/3,210503,2
4,3,21,504,1,887,1,9,4,4,5,single-choice,spatial-relational,4|5,7,4/5,210504,4
4,3,21,505,1,1120,1,13,6,6,7,single-choice,spatial-relational,6|7,7,6/7,210505,6
4,3,21,506,1,731,1,9,4,4,5,single-choice,spatial-relational,4|5,7,4/5,210506,4
4,3,21,507,1,1416,1,11,5,5,6,single-choice,spatial-relational,5|6,7,5/6,210507,5
4,3,21,508,1,746,1,5,2,2,3,single-choice,spatial-relational,2|3,7,2/3,210508,2
4,3,21,509,0,595,1,13,6,7,7,single-choice,spatial-relational,6|7,7,6/7,210509,6
4,3,21,510,0,156,1,3,1,2,2,single-choice,spatial-relational,1|2,7,1/2,210510,1
4,3,21,511,0,890,1,9,4,5,5,single-choice,spatial-relational,4|5,7,4/5,210511,4
4,3,21,512,0,1332,1,11,5,6,6,single-choice,spatial-relational,5|6,7,5/6,210512,5
4,3,21,513,1,603,1,3,1,1,2,single-choice,spatial-relational,1|2,7,1/2,210513,1
4,3,21,514,0,621,1,5,2,3,3,single-choice,spatial-relational,2|3,7,2/3,210514,2
4,3,21,515,1,1127,1,7,3,3,4,single-choice,spatial-relational,3|4,7,3/4,210515,3
4,3,21,516,1,831,1,7,3,3,4,single-choice,spatial-relational,3|4,7,3/4,210516,3
4,3,21,517,0,740,1,9,4,5,5,single-choice,spatial-relational,4|5,7,4/5,210517,4
4,3,21,518,0,584,1,5,2,3,3,single-choice,spatial-relational,2|3,7,2/3,210518,2
4,3,21,519,0,1365,1,13,6,7,7,single-choice,spatial-relational,6|7,7,6/7,210519,6
4,3,21,520,1,526,1,3,1,1,2,single-choice,spatial-relational,1|2,7,1/2,210520,1
4,3,21,521,1,820,1,11,5,5,6,single-choice,spatial-relational,5|6,7,5/6,210521,5
4,3,21,522,1,642,1,7,3,3,4,single-choice,spatial-relational,3|4,7,3/4,210522,3
4,3,21,523,1,1072,1,11,5,5,6,single-choice,spatial-relational,5|6,7,5/6,210523,5
4,3,21,524,1,689,1,3,1,1,2,single-choice,spatial-relational,1|2,7,1/2,210524,1
4,3,21,525,1,722,1,7,3,3,4,single-choice,spatial-relational,3|4,7,3/4,210525,3
4,3,21,526,1,1011,1,13,6,6,7,single-choice,spatial-relational,6|7,7,6/7,210526,6
4,3,21,527,1,891,1,9,4,4,5,single-choice,spatial-relational,4|5,7,4/5,210527,4
4,3,21,528,0,634,1,5,2,3,3,single-choice,spatial-relational,2|3,7,2/3,210528,2
4,3,21,529,1,1077,1,9,4,4,5,single-choice,spatial-relational,4|5,7,4/5,210529,4
4,3,21,530,1,848,1,11,5,5,6,single-choice,spatial-relational,5|6,7,5/6,210530,5
4,3,21,531,1,942,1,7,3,3,4,single-choice,spatial-relational,3|4,7,3/4,210531,3
4,3,21,532,1,630,1,3,1,1,2,single-choice,spatial-relational,1|2,7,1/2,210532,1
4,3,21,533,0,808,1,13,6,7,7,single-choice,spatial-relational,6|7,7,6/7,210533,6
4,3,21,534,1,865,1,5,2,2,3,single-choice,spatial-relational,2|3,7,2/3,210534,2
4,3,21,535,1,734,1,9,4,4,5,single-choice,spatial-relational,4|5,7,4/5,210535,4
4,3,21,536,1,884,1,7,3,3,4,single-choice,spatial-relational,3|4,7,3/4,210536,3
4,3,21,537,1,743,1,3,1,1,2,single-choice,spatial-relational,1|2,7,1/2,210537,1
4,3,21,538,0,826,1,11,5,6,6,single-choice,spatial-relational,5|6,7,5/6,210538,5
4,3,21,539,1,873,1,13,6,6,7,single-choice,spatial-relational,6|7,7,6/7,210539,6
4,3,21,540,1,768,1,5,2,2,3,single-choice,spatial-relational,2|3,7,2/3,210540,2
4,3,21,541,1,771,1,5,2,2,3,single-choice,spatial-relational,2|3,7,2/3,210541,2
4,3,21,542,1,685,1,5,2,2,3,single-choice,spatial-relational,2|3,7,2/3,210542,2
4,3,21,543,0,56,1,13,6,7,7,single-choice,spatial-relational,6|7,7,6/7,210543,6
4,3,21,544,1,532,1,3,1,1,2,single-choice,spatial-relational,1|2,7,1/2,210544,1
4,3,21,545,1,657,1,11,5,5,6,single-choice,spatial-relational,5|6,7,5/6,210545,5
4,3,21,546,1,694,1,3,1,1,2,single-choice,spatial-relational,1|2,7,1/2,210546,1
4,3,21,547,1,862,1,7,3,3,4,single-choice,spatial-relational,3|4,7,3/4,210547,3
4,3,21,548,1,599,1,7,3,3,4,single-choice,spatial-relational,3|4,7,3/4,210548,3
4,3,21,549,1,752,1,13,6,6,7,single-choice,spatial-relational,6|7,7,6/7,210549,6
4,3,21,550,1,1001,1,11,5,5,6,single-choice,spatial-relational,5|6,7,5/6,210550,5
4,3,21,551,0,674,1,9,4,5,5,single-choice,spatial-relational,4|5,7,4/5,210551,4
4,3,21,552,0,584,1,9,4,5,5,single-choice,spatial-relational,4|5,7,4/5,210552,4
4,3,21,553,0,1248,1,3,1,2,2,single-choice,spatial-relational,1|2,7,1/2,210553,1
4,3,21,554,1,934,1,9,4,4,5,single-choice,spatial-relational,4|5,7,4/5,210554,4
4,3,21,555,1,947,1,7,3,3,4,single-choice,spatial-relational,3|4,7,3/4,210555,3
4,3,21,556,1,680,1,7,3,3,4,single-choice,spatial-relational,3|4,7,3/4,210556,3
4,3,21,557,0,1139,1,11,5,6,6,single-choice,spatial-relational,5|6,7,5/6,210557,5
4,3,21,558,1,799,1,5,2,2,3,single-choice,spatial-relational,2|3,7,2/3,210558,2
4,3,21,559,1,841,1,3,1,1,2,single-choice,spatial-relational,1|2,7,1/2,210559,1
4,3,21,560,1,715,1,9,4,4,5,single-choice,spatial-relational,4|5,7,4/5,210560,4
4,3,21,561,1,751,1,13,6,6,7,single-choice,spatial-relational,6|7,7,6/7,210561,6
4,3,21,562,1,738,1,11,5,5,6,single-choice,spatial-relational,5|6,7,5/6,210562,5
4,3,21,563,0,646,1,5,2,3,3,single-choice,spatial-relational,2|3,7,2/3,210563,2
4,3,21,564,1,685,1,13,6,6,7,single-choice,spatial-relational,6|7,7,6/7,210564,6
4,3,21,565,1,710,1,5,2,2,3,single-choice,spatial-relational,2|3,7,2/3,210565,2
4,3,21,566,0,744,1,5,2,3,3,single-choice,spatial-relational,2|3,7,2/3,210566,2
4,3,21,567,0,796,1,9,4,5,5,single-choice,spatial-relational,4|5,7,4/5,210567,4
4,3,21,568,0,516,1,3,1,2,2,single-choice,spatial-relational,1|2,7,1/2,210568,1
4,3,21,569,1,676,1,9,4,4,5,single-choice,spatial-relational,4|5,7,4/5,210569,4
4,3,21,570,1,1602,1,11,5,5,6,single-choice,spatial-relational,5|6,7,5/6,210570,5
4,3,21,571,0,846,1,13,6,7,7,single-choice,spatial-relational,6|7,7,6/7,210571,6
4,3,21,572,1,539,1,7,3,3,4,single-choice,spatial-relational,3|4,7,3/4,210572,3
4,3,21,573,1,958,1,13,6,6,7,single-choice,spatial-relational,6|7,7,6/7,210573,6
4,3,21,574,1,765,1,3,1,1,2,single-choice,spatial-relational,1|2,7,1/2,210574,1
4,3,21,575,1,701,1,7,3,3,4,single-choice,spatial-relational,3|4,7,3/4,210575,3
4,3,21,576,1,1126,1,11,5,5,6,single-choice,spatial-relational,5|6,7,5/6,210576,5
4,3,21,577,1,684,1,5,2,2,3,single-choice,spatial-relational,2|3,7,2/3,210577,2
4,3,21,578,1,831,1,11,5,5,6,single-choice,spatial-relational,5|6,7,5/6,210578,5
4,3,21,579,1,744,1,11,5,5,6,single-choice,spatial-relational,5|6,7,5/6,210579,5
4,3,21,580,1,611,1,3,1,1,2,single-choice,spatial-relational,1|2,7,1/2,210580,1
4,3,21,581,0,801,1,13,6,7,7,single-choice,spatial-relational,6|7,7,6/7,210581,6
4,3,21,582,0,726,1,3,1,2,2,single-choice,spatial-relational,1|2,7,1/2,210582,1
4,3,21,583,1,860,1,7,3,3,4,single-choice,spatial-relational,3|4,7,3/4,210583,3
4,3,21,584,1,650,1,7,3,3,4,single-choice,spatial-relational,3|4,7,3/4,210584,3
4,3,21,585,0,634,1,5,2,3,3,single-choice,spatial-relational,2|3,7,2/3,210585,2
4,3,21,586,1,57,1,9,4,4,5,single-choice,spatial-relational,4|5,7,4/5,210586,4
4,3,21,587,1,812,1,13,6,6,7,single-choice,spatial-relational,6|7,7,6/7,210587,6
4,3,21,588,1,782,1,9,4,4,5,single-choice,spatial-relational,4|5,7,4/5,210588,4
4,3,21,589,1,990,1,7,3,3,4,single-choice,spatial-relational,3|4,7,3/4,210589,3
4,3,21,590,0,1021,1,11,5,6,6,single-choice,spatial-relational,5|6,7,5/6,210590,5
4,3,21,591,0,443,1,3,1,2,2,single-choice,spatial-relational,1|2,7,1/2,210591,1
4,3,21,592,0,799,1,9,4,5,5,single-choice,spatial-relational,4|5,7,4/5,210592,4
4,3,21,593,0,937,1,11,5,6,6,single-choice,spatial-relational,5|6,7,5/6,210593,5
4,3,21,594,1,1185,1,13,6,6,7,single-choice,spatial-relational,6|7,7,6/7,210594,6
4,3,21,595,1,674,1,7,3,3,4,single-choice,spatial-relational,3|4,7,3/4,210595,3
4,3,21,596,1,759,1,9,4,4,5,single-choice,spatial-relational,4|5,7,4/5,210596,4
4,3,21,597,1,723,1,3,1,1,2,single-choice,spatial-relational,1|2,7,1/2,210597,1
4,3,21,598,0,694,1,5,2,3,3,single-choice,spatial-relational,2|3,7,2/3,210598,2
4,3,21,599,0,466,1,5,2,3,3,single-choice,spatial-relational,2|3,7,2/3,210599,2
4,3,21,600,0,197,1,13,6,7,7,single-choice,spatial-relational,6|7,7,6/7,210600,6
5,3,21,1,1,1249,1,5,2,2,3,single-choice,spatial-relational,2|3,7,2/3,210001,2
5,3,21,2,0,497,1,3,1,2,2,single-choice,spatial-relational,1|2,7,1/2,210002,1
5,3,21,3,0,407,1,3,1,2,2,single-choice,spatial-relational,1|2,7,1/2,210003,1
5,3,21,4,0,776,1,13,6,7,7,single-choice,spatial-relational,6|7,7,6/7,210004,6
5,3,21,5,1,599,1,7,3,3,4,single-choice,spatial-relational,3|4,7,3/4,210005,3
5,3,21,6,1,575,1,13,6,6,7,single-choice,spatial-relational,6|7,7,6/7,210006,6
5,3,21,7,0,494,1,5,2,3,3,single-choice,spatial-relational,2|3,7,2/3,210007,2
5,3,21,8,0,524,1,11,5,6,6,single-choice,spatial-relational,5|6,7,5/6,210008,5
5,3,21,9,0,632,1,7,3,4,4,single-choice,spatial-relational,3|4,7,3/4,210009,3
5,3,21,10,0,502,1,9,4,5,5,single-choice,spatial-relational,4|5,7,4/5,210010,4
5,3,21,11,1,448,1,9,4,4,5,single-choice,spatial-relational,4|5,7,4/5,210011,4
5,3,21,12,0,576,1,11,5,6,6,single-choice,spatial-relational,5|6,7,5/6,210012,5
5,3,21,13,0,418,1,7,3,4,4,single-choice,spatial-relational,3|4,7,3/4,210013,3
5,3,21,14,1,519,1,5,2,2,3,single-choice,spatial-relational,2|3,7,2/3,210014,2
5,3,21,15,1,560,1,9,4,4,5,single-choice,spatial-relational,4|5,7,4/5,210015,4
5,3,21,16,0,576,1,7,3,4,4,single-choice,spatial-relational,3|4,7,3/4,210016,3
5,3,21,17,1,605,1,11,5,5,6,single-choice,spatial-relational,5|6,7,5/6,210017,5
5,3,21,18,1,826,1,13,6,6,7,single-choice,spatial-relational,6|7,7,6/7,210018,6
5,3,21,19,1,673,1,5,2,2,3,single-choice,spatial-relational,2|3,7,2/3,210019,2
5,3,21,20,0,613,1,9,4,5,5,single-choice,spatial-relational,4|5,7,4/5,210020,4
5,3,21,21,1,56,1,3,1,1,2,single-choice,spatial-relational,1|2,7,1/2,210021,1
5,3,21,22,1,670,1,13,6,6,7,single-choice,spatial-relational,6|7,7,6/7,210022,6
5,3,21,23,1,701,1,11,5,5,6,single-choice,spatial-relational,5|6,7,5/6,210023,5
5,3,21,24,1,689,1,3,1,1,2,single-choice,spatial-relational,1|2,7,1/2,210024,1
5,3,21,25,0,674,1,9,4,5,5,single-choice,spatial-relational,4|5,7,4/5,210025,4
5,3,21,26,0,416,1,3,1,2,2,single-choice,spatial-relational,1|2,7,1/2,210026,1
5,3,21,27,1,486,1,7,3,3,4,single-choice,spatial-relational,3|4,7,3/4,210027,3
5,3,21,28,1,685,1,13,6,6,7,single-choice,spatial-relational,6|7,7,6/7,210028,6
5,3,21,29,1,630,1,13,6,6,7,single-choice,spatial-relational,6|7,7,6/7,210029,6
5,3,21,30,1,588,1,7,3,3,4,single-choice,spatial-relational,3|4,7,3/4,210030,3
5,3,21,31,1,609,1,11,5,5,6,single-choice,spatial-relational,5|6,7,5/6,210031,5
5,3,21,32,1,525,1,3,1,1,2,single-choice,spatial-relational,1|2,7,1/2,210032,1
5,3,21,33,1,662,1,5,2,2,3,single-choice,spatial-relational,2|3,7,2/3,210033,2
5,3,21,34,0,556,1,5,2,3,3,single-choice,spatial-relational,2|3,7,2/3,210034,2
5,3,21,35,0,1043,1,11,5,6,6,single-choice,spatial-relational,5|6,7,5/6,210035,5
5,3,21,36,1,590,1,9,4,4,5,single-choice,spatial-relational,4|5,7,4/5,210036,4
5,3,21,37,1,616,1,5,2,2,3,single-choice,spatial-relational,2|3,7,2/3,210037,2
5,3,21,38,1,705,1,13,6,6,7,single-choice,spatial-relational,6|7,7,6/7,210038,6
5,3,21,39,1,631,1,9,4,4,5,single-choice,spatial-relational,4|5,7,4/5,210039,4
5,3,21,40,1,709,1,3,1,1,2,single-choice,spatial-relational,1|2,7,1/2,210040,1
5,3,21,41,1,647,1,11,5,5,6,single-choice,spatial-relational,5|6,7,5/6,210041,5
5,3,21,42,1,835,1,7,3,3,4,single-choice,spatial-relational,3|4,7,3/4,210042,3
5,3,21,43,1,622,1,13,6,6,7,single-choice,spatial-relational,6|7,7,6/7,210043,6
5,3,21,44,0,749,1,3,1,2,2,single-choice,spatial-relational,1|2,7,1/2,210044,1
5,3,21,45,1,590,1,7,3,3,4,single-choice,spatial-relational,3|4,7,3/4,210045,3
5,3,21,46,0,568,1,9,4,5,5,single-choice,spatial-relational,4|5,7,4/5,210046,4
5,3,21,47,1,647,1,5,2,2,3,single-choice,spatial-relational,2|3,7,2/3,210047,2
5,3,21,48,1,798,1,11,5,5,6,single-choice,spatial-relational,5|6,7,5/6,210048,5
5,3,21,49,1,576,1,9,4,4,5,single-choice,spatial-relational,4|5,7,4/5,210049,4
5,3,21,50,1,648,1,5,2,2,3,single-choice,spatial-relational,2|3,7,2/3,210050,2
5,3,21,51,1,600,1,9,4,4,5,single-choice,spatial-relational,4|5,7,4/5,210051,4
5,3,21,52,1,862,1,5,2,2,3,single-choice,spatial-relational,2|3,7,2/3,210052,2
5,3,21,53,1,625,1,3,1,1,2,single-choice,spatial-relational,1|2,7,1/2,210053,1
5,3,21,54,0,809,1,11,5,6,6,single-choice,spatial-relational,5|6,7,5/6,210054,5
5,3,21,55,1,598,1,7,3,3,4,single-choice,spatial-relational,3|4,7,3/4,210055,3
5,3,21,56,1,679,1,11,5,5,6,single-choice,spatial-relational,5|6,7,5/6,210056,5
5,3,21,57,1,767,1,3,1,1,2,single-choice,spatial-relational,1|2,7,1/2,210057,1
5,3,21,58,0,530,1,13,6,7,7,single-choice,spatial-relational,6|7,7,6/7,210058,6
5,3,21,59,0,767,1,7,3,4,4,single-choice,spatial-relational,3|4,7,3/4,210059,3
5,3,21,60,1,556,1,13,6,6,7,single-choice,spatial-relational,6|7,7,6/7,210060,6
5,3,21,61,1,634,1,5,2,2,3,single-choice,spatial-relational,2|3,7,2/3,210061,2
5,3,21,62,1,662,1,9,4,4,5,single-choice,spatial-relational,4|5,7,4/5,210062,4
5,3,21,63,1,685,1,5,2,2,3,single-choice,spatial-relational,2|3,7,2/3,210063,2
5,3,21,64,1,615,1,11,5,5,6,single-choice,spatial-relational,5|6,7,5/6,210064,5
5,3,21,65,1,722,1,13,6,6,7,single-choice,spatial-relational,6|7,7,6/7,210065,6
5,3,21,66,0,607,1,9,4,5,5,single-choice,spatial-relational,4|5,7,4/5,210066,4
5,3,21,67,0,857,1,11,5,6,6,single-choice,spatial-relational,5|6,7,5/6,210067,5
5,3,21,68,0,650,1,7,3,4,4,single-choice,spatial-relational,3|4,7,3/4,210068,3
5,3,21,69,1,509,1,7,3,3,4,single-choice,spatial-relational,3|4,7,3/4,210069,3
5,3,21,70,0,680,1,3,1,2,2,single-choice,spatial-relational,1|2,7,1/2,210070,1
5,3,21,71,1,665,1,3,1,1,2,single-choice,spatial-relational,1|2,7,1/2,210071,1
5,3,21,72,0,553,1,13,6,7,7,single-choice,spatial-relational,6|7,7,6/7,210072,6
5,3,21,73,1,599,1,11,5,5,6,single-choice,spatial-relational,5|6,7,5/6,210073,5
5,3,21,74,0,861,1,5,2,3,3,single-choice,spatial-relational,2|3,7,2/3,210074,2
5,3,21,75,1,681,1,9,4,4,5,single-choice,spatial-relational,4|5,7,4/5,210075,4
5,3,21,76,0,712,1,3,1,2,2,single-choice,spatial-relational,1|2,7,1/2,210076,1
5,3,21,77,1,1014,1,9,4,4,5,single-choice,spatial-relational,4|5,7,4/5,210077,4
5,3,21,78,1,712,1,13,6,6,7,single-choice,spatial-relational,6|7,7,6/7,210078,6
5,3,21,79,1,823,1,7,3,3,4,single-choice,spatial-relational,3|4,7,3/4,210079,3
5,3,21,80,1,635,1,7,3,3,4,single-choice,spatial-relational,3|4,7,3/4,210080,3
5,3,21,81,0,580,1,13,6,7,7,single-choice,spatial-relational,6|7,7,6/7,210081,6
5,3,21,82,1,458,1,3,1,1,2,single-choice,spatial-relational,1|2,7,1/2,210082,1
5,3,21,83,1,654,1,11,5,5,6,single-choice,spatial-relational,5|6,7,5/6,210083,5
5,3,21,84,1,657,1,5,2,2,3,single-choice,spatial-relational,2|3,7,2/3,210084,2
5,3,21,85,1,823,1,3,1,1,2,single-choice,spatial-relational,1|2,7,1/2,210085,1
5,3,21,86,1,1369,1,13,6,6,7,single-choice,spatial-relational,6|7,7,6/7,210086,6
5,3,21,87,1,651,1,5,2,2,3,single-choice,spatial-relational,2|3,7,2/3,210087,2
5,3,21,88,1,901,1,7,3,3,4,single-choice,spatial-relational,3|4,7,3/4,210088,3
5,3,21,89,1,642,1,5,2,2,3,single-choice,spatial-relational,2|3,7,2/3,210089,2
5,3,21,90,1,642,1,13,6,6,7,single-choice,spatial-relational,6|7,7,6/7,210090,6
5,3,21,91,1,625,1,9,4,4,5,single-choice,spatial-relational,4|5,7,4/5,210091,4
5,3,21,92,0,622,1,9,4,5,5,single-choice,spatial-relational,4|5,7,4/5,210092,4
5,3,21,93,0,842,1,11,5,6,6,single-choice,spatial-relational,5|6,7,5/6,210093,5
5,3,21,94,0,631,1,11,5,6,6,single-choice,spatial-relational,5|6,7,5/6,210094,5
5,3,21,95,1,456,1,3,1,1,2,single-choice,spatial-relational,1|2,7,1/2,210095,1
5,3,21,96,1,593,1,7,3,3,4,single-choice,spatial-relational,3|4,7,3/4,210096,3
5,3,21,97,1,826,1,11,5,5,6,single-choice,spatial-relational,5|6,7,5/6,210097,5
5,3,21,98,1,1016,1,11,5,5,6,single-choice,spatial-relational,5|6,7,5/6,210098,5
5,3,21,99,0,1075,1,5,2,3,3,single-choice,spatial-relational,2|3,7,2/3,210099,2
5,3,21,100,1,522,1,7,3,3,4,single-choice,spatial-relational,3|4,7,3/4,210100,3
5,3,21,101,1,632,1,3,1,1,2,single-choice,spatial-relational,1|2,7,1/2,210101,1
5,3,21,102,0,634,1,9,4,5,5,single-choice,spatial-relational,4|5,7,4/5,210102,4
5,3,21,103,0,44,1,3,1,2,2,single-choice,spatial-relational,1|2,7,1/2,210103,1
5,3,21,104,1,579,1,13,6,6,7,single-choice,spatial-relational,6|7,7,6/7,210104,6
5,3,21,105,1,761,1,9,4,4,5,single-choice,spatial-relational,4|5,7,4/5,210105,4
5,3,21,106,1,885,1,5,2,2,3,single-choice,spatial-relational,2|3,7,2/3,210106,2
5,3,21,107,1,641,1,7,3,3,4,single-choice,spatial-relational,3|4,7,3/4,210107,3
5,3,21,108,0,490,1,13,6,7,7,single-choice,spatial-relational,6|7,7,6/7,210108,6
5,3,21,109,1,784,1,9,4,4,5,single-choice,spatial-relational,4|5,7,4/5,210109,4
5,3,21,110,1,1331,1,13,6,6,7,single-choice,spatial-relational,6|7,7,6/7,210110,6
5,3,21,111,0,791,1,3,1,2,2,single-choice,spatial-relational,1|2,7,1/2,210111,1
5,3,21,112,1,591,1,5,2,2,3,single-choice,spatial-relational,2|3,7,2/3,210112,2
5,3,21,113,1,1248,1,11,5,5,6,single-choice,spatial-relational,5|6,7,5/6,210113,5
5,3,21,114,0,724,1,7,3,4,4,single-choice,spatial-relational,3|4,7,3/4,210114,3
5,3,21,115,0,803,1,7,3,4,4,single-choice,spatial-relational,3|4,7,3/4,210115,3
5,3,21,116,0,715,1,11,5,6,6,single-choice,spatial-relational,5|6,7,5/6,210116,5
5,3,21,117,0,566,1,5,2,3,3,single-choice,spatial-relational,2|3,7,2/3,210117,2
5,3,21,118,1,504,1,3,1,1,2,single-choice,spatial-relational,1|2,7,1/2,210118,1
5,3,21,119,1,689,1,9,4,4,5,single-choice,spatial-relational,4|5,7,4/5,210119,4
5,3,21,120,1,741,1,13,6,6,7,single-choice,spatial-relational,6|7,7,6/7,210120,6
5,3,21,121,1,798,1,3,1,1,2,single-choice,spatial-relational,1|2,7,1/2,210121,1
5,3,21,122,1,593,1,7,3,3,4,single-choice,spatial-relational,3|4,7,3/4,210122,3
5,3,21,123,1,682,1,13,6,6,7,single-choice,spatial-relational,6|7,7,6/7,210123,6
5,3,21,124,1,766,1,5,2,2,3,single-choice,spatial-relational,2|3,7,2/3,210124,2
5,3,21,125,1,650,1,11,5,5,6,single-choice,spatial-relational,5|6,7,5/6,210125,5
5,3,21,126,1,729,1,13,6,6,7,single-choice,spatial-relational,6|7,7,6/7,210126,6
5,3,21,127,1,701,1,7,3,3,4,single-choice,spatial-relational,3|4,7,3/4,210127,3
5,3,21,128,1,873,1,9,4,4,5,single-choice,spatial-relational,4|5,7,4/5,210128,4
5,3,21,129,1,722,1,5,2,2,3,single-choice,spatial-relational,2|3,7,2/3,210129,2
5,3,21,130,0,908,1,3,1,2,2,single-choice,spatial-relational,1|2,7,1/2,210130,1
5,3,21,131,0,531,1,11,5,6,6,single-choice,spatial-relational,5|6,7,5/6,210131,5
5,3,21,132,0,568,1,9,4,5,5,single-choice,spatial-relational,4|5,7,4/5,210132,4
5,3,21,133,1,466,1,3,1,1,2,single-choice,spatial-relational,1|2,7,1/2,210133,1
5,3,21,134,1,615,1,9,4,4,5,single-choice,spatial-relational,4|5,7,4/5,210134,4
5,3,21,135,1,751,1,3,1,1,2,single-choice,spatial-relational,1|2,7,1/2,210135,1
5,3,21,136,0,611,1,9,4,5,5,single-choice,spatial-relational,4|5,7,4/5,210136,4
5,3,21,137,1,50,1,7,3,3,4,single-choice,spatial-relational,3|4,7,3/4,210137,3
5,3,21,138,1,764,1,13,6,6,7,single-choice,spatial-relational,6|7,7,6/7,210138,6
5,3,21,139,1,669,1,5,2,2,3,single-choice,spatial-relational,2|3,7,2/3,210139,2
5,3,21,140,0,661,1,11,5,6,6,single-choice,spatial-relational,5|6,7,5/6,210140,5
5,3,21,141,1,695,1,11,5,5,6,single-choice,spatial-relational,5|6,7,5/6,210141,5
5,3,21,142,1,583,1,7,3,3,4,single-choice,spatial-relational,3|4,7,3/4,210142,3
5,3,21,143,0,568,1,13,6,7,7,single-choice,spatial-relational,6|7,7,6/7,210143,6
5,3,21,144,1,661,1,5,2,2,3,single-choice,spatial-relational,2|3,7,2/3,210144,2
5,3,21,145,1,598,1,13,6,6,7,single-choice,spatial-relational,6|7,7,6/7,210145,6
5,3,21,146,1,557,1,7,3,3,4,single-choice,spatial-relational,3|4,7,3/4,210146,3
5,3,21,147,1,677,1,7,3,3,4,single-choice,spatial-relational,3|4,7,3/4,210147,3
5,3,21,148,1,635,1,13,6,6,7,single-choice,spatial-relational,6|7,7,6/7,210148,6
5,3,21,149,0,818,1,9,4,5,5,single-choice,spatial-relational,4|5,7,4/5,210149,4
5,3,21,150,0,446,1,5,2,3,3,single-choice,spatial-relational,2|3,7,2/3,210150,2
5,3,21,151,0,435,1,3,1,2,2,single-choice,spatial-relational,1|2,7,1/2,210151,1
5,3,21,152,1,1133,1,11,5,5,6,single-choice,spatial-relational,5|6,7,5/6,210152,5
5,3,21,153,0,698,1,3,1,2,2,single-choice,spatial-relational,1|2,7,1/2,210153,1
5,3,21,154,0,714,1,9,4,5,5,single-choice,spatial-relational,4|5,7,4/5,210154,4
5,3,21,155,1,602,1,5,2,2,3,single-choice,spatial-relational,2|3,7,2/3,210155,2
5,3,21,156,1,720,1,11,5,5,6,single-choice,spatial-relational,5|6,7,5/6,210156,5
5,3,21,157,1,1820,1,13,6,6,7,single-choice,spatial-relational,6|7,7,6/7,210157,6
5,3,21,158,1,689,1,7,3,3,4,single-choice,spatial-relational,3|4,7,3/4,210158,3
5,3,21,159,1,729,1,9,4,4,5,single-choice,spatial-relational,4|5,7,4/5,210159,4
5,3,21,160,1,811,1,13,6,6,7,single-choice,spatial-relational,6|7,7,6/7,210160,6
5,3,21,161,0,563,1,11,5,6,6,single-choice,spatial-relational,5|6,7,5/6,210161,5
5,3,21,162,1,697,1,9,4,4,5,single-choice,spatial-relational,4|5,7,4/5,210162,4
5,3,21,163,1,611,1,3,1,1,2,single-choice,spatial-relational,1|2,7,1/2,210163,1
5,3,21,164,1,654,1,11,5,5,6,single-choice,spatial-relational,5|6,7,5/6,210164,5
5,3,21,165,0,853,1,5,2,3,3,single-choice,spatial-relational,2|3,7,2/3,210165,2
5,3,21,166,0,718,1,3,1,2,2,single-choice,spatial-relational,1|2,7,1/2,210166,1
5,3,21,167,0,454,1,5,2,3,3,single-choice,spatial-relational,2|3,7,2/3,210167,2
5,3,21,168,1,630,1,7,3,3,4,single-choice,spatial-relational,3|4,7,3/4,210168,3
5,3,21,169,1,646,1,13,6,6,7,single-choice,spatial-relational,6|7,7,6/7,210169,6
5,3,21,170,1,822,1,13,6,6,7,single-choice,spatial-relational,6|7,7,6/7,210170,6
5,3,21,171,1,727,1,11,5,5,6,single-choice,spatial-relational,5|6,7,5/6,210171,5
5,3,21,172,0,521,1,3,1,2,2,single-choice,spatial-relational,1|2,7,1/2,210172,1
5,3,21,173,1,943,1,9,4,4,5,single-choice,spatial-relational,4|5,7,4/5,210173,4
5,3,21,174,1,658,1,7,3,3,4,single-choice,spatial-relational,3|4,7,3/4,210174,3
5,3,21,175,1,681,1,9,4,4,5,single-choice,spatial-relational,4|5,7,4/5,210175,4
5,3,21,176,1,912,1,7,3,3,4,single-choice,spatial-relational,3|4,7,3/4,210176,3
5,3,21,177,1,685,1,5,2,2,3,single-choice,spatial-relational,2|3,7,2/3,210177,2
5,3,21,178,1,658,1,5,2,2,3,single-choice,spatial-relational,2|3,7,2/3,210178,2
5,3,21,179,1,12022,1,3,1,1,2,single-choice,spatial-relational,1|2,7,1/2,210179,1
5,3,21,180,0,642,1,11,5,6,6,single-choice,spatial-relational,5|6,7,5/6,210180,5
5,3,21,181,0,615,1,13,6,7,7,single-choice,spatial-relational,6|7,7,6/7,210181,6
5,3,21,182,1,640,1,5,2,2,3,single-choice,spatial-relational,2|3,7,2/3,210182,2
5,3,21,183,0,815,1,9,4,5,5,single-choice,spatial-relational,4|5,7,4/5,210183,4
5,3,21,184,1,779,1,13,6,6,7,single-choice,spatial-relational,6|7,7,6/7,210184,6
5,3,21,185,1,694,1,3,1,1,2,single-choice,spatial-relational,1|2,7,1/2,210185,1
5,3,21,186,1,742,1,3,1,1,2,single-choice,spatial-relational,1|2,7,1/2,210186,1
5,3,21,187,1,670,1,11,5,5,6,single-choice,spatial-relational,5|6,7,5/6,210187,5
5,3,21,188,0,795,1,11,5,6,6,single-choice,spatial-relational,5|6,7,5/6,210188,5
5,3,21,189,1,599,1,7,3,3,4,single-choice,spatial-relational,3|4,7,3/4,210189,3
5,3,21,190,1,642,1,5,2,2,3,single-choice,spatial-relational,2|3,7,2/3,210190,2
5,3,21,191,1,592,1,7,3,3,4,single-choice,spatial-relational,3|4,7,3/4,210191,3
5,3,21,192,1,680,1,9,4,4,5,single-choice,spatial-relational,4|5,7,4/5,210192,4
5,3,21,193,1,664,1,9,4,4,5,single-choice,spatial-relational,4|5,7,4/5,210193,4
5,3,21,194,1,864,1,11,5,5,6,single-choice,spatial-relational,5|6,7,5/6,210194,5
5,3,21,195,1,705,1,13,6,6,7,single-choice,spatial-relational,6|7,7,6/7,210195,6
5,3,21,196,0,802,1,3,1,2,2,single-choice,spatial-relational,1|2,7,1/2,210196,1
5,3,21,197,1,684,1,5,2,2,3,single-choice,spatial-relational,2|3,7,2/3,210197,2
5,3,21,198,1,607,1,7,3,3,4,single-choice,spatial-relational,3|4,7,3/4,210198,3
5,3,21,199,1,674,1,5,2,2,3,single-choice,spatial-relational,2|3,7,2/3,210199,2
5,3,21,200,1,669,1,3,1,1,2,single-choice,spatial-relational,1|2,7,1/2,210200,1
5,3,21,201,0,614,1,9,4,5,5,single-choice,spatial-relational,4|5,7,4/5,210201,4
5,3,21,202,1,645,1,7,3,3,4,single-choice,spatial-relational,3|4,7,3/4,210202,3
5,3,21,203,0,1158,1,11,5,6,6,single-choice,spatial-relational,5|6,7,5/6,210203,5
5,3,21,204,1,670,1,13,6,6,7,single-choice,spatial-relational,6|7,7,6/7,210204,6
5,3,21,205,0,712,1,3,1,2,2,single-choice,spatial-relational,1|2,7,1/2,210205,1
5,3,21,206,0,497,1,11,5,6,6,single-choice,spatial-relational,5|6,7,5/6,210206,5
5,3,21,207,0,36,1,7,3,4,4,single-choice,spatial-relational,3|4,7,3/4,210207,3
5,3,21,208,1,822,1,7,3,3,4,single-choice,spatial-relational,3|4,7,3/4,210208,3
5,3,21,209,1,794,1,3,1,1,2,single-choice,spatial-relational,1|2,7,1/2,210209,1
5,3,21,210,1,693,1,13,6,6,7,single-choice,spatial-relational,6|7,7,6/7,210210,6
5,3,21,211,0,639,1,5,2,3,3,single-choice,spatial-relational,2|3,7,2/3,210211,2
5,3,21,212,1,783,1,13,6,6,7,single-choice,spatial-relational,6|7,7,6/7,210212,6
5,3,21,213,0,932,1,11,5,6,6,single-choice,spatial-relational,5|6,7,5/6,210213,5
5,3,21,214,1,780,1,9,4,4,5,single-choice,spatial-relational,4|5,7,4/5,210214,4
5,3,21,215,1,660,1,9,4,4,5,single-choice,spatial-relational,4|5,7,4/5,210215,4
5,3,21,216,1,744,1,5,2,2,3,single-choice,spatial-relational,2|3,7,2/3,210216,2
5,3,21,217,1,722,1,11,5,5,6,single-choice,spatial-relational,5|6,7,5/6,210217,5
5,3,21,218,0,604,1,9,4,5,5,single-choice,spatial-relational,4|5,7,4/5,210218,4
5,3,21,219,1,695,1,9,4,4,5,single-choice,spatial-relational,4|5,7,4/5,210219,4
5,3,21,220,1,890,1,5,2,2,3,single-choice,spatial-relational,2|3,7,2/3,210220,2
5,3,21,221,1,710,1,13,6,6,7,single-choice,spatial-relational,6|7,7,6/7,210221,6
5,3,21,222,1,604,1,3,1,1,2,single-choice,spatial-relational,1|2,7,1/2,210222,1
5,3,21,223,0,584,1,13,6,7,7,single-choice,spatial-relational,6|7,7,6/7,210223,6
5,3,21,224,1,591,1,5,2,2,3,single-choice,spatial-relational,2|3,7,2/3,210224,2
5,3,21,225,1,691,1,3,1,1,2,single-choice,spatial-relational,1|2,7,1/2,210225,1
5,3,21,226,1,716,1,7,3,3,4,single-choice,spatial-relational,3|4,7,3/4,210226,3
5,3,21,227,1,953,1,11,5,5,6,single-choice,spatial-relational,5|6,7,5/6,210227,5
5,3,21,228,1,873,1,7,3,3,4,single-choice,spatial-relational,3|4,7,3/4,210228,3
5,3,21,229,1,654,1,5,2,2,3,single-choice,spatial-relational,2|3,7,2/3,210229,2
5,3,21,230,1,744,1,11,5,5,6,single-choice,spatial-relational,5|6,7,5/6,210230,5
5,3,21,231,1,841,1,7,3,3,4,single-choice,spatial-relational,3|4,7,3/4,210231,3
5,3,21,232,1,681,1,5,2,2,3,single-choice,spatial-relational,2|3,7,2/3,210232,2
5,3,21,233,1,673,1,13,6,6,7,single-choice,spatial-relational,6|7,7,6/7,210233,6
5,3,21,234,1,716,1,11,5,5,6,single-choice,spatial-relational,5|6,7,5/6,210234,5
5,3,21,235,1,673,1,9,4,4,5,single-choice,spatial-relational,4|5,7,4/5,210235,4
5,3,21,236,1,670,1,3,1,1,2,single-choice,spatial-relational,1|2,7,1/2,210236,1
5,3,21,237,0,627,1,9,4,5,5,single-choice,spatial-relational,4|5,7,4/5,210237,4
5,3,21,238,0,494,1,3,1,2,2,single-choice,spatial-relational,1|2,7,1/2,210238,1
5,3,21,239,1,594,1,13,6,6,7,single-choice,spatial-relational,6|7,7,6/7,210239,6
5,3,21,240,1,576,1,7,3,3,4,single-choice,spatial-relational,3|4,7,3/4,210240,3
5,3,21,241,1,713,1,9,4,4,5,single-choice,spatial-relational,4|5,7,4/5,210241,4
5,3,21,242,1,678,1,13,6,6,7,single-choice,spatial-relational,6|7,7,6/7,210242,6
5,3,21,243,1,607,1,7,3,3,4,single-choice,spatial-relational,3|4,7,3/4,210243,3
5,3,21,244,1,990,1,11,5,5,6,single-choice,spatial-relational,5|6,7,5/6,210244,5
5,3,21,245,0,800,1,3,1,2,2,single-choice,spatial-relational,1|2,7,1/2,210245,1
5,3,21,246,1,674,1,9,4,4,5,single-choice,spatial-relational,4|5,7,4/5,210246,4
5,3,21,247,1,634,1,5,2,2,3,single-choice,spatial-relational,2|3,7,2/3,210247,2
5,3,21,248,0,625,1,5,2,3,3,single-choice,spatial-relational,2|3,7,2/3,210248,2
5,3,21,249,1,773,1,13,6,6,7,single-choice,spatial-relational,6|7,7,6/7,210249,6
5,3,21,250,1,787,1,3,1,1,2,single-choice,spatial-relational,1|2,7,1/2,210250,1
5,3,21,251,1,713,1,11,5,5,6,single-choice,spatial-relational,5|6,7,5/6,210251,5
5,3,21,252,1,876,1,7,3,3,4,single-choice,spatial-relational,3|4,7,3/4,210252,3
5,3,21,253,0,704,1,9,4,5,5,single-choice,spatial-relational,4|5,7,4/5,210253,4
5,3,21,254,1,452,1,5,2,2,3,single-choice,spatial-relational,2|3,7,2/3,210254,2
5,3,21,255,0,642,1,3,1,2,2,single-choice,spatial-relational,1|2,7,1/2,210255,1
5,3,21,256,1,536,1,7,3,3,4,single-choice,spatial-relational,3|4,7,3/4,210256,3
5,3,21,257,1,638,1,7,3,3,4,single-choice,spatial-relational,3|4,7,3/4,210257,3
5,3,21,258,1,678,1,13,6,6,7,single-choice,spatial-relational,6|7,7,6/7,210258,6
5,3,21,259,1,684,1,9,4,4,5,single-choice,spatial-relational,4|5,7,4/5,210259,4
5,3,21,260,1,715,1,5,2,2,3,single-choice,spatial-relational,2|3,7,2/3,210260,2
5,3,21,261,0,561,1,13,6,7,7,single-choice,spatial-relational,6|7,7,6/7,210261,6
5,3,21,262,0,842,1,11,5,6,6,single-choice,spatial-relational,5|6,7,5/6,210262,5
5,3,21,263,1,599,1,11,5,5,6,single-choice,spatial-relational,5|6,7,5/6,210263,5
5,3,21,264,1,692,1,3,1,1,2,single-choice,spatial-relational,1|2,7,1/2,210264,1
5,3,21,265,1,624,1,9,4,4,5,single-choice,spatial-relational,4|5,7,4/5,210265,4
5,3,21,266,1,659,1,13,6,6,7,single-choice,spatial-relational,6|7,7,6/7,210266,6
5,3,21,267,0,650,1,5,2,3,3,single-choice,spatial-relational,2|3,7,2/3,210267,2
5,3,21,268,1,502,1,3,1,1,2,single-choice,spatial-relational,1|2,7,1/2,210268,1
5,3,21,269,1,693,1,5,2,2,3,single-choice,spatial-relational,2|3,7,2/3,210269,2
5,3,21,270,1,962,1,11,5,5,6,single-choice,spatial-relational,5|6,7,5/6,210270,5
5,3,21,271,1,623,1,3,1,1,2,single-choice,spatial-relational,1|2,7,1/2,210271,1
5,3,21,272,1,725,1,13,6,6,7,single-choice,spatial-relational,6|7,7,6/7,210272,6
5,3,21,273,1,590,1,7,3,3,4,single-choice,spatial-relational,3|4,7,3/4,210273,3
5,3,21,274,1,644,1,11,5,5,6,single-choice,spatial-relational,5|6,7,5/6,210274,5
5,3,21,275,1,654,1,9,4,4,5,single-choice,spatial-relational,4|5,7,4/5,210275,4
5,3,21,276,1,1025,1,7,3,3,4,single-choice,spatial-relational,3|4,7,3/4,210276,3
5,3,21,277,1,668,1,13,6,6,7,single-choice,spatial-relational,6|7,7,6/7,210277,6
5,3,21,278,1,642,1,11,5,5,6,single-choice,spatial-relational,5|6,7,5/6,210278,5
5,3,21,279,1,725,1,5,2,2,3,single-choice,spatial-relational,2|3,7,2/3,210279,2
5,3,21,280,0,691,1,11,5,6,6,single-choice,spatial-relational,5|6,7,5/6,210280,5
5,3,21,281,0,675,1,7,3,4,4,single-choice,spatial-relational,3|4,7,3/4,210281,3
5,3,21,282,1,831,1,5,2,2,3,single-choice,spatial-relational,2|3,7,2/3,210282,2
5,3,21,283,1,651,1,7,3,3,4,single-choice,spatial-relational,3|4,7,3/4,210283,3
5,3,21,284,1,656,1,3,1,1,2,single-choice,spatial-relational,1|2,7,1/2,210284,1
5,3,21,285,0,779,1,9,4,5,5,single-choice,spatial-relational,4|5,7,4/5,210285,4
5,3,21,286,0,1329,1,9,4,5,5,single-choice,spatial-relational,4|5,7,4/5,210286,4
5,3,21,287,1,505,1,3,1,1,2,single-choice,spatial-relational,1|2,7,1/2,210287,1
5,3,21,288,1,619,1,13,6,6,7,single-choice,spatial-relational,6|7,7,6/7,210288,6
5,3,21,289,1,599,1,3,1,1,2,single-choice,spatial-relational,1|2,7,1/2,210289,1
5,3,21,290,0,701,1,9,4,5,5,single-choice,spatial-relational,4|5,7,4/5,210290,4
5,3,21,291,0,861,1,7,3,4,4,single-choice,spatial-relational,3|4,7,3/4,210291,3
5,3,21,292,1,574,1,7,3,3,4,single-choice,spatial-relational,3|4,7,3/4,210292,3
5,3,21,293,1,859,1,11,5,5,6,single-choice,spatial-relational,5|6,7,5/6,210293,5
5,3,21,294,0,585,1,5,2,3,3,single-choice,spatial-relational,2|3,7,2/3,210294,2
5,3,21,295,0,55,1,9,4,5,5,single-choice,spatial-relational,4|5,7,4/5,210295,4
5,3,21,296,0,552,1,13,6,7,7,single-choice,spatial-relational,6|7,7,6/7,210296,6
5,3,21,297,1,40,1,3,1,1,2,single-choice,spatial-relational,1|2,7,1/2,210297,1
5,3,21,298,1,594,1,13,6,6,7,single-choice,spatial-relational,6|7,7,6/7,210298,6
5,3,21,299,1,624,1,5,2,2,3,single-choice,spatial-relational,2|3,7,2/3,210299,2
5,3,21,300,1,896,1,11,5,5,6,single-choice,spatial-relational,5|6,7,5/6,210300,5
5,3,21,301,1,591,1,13,6,6,7,single-choice,spatial-relational,6|7,7,6/7,210301,6
5,3,21,302,1,640,1,3,1,1,2,single-choice,spatial-relational,1|2,7,1/2,210302,1
5,3,21,303,1,733,1,5,2,2,3,single-choice,spatial-relational,2|3,7,2/3,210303,2
5,3,21,304,1,658,1,7,3,3,4,single-choice,spatial-relational,3|4,7,3/4,210304,3
5,3,21,305,1,654,1,3,1,1,2,single-choice,spatial-relational,1|2,7,1/2,210305,1
5,3,21,306,0,658,1,11,5,6,6,single-choice,spatial-relational,5|6,7,5/6,210306,5
5,3,21,307,1,65,1,11,5,5,6,single-choice,spatial-relational,5|6,7,5/6,210307,5
5,3,21,308,1,626,1,7,3,3,4,single-choice,spatial-relational,3|4,7,3/4,210308,3
5,3,21,309,0,657,1,5,2,3,3,single-choice,spatial-relational,2|3,7,2/3,210309,2
5,3,21,310,1,752,1,9,4,4,5,single-choice,spatial-relational,4|5,7,4/5,210310,4
5,3,21,311,0,502,1,13,6,7,7,single-choice,spatial-relational,6|7,7,6/7,210311,6
5,3,21,312,0,893,1,9,4,5,5,single-choice,spatial-relational,4|5,7,4/5,210312,4
5,3,21,313,1,696,1,7,3,3,4,single-choice,spatial-relational,3|4,7,3/4,210313,3
5,3,21,314,1,687,1,7,3,3,4,single-choice,spatial-relational,3|4,7,3/4,210314,3
5,3,21,315,0,765,1,11,5,6,6,single-choice,spatial-relational,5|6,7,5/6,210315,5
5,3,21,316,1,1047,1,13,6,6,7,single-choice,spatial-relational,6|7,7,6/7,210316,6
5,3,21,317,0,953,1,11,5,6,6,single-choice,spatial-relational,5|6,7,5/6,210317,5
5,3,21,318,0,597,1,9,4,5,5,single-choice,spatial-relational,4|5,7,4/5,210318,4
5,3,21,319,1,517,1,5,2,2,3,single-choice,spatial-relational,2|3,7,2/3,210319,2
5,3,21,320,0,792,1,9,4,5,5,single-choice,spatial-relational,4|5,7,4/5,210320,4
5,3,21,321,1,714,1,5,2,2,3,single-choice,spatial-relational,2|3,7,2/3,210321,2
5,3,21,322,0,549,1,3,1,2,2,single-choice,spatial-relational,1|2,7,1/2,210322,1
5,3,21,323,1,524,1,3,1,1,2,single-choice,spatial-relational,1|2,7,1/2,210323,1
5,3,21,324,1,655,1,13,6,6,7,single-choice,spatial-relational,6|7,7,6/7,210324,6
5,3,21,325,1,642,1,3,1,1,2,single-choice,spatial-relational,1|2,7,1/2,210325,1
5,3,21,326,1,769,1,11,5,5,6,single-choice,spatial-relational,5|6,7,5/6,210326,5
5,3,21,327,1,730,1,11,5,5,6,single-choice,spatial-relational,5|6,7,5/6,210327,5
5,3,21,328,1,565,1,7,3,3,4,single-choice,spatial-relational,3|4,7,3/4,210328,3
5,3,21,329,1,620,1,5,2,2,3,single-choice,spatial-relational,2|3,7,2/3,210329,2
5,3,21,330,1,821,1,7,3,3,4,single-choice,spatial-relational,3|4,7,3/4,210330,3
5,3,21,331,1,823,1,13,6,6,7,single-choice,spatial-relational,6|7,7,6/7,210331,6
5,3,21,332,0,587,1,3,1,2,2,single-choice,spatial-relational,1|2,7,1/2,210332,1
5,3,21,333,1,754,1,5,2,2,3,single-choice,spatial-relational,2|3,7,2/3,210333,2
5,3,21,334,1,752,1,9,4,4,5,single-choice,spatial-relational,4|5,7,4/5,210334,4
5,3,21,335,0,529,1,13,6,7,7,single-choice,spatial-relational,6|7,7,6/7,210335,6
5,3,21,336,1,690,1,9,4,4,5,single-choice,spatial-relational,4|5,7,4/5,210336,4
5,3,21,337,1,689,1,9,4,4,5,single-choice,spatial-relational,4|5,7,4/5,210337,4
5,3,21,338,1,1169,1,11,5,5,6,single-choice,spatial-relational,5|6,7,5/6,210338,5
5,3,21,339,0,549,1,5,2,3,3,single-choice,spatial-relational,2|3,7,2/3,210339,2
5,3,21,340,1,898,1,13,6,6,7,single-choice,spatial-relational,6|7,7,6/7,210340,6
5,3,21,341,1,837,1,3,1,1,2,single-choice,spatial-relational,1|2,7,1/2,210341,1
5,3,21,342,1,666,1,5,2,2,3,single-choice,spatial-relational,2|3,7,2/3,210342,2
5,3,21,343,1,724,1,9,4,4,5,single-choice,spatial-relational,4|5,7,4/5,210343,4
5,3,21,344,1,715,1,7,3,3,4,single-choice,spatial-relational,3|4,7,3/4,210344,3
5,3,21,345,1,531,1,7,3,3,4,single-choice,spatial-relational,3|4,7,3/4,210345,3
5,3,21,346,1,1012,1,11,5,5,6,single-choice,spatial-relational,5|6,7,5/6,210346,5
5,3,21,347,0,674,1,13,6,7,7,single-choice,spatial-relational,6|7,7,6/7,210347,6
5,3,21,348,0,523,1,3,1,2,2,single-choice,spatial-relational,1|2,7,1/2,210348,1
5,3,21,349,1,490,1,3,1,1,2,single-choice,spatial-relational,1|2,7,1/2,210349,1
5,3,21,350,1,631,1,7,3,3,4,single-choice,spatial-relational,3|4,7,3/4,210350,3
5,3,21,351,1,670,1,9,4,4,5,single-choice,spatial-relational,4|5,7,4/5,210351,4
5,3,21,352,1,545,1,7,3,3,4,single-choice,spatial-relational,3|4,7,3/4,210352,3
5,3,21,353,1,635,1,5,2,2,3,single-choice,spatial-relational,2|3,7,2/3,210353,2
5,3,21,354,0,1606,1,3,1,2,2,single-choice,spatial-relational,1|2,7,1/2,210354,1
5,3,21,355,0,264,1,11,5,6,6,single-choice,spatial-relational,5|6,7,5/6,210355,5
5,3,21,356,0,1056,1,13,6,7,7,single-choice,spatial-relational,6|7,7,6/7,210356,6
5,3,21,357,1,689,1,9,4,4,5,single-choice,spatial-relational,4|5,7,4/5,210357,4
5,3,21,358,1,842,1,5,2,2,3,single-choice,spatial-relational,2|3,7,2/3,210358,2
5,3,21,359,1,722,1,11,5,5,6,single-choice,spatial-relational,5|6,7,5/6,210359,5
5,3,21,360,1,798,1,13,6,6,7,single-choice,spatial-relational,6|7,7,6/7,210360,6
5,3,21,361,1,678,1,9,4,4,5,single-choice,spatial-relational,4|5,7,4/5,210361,4
5,3,21,362,1,822,1,5,2,2,3,single-choice,spatial-relational,2|3,7,2/3,210362,2
5,3,21,363,1,773,1,3,1,1,2,single-choice,spatial-relational,1|2,7,1/2,210363,1
5,3,21,364,1,611,1,3,1,1,2,single-choice,spatial-relational,1|2,7,1/2,210364,1
5,3,21,365,1,626,1,7,3,3,4,single-choice,spatial-relational,3|4,7,3/4,210365,3
5,3,21,366,0,847,1,11,5,6,6,single-choice,spatial-relational,5|6,7,5/6,210366,5
5,3,21,367,1,594,1,13,6,6,7,single-choice,spatial-relational,6|7,7,6/7,210367,6
5,3,21,368,1,681,1,13,6,6,7,single-choice,spatial-relational,6|7,7,6/7,210368,6
5,3,21,369,0,680,1,7,3,4,4,single-choice,spatial-relational,3|4,7,3/4,210369,3
5,3,21,370,1,755,1,5,2,2,3,single-choice,spatial-relational,2|3,7,2/3,210370,2
5,3,21,371,1,713,1,11,5,5,6,single-choice,spatial-relational,5|6,7,5/6,210371,5
5,3,21,372,0,625,1,9,4,5,5,single-choice,spatial-relational,4|5,7,4/5,210372,4
5,3,21,373,1,559,1,3,1,1,2,single-choice,spatial-relational,1|2,7,1/2,210373,1
5,3,21,374,0,585,1,5,2,3,3,single-choice,spatial-relational,2|3,7,2/3,210374,2
5,3,21,375,1,673,1,7,3,3,4,single-choice,spatial-relational,3|4,7,3/4,210375,3
5,3,21,376,1,671,1,13,6,6,7,single-choice,spatial-relational,6|7,7,6/7,210376,6
5,3,21,377,1,642,1,9,4,4,5,single-choice,spatial-relational,4|5,7,4/5,210377,4
5,3,21,378,1,802,1,7,3,3,4,single-choice,spatial-relational,3|4,7,3/4,210378,3
5,3,21,379,1,622,1,13,6,6,7,single-choice,spatial-relational,6|7,7,6/7,210379,6
5,3,21,380,1,705,1,9,4,4,5,single-choice,spatial-relational,4|5,7,4/5,210380,4
5,3,21,381,1,623,1,3,1,1,2,single-choice,spatial-relational,1|2,7,1/2,210381,1
5,3,21,382,1,950,1,11,5,5,6,single-choice,spatial-relational,5|6,7,5/6,210382,5
5,3,21,383,0,607,1,5,2,3,3,single-choice,spatial-relational,2|3,7,2/3,210383,2
5,3,21,384,0,626,1,11,5,6,6,single-choice,spatial-relational,5|6,7,5/6,210384,5
5,3,21,385,0,611,1,11,5,6,6,single-choice,spatial-relational,5|6,7,5/6,210385,5
5,3,21,386,1,64,1,5,2,2,3,single-choice,spatial-relational,2|3,7,2/3,210386,2
5,3,21,387,0,591,1,9,4,5,5,single-choice,spatial-relational,4|5,7,4/5,210387,4
5,3,21,388,0,573,1,3,1,2,2,single-choice,spatial-relational,1|2,7,1/2,210388,1
5,3,21,389,1,673,1,9,4,4,5,single-choice,spatial-relational,4|5,7,4/5,210389,4
5,3,21,390,1,791,1,13,6,6,7,single-choice,spatial-relational,6|7,7,6/7,210390,6
5,3,21,391,1,681,1,13,6,6,7,single-choice,spatial-relational,6|7,7,6/7,210391,6
5,3,21,392,0,762,1,11,5,6,6,single-choice,spatial-relational,5|6,7,5/6,210392,5
5,3,21,393,1,804,1,7,3,3,4,single-choice,spatial-relational,3|4,7,3/4,210393,3
5,3,21,394,1,697,1,5,2,2,3,single-choice,spatial-relational,2|3,7,2/3,210394,2
5,3,21,395,1,799,1,3,1,1,2,single-choice,spatial-relational,1|2,7,1/2,210395,1
5,3,21,396,1,648,1,7,3,3,4,single-choice,spatial-relational,3|4,7,3/4,210396,3
5,3,21,397,1,672,1,7,3,3,4,single-choice,spatial-relational,3|4,7,3/4,210397,3
5,3,21,398,0,969,1,5,2,3,3,single-choice,spatial-relational,2|3,7,2/3,210398,2
5,3,21,399,1,1077,1,11,5,5,6,single-choice,spatial-relational,5|6,7,5/6,210399,5
5,3,21,400,0,584,1,13,6,7,7,single-choice,spatial-relational,6|7,7,6/7,210400,6
5,3,21,401,1,681,1,3,1,1,2,single-choice,spatial-relational,1|2,7,1/2,210401,1
5,3,21,402,1,872,1,3,1,1,2,single-choice,spatial-relational,1|2,7,1/2,210402,1
5,3,21,403,0,613,1,9,4,5,5,single-choice,spatial-relational,4|5,7,4/5,210403,4
5,3,21,404,1,691,1,9,4,4,5,single-choice,spatial-relational,4|5,7,4/5,210404,4
5,3,21,405,1,607,1,5,2,2,3,single-choice,spatial-relational,2|3,7,2/3,210405,2
5,3,21,406,1,755,1,13,6,6,7,single-choice,spatial-relational,6|7,7,6/7,210406,6
5,3,21,407,0,673,1,7,3,4,4,single-choice,spatial-relational,3|4,7,3/4,210407,3
5,3,21,408,1,722,1,11,5,5,6,single-choice,spatial-relational,5|6,7,5/6,210408,5
5,3,21,409,1,852,1,5,2,2,3,single-choice,spatial-relational,2|3,7,2/3,210409,2
5,3,21,410,1,652,1,11,5,5,6,single-choice,spatial-relational,5|6,7,5/6,210410,5
5,3,21,411,1,705,1,5,2,2,3,single-choice,spatial-relational,2|3,7,2/3,210411,2
5,3,21,412,1,610,1,3,1,1,2,single-choice,spatial-relational,1|2,7,1/2,210412,1
5,3,21,413,1,662,1,9,4,4,5,single-choice,spatial-relational,4|5,7,4/5,210413,4
5,3,21,414,1,674,1,3,1,1,2,single-choice,spatial-relational,1|2,7,1/2,210414,1
5,3,21,415,1,727,1,13,6,6,7,single-choice,spatial-relational,6|7,7,6/7,210415,6
5,3,21,416,1,765,1,9,4,4,5,single-choice,spatial-relational,4|5,7,4/5,210416,4
5,3,21,417,1,661,1,13,6,6,7,single-choice,spatial-relational,6|7,7,6/7,210417,6
5,3,21,418,1,670,1,7,3,3,4,single-choice,spatial-relational,3|4,7,3/4,210418,3
5,3,21,419,1,702,1,11,5,5,6,single-choice,spatial-relational,5|6,7,5/6,210419,5
5,3,21,420,1,615,1,7,3,3,4,single-choice,spatial-relational,3|4,7,3/4,210420,3
5,3,21,421,1,756,1,7,3,3,4,single-choice,spatial-relational,3|4,7,3/4,210421,3
5,3,21,422,1,633,1,3,1,1,2,single-choice,spatial-relational,1|2,7,1/2,210422,1
5,3,21,423,1,680,1,7,3,3,4,single-choice,spatial-relational,3|4,7,3/4,210423,3
5,3,21,424,1,740,1,3,1,1,2,single-choice,spatial-relational,1|2,7,1/2,210424,1
5,3,21,425,1,633,1,5,2,2,3,single-choice,spatial-relational,2|3,7,2/3,210425,2
5,3,21,426,1,545,1,13,6,6,7,single-choice,spatial-relational,6|7,7,6/7,210426,6
5,3,21,427,1,861,1,11,5,5,6,single-choice,spatial-relational,5|6,7,5/6,210427,5
5,3,21,428,1,724,1,13,6,6,7,single-choice,spatial-relational,6|7,7,6/7,210428,6
5,3,21,429,1,752,1,9,4,4,5,single-choice,spatial-relational,4|5,7,4/5,210429,4
5,3,21,430,1,738,1,5,2,2,3,single-choice,spatial-relational,2|3,7,2/3,210430,2
5,3,21,431,0,829,1,11,5,6,6,single-choice,spatial-relational,5|6,7,5/6,210431,5
5,3,21,432,1,818,1,9,4,4,5,single-choice,spatial-relational,4|5,7,4/5,210432,4
5,3,21,433,0,835,1,11,5,6,6,single-choice,spatial-relational,5|6,7,5/6,210433,5
5,3,21,434,1,851,1,7,3,3,4,single-choice,spatial-relational,3|4,7,3/4,210434,3
5,3,21,435,0,626,1,3,1,2,2,single-choice,spatial-relational,1|2,7,1/2,210435,1
5,3,21,436,1,709,1,13,6,6,7,single-choice,spatial-relational,6|7,7,6/7,210436,6
5,3,21,437,1,641,1,3,1,1,2,single-choice,spatial-relational,1|2,7,1/2,210437,1
5,3,21,438,1,786,1,9,4,4,5,single-choice,spatial-relational,4|5,7,4/5,210438,4
5,3,21,439,0,545,1,7,3,4,4,single-choice,spatial-relational,3|4,7,3/4,210439,3
5,3,21,440,1,700,1,11,5,5,6,single-choice,spatial-relational,5|6,7,5/6,210440,5
5,3,21,441,0,617,1,5,2,3,3,single-choice,spatial-relational,2|3,7,2/3,210441,2
5,3,21,442,1,686,1,9,4,4,5,single-choice,spatial-relational,4|5,7,4/5,210442,4
5,3,21,443,1,721,1,5,2,2,3,single-choice,spatial-relational,2|3,7,2/3,210443,2
5,3,21,444,0,710,1,13,6,7,7,single-choice,spatial-relational,6|7,7,6/7,210444,6
5,3,21,445,1,36,1,3,1,1,2,single-choice,spatial-relational,1|2,7,1/2,210445,1
5,3,21,446,0,691,1,11,5,6,6,single-choice,spatial-relational,5|6,7,5/6,210446,5
5,3,21,447,1,702,1,5,2,2,3,single-choice,spatial-relational,2|3,7,2/3,210447,2
5,3,21,448,1,670,1,13,6,6,7,single-choice,spatial-relational,6|7,7,6/7,210448,6
5,3,21,449,1,575,1,13,6,6,7,single-choice,spatial-relational,6|7,7,6/7,210449,6
5,3,21,450,1,661,1,3,1,1,2,single-choice,spatial-relational,1|2,7,1/2,210450,1
5,3,21,451,1,664,1,7,3,3,4,single-choice,spatial-relational,3|4,7,3/4,210451,3
5,3,21,452,1,684,1,7,3,3,4,single-choice,spatial-relational,3|4,7,3/4,210452,3
5,3,21,453,1,1053,1,5,2,2,3,single-choice,spatial-relational,2|3,7,2/3,210453,2
5,3,21,454,1,669,1,9,4,4,5,single-choice,spatial-relational,4|5,7,4/5,210454,4
5,3,21,455,1,709,1,11,5,5,6,single-choice,spatial-relational,5|6,7,5/6,210455,5
5,3,21,456,0,621,1,9,4,5,5,single-choice,spatial-relational,4|5,7,4/5,210456,4
5,3,21,457,0,563,1,7,3,4,4,single-choice,spatial-relational,3|4,7,3/4,210457,3
5,3,21,458,1,663,1,9,4,4,5,single-choice,spatial-relational,4|5,7,4/5,210458,4
5,3,21,459,1,705,1,3,1,1,2,single-choice,spatial-relational,1|2,7,1/2,210459,1
5,3,21,460,1,709,1,11,5,5,6,single-choice,spatial-relational,5|6,7,5/6,210460,5
5,3,21,461,1,659,1,5,2,2,3,single-choice,spatial-relational,2|3,7,2/3,210461,2
5,3,21,462,1,671,1,7,3,3,4,single-choice,spatial-relational,3|4,7,3/4,210462,3
5,3,21,463,1,650,1,5,2,2,3,single-choice,spatial-relational,2|3,7,2/3,210463,2
5,3,21,464,1,908,1,13,6,6,7,single-choice,spatial-relational,6|7,7,6/7,210464,6
5,3,21,465,0,565,1,9,4,5,5,single-choice,spatial-relational,4|5,7,4/5,210465,4
5,3,21,466,1,802,1,3,1,1,2,single-choice,spatial-relational,1|2,7,1/2,210466,1
5,3,21,467,1,708,1,13,6,6,7,single-choice,spatial-relational,6|7,7,6/7,210467,6
5,3,21,468,0,766,1,11,5,6,6,single-choice,spatial-relational,5|6,7,5/6,210468,5
5,3,21,469,0,678,1,5,2,3,3,single-choice,spatial-relational,2|3,7,2/3,210469,2
5,3,21,470,0,547,1,3,1,2,2,single-choice,spatial-relational,1|2,7,1/2,210470,1
5,3,21,471,0,685,1,3,1,2,2,single-choice,spatial-relational,1|2,7,1/2,210471,1
5,3,21,472,1,932,1,11,5,5,6,single-choice,spatial-relational,5|6,7,5/6,210472,5
5,3,21,473,0,587,1,13,6,7,7,single-choice,spatial-relational,6|7,7,6/7,210473,6
5,3,21,474,0,507,1,9,4,5,5,single-choice,spatial-relational,4|5,7,4/5,210474,4
5,3,21,475,0,521,1,7,3,4,4,single-choice,spatial-relational,3|4,7,3/4,210475,3
5,3,21,476,0,727,1,9,4,5,5,single-choice,spatial-relational,4|5,7,4/5,210476,4
5,3,21,477,0,626,1,5,2,3,3,single-choice,spatial-relational,2|3,7,2/3,210477,2
5,3,21,478,0,820,1,11,5,6,6,single-choice,spatial-relational,5|6,7,5/6,210478,5
5,3,21,479,1,646,1,13,6,6,7,single-choice,spatial-relational,6|7,7,6/7,210479,6
5,3,21,480,0,750,1,7,3,4,4,single-choice,spatial-relational,3|4,7,3/4,210480,3
5,3,21,481,1,518,1,5,2,2,3,single-choice,spatial-relational,2|3,7,2/3,210481,2
5,3,21,482,1,736,1,13,6,6,7,single-choice,spatial-relational,6|7,7,6/7,210482,6
5,3,21,483,1,717,1,9,4,4,5,single-choice,spatial-relational,4|5,7,4/5,210483,4
5,3,21,484,1,787,1,7,3,3,4,single-choice,spatial-relational,3|4,7,3/4,210484,3
5,3,21,485,0,678,1,11,5,6,6,single-choice,spatial-relational,5|6,7,5/6,210485,5
5,3,21,486,0,542,1,3,1,2,2,single-choice,spatial-relational,1|2,7,1/2,210486,1
5,3,21,487,0,611,1,5,2,3,3,single-choice,spatial-relational,2|3,7,2/3,210487,2
5,3,21,488,1,726,1,13,6,6,7,single-choice,spatial-relational,6|7,7,6/7,210488,6
5,3,21,489,0,686,1,9,4,5,5,single-choice,spatial-relational,4|5,7,4/5,210489,4
5,3,21,490,1,536,1,3,1,1,2,single-choice,spatial-relational,1|2,7,1/2,210490,1
5,3,21,491,1,1170,1,11,5,5,6,single-choice,spatial-relational,5|6,7,5/6,210491,5
5,3,21,492,1,664,1,7,3,3,4,single-choice,spatial-relational,3|4,7,3/4,210492,3
5,3,21,493,1,667,1,9,4,4,5,single-choice,spatial-relational,4|5,7,4/5,210493,4
5,3,21,494,1,631,1,7,3,3,4,single-choice,spatial-relational,3|4,7,3/4,210494,3
5,3,21,495,1,685,1,3,1,1,2,single-choice,spatial-relational,1|2,7,1/2,210495,1
5,3,21,496,0,677,1,9,4,5,5,single-choice,spatial-relational,4|5,7,4/5,210496,4
5,3,21,497,0,637,1,5,2,3,3,single-choice,spatial-relational,2|3,7,2/3,210497,2
5,3,21,498,0,606,1,11,5,6,6,single-choice,spatial-relational,5|6,7,5/6,210498,5
5,3,21,499,1,606,1,7,3,3,4,single-choice,spatial-relational,3|4,7,3/4,210499,3
5,3,21,500,1,702,1,13,6,6,7,single-choice,spatial-relational,6|7,7,6/7,210500,6
5,3,21,501,1,780,1,5,2,2,3,single-choice,spatial-relational,2|3,7,2/3,210501,2
5,3,21,502,0,1152,1,3,1,2,2,single-choice,spatial-relational,1|2,7,1/2,210502,1
5,3,21,503,1,799,1,13,6,6,7,single-choice,spatial-relational,6|7,7,6/7,210503,6
5,3,21,504,1,1040,1,11,5,5,6,single-choice,spatial-relational,5|6,7,5/6,210504,5
5,3,21,505,0,638,1,9,4,5,5,single-choice,spatial-relational,4|5,7,4/5,210505,4
5,3,21,506,1,632,1,13,6,6,7,single-choice,spatial-relational,6|7,7,6/7,210506,6
5,3,21,507,1,713,1,13,6,6,7,single-choice,spatial-relational,6|7,7,6/7,210507,6
5,3,21,508,1,713,1,3,1,1,2,single-choice,spatial-relational,1|2,7,1/2,210508,1
5,3,21,509,1,643,1,7,3,3,4,single-choice,spatial-relational,3|4,7,3/4,210509,3
5,3,21,510,0,65,1,9,4,5,5,single-choice,spatial-relational,4|5,7,4/5,210510,4
5,3,21,511,1,613,1,7,3,3,4,single-choice,spatial-relational,3|4,7,3/4,210511,3
5,3,21,512,0,1066,1,11,5,6,6,single-choice,spatial-relational,5|6,7,5/6,210512,5
5,3,21,513,1,690,1,11,5,5,6,single-choice,spatial-relational,5|6,7,5/6,210513,5
5,3,21,514,0,658,1,5,2,3,3,single-choice,spatial-relational,2|3,7,2/3,210514,2
5,3,21,515,0,455,1,3,1,2,2,single-choice,spatial-relational,1|2,7,1/2,210515,1
5,3,21,516,0,653,1,5,2,3,3,single-choice,spatial-relational,2|3,7,2/3,210516,2
5,3,21,517,0,569,1,7,3,4,4,single-choice,spatial-relational,3|4,7,3/4,210517,3
5,3,21,518,1,556,1,13,6,6,7,single-choice,spatial-relational,6|7,7,6/7,210518,6
5,3,21,519,1,664,1,5,2,2,3,single-choice,spatial-relational,2|3,7,2/3,210519,2
5,3,21,520,1,1815,1,3,1,1,2,single-choice,spatial-relational,1|2,7,1/2,210520,1
5,3,21,521,0,696,1,11,5,6,6,single-choice,spatial-relational,5|6,7,5/6,210521,5
5,3,21,522,0,715,1,9,4,5,5,single-choice,spatial-relational,4|5,7,4/5,210522,4
5,3,21,523,1,775,1,13,6,6,7,single-choice,spatial-relational,6|7,7,6/7,210523,6
5,3,21,524,1,674,1,9,4,4,5,single-choice,spatial-relational,4|5,7,4/5,210524,4
5,3,21,525,0,673,1,5,2,3,3,single-choice,spatial-relational,2|3,7,2/3,210525,2
5,3,21,526,1,673,1,11,5,5,6,single-choice,spatial-relational,5|6,7,5/6,210526,5
5,3,21,527,1,601,1,3,1,1,2,single-choice,spatial-relational,1|2,7,1/2,210527,1
5,3,21,528,1,673,1,7,3,3,4,single-choice,spatial-relational,3|4,7,3/4,210528,3
5,3,21,529,0,592,1,3,1,2,2,single-choice,spatial-relational,1|2,7,1/2,210529,1
5,3,21,530,1,630,1,7,3,3,4,single-choice,spatial-relational,3|4,7,3/4,210530,3
5,3,21,531,0,724,1,5,2,3,3,single-choice,spatial-relational,2|3,7,2/3,210531,2
5,3,21,532,0,797,1,9,4,5,5,single-choice,spatial-relational,4|5,7,4/5,210532,4
5,3,21,533,1,745,1,9,4,4,5,single-choice,spatial-relational,4|5,7,4/5,210533,4
5,3,21,534,1,851,1,13,6,6,7,single-choice,spatial-relational,6|7,7,6/7,210534,6
5,3,21,535,1,771,1,5,2,2,3,single-choice,spatial-relational,2|3,7,2/3,210535,2
5,3,21,536,1,754,1,3,1,1,2,single-choice,spatial-relational,1|2,7,1/2,210536,1
5,3,21,537,1,728,1,11,5,5,6,single-choice,spatial-relational,5|6,7,5/6,210537,5
5,3,21,538,1,1053,1,11,5,5,6,single-choice,spatial-relational,5|6,7,5/6,210538,5
5,3,21,539,1,821,1,13,6,6,7,single-choice,spatial-relational,6|7,7,6/7,210539,6
5,3,21,540,0,745,1,7,3,4,4,single-choice,spatial-relational,3|4,7,3/4,210540,3
5,3,21,541,0,752,1,3,1,2,2,single-choice,spatial-relational,1|2,7,1/2,210541,1
5,3,21,542,1,634,1,13,6,6,7,single-choice,spatial-relational,6|7,7,6/7,210542,6
5,3,21,543,0,721,1,7,3,4,4,single-choice,spatial-relational,3|4,7,3/4,210543,3
5,3,21,544,1,740,1,9,4,4,5,single-choice,spatial-relational,4|5,7,4/5,210544,4
5,3,21,545,0,844,1,11,5,6,6,single-choice,spatial-relational,5|6,7,5/6,210545,5
5,3,21,546,1,940,1,9,4,4,5,single-choice,spatial-relational,4|5,7,4/5,210546,4
5,3,21,547,1,674,1,3,1,1,2,single-choice,spatial-relational,1|2,7,1/2,210547,1
5,3,21,548,1,640,1,13,6,6,7,single-choice,spatial-relational,6|7,7,6/7,210548,6
5,3,21,549,0,754,1,11,5,6,6,single-choice,spatial-relational,5|6,7,5/6,210549,5
5,3,21,550,1,720,1,5,2,2,3,single-choice,spatial-relational,2|3,7,2/3,210550,2
5,3,21,551,0,96,1,7,3,4,4,single-choice,spatial-relational,3|4,7,3/4,210551,3
5,3,21,552,1,947,1,5,2,2,3,single-choice,spatial-relational,2|3,7,2/3,210552,2
5,3,21,553,1,697,1,13,6,6,7,single-choice,spatial-relational,6|7,7,6/7,210553,6
5,3,21,554,1,52,1,5,2,2,3,single-choice,spatial-relational,2|3,7,2/3,210554,2
5,3,21,555,1,627,1,9,4,4,5,single-choice,spatial-relational,4|5,7,4/5,210555,4
5,3,21,556,1,661,1,13,6,6,7,single-choice,spatial-relational,6|7,7,6/7,210556,6
5,3,21,557,1,799,1,11,5,5,6,single-choice,spatial-relational,5|6,7,5/6,210557,5
5,3,21,558,1,654,1,3,1,1,2,single-choice,spatial-relational,1|2,7,1/2,210558,1
5,3,21,559,1,701,1,7,3,3,4,single-choice,spatial-relational,3|4,7,3/4,210559,3
5,3,21,560,0,653,1,3,1,2,2,single-choice,spatial-relational,1|2,7,1/2,210560,1
5,3,21,561,1,650,1,7,3,3,4,single-choice,spatial-relational,3|4,7,3/4,210561,3
5,3,21,562,0,623,1,9,4,5,5,single-choice,spatial-relational,4|5,7,4/5,210562,4
5,3,21,563,1,880,1,11,5,5,6,single-choice,spatial-relational,5|6,7,5/6,210563,5
5,3,21,564,1,613,1,5,2,2,3,single-choice,spatial-relational,2|3,7,2/3,210564,2
5,3,21,565,1,595,1,3,1,1,2,single-choice,spatial-relational,1|2,7,1/2,210565,1
5,3,21,566,1,692,1,3,1,1,2,single-choice,spatial-relational,1|2,7,1/2,210566,1
5,3,21,567,1,680,1,9,4,4,5,single-choice,spatial-relational,4|5,7,4/5,210567,4
5,3,21,568,0,557,1,13,6,7,7,single-choice,spatial-relational,6|7,7,6/7,210568,6
5,3,21,569,1,595,1,7,3,3,4,single-choice,spatial-relational,3|4,7,3/4,210569,3
5,3,21,570,0,752,1,11,5,6,6,single-choice,spatial-relational,5|6,7,5/6,210570,5
5,3,21,571,1,687,1,13,6,6,7,single-choice,spatial-relational,6|7,7,6/7,210571,6
5,3,21,572,1,648,1,5,2,2,3,single-choice,spatial-relational,2|3,7,2/3,210572,2
5,3,21,573,1,860,1,7,3,3,4,single-choice,spatial-relational,3|4,7,3/4,210573,3
5,3,21,574,1,761,1,11,5,5,6,single-choice,spatial-relational,5|6,7,5/6,210574,5
5,3,21,575,0,651,1,5,2,3,3,single-choice,spatial-relational,2|3,7,2/3,210575,2
5,3,21,576,0,791,1,9,4,5,5,single-choice,spatial-relational,4|5,7,4/5,210576,4
5,3,21,577,1,921,1,13,6,6,7,single-choice,spatial-relational,6|7,7,6/7,210577,6
5,3,21,578,1,771,1,13,6,6,7,single-choice,spatial-relational,6|7,7,6/7,210578,6
5,3,21,579,0,637,1,5,2,3,3,single-choice,spatial-relational,2|3,7,2/3,210579,2
5,3,21,580,1,717,1,7,3,3,4,single-choice,spatial-relational,3|4,7,3/4,210580,3
5,3,21,581,1,44,1,3,1,1,2,single-choice,spatial-relational,1|2,7,1/2,210581,1
5,3,21,582,1,832,1,5,2,2,3,single-choice,spatial-relational,2|3,7,2/3,210582,2
5,3,21,583,0,756,1,9,4,5,5,single-choice,spatial-relational,4|5,7,4/5,210583,4
5,3,21,584,0,685,1,3,1,2,2,single-choice,spatial-relational,1|2,7,1/2,210584,1
5,3,21,585,0,804,1,11,5,6,6,single-choice,spatial-relational,5|6,7,5/6,210585,5
5,3,21,586,1,646,1,7,3,3,4,single-choice,spatial-relational,3|4,7,3/4,210586,3
5,3,21,587,1,902,1,9,4,4,5,single-choice,spatial-relational,4|5,7,4/5,210587,4
5,3,21,588,0,685,1,11,5,6,6,single-choice,spatial-relational,5|6,7,5/6,210588,5
5,3,21,589,1,768,1,3,1,1,2,single-choice,spatial-relational,1|2,7,1/2,210589,1
5,3,21,590,1,672,1,13,6,6,7,single-choice,spatial-relational,6|7,7,6/7,210590,6
5,3,21,591,0,928,1,9,4,5,5,single-choice,spatial-relational,4|5,7,4/5,210591,4
5,3,21,592,1,705,1,7,3,3,4,single-choice,spatial-relational,3|4,7,3/4,210592,3
5,3,21,593,1,861,1,11,5,5,6,single-choice,spatial-relational,5|6,7,5/6,210593,5
5,3,21,594,1,700,1,5,2,2,3,single-choice,spatial-relational,2|3,7,2/3,210594,2
5,3,21,595,0,64,1,9,4,5,5,single-choice,spatial-relational,4|5,7,4/5,210595,4
5,3,21,596,1,878,1,11,5,5,6,single-choice,spatial-relational,5|6,7,5/6,210596,5
5,3,21,597,1,623,1,3,1,1,2,single-choice,spatial-relational,1|2,7,1/2,210597,1
5,3,21,598,1,801,1,13,6,6,7,single-choice,spatial-relational,6|7,7,6/7,210598,6
5,3,21,599,1,751,1,5,2,2,3,single-choice,spatial-relational,2|3,7,2/3,210599,2
5,3,21,600,1,768,1,7,3,3,4,single-choice,spatial-relational,3|4,7,3/4,210600,3
6,3,21,1,1,982,1,13,6,6,7,single-choice,spatial-relational,6|7,7,6/7,210001,6
6,3,21,2,0,683,1,13,6,7,7,single-choice,spatial-relational,6|7,7,6/7,210002,6
6,3,21,3,0,46,1,5,2,3,3,single-choice,spatial-relational,2|3,7,2/3,210003,2
6,3,21,4,0,840,1,11,5,6,6,single-choice,spatial-relational,5|6,7,5/6,210004,5
6,3,21,5,0,429,1,11,5,6,6,single-choice,spatial-relational,5|6,7,5/6,210005,5
6,3,21,6,1,590,1,7,3,3,4,single-choice,spatial-relational,3|4,7,3/4,210006,3
6,3,21,7,1,477,1,9,4,4,5,single-choice,spatial-relational,4|5,7,4/5,210007,4
6,3,21,8,0,474,1,7,3,4,4,single-choice,spatial-relational,3|4,7,3/4,210008,3
6,3,21,9,1,561,1,3,1,1,2,single-choice,spatial-relational,1|2,7,1/2,210009,1
6,3,21,10,0,517,1,3,1,2,2,single-choice,spatial-relational,1|2,7,1/2,210010,1
6,3,21,11,0,482,1,9,4,5,5,single-choice,spatial-relational,4|5,7,4/5,210011,4
6,3,21,12,1,466,1,5,2,2,3,single-choice,spatial-relational,2|3,7,2/3,210012,2
6,3,21,13,1,615,1,7,3,3,4,single-choice,spatial-relational,3|4,7,3/4,210013,3
6,3,21,14,0,1250,1,3,1,2,2,single-choice,spatial-relational,1|2,7,1/2,210014,1
6,3,21,15,1,825,1,11,5,5,6,single-choice,spatial-relational,5|6,7,5/6,210015,5
6,3,21,16,1,642,1,7,3,3,4,single-choice,spatial-relational,3|4,7,3/4,210016,3
6,3,21,17,0,563,1,5,2,3,3,single-choice,spatial-relational,2|3,7,2/3,210017,2
6,3,21,18,1,544,1,13,6,6,7,single-choice,spatial-relational,6|7,7,6/7,210018,6
6,3,21,19,1,830,1,5,2,2,3,single-choice,spatial-relational,2|3,7,2/3,210019,2
6,3,21,20,1,635,1,9,4,4,5,single-choice,spatial-relational,4|5,7,4/5,210020,4
6,3,21,21,0,610,1,3,1,2,2,single-choice,spatial-relational,1|2,7,1/2,210021,1
6,3,21,22,0,619,1,9,4,5,5,single-choice,spatial-relational,4|5,7,4/5,210022,4
6,3,21,23,1,621,1,13,6,6,7,single-choice,spatial-relational,6|7,7,6/7,210023,6
6,3,21,24,0,460,1,11,5,6,6,single-choice,spatial-relational,5|6,7,5/6,210024,5
6,3,21,25,1,580,1,13,6,6,7,single-choice,spatial-relational,6|7,7,6/7,210025,6
6,3,21,26,0,468,1,13,6,7,7,single-choice,spatial-relational,6|7,7,6/7,210026,6
6,3,21,27,1,730,1,5,2,2,3,single-choice,spatial-relational,2|3,7,2/3,210027,2
6,3,21,28,1,545,1,7,3,3,4,single-choice,spatial-relational,3|4,7,3/4,210028,3
6,3,21,29,1,506,1,7,3,3,4,single-choice,spatial-relational,3|4,7,3/4,210029,3
6,3,21,30,1,590,1,9,4,4,5,single-choice,spatial-relational,4|5,7,4/5,210030,4
6,3,21,31,1,618,1,9,4,4,5,single-choice,spatial-relational,4|5,7,4/5,210031,4
6,3,21,32,0,581,1,11,5,6,6,single-choice,spatial-relational,5|6,7,5/6,210032,5
6,3,21,33,1,467,1,3,1,1,2,single-choice,spatial-relational,1|2,7,1/2,210033,1
6,3,21,34,0,1258,1,3,1,2,2,single-choice,spatial-relational,1|2,7,1/2,210034,1
6,3,21,35,1,738,1,5,2,2,3,single-choice,spatial-relational,2|3,7,2/3,210035,2
6,3,21,36,1,834,1,11,5,5,6,single-choice,spatial-relational,5|6,7,5/6,210036,5
6,3,21,37,1,816,1,5,2,2,3,single-choice,spatial-relational,2|3,7,2/3,210037,2
6,3,21,38,0,642,1,7,3,4,4,single-choice,spatial-relational,3|4,7,3/4,210038,3
6,3,21,39,1,609,1,11,5,5,6,single-choice,spatial-relational,5|6,7,5/6,210039,5
6,3,21,40,1,549,1,3,1,1,2,single-choice,spatial-relational,1|2,7,1/2,210040,1
6,3,21,41,1,575,1,11,5,5,6,single-choice,spatial-relational,5|6,7,5/6,210041,5
6,3,21,42,1,690,1,3,1,1,2,single-choice,spatial-relational,1|2,7,1/2,210042,1
6,3,21,43,1,635,1,5,2,2,3,single-choice,spatial-relational,2|3,7,2/3,210043,2
6,3,21,44,1,530,1,7,3,3,4,single-choice,spatial-relational,3|4,7,3/4,210044,3
6,3,21,45,0,580,1,9,4,5,5,single-choice,spatial-relational,4|5,7,4/5,210045,4
6,3,21,46,1,716,1,13,6,6,7,single-choice,spatial-relational,6|7,7,6/7,210046,6
6,3,21,47,1,561,1,13,6,6,7,single-choice,spatial-relational,6|7,7,6/7,210047,6
6,3,21,48,1,677,1,9,4,4,5,single-choice,spatial-relational,4|5,7,4/5,210048,4
6,3,21,49,0,490,1,11,5,6,6,single-choice,spatial-relational,5|6,7,5/6,210049,5
6,3,21,50,0,711,1,3,1,2,2,single-choice,spatial-relational,1|2,7,1/2,210050,1
6,3,21,51,1,44,1,7,3,3,4,single-choice,spatial-relational,3|4,7,3/4,210051,3
6,3,21,52,0,1047,1,9,4,5,5,single-choice,spatial-relational,4|5,7,4/5,210052,4
6,3,21,53,1,665,1,11,5,5,6,single-choice,spatial-relational,5|6,7,5/6,210053,5
6,3,21,54,1,587,1,7,3,3,4,single-choice,spatial-relational,3|4,7,3/4,210054,3
6,3,21,55,1,660,1,3,1,1,2,single-choice,spatial-relational,1|2,7,1/2,210055,1
6,3,21,56,1,693,1,5,2,2,3,single-choice,spatial-relational,2|3,7,2/3,210056,2
6,3,21,57,1,654,1,5,2,2,3,single-choice,spatial-relational,2|3,7,2/3,210057,2
6,3,21,58,1,752,1,13,6,6,7,single-choice,spatial-relational,6|7,7,6/7,210058,6
6,3,21,59,1,1278,1,13,6,6,7,single-choice,spatial-relational,6|7,7,6/7,210059,6
6,3,21,60,1,690,1,9,4,4,5,single-choice,spatial-relational,4|5,7,4/5,210060,4
6,3,21,61,1,623,1,9,4,4,5,single-choice,spatial-relational,4|5,7,4/5,210061,4
6,3,21,62,1,596,1,13,6,6,7,single-choice,spatial-relational,6|7,7,6/7,210062,6
6,3,21,63,1,646,1,3,1,1,2,single-choice,spatial-relational,1|2,7,1/2,210063,1
6,3,21,64,0,3001,1,7,3,4,4,single-choice,spatial-relational,3|4,7,3/4,210064,3
6,3,21,65,1,740,1,11,5,5,6,single-choice,spatial-relational,5|6,7,5/6,210065,5
6,3,21,66,1,662,1,5,2,2,3,single-choice,spatial-relational,2|3,7,2/3,210066,2
6,3,21,67,1,711,1,11,5,5,6,single-choice,spatial-relational,5|6,7,5/6,210067,5
6,3,21,68,0,651,1,9,4,5,5,single-choice,spatial-relational,4|5,7,4/5,210068,4
6,3,21,69,1,654,1,13,6,6,7,single-choice,spatial-relational,6|7,7,6/7,210069,6
6,3,21,70,1,642,1,7,3,3,4,single-choice,spatial-relational,3|4,7,3/4,210070,3
6,3,21,71,1,595,1,5,2,2,3,single-choice,spatial-relational,2|3,7,2/3,210071,2
6,3,21,72,0,560,1,3,1,2,2,single-choice,spatial-relational,1|2,7,1/2,210072,1
6,3,21,73,1,716,1,13,6,6,7,single-choice,spatial-relational,6|7,7,6/7,210073,6
6,3,21,74,1,652,1,13,6,6,7,single-choice,spatial-relational,6|7,7,6/7,210074,6
6,3,21,75,0,696,1,7,3,4,4,single-choice,spatial-relational,3|4,7,3/4,210075,3
6,3,21,76,0,587,1,9,4,5,5,single-choice,spatial-relational,4|5,7,4/5,210076,4
6,3,21,77,0,1023,1,9,4,5,5,single-choice,spatial-relational,4|5,7,4/5,210077,4
6,3,21,78,1,596,1,11,5,5,6,single-choice,spatial-relational,5|6,7,5/6,210078,5
6,3,21,79,1,633,1,11,5,5,6,single-choice,spatial-relational,5|6,7,5/6,210079,5
6,3,21,80,0,585,1,3,1,2,2,single-choice,spatial-relational,1|2,7,1/2,210080,1
6,3,21,81,1,990,1,3,1,1,2,single-choice,spatial-relational,1|2,7,1/2,210081,1
6,3,21,82,1,529,1,7,3,3,4,single-choice,spatial-relational,3|4,7,3/4,210082,3
6,3,21,83,1,626,1,5,2,2,3,single-choice,spatial-relational,2|3,7,2/3,210083,2
6,3,21,84,1,609,1,5,2,2,3,single-choice,spatial-relational,2|3,7,2/3,210084,2
6,3,21,85,1,599,1,11,5,5,6,single-choice,spatial-relational,5|6,7,5/6,210085,5
6,3,21,86,1,625,1,13,6,6,7,single-choice,spatial-relational,6|7,7,6/7,210086,6
6,3,21,87,1,1798,1,3,1,1,2,single-choice,spatial-relational,1|2,7,1/2,210087,1
6,3,21,88,1,865,1,11,5,5,6,single-choice,spatial-relational,5|6,7,5/6,210088,5
6,3,21,89,0,517,1,5,2,3,3,single-choice,spatial-relational,2|3,7,2/3,210089,2
6,3,21,90,1,719,1,9,4,4,5,single-choice,spatial-relational,4|5,7,4/5,210090,4
6,3,21,91,1,693,1,5,2,2,3,single-choice,spatial-relational,2|3,7,2/3,210091,2
6,3,21,92,0,752,1,9,4,5,5,single-choice,spatial-relational,4|5,7,4/5,210092,4
6,3,21,93,1,485,1,7,3,3,4,single-choice,spatial-relational,3|4,7,3/4,210093,3
6,3,21,94,1,577,1,7,3,3,4,single-choice,spatial-relational,3|4,7,3/4,210094,3
6,3,21,95,1,608,1,13,6,6,7,single-choice,spatial-relational,6|7,7,6/7,210095,6
6,3,21,96,1,597,1,3,1,1,2,single-choice,spatial-relational,1|2,7,1/2,210096,1
6,3,21,97,1,688,1,11,5,5,6,single-choice,spatial-relational,5|6,7,5/6,210097,5
6,3,21,98,0,4929,1,5,2,3,3,single-choice,spatial-relational,2|3,7,2/3,210098,2
6,3,21,99,1,684,1,3,1,1,2,single-choice,spatial-relational,1|2,7,1/2,210099,1
6,3,21,100,1,642,1,3,1,1,2,single-choice,spatial-relational,1|2,7,1/2,210100,1
6,3,21,101,0,634,1,13,6,7,7,single-choice,spatial-relational,6|7,7,6/7,210101,6
6,3,21,102,1,534,1,7,3,3,4,single-choice,spatial-relational,3|4,7,3/4,210102,3
6,3,21,103,1,529,1,7,3,3,4,single-choice,spatial-relational,3|4,7,3/4,210103,3
6,3,21,104,0,615,1,9,4,5,5,single-choice,spatial-relational,4|5,7,4/5,210104,4
6,3,21,105,1,543,1,13,6,6,7,single-choice,spatial-relational,6|7,7,6/7,210105,6
6,3,21,106,0,732,1,11,5,6,6,single-choice,spatial-relational,5|6,7,5/6,210106,5
6,3,21,107,1,68226,1,5,2,2,3,single-choice,spatial-relational,2|3,7,2/3,210107,2
6,3,21,108,0,756,1,9,4,5,5,single-choice,spatial-relational,4|5,7,4/5,210108,4
6,3,21,109,1,1056,1,9,4,4,5,single-choice,spatial-relational,4|5,7,4/5,210109,4
6,3,21,110,1,595,1,7,3,3,4,single-choice,spatial-relational,3|4,7,3/4,210110,3
6,3,21,111,0,552,1,13,6,7,7,single-choice,spatial-relational,6|7,7,6/7,210111,6
6,3,21,112,1,665,1,3,1,1,2,single-choice,spatial-relational,1|2,7,1/2,210112,1
6,3,21,113,0,664,1,3,1,2,2,single-choice,spatial-relational,1|2,7,1/2,210113,1
6,3,21,114,0,572,1,5,2,3,3,single-choice,spatial-relational,2|3,7,2/3,210114,2
6,3,21,115,1,761,1,11,5,5,6,single-choice,spatial-relational,5|6,7,5/6,210115,5
6,3,21,116,0,506,1,11,5,6,6,single-choice,spatial-relational,5|6,7,5/6,210116,5
6,3,21,117,1,536,1,13,6,6,7,single-choice,spatial-relational,6|7,7,6/7,210117,6
6,3,21,118,1,716,1,5,2,2,3,single-choice,spatial-relational,2|3,7,2/3,210118,2
6,3,21,119,1,720,1,9,4,4,5,single-choice,spatial-relational,4|5,7,4/5,210119,4
6,3,21,120,1,545,1,7,3,3,4,single-choice,spatial-relational,3|4,7,3/4,210120,3
6,3,21,121,1,637,1,13,6,6,7,single-choice,spatial-relational,6|7,7,6/7,210121,6
6,3,21,122,0,822,1,5,2,3,3,single-choice,spatial-relational,2|3,7,2/3,210122,2
6,3,21,123,1,686,1,11,5,5,6,single-choice,spatial-relational,5|6,7,5/6,210123,5
6,3,21,124,0,1339,1,13,6,7,7,single-choice,spatial-relational,6|7,7,6/7,210124,6
6,3,21,125,1,670,1,11,5,5,6,single-choice,spatial-relational,5|6,7,5/6,210125,5
6,3,21,126,1,685,1,5,2,2,3,single-choice,spatial-relational,2|3,7,2/3,210126,2
6,3,21,127,0,720,1,7,3,4,4,single-choice,spatial-relational,3|4,7,3/4,210127,3
6,3,21,128,0,727,1,3,1,2,2,single-choice,spatial-relational,1|2,7,1/2,210128,1
6,3,21,129,1,658,1,9,4,4,5,single-choice,spatial-relational,4|5,7,4/5,210129,4
6,3,21,130,0,14544,1,3,1,2,2,single-choice,spatial-relational,1|2,7,1/2,210130,1
6,3,21,131,0,584,1,9,4,5,5,single-choice,spatial-relational,4|5,7,4/5,210131,4
6,3,21,132,0,12305,1,7,3,4,4,single-choice,spatial-relational,3|4,7,3/4,210132,3
6,3,21,133,0,1099,1,5,2,3,3,single-choice,spatial-relational,2|3,7,2/3,210133,2
6,3,21,134,0,504,1,11,5,6,6,single-choice,spatial-relational,5|6,7,5/6,210134,5
6,3,21,135,1,702,1,13,6,6,7,single-choice,spatial-relational,6|7,7,6/7,210135,6
6,3,21,136,0,685,1,7,3,4,4,single-choice,spatial-relational,3|4,7,3/4,210136,3
6,3,21,137,1,611,1,13,6,6,7,single-choice,spatial-relational,6|7,7,6/7,210137,6
6,3,21,138,1,562,1,7,3,3,4,single-choice,spatial-relational,3|4,7,3/4,210138,3
6,3,21,139,1,1224,1,9,4,4,5,single-choice,spatial-relational,4|5,7,4/5,210139,4
6,3,21,140,0,658,1,3,1,2,2,single-choice,spatial-relational,1|2,7,1/2,210140,1
6,3,21,141,1,647,1,5,2,2,3,single-choice,spatial-relational,2|3,7,2/3,210141,2
6,3,21,142,1,598,1,3,1,1,2,single-choice,spatial-relational,1|2,7,1/2,210142,1
6,3,21,143,1,576,1,9,4,4,5,single-choice,spatial-relational,4|5,7,4/5,210143,4
6,3,21,144,1,667,1,11,5,5,6,single-choice,spatial-relational,5|6,7,5/6,210144,5
6,3,21,145,0,620,1,3,1,2,2,single-choice,spatial-relational,1|2,7,1/2,210145,1
6,3,21,146,0,831,1,11,5,6,6,single-choice,spatial-relational,5|6,7,5/6,210146,5
6,3,21,147,1,563,1,7,3,3,4,single-choice,spatial-relational,3|4,7,3/4,210147,3
6,3,21,148,1,26277,1,13,6,6,7,single-choice,spatial-relational,6|7,7,6/7,210148,6
6,3,21,149,1,609,1,11,5,5,6,single-choice,spatial-relational,5|6,7,5/6,210149,5
6,3,21,150,0,580,1,13,6,7,7,single-choice,spatial-relational,6|7,7,6/7,210150,6
6,3,21,151,1,646,1,5,2,2,3,single-choice,spatial-relational,2|3,7,2/3,210151,2
6,3,21,152,1,935,1,5,2,2,3,single-choice,spatial-relational,2|3,7,2/3,210152,2
6,3,21,153,1,571,1,7,3,3,4,single-choice,spatial-relational,3|4,7,3/4,210153,3
6,3,21,154,0,533,1,9,4,5,5,single-choice,spatial-relational,4|5,7,4/5,210154,4
6,3,21,155,1,650,1,3,1,1,2,single-choice,spatial-relational,1|2,7,1/2,210155,1
6,3,21,156,0,664,1,9,4,5,5,single-choice,spatial-relational,4|5,7,4/5,210156,4
6,3,21,157,1,611,1,3,1,1,2,single-choice,spatial-relational,1|2,7,1/2,210157,1
6,3,21,158,0,506,1,13,6,7,7,single-choice,spatial-relational,6|7,7,6/7,210158,6
6,3,21,159,0,725,1,3,1,2,2,single-choice,spatial-relational,1|2,7,1/2,210159,1
6,3,21,160,1,754,1,9,4,4,5,single-choice,spatial-relational,4|5,7,4/5,210160,4
6,3,21,161,0,596,1,5,2,3,3,single-choice,spatial-relational,2|3,7,2/3,210161,2
6,3,21,162,1,710,1,5,2,2,3,single-choice,spatial-relational,2|3,7,2/3,210162,2
6,3,21,163,1,1158,1,11,5,5,6,single-choice,spatial-relational,5|6,7,5/6,210163,5
6,3,21,164,1,537,1,7,3,3,4,single-choice,spatial-relational,3|4,7,3/4,210164,3
6,3,21,165,1,650,1,11,5,5,6,single-choice,spatial-relational,5|6,7,5/6,210165,5
6,3,21,166,1,529,1,7,3,3,4,single-choice,spatial-relational,3|4,7,3/4,210166,3
6,3,21,167,0,592,1,9,4,5,5,single-choice,spatial-relational,4|5,7,4/5,210167,4
6,3,21,168,1,736,1,13,6,6,7,single-choice,spatial-relational,6|7,7,6/7,210168,6
6,3,21,169,1,619,1,13,6,6,7,single-choice,spatial-relational,6|7,7,6/7,210169,6
6,3,21,170,0,585,1,9,4,5,5,single-choice,spatial-relational,4|5,7,4/5,210170,4
6,3,21,171,1,665,1,11,5,5,6,single-choice,spatial-relational,5|6,7,5/6,210171,5
6,3,21,172,1,596,1,9,4,4,5,single-choice,spatial-relational,4|5,7,4/5,210172,4
6,3,21,173,0,739,1,11,5,6,6,single-choice,spatial-relational,5|6,7,5/6,210173,5
6,3,21,174,1,627,1,13,6,6,7,single-choice,spatial-relational,6|7,7,6/7,210174,6
6,3,21,175,1,724,1,5,2,2,3,single-choice,spatial-relational,2|3,7,2/3,210175,2
6,3,21,176,1,681,1,3,1,1,2,single-choice,spatial-relational,1|2,7,1/2,210176,1
6,3,21,177,0,1798,1,3,1,2,2,single-choice,spatial-relational,1|2,7,1/2,210177,1
6,3,21,178,1,552,1,7,3,3,4,single-choice,spatial-relational,3|4,7,3/4,210178,3
6,3,21,179,1,586,1,7,3,3,4,single-choice,spatial-relational,3|4,7,3/4,210179,3
6,3,21,180,1,591,1,5,2,2,3,single-choice,spatial-relational,2|3,7,2/3,210180,2
6,3,21,181,1,638,1,11,5,5,6,single-choice,spatial-relational,5|6,7,5/6,210181,5
6,3,21,182,1,684,1,5,2,2,3,single-choice,spatial-relational,2|3,7,2/3,210182,2
6,3,21,183,1,654,1,3,1,1,2,single-choice,spatial-relational,1|2,7,1/2,210183,1
6,3,21,184,1,592,1,3,1,1,2,single-choice,spatial-relational,1|2,7,1/2,210184,1
6,3,21,185,1,640,1,13,6,6,7,single-choice,spatial-relational,6|7,7,6/7,210185,6
6,3,21,186,1,585,1,7,3,3,4,single-choice,spatial-relational,3|4,7,3/4,210186,3
6,3,21,187,1,693,1,11,5,5,6,single-choice,spatial-relational,5|6,7,5/6,210187,5
6,3,21,188,0,668,1,9,4,5,5,single-choice,spatial-relational,4|5,7,4/5,210188,4
6,3,21,189,1,603,1,7,3,3,4,single-choice,spatial-relational,3|4,7,3/4,210189,3
6,3,21,190,1,615,1,13,6,6,7,single-choice,spatial-relational,6|7,7,6/7,210190,6
6,3,21,191,0,942,1,5,2,3,3,single-choice,spatial-relational,2|3,7,2/3,210191,2
6,3,21,192,1,756,1,9,4,4,5,single-choice,spatial-relational,4|5,7,4/5,210192,4
6,3,21,193,0,1148,1,3,1,2,2,single-choice,spatial-relational,1|2,7,1/2,210193,1
6,3,21,194,1,565,1,9,4,4,5,single-choice,spatial-relational,4|5,7,4/5,210194,4
6,3,21,195,0,542,1,13,6,7,7,single-choice,spatial-relational,6|7,7,6/7,210195,6
6,3,21,196,0,573,1,5,2,3,3,single-choice,spatial-relational,2|3,7,2/3,210196,2
6,3,21,197,1,569,1,7,3,3,4,single-choice,spatial-relational,3|4,7,3/4,210197,3
6,3,21,198,1,581,1,11,5,5,6,single-choice,spatial-relational,5|6,7,5/6,210198,5
6,3,21,199,1,660,1,11,5,5,6,single-choice,spatial-relational,5|6,7,5/6,210199,5
6,3,21,200,1,553,1,5,2,2,3,single-choice,spatial-relational,2|3,7,2/3,210200,2
6,3,21,201,0,596,1,9,4,5,5,single-choice,spatial-relational,4|5,7,4/5,210201,4
6,3,21,202,1,558,1,3,1,1,2,single-choice,spatial-relational,1|2,7,1/2,210202,1
6,3,21,203,1,684,1,13,6,6,7,single-choice,spatial-relational,6|7,7,6/7,210203,6
6,3,21,204,0,657,1,7,3,4,4,single-choice,spatial-relational,3|4,7,3/4,210204,3
6,3,21,205,1,648,1,11,5,5,6,single-choice,spatial-relational,5|6,7,5/6,210205,5
6,3,21,206,1,609,1,3,1,1,2,single-choice,spatial-relational,1|2,7,1/2,210206,1
6,3,21,207,1,525,1,7,3,3,4,single-choice,spatial-relational,3|4,7,3/4,210207,3
6,3,21,208,1,728,1,9,4,4,5,single-choice,spatial-relational,4|5,7,4/5,210208,4
6,3,21,209,0,740,1,5,2,3,3,single-choice,spatial-relational,2|3,7,2/3,210209,2
6,3,21,210,1,624,1,13,6,6,7,single-choice,spatial-relational,6|7,7,6/7,210210,6
6,3,21,211,1,538,1,5,2,2,3,single-choice,spatial-relational,2|3,7,2/3,210211,2
6,3,21,212,0,802,1,11,5,6,6,single-choice,spatial-relational,5|6,7,5/6,210212,5
6,3,21,213,1,641,1,7,3,3,4,single-choice,spatial-relational,3|4,7,3/4,210213,3
6,3,21,214,0,599,1,9,4,5,5,single-choice,spatial-relational,4|5,7,4/5,210214,4
6,3,21,215,0,622,1,3,1,2,2,single-choice,spatial-relational,1|2,7,1/2,210215,1
6,3,21,216,1,679,1,13,6,6,7,single-choice,spatial-relational,6|7,7,6/7,210216,6
6,3,21,217,1,653,1,11,5,5,6,single-choice,spatial-relational,5|6,7,5/6,210217,5
6,3,21,218,0,576,1,9,4,5,5,single-choice,spatial-relational,4|5,7,4/5,210218,4
6,3,21,219,0,582,1,5,2,3,3,single-choice,spatial-relational,2|3,7,2/3,210219,2
6,3,21,220,0,519,1,3,1,2,2,single-choice,spatial-relational,1|2,7,1/2,210220,1
6,3,21,221,1,571,1,13,6,6,7,single-choice,spatial-relational,6|7,7,6/7,210221,6
6,3,21,222,1,544,1,7,3,3,4,single-choice,spatial-relational,3|4,7,3/4,210222,3
6,3,21,223,0,534,1,5,2,3,3,single-choice,spatial-relational,2|3,7,2/3,210223,2
6,3,21,224,1,1335,1,13,6,6,7,single-choice,spatial-relational,6|7,7,6/7,210224,6
6,3,21,225,0,676,1,7,3,4,4,single-choice,spatial-relational,3|4,7,3/4,210225,3
6,3,21,226,0,613,1,3,1,2,2,single-choice,spatial-relational,1|2,7,1/2,210226,1
6,3,21,227,0,746,1,9,4,5,5,single-choice,spatial-relational,4|5,7,4/5,210227,4
6,3,21,228,1,514,1,11,5,5,6,single-choice,spatial-relational,5|6,7,5/6,210228,5
6,3,21,229,1,565,1,3,1,1,2,single-choice,spatial-relational,1|2,7,1/2,210229,1
6,3,21,230,1,535,1,7,3,3,4,single-choice,spatial-relational,3|4,7,3/4,210230,3
6,3,21,231,1,654,1,11,5,5,6,single-choice,spatial-relational,5|6,7,5/6,210231,5
6,3,21,232,0,541,1,5,2,3,3,single-choice,spatial-relational,2|3,7,2/3,210232,2
6,3,21,233,0,597,1,9,4,5,5,single-choice,spatial-relational,4|5,7,4/5,210233,4
6,3,21,234,0,556,1,9,4,5,5,single-choice,spatial-relational,4|5,7,4/5,210234,4
6,3,21,235,1,545,1,13,6,6,7,single-choice,spatial-relational,6|7,7,6/7,210235,6
6,3,21,236,0,1131,1,5,2,3,3,single-choice,spatial-relational,2|3,7,2/3,210236,2
6,3,21,237,1,683,1,13,6,6,7,single-choice,spatial-relational,6|7,7,6/7,210237,6
6,3,21,238,0,662,1,3,1,2,2,single-choice,spatial-relational,1|2,7,1/2,210238,1
6,3,21,239,1,666,1,11,5,5,6,single-choice,spatial-relational,5|6,7,5/6,210239,5
6,3,21,240,1,621,1,7,3,3,4,single-choice,spatial-relational,3|4,7,3/4,210240,3
6,3,21,241,0,933,1,11,5,6,6,single-choice,spatial-relational,5|6,7,5/6,210241,5
6,3,21,242,1,574,1,7,3,3,4,single-choice,spatial-relational,3|4,7,3/4,210242,3
6,3,21,243,1,618,1,9,4,4,5,single-choice,spatial-relational,4|5,7,4/5,210243,4
6,3,21,244,1,600,1,5,2,2,3,single-choice,spatial-relational,2|3,7,2/3,210244,2
6,3,21,245,1,680,1,13,6,6,7,single-choice,spatial-relational,6|7,7,6/7,210245,6
6,3,21,246,1,716,1,9,4,4,5,single-choice,spatial-relational,4|5,7,4/5,210246,4
6,3,21,247,0,562,1,3,1,2,2,single-choice,spatial-relational,1|2,7,1/2,210247,1
6,3,21,248,1,624,1,3,1,1,2,single-choice,spatial-relational,1|2,7,1/2,210248,1
6,3,21,249,1,593,1,5,2,2,3,single-choice,spatial-relational,2|3,7,2/3,210249,2
6,3,21,250,1,589,1,13,6,6,7,single-choice,spatial-relational,6|7,7,6/7,210250,6
6,3,21,251,0,680,1,7,3,4,4,single-choice,spatial-relational,3|4,7,3/4,210251,3
6,3,21,252,1,743,1,11,5,5,6,single-choice,spatial-relational,5|6,7,5/6,210252,5
6,3,21,253,1,561,1,13,6,6,7,single-choice,spatial-relational,6|7,7,6/7,210253,6
6,3,21,254,0,1072,1,9,4,5,5,single-choice,spatial-relational,4|5,7,4/5,210254,4
6,3,21,255,1,655,1,5,2,2,3,single-choice,spatial-relational,2|3,7,2/3,210255,2
6,3,21,256,0,1349,1,3,1,2,2,single-choice,spatial-relational,1|2,7,1/2,210256,1
6,3,21,257,1,564,1,11,5,5,6,single-choice,spatial-relational,5|6,7,5/6,210257,5
6,3,21,258,1,642,1,11,5,5,6,single-choice,spatial-relational,5|6,7,5/6,210258,5
6,3,21,259,1,704,1,7,3,3,4,single-choice,spatial-relational,3|4,7,3/4,210259,3
6,3,21,260,1,588,1,3,1,1,2,single-choice,spatial-relational,1|2,7,1/2,210260,1
6,3,21,261,1,586,1,13,6,6,7,single-choice,spatial-relational,6|7,7,6/7,210261,6
6,3,21,262,1,607,1,7,3,3,4,single-choice,spatial-relational,3|4,7,3/4,210262,3
6,3,21,263,0,545,1,9,4,5,5,single-choice,spatial-relational,4|5,7,4/5,210263,4
6,3,21,264,1,1149,1,5,2,2,3,single-choice,spatial-relational,2|3,7,2/3,210264,2
6,3,21,265,1,630,1,5,2,2,3,single-choice,spatial-relational,2|3,7,2/3,210265,2
6,3,21,266,1,816,1,7,3,3,4,single-choice,spatial-relational,3|4,7,3/4,210266,3
6,3,21,267,1,502,1,7,3,3,4,single-choice,spatial-relational,3|4,7,3/4,210267,3
6,3,21,268,0,617,1,9,4,5,5,single-choice,spatial-relational,4|5,7,4/5,210268,4
6,3,21,269,1,662,1,11,5,5,6,single-choice,spatial-relational,5|6,7,5/6,210269,5
6,3,21,270,0,751,1,3,1,2,2,single-choice,spatial-relational,1|2,7,1/2,210270,1
6,3,21,271,1,618,1,3,1,1,2,single-choice,spatial-relational,1|2,7,1/2,210271,1
6,3,21,272,1,861,1,9,4,4,5,single-choice,spatial-relational,4|5,7,4/5,210272,4
6,3,21,273,1,620,1,13,6,6,7,single-choice,spatial-relational,6|7,7,6/7,210273,6
6,3,21,274,0,554,1,5,2,3,3,single-choice,spatial-relational,2|3,7,2/3,210274,2
6,3,21,275,1,610,1,11,5,5,6,single-choice,spatial-relational,5|6,7,5/6,210275,5
6,3,21,276,1,638,1,13,6,6,7,single-choice,spatial-relational,6|7,7,6/7,210276,6
6,3,21,277,1,639,1,7,3,3,4,single-choice,spatial-relational,3|4,7,3/4,210277,3
6,3,21,278,1,568,1,9,4,4,5,single-choice,spatial-relational,4|5,7,4/5,210278,4
6,3,21,279,1,645,1,3,1,1,2,single-choice,spatial-relational,1|2,7,1/2,210279,1
6,3,21,280,0,605,1,9,4,5,5,single-choice,spatial-relational,4|5,7,4/5,210280,4
6,3,21,281,1,623,1,5,2,2,3,single-choice,spatial-relational,2|3,7,2/3,210281,2
6,3,21,282,1,705,1,13,6,6,7,single-choice,spatial-relational,6|7,7,6/7,210282,6
6,3,21,283,1,571,1,7,3,3,4,single-choice,spatial-relational,3|4,7,3/4,210283,3
6,3,21,284,0,487,1,3,1,2,2,single-choice,spatial-relational,1|2,7,1/2,210284,1
6,3,21,285,1,536,1,13,6,6,7,single-choice,spatial-relational,6|7,7,6/7,210285,6
6,3,21,286,1,580,1,11,5,5,6,single-choice,spatial-relational,5|6,7,5/6,210286,5
6,3,21,287,0,498,1,5,2,3,3,single-choice,spatial-relational,2|3,7,2/3,210287,2
6,3,21,288,0,758,1,11,5,6,6,single-choice,spatial-relational,5|6,7,5/6,210288,5
6,3,21,289,1,593,1,7,3,3,4,single-choice,spatial-relational,3|4,7,3/4,210289,3
6,3,21,290,0,724,1,11,5,6,6,single-choice,spatial-relational,5|6,7,5/6,210290,5
6,3,21,291,1,508,1,7,3,3,4,single-choice,spatial-relational,3|4,7,3/4,210291,3
6,3,21,292,1,576,1,3,1,1,2,single-choice,spatial-relational,1|2,7,1/2,210292,1
6,3,21,293,1,619,1,9,4,4,5,single-choice,spatial-relational,4|5,7,4/5,210293,4
6,3,21,294,1,642,1,11,5,5,6,single-choice,spatial-relational,5|6,7,5/6,210294,5
6,3,21,295,1,636,1,13,6,6,7,single-choice,spatial-relational,6|7,7,6/7,210295,6
6,3,21,296,0,602,1,3,1,2,2,single-choice,spatial-relational,1|2,7,1/2,210296,1
6,3,21,297,1,642,1,5,2,2,3,single-choice,spatial-relational,2|3,7,2/3,210297,2
6,3,21,298,0,584,1,9,4,5,5,single-choice,spatial-relational,4|5,7,4/5,210298,4
6,3,21,299,1,920,1,5,2,2,3,single-choice,spatial-relational,2|3,7,2/3,210299,2
6,3,21,300,1,603,1,13,6,6,7,single-choice,spatial-relational,6|7,7,6/7,210300,6
6,3,21,301,1,558,1,3,1,1,2,single-choice,spatial-relational,1|2,7,1/2,210301,1
6,3,21,302,1,520,1,7,3,3,4,single-choice,spatial-relational,3|4,7,3/4,210302,3
6,3,21,303,1,521,1,7,3,3,4,single-choice,spatial-relational,3|4,7,3/4,210303,3
6,3,21,304,0,644,1,3,1,2,2,single-choice,spatial-relational,1|2,7,1/2,210304,1
6,3,21,305,1,681,1,5,2,2,3,single-choice,spatial-relational,2|3,7,2/3,210305,2
6,3,21,306,0,764,1,9,4,5,5,single-choice,spatial-relational,4|5,7,4/5,210306,4
6,3,21,307,0,654,1,11,5,6,6,single-choice,spatial-relational,5|6,7,5/6,210307,5
6,3,21,308,0,526,1,13,6,7,7,single-choice,spatial-relational,6|7,7,6/7,210308,6
6,3,21,309,1,503,1,13,6,6,7,single-choice,spatial-relational,6|7,7,6/7,210309,6
6,3,21,310,1,678,1,11,5,5,6,single-choice,spatial-relational,5|6,7,5/6,210310,5
6,3,21,311,1,577,1,9,4,4,5,single-choice,spatial-relational,4|5,7,4/5,210311,4
6,3,21,312,0,518,1,5,2,3,3,single-choice,spatial-relational,2|3,7,2/3,210312,2
6,3,21,313,0,56,1,9,4,5,5,single-choice,spatial-relational,4|5,7,4/5,210313,4
6,3,21,314,1,572,1,7,3,3,4,single-choice,spatial-relational,3|4,7,3/4,210314,3
6,3,21,315,1,674,1,11,5,5,6,single-choice,spatial-relational,5|6,7,5/6,210315,5
6,3,21,316,0,599,1,3,1,2,2,single-choice,spatial-relational,1|2,7,1/2,210316,1
6,3,21,317,1,585,1,3,1,1,2,single-choice,spatial-relational,1|2,7,1/2,210317,1
6,3,21,318,1,599,1,13,6,6,7,single-choice,spatial-relational,6|7,7,6/7,210318,6
6,3,21,319,1,500,1,7,3,3,4,single-choice,spatial-relational,3|4,7,3/4,210319,3
6,3,21,320,1,585,1,5,2,2,3,single-choice,spatial-relational,2|3,7,2/3,210320,2
6,3,21,321,1,576,1,5,2,2,3,single-choice,spatial-relational,2|3,7,2/3,210321,2
6,3,21,322,0,487,1,13,6,7,7,single-choice,spatial-relational,6|7,7,6/7,210322,6
6,3,21,323,1,544,1,11,5,5,6,single-choice,spatial-relational,5|6,7,5/6,210323,5
6,3,21,324,0,557,1,9,4,5,5,single-choice,spatial-relational,4|5,7,4/5,210324,4
6,3,21,325,1,591,1,9,4,4,5,single-choice,spatial-relational,4|5,7,4/5,210325,4
6,3,21,326,1,603,1,7,3,3,4,single-choice,spatial-relational,3|4,7,3/4,210326,3
6,3,21,327,1,592,1,3,1,1,2,single-choice,spatial-relational,1|2,7,1/2,210327,1
6,3,21,328,1,673,1,3,1,1,2,single-choice,spatial-relational,1|2,7,1/2,210328,1
6,3,21,329,1,600,1,5,2,2,3,single-choice,spatial-relational,2|3,7,2/3,210329,2
6,3,21,330,1,575,1,7,3,3,4,single-choice,spatial-relational,3|4,7,3/4,210330,3
6,3,21,331,1,573,1,5,2,2,3,single-choice,spatial-relational,2|3,7,2/3,210331,2
6,3,21,332,1,654,1,9,4,4,5,single-choice,spatial-relational,4|5,7,4/5,210332,4
6,3,21,333,0,713,1,11,5,6,6,single-choice,spatial-relational,5|6,7,5/6,210333,5
6,3,21,334,1,673,1,13,6,6,7,single-choice,spatial-relational,6|7,7,6/7,210334,6
6,3,21,335,0,505,1,13,6,7,7,single-choice,spatial-relational,6|7,7,6/7,210335,6
6,3,21,336,1,60,1,11,5,5,6,single-choice,spatial-relational,5|6,7,5/6,210336,5
6,3,21,337,0,512,1,5,2,3,3,single-choice,spatial-relational,2|3,7,2/3,210337,2
6,3,21,338,1,773,1,11,5,5,6,single-choice,spatial-relational,5|6,7,5/6,210338,5
6,3,21,339,1,609,1,3,1,1,2,single-choice,spatial-relational,1|2,7,1/2,210339,1
6,3,21,340,0,648,1,9,4,5,5,single-choice,spatial-relational,4|5,7,4/5,210340,4
6,3,21,341,0,564,1,11,5,6,6,single-choice,spatial-relational,5|6,7,5/6,210341,5
6,3,21,342,0,588,1,3,1,2,2,single-choice,spatial-relational,1|2,7,1/2,210342,1
6,3,21,343,1,986,1,9,4,4,5,single-choice,spatial-relational,4|5,7,4/5,210343,4
6,3,21,344,1,623,1,13,6,6,7,single-choice,spatial-relational,6|7,7,6/7,210344,6
6,3,21,345,1,596,1,7,3,3,4,single-choice,spatial-relational,3|4,7,3/4,210345,3
6,3,21,346,0,1111,1,5,2,3,3,single-choice,spatial-relational,2|3,7,2/3,210346,2
6,3,21,347,0,914,1,13,6,7,7,single-choice,spatial-relational,6|7,7,6/7,210347,6
6,3,21,348,1,545,1,7,3,3,4,single-choice,spatial-relational,3|4,7,3/4,210348,3
6,3,21,349,0,933,1,3,1,2,2,single-choice,spatial-relational,1|2,7,1/2,210349,1
6,3,21,350,1,597,1,7,3,3,4,single-choice,spatial-relational,3|4,7,3/4,210350,3
6,3,21,351,1,630,1,13,6,6,7,single-choice,spatial-relational,6|7,7,6/7,210351,6
6,3,21,352,1,486,1,13,6,6,7,single-choice,spatial-relational,6|7,7,6/7,210352,6
6,3,21,353,1,572,1,3,1,1,2,single-choice,spatial-relational,1|2,7,1/2,210353,1
6,3,21,354,1,623,1,11,5,5,6,single-choice,spatial-relational,5|6,7,5/6,210354,5
6,3,21,355,1,615,1,5,2,2,3,single-choice,spatial-relational,2|3,7,2/3,210355,2
6,3,21,356,1,593,1,5,2,2,3,single-choice,spatial-relational,2|3,7,2/3,210356,2
6,3,21,357,1,697,1,9,4,4,5,single-choice,spatial-relational,4|5,7,4/5,210357,4
6,3,21,358,0,662,1,11,5,6,6,single-choice,spatial-relational,5|6,7,5/6,210358,5
6,3,21,359,0,881,1,9,4,5,5,single-choice,spatial-relational,4|5,7,4/5,210359,4
6,3,21,360,1,572,1,7,3,3,4,single-choice,spatial-relational,3|4,7,3/4,210360,3
6,3,21,361,1,615,1,3,1,1,2,single-choice,spatial-relational,1|2,7,1/2,210361,1
6,3,21,362,0,696,1,13,6,7,7,single-choice,spatial-relational,6|7,7,6/7,210362,6
6,3,21,363,1,636,1,9,4,4,5,single-choice,spatial-relational,4|5,7,4/5,210363,4
6,3,21,364,1,539,1,7,3,3,4,single-choice,spatial-relational,3|4,7,3/4,210364,3
6,3,21,365,0,517,1,5,2,3,3,single-choice,spatial-relational,2|3,7,2/3,210365,2
6,3,21,366,1,632,1,11,5,5,6,single-choice,spatial-relational,5|6,7,5/6,210366,5
6,3,21,367,1,669,1,3,1,1,2,single-choice,spatial-relational,1|2,7,1/2,210367,1
6,3,21,368,1,634,1,13,6,6,7,single-choice,spatial-relational,6|7,7,6/7,210368,6
6,3,21,369,1,695,1,11,5,5,6,single-choice,spatial-relational,5|6,7,5/6,210369,5
6,3,21,370,1,611,1,5,2,2,3,single-choice,spatial-relational,2|3,7,2/3,210370,2
6,3,21,371,1,657,1,9,4,4,5,single-choice,spatial-relational,4|5,7,4/5,210371,4
6,3,21,372,1,591,1,7,3,3,4,single-choice,spatial-relational,3|4,7,3/4,210372,3
6,3,21,373,1,625,1,5,2,2,3,single-choice,spatial-relational,2|3,7,2/3,210373,2
6,3,21,374,1,682,1,5,2,2,3,single-choice,spatial-relational,2|3,7,2/3,210374,2
6,3,21,375,1,615,1,7,3,3,4,single-choice,spatial-relational,3|4,7,3/4,210375,3
6,3,21,376,1,565,1,13,6,6,7,single-choice,spatial-relational,6|7,7,6/7,210376,6
6,3,21,377,0,670,1,11,5,6,6,single-choice,spatial-relational,5|6,7,5/6,210377,5
6,3,21,378,1,553,1,3,1,1,2,single-choice,spatial-relational,1|2,7,1/2,210378,1
6,3,21,379,0,661,1,3,1,2,2,single-choice,spatial-relational,1|2,7,1/2,210379,1
6,3,21,380,1,649,1,11,5,5,6,single-choice,spatial-relational,5|6,7,5/6,210380,5
6,3,21,381,1,672,1,9,4,4,5,single-choice,spatial-relational,4|5,7,4/5,210381,4
6,3,21,382,1,632,1,7,3,3,4,single-choice,spatial-relational,3|4,7,3/4,210382,3
6,3,21,383,1,599,1,9,4,4,5,single-choice,spatial-relational,4|5,7,4/5,210383,4
6,3,21,384,1,657,1,13,6,6,7,single-choice,spatial-relational,6|7,7,6/7,210384,6
6,3,21,385,1,783,1,5,2,2,3,single-choice,spatial-relational,2|3,7,2/3,210385,2
6,3,21,386,1,627,1,13,6,6,7,single-choice,spatial-relational,6|7,7,6/7,210386,6
6,3,21,387,1,802,1,7,3,3,4,single-choice,spatial-relational,3|4,7,3/4,210387,3
6,3,21,388,1,564,1,9,4,4,5,single-choice,spatial-relational,4|5,7,4/5,210388,4
6,3,21,389,0,565,1,5,2,3,3,single-choice,spatial-relational,2|3,7,2/3,210389,2
6,3,21,390,1,619,1,13,6,6,7,single-choice,spatial-relational,6|7,7,6/7,210390,6
6,3,21,391,1,678,1,11,5,5,6,single-choice,spatial-relational,5|6,7,5/6,210391,5
6,3,21,392,0,604,1,3,1,2,2,single-choice,spatial-relational,1|2,7,1/2,210392,1
6,3,21,393,0,725,1,9,4,5,5,single-choice,spatial-relational,4|5,7,4/5,210393,4
6,3,21,394,1,609,1,7,3,3,4,single-choice,spatial-relational,3|4,7,3/4,210394,3
6,3,21,395,0,682,1,3,1,2,2,single-choice,spatial-relational,1|2,7,1/2,210395,1
6,3,21,396,1,695,1,11,5,5,6,single-choice,spatial-relational,5|6,7,5/6,210396,5
6,3,21,397,0,529,1,13,6,7,7,single-choice,spatial-relational,6|7,7,6/7,210397,6
6,3,21,398,1,601,1,9,4,4,5,single-choice,spatial-relational,4|5,7,4/5,210398,4
6,3,21,399,1,551,1,3,1,1,2,single-choice,spatial-relational,1|2,7,1/2,210399,1
6,3,21,400,1,648,1,11,5,5,6,single-choice,spatial-relational,5|6,7,5/6,210400,5
6,3,21,401,1,649,1,7,3,3,4,single-choice,spatial-relational,3|4,7,3/4,210401,3
6,3,21,402,1,569,1,5,2,2,3,single-choice,spatial-relational,2|3,7,2/3,210402,2
6,3,21,403,1,523,1,13,6,6,7,single-choice,spatial-relational,6|7,7,6/7,210403,6
6,3,21,404,1,576,1,7,3,3,4,single-choice,spatial-relational,3|4,7,3/4,210404,3
6,3,21,405,0,552,1,5,2,3,3,single-choice,spatial-relational,2|3,7,2/3,210405,2
6,3,21,406,0,587,1,9,4,5,5,single-choice,spatial-relational,4|5,7,4/5,210406,4
6,3,21,407,0,508,1,11,5,6,6,single-choice,spatial-relational,5|6,7,5/6,210407,5
6,3,21,408,1,507,1,3,1,1,2,single-choice,spatial-relational,1|2,7,1/2,210408,1
6,3,21,409,1,525,1,3,1,1,2,single-choice,spatial-relational,1|2,7,1/2,210409,1
6,3,21,410,0,561,1,9,4,5,5,single-choice,spatial-relational,4|5,7,4/5,210410,4
6,3,21,411,0,705,1,13,6,7,7,single-choice,spatial-relational,6|7,7,6/7,210411,6
6,3,21,412,1,555,1,3,1,1,2,single-choice,spatial-relational,1|2,7,1/2,210412,1
6,3,21,413,1,612,1,13,6,6,7,single-choice,spatial-relational,6|7,7,6/7,210413,6
6,3,21,414,1,583,1,5,2,2,3,single-choice,spatial-relational,2|3,7,2/3,210414,2
6,3,21,415,0,615,1,5,2,3,3,single-choice,spatial-relational,2|3,7,2/3,210415,2
6,3,21,416,1,587,1,11,5,5,6,single-choice,spatial-relational,5|6,7,5/6,210416,5
6,3,21,417,1,590,1,9,4,4,5,single-choice,spatial-relational,4|5,7,4/5,210417,4
6,3,21,418,1,552,1,7,3,3,4,single-choice,spatial-relational,3|4,7,3/4,210418,3
6,3,21,419,1,650,1,11,5,5,6,single-choice,spatial-relational,5|6,7,5/6,210419,5
6,3,21,420,1,837,1,7,3,3,4,single-choice,spatial-relational,3|4,7,3/4,210420,3
6,3,21,421,1,615,1,9,4,4,5,single-choice,spatial-relational,4|5,7,4/5,210421,4
6,3,21,422,1,611,1,3,1,1,2,single-choice,spatial-relational,1|2,7,1/2,210422,1
6,3,21,423,1,630,1,11,5,5,6,single-choice,spatial-relational,5|6,7,5/6,210423,5
6,3,21,424,1,1374,1,7,3,3,4,single-choice,spatial-relational,3|4,7,3/4,210424,3
6,3,21,425,1,600,1,11,5,5,6,single-choice,spatial-relational,5|6,7,5/6,210425,5
6,3,21,426,0,593,1,5,2,3,3,single-choice,spatial-relational,2|3,7,2/3,210426,2
6,3,21,427,0,491,1,9,4,5,5,single-choice,spatial-relational,4|5,7,4/5,210427,4
6,3,21,428,0,642,1,3,1,2,2,single-choice,spatial-relational,1|2,7,1/2,210428,1
6,3,21,429,1,635,1,13,6,6,7,single-choice,spatial-relational,6|7,7,6/7,210429,6
6,3,21,430,1,604,1,7,3,3,4,single-choice,spatial-relational,3|4,7,3/4,210430,3
6,3,21,431,1,589,1,13,6,6,7,single-choice,spatial-relational,6|7,7,6/7,210431,6
6,3,21,432,1,576,1,5,2,2,3,single-choice,spatial-relational,2|3,7,2/3,210432,2
6,3,21,433,1,658,1,11,5,5,6,single-choice,spatial-relational,5|6,7,5/6,210433,5
6,3,21,434,1,584,1,9,4,4,5,single-choice,spatial-relational,4|5,7,4/5,210434,4
6,3,21,435,1,591,1,13,6,6,7,single-choice,spatial-relational,6|7,7,6/7,210435,6
6,3,21,436,0,799,1,7,3,4,4,single-choice,spatial-relational,3|4,7,3/4,210436,3
6,3,21,437,1,644,1,3,1,1,2,single-choice,spatial-relational,1|2,7,1/2,210437,1
6,3,21,438,1,583,1,3,1,1,2,single-choice,spatial-relational,1|2,7,1/2,210438,1
6,3,21,439,1,581,1,5,2,2,3,single-choice,spatial-relational,2|3,7,2/3,210439,2
6,3,21,440,1,563,1,7,3,3,4,single-choice,spatial-relational,3|4,7,3/4,210440,3
6,3,21,441,1,682,1,13,6,6,7,single-choice,spatial-relational,6|7,7,6/7,210441,6
6,3,21,442,1,762,1,5,2,2,3,single-choice,spatial-relational,2|3,7,2/3,210442,2
6,3,21,443,1,635,1,11,5,5,6,single-choice,spatial-relational,5|6,7,5/6,210443,5
6,3,21,444,0,662,1,9,4,5,5,single-choice,spatial-relational,4|5,7,4/5,210444,4
6,3,21,445,0,703,1,9,4,5,5,single-choice,spatial-relational,4|5,7,4/5,210445,4
6,3,21,446,1,568,1,7,3,3,4,single-choice,spatial-relational,3|4,7,3/4,210446,3
6,3,21,447,1,589,1,13,6,6,7,single-choice,spatial-relational,6|7,7,6/7,210447,6
6,3,21,448,1,714,1,5,2,2,3,single-choice,spatial-relational,2|3,7,2/3,210448,2
6,3,21,449,0,533,1,3,1,2,2,single-choice,spatial-relational,1|2,7,1/2,210449,1
6,3,21,450,1,689,1,5,2,2,3,single-choice,spatial-relational,2|3,7,2/3,210450,2
6,3,21,451,1,646,1,7,3,3,4,single-choice,spatial-relational,3|4,7,3/4,210451,3
6,3,21,452,1,615,1,9,4,4,5,single-choice,spatial-relational,4|5,7,4/5,210452,4
6,3,21,453,0,525,1,11,5,6,6,single-choice,spatial-relational,5|6,7,5/6,210453,5
6,3,21,454,1,592,1,13,6,6,7,single-choice,spatial-relational,6|7,7,6/7,210454,6
6,3,21,455,0,4949,1,3,1,2,2,single-choice,spatial-relational,1|2,7,1/2,210455,1
6,3,21,456,1,630,1,11,5,5,6,single-choice,spatial-relational,5|6,7,5/6,210456,5
6,3,21,457,0,957,1,5,2,3,3,single-choice,spatial-relational,2|3,7,2/3,210457,2
6,3,21,458,1,650,1,9,4,4,5,single-choice,spatial-relational,4|5,7,4/5,210458,4
6,3,21,459,1,560,1,13,6,6,7,single-choice,spatial-relational,6|7,7,6/7,210459,6
6,3,21,460,0,676,1,11,5,6,6,single-choice,spatial-relational,5|6,7,5/6,210460,5
6,3,21,461,0,928,1,7,3,4,4,single-choice,spatial-relational,3|4,7,3/4,210461,3
6,3,21,462,1,634,1,13,6,6,7,single-choice,spatial-relational,6|7,7,6/7,210462,6
6,3,21,463,1,653,1,5,2,2,3,single-choice,spatial-relational,2|3,7,2/3,210463,2
6,3,21,464,0,786,1,7,3,4,4,single-choice,spatial-relational,3|4,7,3/4,210464,3
6,3,21,465,0,107,1,3,1,2,2,single-choice,spatial-relational,1|2,7,1/2,210465,1
6,3,21,466,0,641,1,3,1,2,2,single-choice,spatial-relational,1|2,7,1/2,210466,1
6,3,21,467,0,475,1,11,5,6,6,single-choice,spatial-relational,5|6,7,5/6,210467,5
6,3,21,468,1,682,1,9,4,4,5,single-choice,spatial-relational,4|5,7,4/5,210468,4
6,3,21,469,1,673,1,11,5,5,6,single-choice,spatial-relational,5|6,7,5/6,210469,5
6,3,21,470,1,621,1,13,6,6,7,single-choice,spatial-relational,6|7,7,6/7,210470,6
6,3,21,471,1,564,1,5,2,2,3,single-choice,spatial-relational,2|3,7,2/3,210471,2
6,3,21,472,1,599,1,5,2,2,3,single-choice,spatial-relational,2|3,7,2/3,210472,2
6,3,21,473,1,634,1,3,1,1,2,single-choice,spatial-relational,1|2,7,1/2,210473,1
6,3,21,474,0,663,1,7,3,4,4,single-choice,spatial-relational,3|4,7,3/4,210474,3
6,3,21,475,0,641,1,3,1,2,2,single-choice,spatial-relational,1|2,7,1/2,210475,1
6,3,21,476,1,646,1,9,4,4,5,single-choice,spatial-relational,4|5,7,4/5,210476,4
6,3,21,477,1,603,1,9,4,4,5,single-choice,spatial-relational,4|5,7,4/5,210477,4
6,3,21,478,1,561,1,7,3,3,4,single-choice,spatial-relational,3|4,7,3/4,210478,3
6,3,21,479,1,597,1,13,6,6,7,single-choice,spatial-relational,6|7,7,6/7,210479,6
6,3,21,480,1,643,1,11,5,5,6,single-choice,spatial-relational,5|6,7,5/6,210480,5
6,3,21,481,1,740,1,11,5,5,6,single-choice,spatial-relational,5|6,7,5/6,210481,5
6,3,21,482,1,572,1,13,6,6,7,single-choice,spatial-relational,6|7,7,6/7,210482,6
6,3,21,483,1,666,1,5,2,2,3,single-choice,spatial-relational,2|3,7,2/3,210483,2
6,3,21,484,1,626,1,7,3,3,4,single-choice,spatial-relational,3|4,7,3/4,210484,3
6,3,21,485,1,701,1,9,4,4,5,single-choice,spatial-relational,4|5,7,4/5,210485,4
6,3,21,486,1,662,1,7,3,3,4,single-choice,spatial-relational,3|4,7,3/4,210486,3
6,3,21,487,1,681,1,5,2,2,3,single-choice,spatial-relational,2|3,7,2/3,210487,2
6,3,21,488,1,685,1,3,1,1,2,single-choice,spatial-relational,1|2,7,1/2,210488,1
6,3,21,489,0,584,1,9,4,5,5,single-choice,spatial-relational,4|5,7,4/5,210489,4
6,3,21,490,1,608,1,11,5,5,6,single-choice,spatial-relational,5|6,7,5/6,210490,5
6,3,21,491,0,619,1,13,6,7,7,single-choice,spatial-relational,6|7,7,6/7,210491,6
6,3,21,492,0,2727,1,3,1,2,2,single-choice,spatial-relational,1|2,7,1/2,210492,1
6,3,21,493,0,589,1,9,4,5,5,single-choice,spatial-relational,4|5,7,4/5,210493,4
6,3,21,494,1,575,1,13,6,6,7,single-choice,spatial-relational,6|7,7,6/7,210494,6
6,3,21,495,1,706,1,9,4,4,5,single-choice,spatial-relational,4|5,7,4/5,210495,4
6,3,21,496,1,685,1,7,3,3,4,single-choice,spatial-relational,3|4,7,3/4,210496,3
6,3,21,497,1,13036,1,3,1,1,2,single-choice,spatial-relational,1|2,7,1/2,210497,1
6,3,21,498,1,576,1,5,2,2,3,single-choice,spatial-relational,2|3,7,2/3,210498,2
6,3,21,499,1,352494,1,7,3,3,4,single-choice,spatial-relational,3|4,7,3/4,210499,3
6,3,21,500,1,655,1,3,1,1,2,single-choice,spatial-relational,1|2,7,1/2,210500,1
6,3,21,501,1,582,1,13,6,6,7,single-choice,spatial-relational,6|7,7,6/7,210501,6
6,3,21,502,0,592,1,11,5,6,6,single-choice,spatial-relational,5|6,7,5/6,210502,5
6,3,21,503,1,677,1,5,2,2,3,single-choice,spatial-relational,2|3,7,2/3,210503,2
6,3,21,504,1,607,1,11,5,5,6,single-choice,spatial-relational,5|6,7,5/6,210504,5
6,3,21,505,1,563,1,3,1,1,2,single-choice,spatial-relational,1|2,7,1/2,210505,1
6,3,21,506,1,611,1,11,5,5,6,single-choice,spatial-relational,5|6,7,5/6,210506,5
6,3,21,507,1,642,1,5,2,2,3,single-choice,spatial-relational,2|3,7,2/3,210507,2
6,3,21,508,0,629,1,3,1,2,2,single-choice,spatial-relational,1|2,7,1/2,210508,1
6,3,21,509,1,709,1,13,6,6,7,single-choice,spatial-relational,6|7,7,6/7,210509,6
6,3,21,510,1,619,1,9,4,4,5,single-choice,spatial-relational,4|5,7,4/5,210510,4
6,3,21,511,0,549,1,13,6,7,7,single-choice,spatial-relational,6|7,7,6/7,210511,6
6,3,21,512,1,608,1,11,5,5,6,single-choice,spatial-relational,5|6,7,5/6,210512,5
6,3,21,513,0,604,1,9,4,5,5,single-choice,spatial-relational,4|5,7,4/5,210513,4
6,3,21,514,1,667,1,5,2,2,3,single-choice,spatial-relational,2|3,7,2/3,210514,2
6,3,21,515,0,771,1,7,3,4,4,single-choice,spatial-relational,3|4,7,3/4,210515,3
6,3,21,516,1,590,1,7,3,3,4,single-choice,spatial-relational,3|4,7,3/4,210516,3
6,3,21,517,0,568,1,9,4,5,5,single-choice,spatial-relational,4|5,7,4/5,210517,4
6,3,21,518,1,586,1,5,2,2,3,single-choice,spatial-relational,2|3,7,2/3,210518,2
6,3,21,519,1,573,1,7,3,3,4,single-choice,spatial-relational,3|4,7,3/4,210519,3
6,3,21,520,1,700,1,3,1,1,2,single-choice,spatial-relational,1|2,7,1/2,210520,1
6,3,21,521,1,557,1,7,3,3,4,single-choice,spatial-relational,3|4,7,3/4,210521,3
6,3,21,522,1,545,1,5,2,2,3,single-choice,spatial-relational,2|3,7,2/3,210522,2
6,3,21,523,1,576,1,11,5,5,6,single-choice,spatial-relational,5|6,7,5/6,210523,5
6,3,21,524,1,602,1,13,6,6,7,single-choice,spatial-relational,6|7,7,6/7,210524,6
6,3,21,525,0,541,1,3,1,2,2,single-choice,spatial-relational,1|2,7,1/2,210525,1
6,3,21,526,1,709,1,11,5,5,6,single-choice,spatial-relational,5|6,7,5/6,210526,5
6,3,21,527,1,541,1,13,6,6,7,single-choice,spatial-relational,6|7,7,6/7,210527,6
6,3,21,528,1,673,1,9,4,4,5,single-choice,spatial-relational,4|5,7,4/5,210528,4
6,3,21,529,1,544,1,13,6,6,7,single-choice,spatial-relational,6|7,7,6/7,210529,6
6,3,21,530,0,607,1,11,5,6,6,single-choice,spatial-relational,5|6,7,5/6,210530,5
6,3,21,531,1,613,1,7,3,3,4,single-choice,spatial-relational,3|4,7,3/4,210531,3
6,3,21,532,1,534,1,9,4,4,5,single-choice,spatial-relational,4|5,7,4/5,210532,4
6,3,21,533,1,516,1,7,3,3,4,single-choice,spatial-relational,3|4,7,3/4,210533,3
6,3,21,534,1,555,1,5,2,2,3,single-choice,spatial-relational,2|3,7,2/3,210534,2
6,3,21,535,1,650,1,3,1,1,2,single-choice,spatial-relational,1|2,7,1/2,210535,1
6,3,21,536,0,523,1,3,1,2,2,single-choice,spatial-relational,1|2,7,1/2,210536,1
6,3,21,537,0,897,1,9,4,5,5,single-choice,spatial-relational,4|5,7,4/5,210537,4
6,3,21,538,0,643,1,5,2,3,3,single-choice,spatial-relational,2|3,7,2/3,210538,2
6,3,21,539,1,904,1,13,6,6,7,single-choice,spatial-relational,6|7,7,6/7,210539,6
6,3,21,540,0,772,1,11,5,6,6,single-choice,spatial-relational,5|6,7,5/6,210540,5
6,3,21,541,0,980,1,5,2,3,3,single-choice,spatial-relational,2|3,7,2/3,210541,2
6,3,21,542,1,671,1,3,1,1,2,single-choice,spatial-relational,1|2,7,1/2,210542,1
6,3,21,543,1,580,1,11,5,5,6,single-choice,spatial-relational,5|6,7,5/6,210543,5
6,3,21,544,0,561,1,9,4,5,5,single-choice,spatial-relational,4|5,7,4/5,210544,4
6,3,21,545,1,646,1,11,5,5,6,single-choice,spatial-relational,5|6,7,5/6,210545,5
6,3,21,546,1,1235,1,13,6,6,7,single-choice,spatial-relational,6|7,7,6/7,210546,6
6,3,21,547,0,728,1,5,2,3,3,single-choice,spatial-relational,2|3,7,2/3,210547,2
6,3,21,548,1,732,1,3,1,1,2,single-choice,spatial-relational,1|2,7,1/2,210548,1
6,3,21,549,1,553,1,9,4,4,5,single-choice,spatial-relational,4|5,7,4/5,210549,4
6,3,21,550,1,626,1,13,6,6,7,single-choice,spatial-relational,6|7,7,6/7,210550,6
6,3,21,551,0,615,1,7,3,4,4,single-choice,spatial-relational,3|4,7,3/4,210551,3
6,3,21,552,1,761,1,7,3,3,4,single-choice,spatial-relational,3|4,7,3/4,210552,3
6,3,21,553,0,615,1,13,6,7,7,single-choice,spatial-relational,6|7,7,6/7,210553,6
6,3,21,554,1,705,1,5,2,2,3,single-choice,spatial-relational,2|3,7,2/3,210554,2
6,3,21,555,1,621,1,3,1,1,2,single-choice,spatial-relational,1|2,7,1/2,210555,1
6,3,21,556,1,609,1,9,4,4,5,single-choice,spatial-relational,4|5,7,4/5,210556,4
6,3,21,557,1,682,1,7,3,3,4,single-choice,spatial-relational,3|4,7,3/4,210557,3
6,3,21,558,1,669,1,5,2,2,3,single-choice,spatial-relational,2|3,7,2/3,210558,2
6,3,21,559,1,705,1,11,5,5,6,single-choice,spatial-relational,5|6,7,5/6,210559,5
6,3,21,560,1,717,1,11,5,5,6,single-choice,spatial-relational,5|6,7,5/6,210560,5
6,3,21,561,1,541,1,13,6,6,7,single-choice,spatial-relational,6|7,7,6/7,210561,6
6,3,21,562,1,553,1,7,3,3,4,single-choice,spatial-relational,3|4,7,3/4,210562,3
6,3,21,563,0,532,1,3,1,2,2,single-choice,spatial-relational,1|2,7,1/2,210563,1
6,3,21,564,1,678,1,9,4,4,5,single-choice,spatial-relational,4|5,7,4/5,210564,4
6,3,21,565,1,654,1,11,5,5,6,single-choice,spatial-relational,5|6,7,5/6,210565,5
6,3,21,566,0,688,1,9,4,5,5,single-choice,spatial-relational,4|5,7,4/5,210566,4
6,3,21,567,0,1201,1,3,1,2,2,single-choice,spatial-relational,1|2,7,1/2,210567,1
6,3,21,568,1,697,1,9,4,4,5,single-choice,spatial-relational,4|5,7,4/5,210568,4
6,3,21,569,0,687,1,13,6,7,7,single-choice,spatial-relational,6|7,7,6/7,210569,6
6,3,21,570,1,675,1,7,3,3,4,single-choice,spatial-relational,3|4,7,3/4,210570,3
6,3,21,571,1,613,1,3,1,1,2,single-choice,spatial-relational,1|2,7,1/2,210571,1
6,3,21,572,1,635,1,7,3,3,4,single-choice,spatial-relational,3|4,7,3/4,210572,3
6,3,21,573,1,501,1,5,2,2,3,single-choice,spatial-relational,2|3,7,2/3,210573,2
6,3,21,574,1,687,1,11,5,5,6,single-choice,spatial-relational,5|6,7,5/6,210574,5
6,3,21,575,0,705,1,13,6,7,7,single-choice,spatial-relational,6|7,7,6/7,210575,6
6,3,21,576,1,536,1,5,2,2,3,single-choice,spatial-relational,2|3,7,2/3,210576,2
6,3,21,577,1,571,1,13,6,6,7,single-choice,spatial-relational,6|7,7,6/7,210577,6
6,3,21,578,1,733,1,11,5,5,6,single-choice,spatial-relational,5|6,7,5/6,210578,5
6,3,21,579,1,792,1,13,6,6,7,single-choice,spatial-relational,6|7,7,6/7,210579,6
6,3,21,580,1,742,1,3,1,1,2,single-choice,spatial-relational,1|2,7,1/2,210580,1
6,3,21,581,1,595,1,5,2,2,3,single-choice,spatial-relational,2|3,7,2/3,210581,2
6,3,21,582,1,616,1,7,3,3,4,single-choice,spatial-relational,3|4,7,3/4,210582,3
6,3,21,583,1,826,1,11,5,5,6,single-choice,spatial-relational,5|6,7,5/6,210583,5
6,3,21,584,0,555,1,5,2,3,3,single-choice,spatial-relational,2|3,7,2/3,210584,2
6,3,21,585,1,597,1,7,3,3,4,single-choice,spatial-relational,3|4,7,3/4,210585,3
6,3,21,586,0,1362,1,3,1,2,2,single-choice,spatial-relational,1|2,7,1/2,210586,1
6,3,21,587,0,689,1,9,4,5,5,single-choice,spatial-relational,4|5,7,4/5,210587,4
6,3,21,588,0,642,1,9,4,5,5,single-choice,spatial-relational,4|5,7,4/5,210588,4
6,3,21,589,0,905,1,3,1,2,2,single-choice,spatial-relational,1|2,7,1/2,210589,1
6,3,21,590,1,738,1,5,2,2,3,single-choice,spatial-relational,2|3,7,2/3,210590,2
6,3,21,591,1,650,1,13,6,6,7,single-choice,spatial-relational,6|7,7,6/7,210591,6
6,3,21,592,1,575,1,7,3,3,4,single-choice,spatial-relational,3|4,7,3/4,210592,3
6,3,21,593,1,611,1,5,2,2,3,single-choice,spatial-relational,2|3,7,2/3,210593,2
6,3,21,594,1,549,1,13,6,6,7,single-choice,spatial-relational,6|7,7,6/7,210594,6
6,3,21,595,0,596,1,9,4,5,5,single-choice,spatial-relational,4|5,7,4/5,210595,4
6,3,21,596,1,636,1,7,3,3,4,single-choice,spatial-relational,3|4,7,3/4,210596,3
6,3,21,597,1,734,1,11,5,5,6,single-choice,spatial-relational,5|6,7,5/6,210597,5
6,3,21,598,1,36,1,3,1,1,2,single-choice,spatial-relational,1|2,7,1/2,210598,1
6,3,21,599,0,682,1,11,5,6,6,single-choice,spatial-relational,5|6,7,5/6,210599,5
6,3,21,600,1,839,1,9,4,4,5,single-choice,spatial-relational,4|5,7,4/5,210600,4
7,3,21,1,0,5484,1,5,2,3,3,single-choice,spatial-relational,2|3,7,2/3,210001,2
7,3,21,2,1,571,1,9,4,4,5,single-choice,spatial-relational,4|5,7,4/5,210002,4
7,3,21,3,0,581,1,7,3,4,4,single-choice,spatial-relational,3|4,7,3/4,210003,3
7,3,21,4,0,478,1,9,4,5,5,single-choice,spatial-relational,4|5,7,4/5,210004,4
7,3,21,5,1,501,1,5,2,2,3,single-choice,spatial-relational,2|3,7,2/3,210005,2
7,3,21,6,1,484,1,3,1,1,2,single-choice,spatial-relational,1|2,7,1/2,210006,1
7,3,21,7,1,1068,1,13,6,6,7,single-choice,spatial-relational,6|7,7,6/7,210007,6
7,3,21,8,0,534,1,3,1,2,2,single-choice,spatial-relational,1|2,7,1/2,210008,1
7,3,21,9,1,627,1,7,3,3,4,single-choice,spatial-relational,3|4,7,3/4,210009,3
7,3,21,10,1,527,1,13,6,6,7,single-choice,spatial-relational,6|7,7,6/7,210010,6
7,3,21,11,0,500,1,11,5,6,6,single-choice,spatial-relational,5|6,7,5/6,210011,5
7,3,21,12,1,795,1,11,5,5,6,single-choice,spatial-relational,5|6,7,5/6,210012,5
7,3,21,13,0,447,1,7,3,4,4,single-choice,spatial-relational,3|4,7,3/4,210013,3
7,3,21,14,0,560,1,13,6,7,7,single-choice,spatial-relational,6|7,7,6/7,210014,6
7,3,21,15,0,493,1,3,1,2,2,single-choice,spatial-relational,1|2,7,1/2,210015,1
7,3,21,16,1,552,1,13,6,6,7,single-choice,spatial-relational,6|7,7,6/7,210016,6
7,3,21,17,1,533,1,7,3,3,4,single-choice,spatial-relational,3|4,7,3/4,210017,3
7,3,21,18,1,541,1,9,4,4,5,single-choice,spatial-relational,4|5,7,4/5,210018,4
7,3,21,19,0,525,1,9,4,5,5,single-choice,spatial-relational,4|5,7,4/5,210019,4
7,3,21,20,0,423,1,5,2,3,3,single-choice,spatial-relational,2|3,7,2/3,210020,2
7,3,21,21,1,1001,1,3,1,1,2,single-choice,spatial-relational,1|2,7,1/2,210021,1
7,3,21,22,0,446,1,11,5,6,6,single-choice,spatial-relational,5|6,7,5/6,210022,5
7,3,21,23,0,40,1,5,2,3,3,single-choice,spatial-relational,2|3,7,2/3,210023,2
7,3,21,24,0,762,1,11,5,6,6,single-choice,spatial-relational,5|6,7,5/6,210024,5
7,3,21,25,0,507,1,7,3,4,4,single-choice,spatial-relational,3|4,7,3/4,210025,3
7,3,21,26,0,529,1,13,6,7,7,single-choice,spatial-relational,6|7,7,6/7,210026,6
7,3,21,27,0,510,1,5,2,3,3,single-choice,spatial-relational,2|3,7,2/3,210027,2
7,3,21,28,1,601,1,9,4,4,5,single-choice,spatial-relational,4|5,7,4/5,210028,4
7,3,21,29,0,762,1,11,5,6,6,single-choice,spatial-relational,5|6,7,5/6,210029,5
7,3,21,30,1,620,1,7,3,3,4,single-choice,spatial-relational,3|4,7,3/4,210030,3
7,3,21,31,0,502,1,11,5,6,6,single-choice,spatial-relational,5|6,7,5/6,210031,5
7,3,21,32,1,610,1,5,2,2,3,single-choice,spatial-relational,2|3,7,2/3,210032,2
7,3,21,33,0,540,1,3,1,2,2,single-choice,spatial-relational,1|2,7,1/2,210033,1
7,3,21,34,1,585,1,3,1,1,2,single-choice,spatial-relational,1|2,7,1/2,210034,1
7,3,21,35,1,572,1,13,6,6,7,single-choice,spatial-relational,6|7,7,6/7,210035,6
7,3,21,36,0,1063,1,9,4,5,5,single-choice,spatial-relational,4|5,7,4/5,210036,4
7,3,21,37,1,523,1,7,3,3,4,single-choice,spatial-relational,3|4,7,3/4,210037,3
7,3,21,38,0,865,1,5,2,3,3,single-choice,spatial-relational,2|3,7,2/3,210038,2
7,3,21,39,1,658,1,13,6,6,7,single-choice,spatial-relational,6|7,7,6/7,210039,6
7,3,21,40,0,751,1,11,5,6,6,single-choice,spatial-relational,5|6,7,5/6,210040,5
7,3,21,41,1,578,1,3,1,1,2,single-choice,spatial-relational,1|2,7,1/2,210041,1
7,3,21,42,0,612,1,11,5,6,6,single-choice,spatial-relational,5|6,7,5/6,210042,5
7,3,21,43,0,683,1,9,4,5,5,single-choice,spatial-relational,4|5,7,4/5,210043,4
7,3,21,44,1,787,1,5,2,2,3,single-choice,spatial-relational,2|3,7,2/3,210044,2
7,3,21,45,1,662,1,9,4,4,5,single-choice,spatial-relational,4|5,7,4/5,210045,4
7,3,21,46,1,873,1,7,3,3,4,single-choice,spatial-relational,3|4,7,3/4,210046,3
7,3,21,47,0,658,1,13,6,7,7,single-choice,spatial-relational,6|7,7,6/7,210047,6
7,3,21,48,0,454,1,3,1,2,2,single-choice,spatial-relational,1|2,7,1/2,210048,1
7,3,21,49,1,586,1,7,3,3,4,single-choice,spatial-relational,3|4,7,3/4,210049,3
7,3,21,50,1,756,1,9,4,4,5,single-choice,spatial-relational,4|5,7,4/5,210050,4
7,3,21,51,1,582,1,9,4,4,5,single-choice,spatial-relational,4|5,7,4/5,210051,4
7,3,21,52,0,577,1,5,2,3,3,single-choice,spatial-relational,2|3,7,2/3,210052,2
7,3,21,53,1,1785,1,13,6,6,7,single-choice,spatial-relational,6|7,7,6/7,210053,6
7,3,21,54,1,682,1,3,1,1,2,single-choice,spatial-relational,1|2,7,1/2,210054,1
7,3,21,55,1,660,1,3,1,1,2,single-choice,spatial-relational,1|2,7,1/2,210055,1
7,3,21,56,0,599,1,13,6,7,7,single-choice,spatial-relational,6|7,7,6/7,210056,6
7,3,21,57,0,860,1,7,3,4,4,single-choice,spatial-relational,3|4,7,3/4,210057,3
7,3,21,58,1,960,1,11,5,5,6,single-choice,spatial-relational,5|6,7,5/6,210058,5
7,3,21,59,1,888,1,5,2,2,3,single-choice,spatial-relational,2|3,7,2/3,210059,2
7,3,21,60,1,636,1,11,5,5,6,single-choice,spatial-relational,5|6,7,5/6,210060,5
7,3,21,61,0,704,1,5,2,3,3,single-choice,spatial-relational,2|3,7,2/3,210061,2
7,3,21,62,1,594,1,9,4,4,5,single-choice,spatial-relational,4|5,7,4/5,210062,4
7,3,21,63,1,690,1,7,3,3,4,single-choice,spatial-relational,3|4,7,3/4,210063,3
7,3,21,64,1,585,1,13,6,6,7,single-choice,spatial-relational,6|7,7,6/7,210064,6
7,3,21,65,0,531,1,11,5,6,6,single-choice,spatial-relational,5|6,7,5/6,210065,5
7,3,21,66,1,643,1,7,3,3,4,single-choice,spatial-relational,3|4,7,3/4,210066,3
7,3,21,67,1,685,1,5,2,2,3,single-choice,spatial-relational,2|3,7,2/3,210067,2
7,3,21,68,1,650,1,3,1,1,2,single-choice,spatial-relational,1|2,7,1/2,210068,1
7,3,21,69,0,513,1,13,6,7,7,single-choice,spatial-relational,6|7,7,6/7,210069,6
7,3,21,70,0,498,1,3,1,2,2,single-choice,spatial-relational,1|2,7,1/2,210070,1
7,3,21,71,0,614,1,9,4,5,5,single-choice,spatial-relational,4|5,7,4/5,210071,4
7,3,21,72,1,635,1,11,5,5,6,single-choice,spatial-relational,5|6,7,5/6,210072,5
7,3,21,73,0,573,1,9,4,5,5,single-choice,spatial-relational,4|5,7,4/5,210073,4
7,3,21,74,1,776,1,13,6,6,7,single-choice,spatial-relational,6|7,7,6/7,210074,6
7,3,21,75,1,696,1,7,3,3,4,single-choice,spatial-relational,3|4,7,3/4,210075,3
7,3,21,76,1,678,1,7,3,3,4,single-choice,spatial-relational,3|4,7,3/4,210076,3
7,3,21,77,1,697,1,5,2,2,3,single-choice,spatial-relational,2|3,7,2/3,210077,2
7,3,21,78,0,556,1,11,5,6,6,single-choice,spatial-relational,5|6,7,5/6,210078,5
7,3,21,79,0,597,1,13,6,7,7,single-choice,spatial-relational,6|7,7,6/7,210079,6
7,3,21,80,0,701,1,5,2,3,3,single-choice,spatial-relational,2|3,7,2/3,210080,2
7,3,21,81,1,564,1,3,1,1,2,single-choice,spatial-relational,1|2,7,1/2,210081,1
7,3,21,82,1,675,1,3,1,1,2,single-choice,spatial-relational,1|2,7,1/2,210082,1
7,3,21,83,1,652,1,9,4,4,5,single-choice,spatial-relational,4|5,7,4/5,210083,4
7,3,21,84,1,683,1,11,5,5,6,single-choice,spatial-relational,5|6,7,5/6,210084,5
7,3,21,85,0,673,1,5,2,3,3,single-choice,spatial-relational,2|3,7,2/3,210085,2
7,3,21,86,1,744,1,5,2,2,3,single-choice,spatial-relational,2|3,7,2/3,210086,2
7,3,21,87,1,670,1,3,1,1,2,single-choice,spatial-relational,1|2,7,1/2,210087,1
7,3,21,88,0,756,1,7,3,4,4,single-choice,spatial-relational,3|4,7,3/4,210088,3
7,3,21,89,1,563,1,11,5,5,6,single-choice,spatial-relational,5|6,7,5/6,210089,5
7,3,21,90,1,686,1,7,3,3,4,single-choice,spatial-relational,3|4,7,3/4,210090,3
7,3,21,91,1,817,1,9,4,4,5,single-choice,spatial-relational,4|5,7,4/5,210091,4
7,3,21,92,1,591,1,9,4,4,5,single-choice,spatial-relational,4|5,7,4/5,210092,4
7,3,21,93,0,595,1,13,6,7,7,single-choice,spatial-relational,6|7,7,6/7,210093,6
7,3,21,94,1,537,1,13,6,6,7,single-choice,spatial-relational,6|7,7,6/7,210094,6
7,3,21,95,0,562,1,11,5,6,6,single-choice,spatial-relational,5|6,7,5/6,210095,5
7,3,21,96,1,605,1,3,1,1,2,single-choice,spatial-relational,1|2,7,1/2,210096,1
7,3,21,97,1,682,1,7,3,3,4,single-choice,spatial-relational,3|4,7,3/4,210097,3
7,3,21,98,1,583,1,5,2,2,3,single-choice,spatial-relational,2|3,7,2/3,210098,2
7,3,21,99,1,537,1,13,6,6,7,single-choice,spatial-relational,6|7,7,6/7,210099,6
7,3,21,100,1,767,1,5,2,2,3,single-choice,spatial-relational,2|3,7,2/3,210100,2
7,3,21,101,1,664,1,3,1,1,2,single-choice,spatial-relational,1|2,7,1/2,210101,1
7,3,21,102,0,673,1,9,4,5,5,single-choice,spatial-relational,4|5,7,4/5,210102,4
7,3,21,103,0,614,1,13,6,7,7,single-choice,spatial-relational,6|7,7,6/7,210103,6
7,3,21,104,1,680,1,3,1,1,2,single-choice,spatial-relational,1|2,7,1/2,210104,1
7,3,21,105,1,584,1,7,3,3,4,single-choice,spatial-relational,3|4,7,3/4,210105,3
7,3,21,106,1,739,1,11,5,5,6,single-choice,spatial-relational,5|6,7,5/6,210106,5
7,3,21,107,1,642,1,11,5,5,6,single-choice,spatial-relational,5|6,7,5/6,210107,5
7,3,21,108,1,729,1,9,4,4,5,single-choice,spatial-relational,4|5,7,4/5,210108,4
7,3,21,109,1,630,1,13,6,6,7,single-choice,spatial-relational,6|7,7,6/7,210109,6
7,3,21,110,1,667,1,5,2,2,3,single-choice,spatial-relational,2|3,7,2/3,210110,2
7,3,21,111,0,623,1,13,6,7,7,single-choice,spatial-relational,6|7,7,6/7,210111,6
7,3,21,112,0,635,1,5,2,3,3,single-choice,spatial-relational,2|3,7,2/3,210112,2
7,3,21,113,0,628,1,3,1,2,2,single-choice,spatial-relational,1|2,7,1/2,210113,1
7,3,21,114,0,694,1,9,4,5,5,single-choice,spatial-relational,4|5,7,4/5,210114,4
7,3,21,115,1,642,1,3,1,1,2,single-choice,spatial-relational,1|2,7,1/2,210115,1
7,3,21,116,1,541,1,11,5,5,6,single-choice,spatial-relational,5|6,7,5/6,210116,5
7,3,21,117,1,728,1,7,3,3,4,single-choice,spatial-relational,3|4,7,3/4,210117,3
7,3,21,118,1,876,1,11,5,5,6,single-choice,spatial-relational,5|6,7,5/6,210118,5
7,3,21,119,0,776,1,7,3,4,4,single-choice,spatial-relational,3|4,7,3/4,210119,3
7,3,21,120,0,1384,1,9,4,5,5,single-choice,spatial-relational,4|5,7,4/5,210120,4
7,3,21,121,0,36,1,3,1,2,2,single-choice,spatial-relational,1|2,7,1/2,210121,1
7,3,21,122,0,884,1,11,5,6,6,single-choice,spatial-relational,5|6,7,5/6,210122,5
7,3,21,123,1,599,1,9,4,4,5,single-choice,spatial-relational,4|5,7,4/5,210123,4
7,3,21,124,0,556,1,13,6,7,7,single-choice,spatial-relational,6|7,7,6/7,210124,6
7,3,21,125,1,530,1,3,1,1,2,single-choice,spatial-relational,1|2,7,1/2,210125,1
7,3,21,126,1,705,1,5,2,2,3,single-choice,spatial-relational,2|3,7,2/3,210126,2
7,3,21,127,1,572,1,5,2,2,3,single-choice,spatial-relational,2|3,7,2/3,210127,2
7,3,21,128,1,690,1,7,3,3,4,single-choice,spatial-relational,3|4,7,3/4,210128,3
7,3,21,129,0,830,1,7,3,4,4,single-choice,spatial-relational,3|4,7,3/4,210129,3
7,3,21,130,0,645,1,9,4,5,5,single-choice,spatial-relational,4|5,7,4/5,210130,4
7,3,21,131,0,725,1,11,5,6,6,single-choice,spatial-relational,5|6,7,5/6,210131,5
7,3,21,132,1,590,1,13,6,6,7,single-choice,spatial-relational,6|7,7,6/7,210132,6
7,3,21,133,1,680,1,5,2,2,3,single-choice,spatial-relational,2|3,7,2/3,210133,2
7,3,21,134,1,675,1,7,3,3,4,single-choice,spatial-relational,3|4,7,3/4,210134,3
7,3,21,135,0,605,1,11,5,6,6,single-choice,spatial-relational,5|6,7,5/6,210135,5
7,3,21,136,1,636,1,11,5,5,6,single-choice,spatial-relational,5|6,7,5/6,210136,5
7,3,21,137,1,548,1,13,6,6,7,single-choice,spatial-relational,6|7,7,6/7,210137,6
7,3,21,138,1,623,1,7,3,3,4,single-choice,spatial-relational,3|4,7,3/4,210138,3
7,3,21,139,0,692,1,9,4,5,5,single-choice,spatial-relational,4|5,7,4/5,210139,4
7,3,21,140,0,751,1,5,2,3,3,single-choice,spatial-relational,2|3,7,2/3,210140,2
7,3,21,141,0,605,1,9,4,5,5,single-choice,spatial-relational,4|5,7,4/5,210141,4
7,3,21,142,1,587,1,3,1,1,2,single-choice,spatial-relational,1|2,7,1/2,210142,1
7,3,21,143,0,652,1,3,1,2,2,single-choice,spatial-relational,1|2,7,1/2,210143,1
7,3,21,144,1,1355,1,13,6,6,7,single-choice,spatial-relational,6|7,7,6/7,210144,6
7,3,21,145,0,533,1,3,1,2,2,single-choice,spatial-relational,1|2,7,1/2,210145,1
7,3,21,146,1,660,1,13,6,6,7,single-choice,spatial-relational,6|7,7,6/7,210146,6
7,3,21,147,1,588,1,7,3,3,4,single-choice,spatial-relational,3|4,7,3/4,210147,3
7,3,21,148,1,712,1,7,3,3,4,single-choice,spatial-relational,3|4,7,3/4,210148,3
7,3,21,149,1,642,1,9,4,4,5,single-choice,spatial-relational,4|5,7,4/5,210149,4
7,3,21,150,1,777,1,5,2,2,3,single-choice,spatial-relational,2|3,7,2/3,210150,2
7,3,21,151,0,841,1,5,2,3,3,single-choice,spatial-relational,2|3,7,2/3,210151,2
7,3,21,152,1,574,1,3,1,1,2,single-choice,spatial-relational,1|2,7,1/2,210152,1
7,3,21,153,1,713,1,13,6,6,7,single-choice,spatial-relational,6|7,7,6/7,210153,6
7,3,21,154,1,881,1,11,5,5,6,single-choice,spatial-relational,5|6,7,5/6,210154,5
7,3,21,155,1,694,1,11,5,5,6,single-choice,spatial-relational,5|6,7,5/6,210155,5
7,3,21,156,1,727,1,9,4,4,5,single-choice,spatial-relational,4|5,7,4/5,210156,4
7,3,21,157,1,1252,1,3,1,1,2,single-choice,spatial-relational,1|2,7,1/2,210157,1
7,3,21,158,1,654,1,3,1,1,2,single-choice,spatial-relational,1|2,7,1/2,210158,1
7,3,21,159,1,552,1,13,6,6,7,single-choice,spatial-relational,6|7,7,6/7,210159,6
7,3,21,160,1,817,1,9,4,4,5,single-choice,spatial-relational,4|5,7,4/5,210160,4
7,3,21,161,0,868,1,11,5,6,6,single-choice,spatial-relational,5|6,7,5/6,210161,5
7,3,21,162,1,604,1,7,3,3,4,single-choice,spatial-relational,3|4,7,3/4,210162,3
7,3,21,163,1,709,1,11,5,5,6,single-choice,spatial-relational,5|6,7,5/6,210163,5
7,3,21,164,1,744,1,9,4,4,5,single-choice,spatial-relational,4|5,7,4/5,210164,4
7,3,21,165,0,739,1,13,6,7,7,single-choice,spatial-relational,6|7,7,6/7,210165,6
7,3,21,166,1,639,1,7,3,3,4,single-choice,spatial-relational,3|4,7,3/4,210166,3
7,3,21,167,1,1227,1,5,2,2,3,single-choice,spatial-relational,2|3,7,2/3,210167,2
7,3,21,168,1,645,1,5,2,2,3,single-choice,spatial-relational,2|3,7,2/3,210168,2
7,3,21,169,1,637,1,7,3,3,4,single-choice,spatial-relational,3|4,7,3/4,210169,3
7,3,21,170,1,604,1,5,2,2,3,single-choice,spatial-relational,2|3,7,2/3,210170,2
7,3,21,171,1,656,1,13,6,6,7,single-choice,spatial-relational,6|7,7,6/7,210171,6
7,3,21,172,1,651,1,3,1,1,2,single-choice,spatial-relational,1|2,7,1/2,210172,1
7,3,21,173,1,662,1,9,4,4,5,single-choice,spatial-relational,4|5,7,4/5,210173,4
7,3,21,174,1,776,1,5,2,2,3,single-choice,spatial-relational,2|3,7,2/3,210174,2
7,3,21,175,0,724,1,9,4,5,5,single-choice,spatial-relational,4|5,7,4/5,210175,4
7,3,21,176,1,647,1,7,3,3,4,single-choice,spatial-relational,3|4,7,3/4,210176,3
7,3,21,177,1,665,1,11,5,5,6,single-choice,spatial-relational,5|6,7,5/6,210177,5
7,3,21,178,0,642,1,13,6,7,7,single-choice,spatial-relational,6|7,7,6/7,210178,6
7,3,21,179,1,596,1,11,5,5,6,single-choice,spatial-relational,5|6,7,5/6,210179,5
7,3,21,180,0,682,1,3,1,2,2,single-choice,spatial-relational,1|2,7,1/2,210180,1
7,3,21,181,1,637,1,9,4,4,5,single-choice,spatial-relational,4|5,7,4/5,210181,4
7,3,21,182,1,530,1,13,6,6,7,single-choice,spatial-relational,6|7,7,6/7,210182,6
7,3,21,183,1,623,1,7,3,3,4,single-choice,spatial-relational,3|4,7,3/4,210183,3
7,3,21,184,0,1147,1,3,1,2,2,single-choice,spatial-relational,1|2,7,1/2,210184,1
7,3,21,185,1,689,1,7,3,3,4,single-choice,spatial-relational,3|4,7,3/4,210185,3
7,3,21,186,1,660,1,5,2,2,3,single-choice,spatial-relational,2|3,7,2/3,210186,2
7,3,21,187,1,677,1,9,4,4,5,single-choice,spatial-relational,4|5,7,4/5,210187,4
7,3,21,188,1,595,1,11,5,5,6,single-choice,spatial-relational,5|6,7,5/6,210188,5
7,3,21,189,0,521,1,11,5,6,6,single-choice,spatial-relational,5|6,7,5/6,210189,5
7,3,21,190,0,650,1,5,2,3,3,single-choice,spatial-relational,2|3,7,2/3,210190,2
7,3,21,191,1,737,1,3,1,1,2,single-choice,spatial-relational,1|2,7,1/2,210191,1
7,3,21,192,0,506,1,13,6,7,7,single-choice,spatial-relational,6|7,7,6/7,210192,6
7,3,21,193,0,510,1,11,5,6,6,single-choice,spatial-relational,5|6,7,5/6,210193,5
7,3,21,194,0,36,1,3,1,2,2,single-choice,spatial-relational,1|2,7,1/2,210194,1
7,3,21,195,1,674,1,7,3,3,4,single-choice,spatial-relational,3|4,7,3/4,210195,3
7,3,21,196,1,779,1,9,4,4,5,single-choice,spatial-relational,4|5,7,4/5,210196,4
7,3,21,197,1,672,1,5,2,2,3,single-choice,spatial-relational,2|3,7,2/3,210197,2
7,3,21,198,1,671,1,5,2,2,3,single-choice,spatial-relational,2|3,7,2/3,210198,2
7,3,21,199,1,697,1,3,1,1,2,single-choice,spatial-relational,1|2,7,1/2,210199,1
7,3,21,200,1,665,1,11,5,5,6,single-choice,spatial-relational,5|6,7,5/6,210200,5
7,3,21,201,1,602,1,13,6,6,7,single-choice,spatial-relational,6|7,7,6/7,210201,6
7,3,21,202,1,1326,1,9,4,4,5,single-choice,spatial-relational,4|5,7,4/5,210202,4
7,3,21,203,0,604,1,13,6,7,7,single-choice,spatial-relational,6|7,7,6/7,210203,6
7,3,21,204,1,664,1,7,3,3,4,single-choice,spatial-relational,3|4,7,3/4,210204,3
7,3,21,205,0,593,1,13,6,7,7,single-choice,spatial-relational,6|7,7,6/7,210205,6
7,3,21,206,1,595,1,11,5,5,6,single-choice,spatial-relational,5|6,7,5/6,210206,5
7,3,21,207,1,631,1,7,3,3,4,single-choice,spatial-relational,3|4,7,3/4,210207,3
7,3,21,208,1,721,1,9,4,4,5,single-choice,spatial-relational,4|5,7,4/5,210208,4
7,3,21,209,0,721,1,3,1,2,2,single-choice,spatial-relational,1|2,7,1/2,210209,1
7,3,21,210,1,776,1,9,4,4,5,single-choice,spatial-relational,4|5,7,4/5,210210,4
7,3,21,211,1,583,1,5,2,2,3,single-choice,spatial-relational,2|3,7,2/3,210211,2
7,3,21,212,0,951,1,11,5,6,6,single-choice,spatial-relational,5|6,7,5/6,210212,5
7,3,21,213,0,1020,1,5,2,3,3,single-choice,spatial-relational,2|3,7,2/3,210213,2
7,3,21,214,1,40,1,13,6,6,7,single-choice,spatial-relational,6|7,7,6/7,210214,6
7,3,21,215,0,705,1,7,3,4,4,single-choice,spatial-relational,3|4,7,3/4,210215,3
7,3,21,216,0,725,1,3,1,2,2,single-choice,spatial-relational,1|2,7,1/2,210216,1
7,3,21,217,0,576,1,13,6,7,7,single-choice,spatial-relational,6|7,7,6/7,210217,6
7,3,21,218,0,482,1,5,2,3,3,single-choice,spatial-relational,2|3,7,2/3,210218,2
7,3,21,219,1,702,1,13,6,6,7,single-choice,spatial-relational,6|7,7,6/7,210219,6
7,3,21,220,1,795,1,9,4,4,5,single-choice,spatial-relational,4|5,7,4/5,210220,4
7,3,21,221,1,792,1,3,1,1,2,single-choice,spatial-relational,1|2,7,1/2,210221,1
7,3,21,222,1,735,1,7,3,3,4,single-choice,spatial-relational,3|4,7,3/4,210222,3
7,3,21,223,1,1277,1,11,5,5,6,single-choice,spatial-relational,5|6,7,5/6,210223,5
7,3,21,224,0,749,1,3,1,2,2,single-choice,spatial-relational,1|2,7,1/2,210224,1
7,3,21,225,1,714,1,11,5,5,6,single-choice,spatial-relational,5|6,7,5/6,210225,5
7,3,21,226,1,763,1,9,4,4,5,single-choice,spatial-relational,4|5,7,4/5,210226,4
7,3,21,227,0,730,1,7,3,4,4,single-choice,spatial-relational,3|4,7,3/4,210227,3
7,3,21,228,0,770,1,5,2,3,3,single-choice,spatial-relational,2|3,7,2/3,210228,2
7,3,21,229,1,657,1,11,5,5,6,single-choice,spatial-relational,5|6,7,5/6,210229,5
7,3,21,230,1,701,1,3,1,1,2,single-choice,spatial-relational,1|2,7,1/2,210230,1
7,3,21,231,1,671,1,5,2,2,3,single-choice,spatial-relational,2|3,7,2/3,210231,2
7,3,21,232,1,627,1,9,4,4,5,single-choice,spatial-relational,4|5,7,4/5,210232,4
7,3,21,233,1,844,1,7,3,3,4,single-choice,spatial-relational,3|4,7,3/4,210233,3
7,3,21,234,1,903,1,13,6,6,7,single-choice,spatial-relational,6|7,7,6/7,210234,6
7,3,21,235,0,675,1,9,4,5,5,single-choice,spatial-relational,4|5,7,4/5,210235,4
7,3,21,236,0,780,1,5,2,3,3,single-choice,spatial-relational,2|3,7,2/3,210236,2
7,3,21,237,0,707,1,3,1,2,2,single-choice,spatial-relational,1|2,7,1/2,210237,1
7,3,21,238,0,1338,1,7,3,4,4,single-choice,spatial-relational,3|4,7,3/4,210238,3
7,3,21,239,1,643,1,13,6,6,7,single-choice,spatial-relational,6|7,7,6/7,210239,6
7,3,21,240,1,1266,1,11,5,5,6,single-choice,spatial-relational,5|6,7,5/6,210240,5
7,3,21,241,1,732,1,13,6,6,7,single-choice,spatial-relational,6|7,7,6/7,210241,6
7,3,21,242,1,648,1,3,1,1,2,single-choice,spatial-relational,1|2,7,1/2,210242,1
7,3,21,243,1,626,1,11,5,5,6,single-choice,spatial-relational,5|6,7,5/6,210243,5
7,3,21,244,1,565,1,13,6,6,7,single-choice,spatial-relational,6|7,7,6/7,210244,6
7,3,21,245,0,673,1,3,1,2,2,single-choice,spatial-relational,1|2,7,1/2,210245,1
7,3,21,246,1,544,1,5,2,2,3,single-choice,spatial-relational,2|3,7,2/3,210246,2
7,3,21,247,1,588,1,7,3,3,4,single-choice,spatial-relational,3|4,7,3/4,210247,3
7,3,21,248,1,654,1,11,5,5,6,single-choice,spatial-relational,5|6,7,5/6,210248,5
7,3,21,249,1,655,1,7,3,3,4,single-choice,spatial-relational,3|4,7,3/4,210249,3
7,3,21,250,0,720,1,9,4,5,5,single-choice,spatial-relational,4|5,7,4/5,210250,4
7,3,21,251,1,1687,1,9,4,4,5,single-choice,spatial-relational,4|5,7,4/5,210251,4
7,3,21,252,0,535,1,5,2,3,3,single-choice,spatial-relational,2|3,7,2/3,210252,2
7,3,21,253,1,663,1,3,1,1,2,single-choice,spatial-relational,1|2,7,1/2,210253,1
7,3,21,254,1,632,1,11,5,5,6,single-choice,spatial-relational,5|6,7,5/6,210254,5
7,3,21,255,0,567,1,9,4,5,5,single-choice,spatial-relational,4|5,7,4/5,210255,4
7,3,21,256,0,657,1,3,1,2,2,single-choice,spatial-relational,1|2,7,1/2,210256,1
7,3,21,257,0,642,1,13,6,7,7,single-choice,spatial-relational,6|7,7,6/7,210257,6
7,3,21,258,1,832,1,13,6,6,7,single-choice,spatial-relational,6|7,7,6/7,210258,6
7,3,21,259,1,693,1,7,3,3,4,single-choice,spatial-relational,3|4,7,3/4,210259,3
7,3,21,260,1,592,1,7,3,3,4,single-choice,spatial-relational,3|4,7,3/4,210260,3
7,3,21,261,1,688,1,11,5,5,6,single-choice,spatial-relational,5|6,7,5/6,210261,5
7,3,21,262,1,615,1,5,2,2,3,single-choice,spatial-relational,2|3,7,2/3,210262,2
7,3,21,263,1,684,1,5,2,2,3,single-choice,spatial-relational,2|3,7,2/3,210263,2
7,3,21,264,0,733,1,9,4,5,5,single-choice,spatial-relational,4|5,7,4/5,210264,4
7,3,21,265,0,613,1,9,4,5,5,single-choice,spatial-relational,4|5,7,4/5,210265,4
7,3,21,266,1,643,1,5,2,2,3,single-choice,spatial-relational,2|3,7,2/3,210266,2
7,3,21,267,1,544,1,7,3,3,4,single-choice,spatial-relational,3|4,7,3/4,210267,3
7,3,21,268,1,610,1,7,3,3,4,single-choice,spatial-relational,3|4,7,3/4,210268,3
7,3,21,269,1,741,1,13,6,6,7,single-choice,spatial-relational,6|7,7,6/7,210269,6
7,3,21,270,0,599,1,11,5,6,6,single-choice,spatial-relational,5|6,7,5/6,210270,5
7,3,21,271,1,629,1,5,2,2,3,single-choice,spatial-relational,2|3,7,2/3,210271,2
7,3,21,272,1,720,1,9,4,4,5,single-choice,spatial-relational,4|5,7,4/5,210272,4
7,3,21,273,1,655,1,3,1,1,2,single-choice,spatial-relational,1|2,7,1/2,210273,1
7,3,21,274,1,660,1,3,1,1,2,single-choice,spatial-relational,1|2,7,1/2,210274,1
7,3,21,275,1,666,1,11,5,5,6,single-choice,spatial-relational,5|6,7,5/6,210275,5
7,3,21,276,1,934,1,13,6,6,7,single-choice,spatial-relational,6|7,7,6/7,210276,6
7,3,21,277,1,623,1,11,5,5,6,single-choice,spatial-relational,5|6,7,5/6,210277,5
7,3,21,278,1,635,1,3,1,1,2,single-choice,spatial-relational,1|2,7,1/2,210278,1
7,3,21,279,1,640,1,7,3,3,4,single-choice,spatial-relational,3|4,7,3/4,210279,3
7,3,21,280,1,613,1,3,1,1,2,single-choice,spatial-relational,1|2,7,1/2,210280,1
7,3,21,281,1,600,1,9,4,4,5,single-choice,spatial-relational,4|5,7,4/5,210281,4
7,3,21,282,1,639,1,5,2,2,3,single-choice,spatial-relational,2|3,7,2/3,210282,2
7,3,21,283,1,802,1,9,4,4,5,single-choice,spatial-relational,4|5,7,4/5,210283,4
7,3,21,284,1,629,1,7,3,3,4,single-choice,spatial-relational,3|4,7,3/4,210284,3
7,3,21,285,1,699,1,11,5,5,6,single-choice,spatial-relational,5|6,7,5/6,210285,5
7,3,21,286,1,732,1,5,2,2,3,single-choice,spatial-relational,2|3,7,2/3,210286,2
7,3,21,287,1,560,1,13,6,6,7,single-choice,spatial-relational,6|7,7,6/7,210287,6
7,3,21,288,0,653,1,13,6,7,7,single-choice,spatial-relational,6|7,7,6/7,210288,6
7,3,21,289,1,737,1,5,2,2,3,single-choice,spatial-relational,2|3,7,2/3,210289,2
7,3,21,290,1,642,1,3,1,1,2,single-choice,spatial-relational,1|2,7,1/2,210290,1
7,3,21,291,1,567,1,7,3,3,4,single-choice,spatial-relational,3|4,7,3/4,210291,3
7,3,21,292,1,731,1,11,5,5,6,single-choice,spatial-relational,5|6,7,5/6,210292,5
7,3,21,293,1,512,1,13,6,6,7,single-choice,spatial-relational,6|7,7,6/7,210293,6
7,3,21,294,1,642,1,11,5,5,6,single-choice,spatial-relational,5|6,7,5/6,210294,5
7,3,21,295,0,658,1,9,4,5,5,single-choice,spatial-relational,4|5,7,4/5,210295,4
7,3,21,296,1,1260,1,5,2,2,3,single-choice,spatial-relational,2|3,7,2/3,210296,2
7,3,21,297,1,658,1,9,4,4,5,single-choice,spatial-relational,4|5,7,4/5,210297,4
7,3,21,298,0,761,1,7,3,4,4,single-choice,spatial-relational,3|4,7,3/4,210298,3
7,3,21,299,1,671,1,3,1,1,2,single-choice,spatial-relational,1|2,7,1/2,210299,1
7,3,21,300,1,649,1,13,6,6,7,single-choice,spatial-relational,6|7,7,6/7,210300,6
7,3,21,301,1,592,1,3,1,1,2,single-choice,spatial-relational,1|2,7,1/2,210301,1
7,3,21,302,0,552,1,13,6,7,7,single-choice,spatial-relational,6|7,7,6/7,210302,6
7,3,21,303,0,542,1,11,5,6,6,single-choice,spatial-relational,5|6,7,5/6,210303,5
7,3,21,304,0,658,1,5,2,3,3,single-choice,spatial-relational,2|3,7,2/3,210304,2
7,3,21,305,1,745,1,11,5,5,6,single-choice,spatial-relational,5|6,7,5/6,210305,5
7,3,21,306,1,655,1,5,2,2,3,single-choice,spatial-relational,2|3,7,2/3,210306,2
7,3,21,307,1,679,1,7,3,3,4,single-choice,spatial-relational,3|4,7,3/4,210307,3
7,3,21,308,1,716,1,9,4,4,5,single-choice,spatial-relational,4|5,7,4/5,210308,4
7,3,21,309,1,580,1,7,3,3,4,single-choice,spatial-relational,3|4,7,3/4,210309,3
7,3,21,310,1,542,1,13,6,6,7,single-choice,spatial-relational,6|7,7,6/7,210310,6
7,3,21,311,1,603,1,3,1,1,2,single-choice,spatial-relational,1|2,7,1/2,210311,1
7,3,21,312,0,638,1,9,4,5,5,single-choice,spatial-relational,4|5,7,4/5,210312,4
7,3,21,313,1,771,1,11,5,5,6,single-choice,spatial-relational,5|6,7,5/6,210313,5
7,3,21,314,1,602,1,7,3,3,4,single-choice,spatial-relational,3|4,7,3/4,210314,3
7,3,21,315,1,785,1,13,6,6,7,single-choice,spatial-relational,6|7,7,6/7,210315,6
7,3,21,316,1,654,1,5,2,2,3,single-choice,spatial-relational,2|3,7,2/3,210316,2
7,3,21,317,1,695,1,11,5,5,6,single-choice,spatial-relational,5|6,7,5/6,210317,5
7,3,21,318,1,692,1,5,2,2,3,single-choice,spatial-relational,2|3,7,2/3,210318,2
7,3,21,319,1,709,1,3,1,1,2,single-choice,spatial-relational,1|2,7,1/2,210319,1
7,3,21,320,1,548,1,13,6,6,7,single-choice,spatial-relational,6|7,7,6/7,210320,6
7,3,21,321,1,712,1,9,4,4,5,single-choice,spatial-relational,4|5,7,4/5,210321,4
7,3,21,322,0,680,1,9,4,5,5,single-choice,spatial-relational,4|5,7,4/5,210322,4
7,3,21,323,1,615,1,7,3,3,4,single-choice,spatial-relational,3|4,7,3/4,210323,3
7,3,21,324,1,736,1,3,1,1,2,single-choice,spatial-relational,1|2,7,1/2,210324,1
7,3,21,325,0,612,1,3,1,2,2,single-choice,spatial-relational,1|2,7,1/2,210325,1
7,3,21,326,1,757,1,13,6,6,7,single-choice,spatial-relational,6|7,7,6/7,210326,6
7,3,21,327,1,663,1,7,3,3,4,single-choice,spatial-relational,3|4,7,3/4,210327,3
7,3,21,328,1,665,1,11,5,5,6,single-choice,spatial-relational,5|6,7,5/6,210328,5
7,3,21,329,1,697,1,9,4,4,5,single-choice,spatial-relational,4|5,7,4/5,210329,4
7,3,21,330,1,651,1,3,1,1,2,single-choice,spatial-relational,1|2,7,1/2,210330,1
7,3,21,331,1,662,1,9,4,4,5,single-choice,spatial-relational,4|5,7,4/5,210331,4
7,3,21,332,0,612,1,13,6,7,7,single-choice,spatial-relational,6|7,7,6/7,210332,6
7,3,21,333,1,668,1,5,2,2,3,single-choice,spatial-relational,2|3,7,2/3,210333,2
7,3,21,334,1,542,1,5,2,2,3,single-choice,spatial-relational,2|3,7,2/3,210334,2
7,3,21,335,1,595,1,7,3,3,4,single-choice,spatial-relational,3|4,7,3/4,210335,3
7,3,21,336,1,646,1,11,5,5,6,single-choice,spatial-relational,5|6,7,5/6,210336,5
7,3,21,337,0,674,1,11,5,6,6,single-choice,spatial-relational,5|6,7,5/6,210337,5
7,3,21,338,1,721,1,11,5,5,6,single-choice,spatial-relational,5|6,7,5/6,210338,5
7,3,21,339,1,644,1,3,1,1,2,single-choice,spatial-relational,1|2,7,1/2,210339,1
7,3,21,340,1,626,1,3,1,1,2,single-choice,spatial-relational,1|2,7,1/2,210340,1
7,3,21,341,1,737,1,9,4,4,5,single-choice,spatial-relational,4|5,7,4/5,210341,4
7,3,21,342,1,598,1,5,2,2,3,single-choice,spatial-relational,2|3,7,2/3,210342,2
7,3,21,343,0,624,1,7,3,4,4,single-choice,spatial-relational,3|4,7,3/4,210343,3
7,3,21,344,1,720,1,13,6,6,7,single-choice,spatial-relational,6|7,7,6/7,210344,6
7,3,21,345,1,525,1,13,6,6,7,single-choice,spatial-relational,6|7,7,6/7,210345,6
7,3,21,346,1,1136,1,7,3,3,4,single-choice,spatial-relational,3|4,7,3/4,210346,3
7,3,21,347,1,760,1,9,4,4,5,single-choice,spatial-relational,4|5,7,4/5,210347,4
7,3,21,348,0,1045,1,5,2,3,3,single-choice,spatial-relational,2|3,7,2/3,210348,2
7,3,21,349,0,1021,1,3,1,2,2,single-choice,spatial-relational,1|2,7,1/2,210349,1
7,3,21,350,1,1041,1,5,2,2,3,single-choice,spatial-relational,2|3,7,2/3,210350,2
7,3,21,351,1,559,1,3,1,1,2,single-choice,spatial-relational,1|2,7,1/2,210351,1
7,3,21,352,0,622,1,9,4,5,5,single-choice,spatial-relational,4|5,7,4/5,210352,4
7,3,21,353,0,714,1,9,4,5,5,single-choice,spatial-relational,4|5,7,4/5,210353,4
7,3,21,354,0,538,1,11,5,6,6,single-choice,spatial-relational,5|6,7,5/6,210354,5
7,3,21,355,1,506,1,13,6,6,7,single-choice,spatial-relational,6|7,7,6/7,210355,6
7,3,21,356,1,696,1,5,2,2,3,single-choice,spatial-relational,2|3,7,2/3,210356,2
7,3,21,357,1,631,1,7,3,3,4,single-choice,spatial-relational,3|4,7,3/4,210357,3
7,3,21,358,1,1170,1,13,6,6,7,single-choice,spatial-relational,6|7,7,6/7,210358,6
7,3,21,359,0,491,1,11,5,6,6,single-choice,spatial-relational,5|6,7,5/6,210359,5
7,3,21,360,1,631,1,7,3,3,4,single-choice,spatial-relational,3|4,7,3/4,210360,3
7,3,21,361,1,974,1,3,1,1,2,single-choice,spatial-relational,1|2,7,1/2,210361,1
7,3,21,362,1,592,1,3,1,1,2,single-choice,spatial-relational,1|2,7,1/2,210362,1
7,3,21,363,1,565,1,7,3,3,4,single-choice,spatial-relational,3|4,7,3/4,210363,3
7,3,21,364,0,522,1,9,4,5,5,single-choice,spatial-relational,4|5,7,4/5,210364,4
7,3,21,365,1,611,1,11,5,5,6,single-choice,spatial-relational,5|6,7,5/6,210365,5
7,3,21,366,1,608,1,5,2,2,3,single-choice,spatial-relational,2|3,7,2/3,210366,2
7,3,21,367,1,641,1,11,5,5,6,single-choice,spatial-relational,5|6,7,5/6,210367,5
7,3,21,368,0,622,1,7,3,4,4,single-choice,spatial-relational,3|4,7,3/4,210368,3
7,3,21,369,1,675,1,13,6,6,7,single-choice,spatial-relational,6|7,7,6/7,210369,6
7,3,21,370,1,647,1,5,2,2,3,single-choice,spatial-relational,2|3,7,2/3,210370,2
7,3,21,371,1,14983,1,9,4,4,5,single-choice,spatial-relational,4|5,7,4/5,210371,4
7,3,21,372,1,560,1,13,6,6,7,single-choice,spatial-relational,6|7,7,6/7,210372,6
7,3,21,373,1,584,1,13,6,6,7,single-choice,spatial-relational,6|7,7,6/7,210373,6
7,3,21,374,0,650,1,5,2,3,3,single-choice,spatial-relational,2|3,7,2/3,210374,2
7,3,21,375,0,599,1,3,1,2,2,single-choice,spatial-relational,1|2,7,1/2,210375,1
7,3,21,376,0,662,1,3,1,2,2,single-choice,spatial-relational,1|2,7,1/2,210376,1
7,3,21,377,1,654,1,7,3,3,4,single-choice,spatial-relational,3|4,7,3/4,210377,3
7,3,21,378,1,631,1,7,3,3,4,single-choice,spatial-relational,3|4,7,3/4,210378,3
7,3,21,379,1,637,1,5,2,2,3,single-choice,spatial-relational,2|3,7,2/3,210379,2
7,3,21,380,1,643,1,9,4,4,5,single-choice,spatial-relational,4|5,7,4/5,210380,4
7,3,21,381,0,611,1,9,4,5,5,single-choice,spatial-relational,4|5,7,4/5,210381,4
7,3,21,382,1,675,1,11,5,5,6,single-choice,spatial-relational,5|6,7,5/6,210382,5
7,3,21,383,0,585,1,13,6,7,7,single-choice,spatial-relational,6|7,7,6/7,210383,6
7,3,21,384,0,508,1,11,5,6,6,single-choice,spatial-relational,5|6,7,5/6,210384,5
7,3,21,385,1,576,1,3,1,1,2,single-choice,spatial-relational,1|2,7,1/2,210385,1
7,3,21,386,1,622,1,5,2,2,3,single-choice,spatial-relational,2|3,7,2/3,210386,2
7,3,21,387,1,707,1,11,5,5,6,single-choice,spatial-relational,5|6,7,5/6,210387,5
7,3,21,388,1,638,1,13,6,6,7,single-choice,spatial-relational,6|7,7,6/7,210388,6
7,3,21,389,1,788,1,11,5,5,6,single-choice,spatial-relational,5|6,7,5/6,210389,5
7,3,21,390,0,758,1,13,6,7,7,single-choice,spatial-relational,6|7,7,6/7,210390,6
7,3,21,391,1,574,1,9,4,4,5,single-choice,spatial-relational,4|5,7,4/5,210391,4
7,3,21,392,1,1072,1,7,3,3,4,single-choice,spatial-relational,3|4,7,3/4,210392,3
7,3,21,393,1,665,1,9,4,4,5,single-choice,spatial-relational,4|5,7,4/5,210393,4
7,3,21,394,1,615,1,3,1,1,2,single-choice,spatial-relational,1|2,7,1/2,210394,1
7,3,21,395,1,591,1,7,3,3,4,single-choice,spatial-relational,3|4,7,3/4,210395,3
7,3,21,396,1,549,1,5,2,2,3,single-choice,spatial-relational,2|3,7,2/3,210396,2
7,3,21,397,1,576,1,7,3,3,4,single-choice,spatial-relational,3|4,7,3/4,210397,3
7,3,21,398,1,1055,1,9,4,4,5,single-choice,spatial-relational,4|5,7,4/5,210398,4
7,3,21,399,0,732,1,5,2,3,3,single-choice,spatial-relational,2|3,7,2/3,210399,2
7,3,21,400,1,601,1,9,4,4,5,single-choice,spatial-relational,4|5,7,4/5,210400,4
7,3,21,401,0,633,1,5,2,3,3,single-choice,spatial-relational,2|3,7,2/3,210401,2
7,3,21,402,0,627,1,11,5,6,6,single-choice,spatial-relational,5|6,7,5/6,210402,5
7,3,21,403,0,685,1,3,1,2,2,single-choice,spatial-relational,1|2,7,1/2,210403,1
7,3,21,404,1,637,1,7,3,3,4,single-choice,spatial-relational,3|4,7,3/4,210404,3
7,3,21,405,0,483,1,11,5,6,6,single-choice,spatial-relational,5|6,7,5/6,210405,5
7,3,21,406,1,611,1,13,6,6,7,single-choice,spatial-relational,6|7,7,6/7,210406,6
7,3,21,407,1,633,1,3,1,1,2,single-choice,spatial-relational,1|2,7,1/2,210407,1
7,3,21,408,1,505,1,13,6,6,7,single-choice,spatial-relational,6|7,7,6/7,210408,6
7,3,21,409,0,4667,1,9,4,5,5,single-choice,spatial-relational,4|5,7,4/5,210409,4
7,3,21,410,1,683,1,9,4,4,5,single-choice,spatial-relational,4|5,7,4/5,210410,4
7,3,21,411,1,1617,1,7,3,3,4,single-choice,spatial-relational,3|4,7,3/4,210411,3
7,3,21,412,1,550,1,3,1,1,2,single-choice,spatial-relational,1|2,7,1/2,210412,1
7,3,21,413,1,585,1,3,1,1,2,single-choice,spatial-relational,1|2,7,1/2,210413,1
7,3,21,414,1,527,1,13,6,6,7,single-choice,spatial-relational,6|7,7,6/7,210414,6
7,3,21,415,1,666,1,11,5,5,6,single-choice,spatial-relational,5|6,7,5/6,210415,5
7,3,21,416,1,1151,1,5,2,2,3,single-choice,spatial-relational,2|3,7,2/3,210416,2
7,3,21,417,0,571,1,5,2,3,3,single-choice,spatial-relational,2|3,7,2/3,210417,2
7,3,21,418,1,642,1,7,3,3,4,single-choice,spatial-relational,3|4,7,3/4,210418,3
7,3,21,419,1,603,1,13,6,6,7,single-choice,spatial-relational,6|7,7,6/7,210419,6
7,3,21,420,0,1229,1,11,5,6,6,single-choice,spatial-relational,5|6,7,5/6,210420,5
7,3,21,421,0,948,1,3,1,2,2,single-choice,spatial-relational,1|2,7,1/2,210421,1
7,3,21,422,0,1170,1,11,5,6,6,single-choice,spatial-relational,5|6,7,5/6,210422,5
7,3,21,423,0,686,1,7,3,4,4,single-choice,spatial-relational,3|4,7,3/4,210423,3
7,3,21,424,0,1455,1,9,4,5,5,single-choice,spatial-relational,4|5,7,4/5,210424,4
7,3,21,425,0,1201,1,5,2,3,3,single-choice,spatial-relational,2|3,7,2/3,210425,2
7,3,21,426,1,747,1,11,5,5,6,single-choice,spatial-relational,5|6,7,5/6,210426,5
7,3,21,427,1,724,1,5,2,2,3,single-choice,spatial-relational,2|3,7,2/3,210427,2
7,3,21,428,1,634,1,13,6,6,7,single-choice,spatial-relational,6|7,7,6/7,210428,6
7,3,21,429,1,587,1,7,3,3,4,single-choice,spatial-relational,3|4,7,3/4,210429,3
7,3,21,430,1,647,1,9,4,4,5,single-choice,spatial-relational,4|5,7,4/5,210430,4
7,3,21,431,0,545,1,13,6,7,7,single-choice,spatial-relational,6|7,7,6/7,210431,6
7,3,21,432,0,627,1,3,1,2,2,single-choice,spatial-relational,1|2,7,1/2,210432,1
7,3,21,433,1,541,1,3,1,1,2,single-choice,spatial-relational,1|2,7,1/2,210433,1
7,3,21,434,1,625,1,11,5,5,6,single-choice,spatial-relational,5|6,7,5/6,210434,5
7,3,21,435,1,579,1,11,5,5,6,single-choice,spatial-relational,5|6,7,5/6,210435,5
7,3,21,436,0,664,1,13,6,7,7,single-choice,spatial-relational,6|7,7,6/7,210436,6
7,3,21,437,1,622,1,5,2,2,3,single-choice,spatial-relational,2|3,7,2/3,210437,2
7,3,21,438,1,477,1,13,6,6,7,single-choice,spatial-relational,6|7,7,6/7,210438,6
7,3,21,439,0,651,1,7,3,4,4,single-choice,spatial-relational,3|4,7,3/4,210439,3
7,3,21,440,1,563,1,7,3,3,4,single-choice,spatial-relational,3|4,7,3/4,210440,3
7,3,21,441,1,629,1,9,4,4,5,single-choice,spatial-relational,4|5,7,4/5,210441,4
7,3,21,442,1,564,1,5,2,2,3,single-choice,spatial-relational,2|3,7,2/3,210442,2
7,3,21,443,1,755,1,9,4,4,5,single-choice,spatial-relational,4|5,7,4/5,210443,4
7,3,21,444,1,565,1,3,1,1,2,single-choice,spatial-relational,1|2,7,1/2,210444,1
7,3,21,445,1,615,1,9,4,4,5,single-choice,spatial-relational,4|5,7,4/5,210445,4
7,3,21,446,1,570,1,7,3,3,4,single-choice,spatial-relational,3|4,7,3/4,210446,3
7,3,21,447,1,543,1,7,3,3,4,single-choice,spatial-relational,3|4,7,3/4,210447,3
7,3,21,448,1,560,1,5,2,2,3,single-choice,spatial-relational,2|3,7,2/3,210448,2
7,3,21,449,1,495,1,13,6,6,7,single-choice,spatial-relational,6|7,7,6/7,210449,6
7,3,21,450,0,615,1,9,4,5,5,single-choice,spatial-relational,4|5,7,4/5,210450,4
7,3,21,451,1,633,1,5,2,2,3,single-choice,spatial-relational,2|3,7,2/3,210451,2
7,3,21,452,1,595,1,3,1,1,2,single-choice,spatial-relational,1|2,7,1/2,210452,1
7,3,21,453,1,1013,1,3,1,1,2,single-choice,spatial-relational,1|2,7,1/2,210453,1
7,3,21,454,1,602,1,11,5,5,6,single-choice,spatial-relational,5|6,7,5/6,210454,5
7,3,21,455,1,674,1,13,6,6,7,single-choice,spatial-relational,6|7,7,6/7,210455,6
7,3,21,456,1,552,1,11,5,5,6,single-choice,spatial-relational,5|6,7,5/6,210456,5
7,3,21,457,0,1308,1,7,3,4,4,single-choice,spatial-relational,3|4,7,3/4,210457,3
7,3,21,458,0,488,1,5,2,3,3,single-choice,spatial-relational,2|3,7,2/3,210458,2
7,3,21,459,0,581,1,5,2,3,3,single-choice,spatial-relational,2|3,7,2/3,210459,2
7,3,21,460,1,1171,1,11,5,5,6,single-choice,spatial-relational,5|6,7,5/6,210460,5
7,3,21,461,1,555,1,7,3,3,4,single-choice,spatial-relational,3|4,7,3/4,210461,3
7,3,21,462,1,661,1,9,4,4,5,single-choice,spatial-relational,4|5,7,4/5,210462,4
7,3,21,463,1,641,1,11,5,5,6,single-choice,spatial-relational,5|6,7,5/6,210463,5
7,3,21,464,0,615,1,13,6,7,7,single-choice,spatial-relational,6|7,7,6/7,210464,6
7,3,21,465,0,555,1,3,1,2,2,single-choice,spatial-relational,1|2,7,1/2,210465,1
7,3,21,466,1,647,1,9,4,4,5,single-choice,spatial-relational,4|5,7,4/5,210466,4
7,3,21,467,1,588,1,3,1,1,2,single-choice,spatial-relational,1|2,7,1/2,210467,1
7,3,21,468,1,502,1,13,6,6,7,single-choice,spatial-relational,6|7,7,6/7,210468,6
7,3,21,469,1,582,1,5,2,2,3,single-choice,spatial-relational,2|3,7,2/3,210469,2
7,3,21,470,1,564,1,7,3,3,4,single-choice,spatial-relational,3|4,7,3/4,210470,3
7,3,21,471,1,615,1,11,5,5,6,single-choice,spatial-relational,5|6,7,5/6,210471,5
7,3,21,472,1,595,1,7,3,3,4,single-choice,spatial-relational,3|4,7,3/4,210472,3
7,3,21,473,0,570,1,9,4,5,5,single-choice,spatial-relational,4|5,7,4/5,210473,4
7,3,21,474,1,541,1,13,6,6,7,single-choice,spatial-relational,6|7,7,6/7,210474,6
7,3,21,475,1,642,1,9,4,4,5,single-choice,spatial-relational,4|5,7,4/5,210475,4
7,3,21,476,1,603,1,13,6,6,7,single-choice,spatial-relational,6|7,7,6/7,210476,6
7,3,21,477,0,573,1,5,2,3,3,single-choice,spatial-relational,2|3,7,2/3,210477,2
7,3,21,478,1,1005,1,3,1,1,2,single-choice,spatial-relational,1|2,7,1/2,210478,1
7,3,21,479,1,517,1,3,1,1,2,single-choice,spatial-relational,1|2,7,1/2,210479,1
7,3,21,480,1,541,1,11,5,5,6,single-choice,spatial-relational,5|6,7,5/6,210480,5
7,3,21,481,1,605,1,11,5,5,6,single-choice,spatial-relational,5|6,7,5/6,210481,5
7,3,21,482,0,554,1,13,6,7,7,single-choice,spatial-relational,6|7,7,6/7,210482,6
7,3,21,483,1,554,1,7,3,3,4,single-choice,spatial-relational,3|4,7,3/4,210483,3
7,3,21,484,0,691,1,7,3,4,4,single-choice,spatial-relational,3|4,7,3/4,210484,3
7,3,21,485,1,683,1,13,6,6,7,single-choice,spatial-relational,6|7,7,6/7,210485,6
7,3,21,486,1,603,1,5,2,2,3,single-choice,spatial-relational,2|3,7,2/3,210486,2
7,3,21,487,1,634,1,9,4,4,5,single-choice,spatial-relational,4|5,7,4/5,210487,4
7,3,21,488,1,577,1,3,1,1,2,single-choice,spatial-relational,1|2,7,1/2,210488,1
7,3,21,489,0,575,1,9,4,5,5,single-choice,spatial-relational,4|5,7,4/5,210489,4
7,3,21,490,1,642,1,11,5,5,6,single-choice,spatial-relational,5|6,7,5/6,210490,5
7,3,21,491,1,626,1,3,1,1,2,single-choice,spatial-relational,1|2,7,1/2,210491,1
7,3,21,492,1,625,1,5,2,2,3,single-choice,spatial-relational,2|3,7,2/3,210492,2
7,3,21,493,1,625,1,5,2,2,3,single-choice,spatial-relational,2|3,7,2/3,210493,2
7,3,21,494,1,673,1,9,4,4,5,single-choice,spatial-relational,4|5,7,4/5,210494,4
7,3,21,495,1,572,1,11,5,5,6,single-choice,spatial-relational,5|6,7,5/6,210495,5
7,3,21,496,1,587,1,3,1,1,2,single-choice,spatial-relational,1|2,7,1/2,210496,1
7,3,21,497,1,630,1,13,6,6,7,single-choice,spatial-relational,6|7,7,6/7,210497,6
7,3,21,498,1,628,1,11,5,5,6,single-choice,spatial-relational,5|6,7,5/6,210498,5
7,3,21,499,1,572,1,7,3,3,4,single-choice,spatial-relational,3|4,7,3/4,210499,3
7,3,21,500,1,522,1,13,6,6,7,single-choice,spatial-relational,6|7,7,6/7,210500,6
7,3,21,501,0,576,1,9,4,5,5,single-choice,spatial-relational,4|5,7,4/5,210501,4
7,3,21,502,1,612,1,7,3,3,4,single-choice,spatial-relational,3|4,7,3/4,210502,3
7,3,21,503,1,670,1,5,2,2,3,single-choice,spatial-relational,2|3,7,2/3,210503,2
7,3,21,504,1,577,1,3,1,1,2,single-choice,spatial-relational,1|2,7,1/2,210504,1
7,3,21,505,0,721,1,13,6,7,7,single-choice,spatial-relational,6|7,7,6/7,210505,6
7,3,21,506,1,791,1,9,4,4,5,single-choice,spatial-relational,4|5,7,4/5,210506,4
7,3,21,507,1,562,1,3,1,1,2,single-choice,spatial-relational,1|2,7,1/2,210507,1
7,3,21,508,1,701,1,11,5,5,6,single-choice,spatial-relational,5|6,7,5/6,210508,5
7,3,21,509,1,559,1,13,6,6,7,single-choice,spatial-relational,6|7,7,6/7,210509,6
7,3,21,510,1,1385,1,5,2,2,3,single-choice,spatial-relational,2|3,7,2/3,210510,2
7,3,21,511,1,703,1,9,4,4,5,single-choice,spatial-relational,4|5,7,4/5,210511,4
7,3,21,512,0,565,1,5,2,3,3,single-choice,spatial-relational,2|3,7,2/3,210512,2
7,3,21,513,1,667,1,11,5,5,6,single-choice,spatial-relational,5|6,7,5/6,210513,5
7,3,21,514,1,548,1,7,3,3,4,single-choice,spatial-relational,3|4,7,3/4,210514,3
7,3,21,515,1,593,1,7,3,3,4,single-choice,spatial-relational,3|4,7,3/4,210515,3
7,3,21,516,1,549,1,3,1,1,2,single-choice,spatial-relational,1|2,7,1/2,210516,1
7,3,21,517,1,576,1,11,5,5,6,single-choice,spatial-relational,5|6,7,5/6,210517,5
7,3,21,518,1,543,1,7,3,3,4,single-choice,spatial-relational,3|4,7,3/4,210518,3
7,3,21,519,1,706,1,3,1,1,2,single-choice,spatial-relational,1|2,7,1/2,210519,1
7,3,21,520,1,544,1,5,2,2,3,single-choice,spatial-relational,2|3,7,2/3,210520,2
7,3,21,521,1,540,1,5,2,2,3,single-choice,spatial-relational,2|3,7,2/3,210521,2
7,3,21,522,1,605,1,9,4,4,5,single-choice,spatial-relational,4|5,7,4/5,210522,4
7,3,21,523,1,514,1,13,6,6,7,single-choice,spatial-relational,6|7,7,6/7,210523,6
7,3,21,524,1,547,1,3,1,1,2,single-choice,spatial-relational,1|2,7,1/2,210524,1
7,3,21,525,1,627,1,9,4,4,5,single-choice,spatial-relational,4|5,7,4/5,210525,4
7,3,21,526,1,599,1,11,5,5,6,single-choice,spatial-relational,5|6,7,5/6,210526,5
7,3,21,527,1,1186,1,13,6,6,7,single-choice,spatial-relational,6|7,7,6/7,210527,6
7,3,21,528,0,1858,1,7,3,4,4,single-choice,spatial-relational,3|4,7,3/4,210528,3
7,3,21,529,0,1189,1,11,5,6,6,single-choice,spatial-relational,5|6,7,5/6,210529,5
7,3,21,530,1,583,1,3,1,1,2,single-choice,spatial-relational,1|2,7,1/2,210530,1
7,3,21,531,1,680,1,11,5,5,6,single-choice,spatial-relational,5|6,7,5/6,210531,5
7,3,21,532,1,582,1,3,1,1,2,single-choice,spatial-relational,1|2,7,1/2,210532,1
7,3,21,533,0,668,1,13,6,7,7,single-choice,spatial-relational,6|7,7,6/7,210533,6
7,3,21,534,0,637,1,9,4,5,5,single-choice,spatial-relational,4|5,7,4/5,210534,4
7,3,21,535,1,668,1,7,3,3,4,single-choice,spatial-relational,3|4,7,3/4,210535,3
7,3,21,536,1,587,1,7,3,3,4,single-choice,spatial-relational,3|4,7,3/4,210536,3
7,3,21,537,1,631,1,9,4,4,5,single-choice,spatial-relational,4|5,7,4/5,210537,4
7,3,21,538,1,588,1,5,2,2,3,single-choice,spatial-relational,2|3,7,2/3,210538,2
7,3,21,539,1,588,1,5,2,2,3,single-choice,spatial-relational,2|3,7,2/3,210539,2
7,3,21,540,1,666,1,13,6,6,7,single-choice,spatial-relational,6|7,7,6/7,210540,6
7,3,21,541,1,576,1,3,1,1,2,single-choice,spatial-relational,1|2,7,1/2,210541,1
7,3,21,542,1,565,1,7,3,3,4,single-choice,spatial-relational,3|4,7,3/4,210542,3
7,3,21,543,1,546,1,5,2,2,3,single-choice,spatial-relational,2|3,7,2/3,210543,2
7,3,21,544,1,520,1,13,6,6,7,single-choice,spatial-relational,6|7,7,6/7,210544,6
7,3,21,545,1,651,1,5,2,2,3,single-choice,spatial-relational,2|3,7,2/3,210545,2
7,3,21,546,0,720,1,7,3,4,4,single-choice,spatial-relational,3|4,7,3/4,210546,3
7,3,21,547,0,585,1,9,4,5,5,single-choice,spatial-relational,4|5,7,4/5,210547,4
7,3,21,548,1,1190,1,11,5,5,6,single-choice,spatial-relational,5|6,7,5/6,210548,5
7,3,21,549,0,670,1,13,6,7,7,single-choice,spatial-relational,6|7,7,6/7,210549,6
7,3,21,550,1,576,1,3,1,1,2,single-choice,spatial-relational,1|2,7,1/2,210550,1
7,3,21,551,1,616,1,11,5,5,6,single-choice,spatial-relational,5|6,7,5/6,210551,5
7,3,21,552,1,7206,1,9,4,4,5,single-choice,spatial-relational,4|5,7,4/5,210552,4
7,3,21,553,1,603,1,7,3,3,4,single-choice,spatial-relational,3|4,7,3/4,210553,3
7,3,21,554,0,798,1,11,5,6,6,single-choice,spatial-relational,5|6,7,5/6,210554,5
7,3,21,555,0,36,1,3,1,2,2,single-choice,spatial-relational,1|2,7,1/2,210555,1
7,3,21,556,1,682,1,13,6,6,7,single-choice,spatial-relational,6|7,7,6/7,210556,6
7,3,21,557,0,738,1,5,2,3,3,single-choice,spatial-relational,2|3,7,2/3,210557,2
7,3,21,558,1,647,1,5,2,2,3,single-choice,spatial-relational,2|3,7,2/3,210558,2
7,3,21,559,0,594,1,13,6,7,7,single-choice,spatial-relational,6|7,7,6/7,210559,6
7,3,21,560,0,710,1,9,4,5,5,single-choice,spatial-relational,4|5,7,4/5,210560,4
7,3,21,561,1,623,1,3,1,1,2,single-choice,spatial-relational,1|2,7,1/2,210561,1
7,3,21,562,1,567,1,11,5,5,6,single-choice,spatial-relational,5|6,7,5/6,210562,5
7,3,21,563,1,744,1,9,4,4,5,single-choice,spatial-relational,4|5,7,4/5,210563,4
7,3,21,564,1,586,1,7,3,3,4,single-choice,spatial-relational,3|4,7,3/4,210564,3
7,3,21,565,1,580,1,3,1,1,2,single-choice,spatial-relational,1|2,7,1/2,210565,1
7,3,21,566,1,555,1,7,3,3,4,single-choice,spatial-relational,3|4,7,3/4,210566,3
7,3,21,567,1,681,1,5,2,2,3,single-choice,spatial-relational,2|3,7,2/3,210567,2
7,3,21,568,0,587,1,3,1,2,2,single-choice,spatial-relational,1|2,7,1/2,210568,1
7,3,21,569,0,963,1,9,4,5,5,single-choice,spatial-relational,4|5,7,4/5,210569,4
7,3,21,570,0,673,1,9,4,5,5,single-choice,spatial-relational,4|5,7,4/5,210570,4
7,3,21,571,0,839,1,5,2,3,3,single-choice,spatial-relational,2|3,7,2/3,210571,2
7,3,21,572,1,560,1,13,6,6,7,single-choice,spatial-relational,6|7,7,6/7,210572,6
7,3,21,573,0,659,1,7,3,4,4,single-choice,spatial-relational,3|4,7,3/4,210573,3
7,3,21,574,1,1378,1,13,6,6,7,single-choice,spatial-relational,6|7,7,6/7,210574,6
7,3,21,575,1,662,1,11,5,5,6,single-choice,spatial-relational,5|6,7,5/6,210575,5
7,3,21,576,1,631,1,11,5,5,6,single-choice,spatial-relational,5|6,7,5/6,210576,5
7,3,21,577,1,681,1,9,4,4,5,single-choice,spatial-relational,4|5,7,4/5,210577,4
7,3,21,578,1,607,1,7,3,3,4,single-choice,spatial-relational,3|4,7,3/4,210578,3
7,3,21,579,1,584,1,3,1,1,2,single-choice,spatial-relational,1|2,7,1/2,210579,1
7,3,21,580,1,701,1,11,5,5,6,single-choice,spatial-relational,5|6,7,5/6,210580,5
7,3,21,581,1,611,1,13,6,6,7,single-choice,spatial-relational,6|7,7,6/7,210581,6
7,3,21,582,1,634,1,5,2,2,3,single-choice,spatial-relational,2|3,7,2/3,210582,2
7,3,21,583,1,654,1,9,4,4,5,single-choice,spatial-relational,4|5,7,4/5,210583,4
7,3,21,584,1,701,1,3,1,1,2,single-choice,spatial-relational,1|2,7,1/2,210584,1
7,3,21,585,1,584,1,11,5,5,6,single-choice,spatial-relational,5|6,7,5/6,210585,5
7,3,21,586,1,610,1,13,6,6,7,single-choice,spatial-relational,6|7,7,6/7,210586,6
7,3,21,587,0,673,1,7,3,4,4,single-choice,spatial-relational,3|4,7,3/4,210587,3
7,3,21,588,1,622,1,5,2,2,3,single-choice,spatial-relational,2|3,7,2/3,210588,2
7,3,21,589,1,552,1,7,3,3,4,single-choice,spatial-relational,3|4,7,3/4,210589,3
7,3,21,590,1,780,1,5,2,2,3,single-choice,spatial-relational,2|3,7,2/3,210590,2
7,3,21,591,1,569,1,7,3,3,4,single-choice,spatial-relational,3|4,7,3/4,210591,3
7,3,21,592,1,568,1,13,6,6,7,single-choice,spatial-relational,6|7,7,6/7,210592,6
7,3,21,593,0,563,1,5,2,3,3,single-choice,spatial-relational,2|3,7,2/3,210593,2
7,3,21,594,0,528,1,11,5,6,6,single-choice,spatial-relational,5|6,7,5/6,210594,5
7,3,21,595,1,704,1,9,4,4,5,single-choice,spatial-relational,4|5,7,4/5,210595,4
7,3,21,596,1,621,1,3,1,1,2,single-choice,spatial-relational,1|2,7,1/2,210596,1
7,3,21,597,1,635,1,9,4,4,5,single-choice,spatial-relational,4|5,7,4/5,210597,4
7,3,21,598,1,551,1,3,1,1,2,single-choice,spatial-relational,1|2,7,1/2,210598,1
7,3,21,599,1,757,1,13,6,6,7,single-choice,spatial-relational,6|7,7,6/7,210599,6
7,3,21,600,1,603,1,11,5,5,6,single-choice,spatial-relational,5|6,7,5/6,210600,5
1,3,22,1,0,1154,2,12,5,7,7,single-choice,spatial-relational,5|7,7,5/7,220001,5
1,3,22,2,0,650,3,11,4,7,7,single-choice,spatial-relational,4|7,7,4/7,220002,4
1,3,22,3,1,696,1,13,6,6,7,single-choice,spatial-relational,6|7,7,6/7,220003,6
1,3,22,4,0,632,5,7,1,6,6,single-choice,spatial-relational,1|6,7,1/6,220004,1
1,3,22,5,0,1022,6,8,1,7,7,single-choice,spatial-relational,1|7,7,1/7,220005,1
1,3,22,6,0,576,5,9,2,7,7,single-choice,spatial-relational,2|7,7,2/7,220006,2
1,3,22,7,1,553,4,8,2,2,6,single-choice,spatial-relational,2|6,7,2/6,220007,2
1,3,22,8,1,1207,1,9,4,4,5,single-choice,spatial-relational,4|5,7,4/5,220008,4
1,3,22,9,1,576,1,11,5,5,6,single-choice,spatial-relational,5|6,7,5/6,220009,5
1,3,22,10,1,557,4,6,1,1,5,single-choice,spatial-relational,1|5,7,1/5,220010,1
1,3,22,11,1,461,1,13,6,6,7,single-choice,spatial-relational,6|7,7,6/7,220011,6
1,3,22,12,1,724,1,7,3,3,4,single-choice,spatial-relational,3|4,7,3/4,220012,3
1,3,22,13,0,607,2,8,3,5,5,single-choice,spatial-relational,3|5,7,3/5,220013,3
1,3,22,14,1,523,3,7,2,2,5,single-choice,spatial-relational,2|5,7,2/5,220014,2
1,3,22,15,0,471,6,8,1,7,7,single-choice,spatial-relational,1|7,7,1/7,220015,1
1,3,22,16,0,487,3,7,2,5,5,single-choice,spatial-relational,2|5,7,2/5,220016,2
1,3,22,17,0,447,4,8,2,6,6,single-choice,spatial-relational,2|6,7,2/6,220017,2
1,3,22,18,0,553,2,6,2,4,4,single-choice,spatial-relational,2|4,7,2/4,220018,2
1,3,22,19,0,585,1,3,1,2,2,single-choice,spatial-relational,1|2,7,1/2,220019,1
1,3,22,20,0,804,2,10,4,6,6,single-choice,spatial-relational,4|6,7,4/6,220020,4
1,3,22,21,1,771,2,4,1,1,3,single-choice,spatial-relational,1|3,7,1/3,220021,1
1,3,22,22,1,621,3,9,3,3,6,single-choice,spatial-relational,3|6,7,3/6,220022,3
1,3,22,23,1,712,1,5,2,2,3,single-choice,spatial-relational,2|3,7,2/3,220023,2
1,3,22,24,1,702,2,4,1,1,3,single-choice,spatial-relational,1|3,7,1/3,220024,1
1,3,22,25,1,621,5,9,2,2,7,single-choice,spatial-relational,2|7,7,2/7,220025,2
1,3,22,26,1,1275,3,9,3,3,6,single-choice,spatial-relational,3|6,7,3/6,220026,3
1,3,22,27,1,686,4,6,1,1,5,single-choice,spatial-relational,1|5,7,1/5,220027,1
1,3,22,28,1,869,3,11,4,4,7,single-choice,spatial-relational,4|7,7,4/7,220028,4
1,3,22,29,1,683,4,10,3,3,7,single-choice,spatial-relational,3|7,7,3/7,220029,3
1,3,22,30,1,1359,4,10,3,3,7,single-choice,spatial-relational,3|7,7,3/7,220030,3
1,3,22,31,1,654,2,8,3,3,5,single-choice,spatial-relational,3|5,7,3/5,220031,3
1,3,22,32,1,765,5,7,1,1,6,single-choice,spatial-relational,1|6,7,1/6,220032,1
1,3,22,33,0,611,1,5,2,3,3,single-choice,spatial-relational,2|3,7,2/3,220033,2
1,3,22,34,0,685,2,12,5,7,7,single-choice,spatial-relational,5|7,7,5/7,220034,5
1,3,22,35,1,654,1,9,4,4,5,single-choice,spatial-relational,4|5,7,4/5,220035,4
1,3,22,36,1,624,1,3,1,1,2,single-choice,spatial-relational,1|2,7,1/2,220036,1
1,3,22,37,1,610,2,6,2,2,4,single-choice,spatial-relational,2|4,7,2/4,220037,2
1,3,22,38,1,649,1,11,5,5,6,single-choice,spatial-relational,5|6,7,5/6,220038,5
1,3,22,39,1,837,1,7,3,3,4,single-choice,spatial-relational,3|4,7,3/4,220039,3
1,3,22,40,1,1254,2,10,4,4,6,single-choice,spatial-relational,4|6,7,4/6,220040,4
1,3,22,41,0,1789,3,5,1,4,4,single-choice,spatial-relational,1|4,7,1/4,220041,1
1,3,22,42,1,532,3,5,1,1,4,single-choice,spatial-relational,1|4,7,1/4,220042,1
1,3,22,43,1,1222,2,10,4,4,6,single-choice,spatial-relational,4|6,7,4/6,220043,4
1,3,22,44,1,623,6,8,1,1,7,single-choice,spatial-relational,1|7,7,1/7,220044,1
1,3,22,45,1,656,5,9,2,2,7,single-choice,spatial-relational,2|7,7,2/7,220045,2
1,3,22,46,1,564,5,9,2,2,7,single-choice,spatial-relational,2|7,7,2/7,220046,2
1,3,22,47,0,791,3,9,3,6,6,single-choice,spatial-relational,3|6,7,3/6,220047,3
1,3,22,48,1,614,1,3,1,1,2,single-choice,spatial-relational,1|2,7,1/2,220048,1
1,3,22,49,1,604,6,8,1,1,7,single-choice,spatial-relational,1|7,7,1/7,220049,1
1,3,22,50,1,534,4,10,3,3,7,single-choice,spatial-relational,3|7,7,3/7,220050,3
1,3,22,51,1,613,2,6,2,2,4,single-choice,spatial-relational,2|4,7,2/4,220051,2
1,3,22,52,1,592,4,8,2,2,6,single-choice,spatial-relational,2|6,7,2/6,220052,2
1,3,22,53,1,627,1,7,3,3,4,single-choice,spatial-relational,3|4,7,3/4,220053,3
1,3,22,54,1,1265,2,8,3,3,5,single-choice,spatial-relational,3|5,7,3/5,220054,3
1,3,22,55,1,688,2,12,5,5,7,single-choice,spatial-relational,5|7,7,5/7,220055,5
1,3,22,56,1,533,3,5,1,1,4,single-choice,spatial-relational,1|4,7,1/4,220056,1
1,3,22,57,1,592,4,6,1,1,5,single-choice,spatial-relational,1|5,7,1/5,220057,1
1,3,22,58,1,584,5,7,1,1,6,single-choice,spatial-relational,1|6,7,1/6,220058,1
1,3,22,59,1,663,4,10,3,3,7,single-choice,spatial-relational,3|7,7,3/7,220059,3
1,3,22,60,1,560,1,3,1,1,2,single-choice,spatial-relational,1|2,7,1/2,220060,1
1,3,22,61,1,685,3,7,2,2,5,single-choice,spatial-relational,2|5,7,2/5,220061,2
1,3,22,62,1,608,1,9,4,4,5,single-choice,spatial-relational,4|5,7,4/5,220062,4
1,3,22,63,1,544,2,12,5,5,7,single-choice,spatial-relational,5|7,7,5/7,220063,5
1,3,22,64,1,572,4,6,1,1,5,single-choice,spatial-relational,1|5,7,1/5,220064,1
1,3,22,65,1,569,1,5,2,2,3,single-choice,spatial-relational,2|3,7,2/3,220065,2
1,3,22,66,1,529,2,4,1,1,3,single-choice,spatial-relational,1|3,7,1/3,220066,1
1,3,22,67,1,580,1,11,5,5,6,single-choice,spatial-relational,5|6,7,5/6,220067,5
1,3,22,68,1,495,1,13,6,6,7,single-choice,spatial-relational,6|7,7,6/7,220068,6
1,3,22,69,1,523,3,11,4,4,7,single-choice,spatial-relational,4|7,7,4/7,220069,4
1,3,22,70,1,521,2,8,3,3,5,single-choice,spatial-relational,3|5,7,3/5,220070,3
1,3,22,71,1,596,3,5,1,1,4,single-choice,spatial-relational,1|4,7,1/4,220071,1
1,3,22,72,1,1406,3,9,3,3,6,single-choice,spatial-relational,3|6,7,3/6,220072,3
1,3,22,73,0,568,1,11,5,6,6,single-choice,spatial-relational,5|6,7,5/6,220073,5
1,3,22,74,0,1265,5,7,1,6,6,single-choice,spatial-relational,1|6,7,1/6,220074,1
1,3,22,75,0,558,1,9,4,5,5,single-choice,spatial-relational,4|5,7,4/5,220075,4
1,3,22,76,0,48,3,11,4,7,7,single-choice,spatial-relational,4|7,7,4/7,220076,4
1,3,22,77,1,1229,1,5,2,2,3,single-choice,spatial-relational,2|3,7,2/3,220077,2
1,3,22,78,1,533,1,7,3,3,4,single-choice,spatial-relational,3|4,7,3/4,220078,3
1,3,22,79,1,626,2,4,1,1,3,single-choice,spatial-relational,1|3,7,1/3,220079,1
1,3,22,80,1,584,3,7,2,2,5,single-choice,spatial-relational,2|5,7,2/5,220080,2
1,3,22,81,1,565,2,10,4,4,6,single-choice,spatial-relational,4|6,7,4/6,220081,4
1,3,22,82,1,662,2,6,2,2,4,single-choice,spatial-relational,2|4,7,2/4,220082,2
1,3,22,83,0,537,1,13,6,7,7,single-choice,spatial-relational,6|7,7,6/7,220083,6
1,3,22,84,1,600,4,8,2,2,6,single-choice,spatial-relational,2|6,7,2/6,220084,2
1,3,22,85,1,485,3,11,4,4,7,single-choice,spatial-relational,4|7,7,4/7,220085,4
1,3,22,86,1,595,1,3,1,1,2,single-choice,spatial-relational,1|2,7,1/2,220086,1
1,3,22,87,1,479,1,13,6,6,7,single-choice,spatial-relational,6|7,7,6/7,220087,6
1,3,22,88,1,660,1,11,5,5,6,single-choice,spatial-relational,5|6,7,5/6,220088,5
1,3,22,89,1,611,2,10,4,4,6,single-choice,spatial-relational,4|6,7,4/6,220089,4
1,3,22,90,1,611,2,10,4,4,6,single-choice,spatial-relational,4|6,7,4/6,220090,4
1,3,22,91,0,613,1,9,4,5,5,single-choice,spatial-relational,4|5,7,4/5,220091,4
1,3,22,92,1,765,1,9,4,4,5,single-choice,spatial-relational,4|5,7,4/5,220092,4
1,3,22,93,1,539,4,8,2,2,6,single-choice,spatial-relational,2|6,7,2/6,220093,2
1,3,22,94,1,584,2,6,2,2,4,single-choice,spatial-relational,2|4,7,2/4,220094,2
1,3,22,95,0,527,2,12,5,7,7,single-choice,spatial-relational,5|7,7,5/7,220095,5
1,3,22,96,1,1180,2,8,3,3,5,single-choice,spatial-relational,3|5,7,3/5,220096,3
1,3,22,97,1,504,3,9,3,3,6,single-choice,spatial-relational,3|6,7,3/6,220097,3
1,3,22,98,1,596,4,6,1,1,5,single-choice,spatial-relational,1|5,7,1/5,220098,1
1,3,22,99,1,583,5,7,1,1,6,single-choice,spatial-relational,1|6,7,1/6,220099,1
1,3,22,100,1,631,3,11,4,4,7,single-choice,spatial-relational,4|7,7,4/7,220100,4
1,3,22,101,1,561,1,7,3,3,4,single-choice,spatial-relational,3|4,7,3/4,220101,3
1,3,22,102,1,618,4,10,3,3,7,single-choice,spatial-relational,3|7,7,3/7,220102,3
1,3,22,103,1,703,3,7,2,2,5,single-choice,spatial-relational,2|5,7,2/5,220103,2
1,3,22,104,1,684,4,8,2,2,6,single-choice,spatial-relational,2|6,7,2/6,220104,2
1,3,22,105,1,571,3,7,2,2,5,single-choice,spatial-relational,2|5,7,2/5,220105,2
1,3,22,106,1,583,2,4,1,1,3,single-choice,spatial-relational,1|3,7,1/3,220106,1
1,3,22,107,0,690,3,5,1,4,4,single-choice,spatial-relational,1|4,7,1/4,220107,1
1,3,22,108,0,686,1,13,6,7,7,single-choice,spatial-relational,6|7,7,6/7,220108,6
1,3,22,109,1,554,6,8,1,1,7,single-choice,spatial-relational,1|7,7,1/7,220109,1
1,3,22,110,1,616,2,6,2,2,4,single-choice,spatial-relational,2|4,7,2/4,220110,2
1,3,22,111,1,608,1,5,2,2,3,single-choice,spatial-relational,2|3,7,2/3,220111,2
1,3,22,112,1,1282,1,3,1,1,2,single-choice,spatial-relational,1|2,7,1/2,220112,1
1,3,22,113,1,514,1,11,5,5,6,single-choice,spatial-relational,5|6,7,5/6,220113,5
1,3,22,114,1,2402,5,9,2,2,7,single-choice,spatial-relational,2|7,7,2/7,220114,2
1,3,22,115,1,623,3,5,1,1,4,single-choice,spatial-relational,1|4,7,1/4,220115,1
1,3,22,116,1,673,2,4,1,1,3,single-choice,spatial-relational,1|3,7,1/3,220116,1
1,3,22,117,1,676,1,5,2,2,3,single-choice,spatial-relational,2|3,7,2/3,220117,2
1,3,22,118,0,544,3,9,3,6,6,single-choice,spatial-relational,3|6,7,3/6,220118,3
1,3,22,119,1,634,5,7,1,1,6,single-choice,spatial-relational,1|6,7,1/6,220119,1
1,3,22,120,0,638,4,6,1,5,5,single-choice,spatial-relational,1|5,7,1/5,220120,1
1,3,22,121,1,621,2,12,5,5,7,single-choice,spatial-relational,5|7,7,5/7,220121,5
1,3,22,122,1,566,5,9,2,2,7,single-choice,spatial-relational,2|7,7,2/7,220122,2
1,3,22,123,1,626,2,8,3,3,5,single-choice,spatial-relational,3|5,7,3/5,220123,3
1,3,22,124,1,611,6,8,1,1,7,single-choice,spatial-relational,1|7,7,1/7,220124,1
1,3,22,125,1,643,1,7,3,3,4,single-choice,spatial-relational,3|4,7,3/4,220125,3
1,3,22,126,1,531,4,10,3,3,7,single-choice,spatial-relational,3|7,7,3/7,220126,3
1,3,22,127,1,614,1,7,3,3,4,single-choice,spatial-relational,3|4,7,3/4,220127,3
1,3,22,128,0,665,2,8,3,5,5,single-choice,spatial-relational,3|5,7,3/5,220128,3
1,3,22,129,1,494,6,8,1,1,7,single-choice,spatial-relational,1|7,7,1/7,220129,1
1,3,22,130,1,586,2,6,2,2,4,single-choice,spatial-relational,2|4,7,2/4,220130,2
1,3,22,131,1,606,5,7,1,1,6,single-choice,spatial-relational,1|6,7,1/6,220131,1
1,3,22,132,1,536,1,3,1,1,2,single-choice,spatial-relational,1|2,7,1/2,220132,1
1,3,22,133,1,487,1,13,6,6,7,single-choice,spatial-relational,6|7,7,6/7,220133,6
1,3,22,134,1,617,6,8,1,1,7,single-choice,spatial-relational,1|7,7,1/7,220134,1
1,3,22,135,0,704,2,8,3,5,5,single-choice,spatial-relational,3|5,7,3/5,220135,3
1,3,22,136,1,1224,4,8,2,2,6,single-choice,spatial-relational,2|6,7,2/6,220136,2
1,3,22,137,1,683,4,10,3,3,7,single-choice,spatial-relational,3|7,7,3/7,220137,3
1,3,22,138,1,487,3,11,4,4,7,single-choice,spatial-relational,4|7,7,4/7,220138,4
1,3,22,139,1,573,2,4,1,1,3,single-choice,spatial-relational,1|3,7,1/3,220139,1
1,3,22,140,1,663,3,9,3,3,6,single-choice,spatial-relational,3|6,7,3/6,220140,3
1,3,22,141,1,674,4,6,1,1,5,single-choice,spatial-relational,1|5,7,1/5,220141,1
1,3,22,142,1,583,2,10,4,4,6,single-choice,spatial-relational,4|6,7,4/6,220142,4
1,3,22,143,0,598,2,12,5,7,7,single-choice,spatial-relational,5|7,7,5/7,220143,5
1,3,22,144,1,1373,1,13,6,6,7,single-choice,spatial-relational,6|7,7,6/7,220144,6
1,3,22,145,1,594,4,8,2,2,6,single-choice,spatial-relational,2|6,7,2/6,220145,2
1,3,22,146,0,623,4,6,1,5,5,single-choice,spatial-relational,1|5,7,1/5,220146,1
1,3,22,147,1,556,2,6,2,2,4,single-choice,spatial-relational,2|4,7,2/4,220147,2
1,3,22,148,1,558,1,11,5,5,6,single-choice,spatial-relational,5|6,7,5/6,220148,5
1,3,22,149,1,638,1,7,3,3,4,single-choice,spatial-relational,3|4,7,3/4,220149,3
1,3,22,150,1,614,5,9,2,2,7,single-choice,spatial-relational,2|7,7,2/7,220150,2
1,3,22,151,1,611,3,5,1,1,4,single-choice,spatial-relational,1|4,7,1/4,220151,1
1,3,22,152,1,577,3,9,3,3,6,single-choice,spatial-relational,3|6,7,3/6,220152,3
1,3,22,153,1,593,1,3,1,1,2,single-choice,spatial-relational,1|2,7,1/2,220153,1
1,3,22,154,0,1248,1,9,4,5,5,single-choice,spatial-relational,4|5,7,4/5,220154,4
1,3,22,155,1,672,3,7,2,2,5,single-choice,spatial-relational,2|5,7,2/5,220155,2
1,3,22,156,1,581,5,9,2,2,7,single-choice,spatial-relational,2|7,7,2/7,220156,2
1,3,22,157,1,687,2,10,4,4,6,single-choice,spatial-relational,4|6,7,4/6,220157,4
1,3,22,158,1,698,3,11,4,4,7,single-choice,spatial-relational,4|7,7,4/7,220158,4
1,3,22,159,1,639,2,4,1,1,3,single-choice,spatial-relational,1|3,7,1/3,220159,1
1,3,22,160,1,623,1,5,2,2,3,single-choice,spatial-relational,2|3,7,2/3,220160,2
1,3,22,161,1,552,4,10,3,3,7,single-choice,spatial-relational,3|7,7,3/7,220161,3
1,3,22,162,0,1379,5,7,1,6,6,single-choice,spatial-relational,1|6,7,1/6,220162,1
1,3,22,163,1,520,3,5,1,1,4,single-choice,spatial-relational,1|4,7,1/4,220163,1
1,3,22,164,1,603,1,11,5,5,6,single-choice,spatial-relational,5|6,7,5/6,220164,5
1,3,22,165,0,535,1,9,4,5,5,single-choice,spatial-relational,4|5,7,4/5,220165,4
1,3,22,166,1,52,2,12,5,5,7,single-choice,spatial-relational,5|7,7,5/7,220166,5
1,3,22,167,1,626,3,7,2,2,5,single-choice,spatial-relational,2|5,7,2/5,220167,2
1,3,22,168,1,586,1,5,2,2,3,single-choice,spatial-relational,2|3,7,2/3,220168,2
1,3,22,169,1,670,1,11,5,5,6,single-choice,spatial-relational,5|6,7,5/6,220169,5
1,3,22,170,0,623,2,4,1,3,3,single-choice,spatial-relational,1|3,7,1/3,220170,1
1,3,22,171,1,721,4,8,2,2,6,single-choice,spatial-relational,2|6,7,2/6,220171,2
1,3,22,172,1,618,3,5,1,1,4,single-choice,spatial-relational,1|4,7,1/4,220172,1
1,3,22,173,1,606,2,6,2,2,4,single-choice,spatial-relational,2|4,7,2/4,220173,2
1,3,22,174,0,587,1,5,2,3,3,single-choice,spatial-relational,2|3,7,2/3,220174,2
1,3,22,175,1,681,4,8,2,2,6,single-choice,spatial-relational,2|6,7,2/6,220175,2
1,3,22,176,1,637,3,9,3,3,6,single-choice,spatial-relational,3|6,7,3/6,220176,3
1,3,22,177,0,583,2,10,4,6,6,single-choice,spatial-relational,4|6,7,4/6,220177,4
1,3,22,178,1,1362,2,8,3,3,5,single-choice,spatial-relational,3|5,7,3/5,220178,3
1,3,22,179,1,657,4,6,1,1,5,single-choice,spatial-relational,1|5,7,1/5,220179,1
1,3,22,180,1,622,5,9,2,2,7,single-choice,spatial-relational,2|7,7,2/7,220180,2
1,3,22,181,1,600,1,5,2,2,3,single-choice,spatial-relational,2|3,7,2/3,220181,2
1,3,22,182,1,581,2,8,3,3,5,single-choice,spatial-relational,3|5,7,3/5,220182,3
1,3,22,183,1,514,1,13,6,6,7,single-choice,spatial-relational,6|7,7,6/7,220183,6
1,3,22,184,1,619,1,7,3,3,4,single-choice,spatial-relational,3|4,7,3/4,220184,3
1,3,22,185,1,635,2,4,1,1,3,single-choice,spatial-relational,1|3,7,1/3,220185,1
1,3,22,186,1,713,3,7,2,2,5,single-choice,spatial-relational,2|5,7,2/5,220186,2
1,3,22,187,1,571,2,12,5,5,7,single-choice,spatial-relational,5|7,7,5/7,220187,5
1,3,22,188,1,564,1,3,1,1,2,single-choice,spatial-relational,1|2,7,1/2,220188,1
1,3,22,189,1,594,6,8,1,1,7,single-choice,spatial-relational,1|7,7,1/7,220189,1
1,3,22,190,1,614,5,7,1,1,6,single-choice,spatial-relational,1|6,7,1/6,220190,1
1,3,22,191,1,1356,5,7,1,1,6,single-choice,spatial-relational,1|6,7,1/6,220191,1
1,3,22,192,1,634,1,7,3,3,4,single-choice,spatial-relational,3|4,7,3/4,220192,3
1,3,22,193,1,621,4,10,3,3,7,single-choice,spatial-relational,3|7,7,3/7,220193,3
1,3,22,194,1,551,1,11,5,5,6,single-choice,spatial-relational,5|6,7,5/6,220194,5
1,3,22,195,1,564,5,9,2,2,7,single-choice,spatial-relational,2|7,7,2/7,220195,2
1,3,22,196,1,678,3,11,4,4,7,single-choice,spatial-relational,4|7,7,4/7,220196,4
1,3,22,197,0,1142,4,6,1,5,5,single-choice,spatial-relational,1|5,7,1/5,220197,1
1,3,22,198,1,604,2,6,2,2,4,single-choice,spatial-relational,2|4,7,2/4,220198,2
1,3,22,199,1,543,1,9,4,4,5,single-choice,spatial-relational,4|5,7,4/5,220199,4
1,3,22,200,0,1578,6,8,1,7,7,single-choice,spatial-relational,1|7,7,1/7,220200,1
1,3,22,201,1,1208,2,12,5,5,7,single-choice,spatial-relational,5|7,7,5/7,220201,5
1,3,22,202,0,546,1,9,4,5,5,single-choice,spatial-relational,4|5,7,4/5,220202,4
1,3,22,203,1,1329,1,13,6,6,7,single-choice,spatial-relational,6|7,7,6/7,220203,6
1,3,22,204,0,557,1,3,1,2,2,single-choice,spatial-relational,1|2,7,1/2,220204,1
1,3,22,205,1,584,3,9,3,3,6,single-choice,spatial-relational,3|6,7,3/6,220205,3
1,3,22,206,1,694,3,5,1,1,4,single-choice,spatial-relational,1|4,7,1/4,220206,1
1,3,22,207,1,1175,3,7,2,2,5,single-choice,spatial-relational,2|5,7,2/5,220207,2
1,3,22,208,1,518,4,10,3,3,7,single-choice,spatial-relational,3|7,7,3/7,220208,3
1,3,22,209,1,642,2,10,4,4,6,single-choice,spatial-relational,4|6,7,4/6,220209,4
1,3,22,210,1,544,3,11,4,4,7,single-choice,spatial-relational,4|7,7,4/7,220210,4
1,3,22,211,1,639,1,9,4,4,5,single-choice,spatial-relational,4|5,7,4/5,220211,4
1,3,22,212,0,720,1,7,3,4,4,single-choice,spatial-relational,3|4,7,3/4,220212,3
1,3,22,213,0,586,1,5,2,3,3,single-choice,spatial-relational,2|3,7,2/3,220213,2
1,3,22,214,1,652,2,6,2,2,4,single-choice,spatial-relational,2|4,7,2/4,220214,2
1,3,22,215,1,528,6,8,1,1,7,single-choice,spatial-relational,1|7,7,1/7,220215,1
1,3,22,216,1,587,3,9,3,3,6,single-choice,spatial-relational,3|6,7,3/6,220216,3
1,3,22,217,1,545,4,10,3,3,7,single-choice,spatial-relational,3|7,7,3/7,220217,3
1,3,22,218,1,660,4,8,2,2,6,single-choice,spatial-relational,2|6,7,2/6,220218,2
1,3,22,219,1,674,5,9,2,2,7,single-choice,spatial-relational,2|7,7,2/7,220219,2
1,3,22,220,1,598,2,4,1,1,3,single-choice,spatial-relational,1|3,7,1/3,220220,1
1,3,22,221,0,655,2,10,4,6,6,single-choice,spatial-relational,4|6,7,4/6,220221,4
1,3,22,222,1,544,3,5,1,1,4,single-choice,spatial-relational,1|4,7,1/4,220222,1
1,3,22,223,1,556,5,7,1,1,6,single-choice,spatial-relational,1|6,7,1/6,220223,1
1,3,22,224,1,1443,3,9,3,3,6,single-choice,spatial-relational,3|6,7,3/6,220224,3
1,3,22,225,1,610,3,7,2,2,5,single-choice,spatial-relational,2|5,7,2/5,220225,2
1,3,22,226,1,1243,5,7,1,1,6,single-choice,spatial-relational,1|6,7,1/6,220226,1
1,3,22,227,0,634,1,13,6,7,7,single-choice,spatial-relational,6|7,7,6/7,220227,6
1,3,22,228,0,615,1,3,1,2,2,single-choice,spatial-relational,1|2,7,1/2,220228,1
1,3,22,229,1,631,2,10,4,4,6,single-choice,spatial-relational,4|6,7,4/6,220229,4
1,3,22,230,0,561,2,12,5,7,7,single-choice,spatial-relational,5|7,7,5/7,220230,5
1,3,22,231,1,629,1,11,5,5,6,single-choice,spatial-relational,5|6,7,5/6,220231,5
1,3,22,232,1,629,1,11,5,5,6,single-choice,spatial-relational,5|6,7,5/6,220232,5
1,3,22,233,1,632,1,3,1,1,2,single-choice,spatial-relational,1|2,7,1/2,220233,1
1,3,22,234,1,662,4,6,1,1,5,single-choice,spatial-relational,1|5,7,1/5,220234,1
1,3,22,235,1,606,6,8,1,1,7,single-choice,spatial-relational,1|7,7,1/7,220235,1
1,3,22,236,1,586,2,8,3,3,5,single-choice,spatial-relational,3|5,7,3/5,220236,3
1,3,22,237,1,509,2,12,5,5,7,single-choice,spatial-relational,5|7,7,5/7,220237,5
1,3,22,238,1,710,3,7,2,2,5,single-choice,spatial-relational,2|5,7,2/5,220238,2
1,3,22,239,1,535,4,8,2,2,6,single-choice,spatial-relational,2|6,7,2/6,220239,2
1,3,22,240,1,628,4,10,3,3,7,single-choice,spatial-relational,3|7,7,3/7,220240,3
1,3,22,241,1,583,3,11,4,4,7,single-choice,spatial-relational,4|7,7,4/7,220241,4
1,3,22,242,1,771,2,6,2,2,4,single-choice,spatial-relational,2|4,7,2/4,220242,2
1,3,22,243,0,1410,4,6,1,5,5,single-choice,spatial-relational,1|5,7,1/5,220243,1
1,3,22,244,1,603,2,4,1,1,3,single-choice,spatial-relational,1|3,7,1/3,220244,1
1,3,22,245,1,604,3,5,1,1,4,single-choice,spatial-relational,1|4,7,1/4,220245,1
1,3,22,246,1,775,2,8,3,3,5,single-choice,spatial-relational,3|5,7,3/5,220246,3
1,3,22,247,0,522,3,11,4,7,7,single-choice,spatial-relational,4|7,7,4/7,220247,4
1,3,22,248,1,552,1,13,6,6,7,single-choice,spatial-relational,6|7,7,6/7,220248,6
1,3,22,249,1,533,5,9,2,2,7,single-choice,spatial-relational,2|7,7,2/7,220249,2
1,3,22,250,0,623,1,9,4,5,5,single-choice,spatial-relational,4|5,7,4/5,220250,4
1,3,22,251,1,610,1,7,3,3,4,single-choice,spatial-relational,3|4,7,3/4,220251,3
1,3,22,252,1,614,1,5,2,2,3,single-choice,spatial-relational,2|3,7,2/3,220252,2
1,3,22,253,1,607,2,6,2,2,4,single-choice,spatial-relational,2|4,7,2/4,220253,2
1,3,22,254,1,772,3,11,4,4,7,single-choice,spatial-relational,4|7,7,4/7,220254,4
1,3,22,255,1,737,2,6,2,2,4,single-choice,spatial-relational,2|4,7,2/4,220255,2
1,3,22,256,1,693,3,7,2,2,5,single-choice,spatial-relational,2|5,7,2/5,220256,2
1,3,22,257,0,685,1,9,4,5,5,single-choice,spatial-relational,4|5,7,4/5,220257,4
1,3,22,258,1,567,1,3,1,1,2,single-choice,spatial-relational,1|2,7,1/2,220258,1
1,3,22,259,1,575,4,6,1,1,5,single-choice,spatial-relational,1|5,7,1/5,220259,1
1,3,22,260,0,873,3,5,1,4,4,single-choice,spatial-relational,1|4,7,1/4,220260,1
1,3,22,261,1,597,2,8,3,3,5,single-choice,spatial-relational,3|5,7,3/5,220261,3
1,3,22,262,0,709,1,11,5,6,6,single-choice,spatial-relational,5|6,7,5/6,220262,5
1,3,22,263,1,173,4,8,2,2,6,single-choice,spatial-relational,2|6,7,2/6,220263,2
1,3,22,264,1,643,2,8,3,3,5,single-choice,spatial-relational,3|5,7,3/5,220264,3
1,3,22,265,1,593,1,5,2,2,3,single-choice,spatial-relational,2|3,7,2/3,220265,2
1,3,22,266,1,603,2,4,1,1,3,single-choice,spatial-relational,1|3,7,1/3,220266,1
1,3,22,267,1,602,5,9,2,2,7,single-choice,spatial-relational,2|7,7,2/7,220267,2
1,3,22,268,0,607,1,13,6,7,7,single-choice,spatial-relational,6|7,7,6/7,220268,6
1,3,22,269,1,584,4,10,3,3,7,single-choice,spatial-relational,3|7,7,3/7,220269,3
1,3,22,270,0,750,5,7,1,6,6,single-choice,spatial-relational,1|6,7,1/6,220270,1
1,3,22,271,1,506,1,13,6,6,7,single-choice,spatial-relational,6|7,7,6/7,220271,6
1,3,22,272,1,1322,1,9,4,4,5,single-choice,spatial-relational,4|5,7,4/5,220272,4
1,3,22,273,1,603,1,7,3,3,4,single-choice,spatial-relational,3|4,7,3/4,220273,3
1,3,22,274,0,829,2,12,5,7,7,single-choice,spatial-relational,5|7,7,5/7,220274,5
1,3,22,275,1,576,4,10,3,3,7,single-choice,spatial-relational,3|7,7,3/7,220275,3
1,3,22,276,1,635,4,8,2,2,6,single-choice,spatial-relational,2|6,7,2/6,220276,2
1,3,22,277,1,545,1,7,3,3,4,single-choice,spatial-relational,3|4,7,3/4,220277,3
1,3,22,278,1,603,6,8,1,1,7,single-choice,spatial-relational,1|7,7,1/7,220278,1
1,3,22,279,1,666,2,10,4,4,6,single-choice,spatial-relational,4|6,7,4/6,220279,4
1,3,22,280,1,585,3,9,3,3,6,single-choice,spatial-relational,3|6,7,3/6,220280,3
1,3,22,281,1,1244,3,9,3,3,6,single-choice,spatial-relational,3|6,7,3/6,220281,3
1,3,22,282,0,1052,4,6,1,5,5,single-choice,spatial-relational,1|5,7,1/5,220282,1
1,3,22,283,1,654,3,5,1,1,4,single-choice,spatial-relational,1|4,7,1/4,220283,1
1,3,22,284,1,554,2,12,5,5,7,single-choice,spatial-relational,5|7,7,5/7,220284,5
1,3,22,285,1,626,1,5,2,2,3,single-choice,spatial-relational,2|3,7,2/3,220285,2
1,3,22,286,1,604,2,4,1,1,3,single-choice,spatial-relational,1|3,7,1/3,220286,1
1,3,22,287,1,635,1,11,5,5,6,single-choice,spatial-relational,5|6,7,5/6,220287,5
1,3,22,288,1,524,3,11,4,4,7,single-choice,spatial-relational,4|7,7,4/7,220288,4
1,3,22,289,1,636,5,9,2,2,7,single-choice,spatial-relational,2|7,7,2/7,220289,2
1,3,22,290,1,563,6,8,1,1,7,single-choice,spatial-relational,1|7,7,1/7,220290,1
1,3,22,291,1,1258,5,7,1,1,6,single-choice,spatial-relational,1|6,7,1/6,220291,1
1,3,22,292,1,643,1,3,1,1,2,single-choice,spatial-relational,1|2,7,1/2,220292,1
1,3,22,293,1,784,3,7,2,2,5,single-choice,spatial-relational,2|5,7,2/5,220293,2
1,3,22,294,0,637,2,10,4,6,6,single-choice,spatial-relational,4|6,7,4/6,220294,4
1,3,22,295,0,643,1,9,4,5,5,single-choice,spatial-relational,4|5,7,4/5,220295,4
1,3,22,296,1,591,5,9,2,2,7,single-choice,spatial-relational,2|7,7,2/7,220296,2
1,3,22,297,1,516,3,5,1,1,4,single-choice,spatial-relational,1|4,7,1/4,220297,1
1,3,22,298,1,673,3,7,2,2,5,single-choice,spatial-relational,2|5,7,2/5,220298,2
1,3,22,299,1,640,3,11,4,4,7,single-choice,spatial-relational,4|7,7,4/7,220299,4
1,3,22,300,1,713,3,5,1,1,4,single-choice,spatial-relational,1|4,7,1/4,220300,1
1,3,22,301,1,534,4,10,3,3,7,single-choice,spatial-relational,3|7,7,3/7,220301,3
1,3,22,302,1,599,5,9,2,2,7,single-choice,spatial-relational,2|7,7,2/7,220302,2
1,3,22,303,1,591,2,4,1,1,3,single-choice,spatial-relational,1|3,7,1/3,220303,1
1,3,22,304,1,521,2,12,5,5,7,single-choice,spatial-relational,5|7,7,5/7,220304,5
1,3,22,305,0,673,2,10,4,6,6,single-choice,spatial-relational,4|6,7,4/6,220305,4
1,3,22,306,1,605,3,7,2,2,5,single-choice,spatial-relational,2|5,7,2/5,220306,2
1,3,22,307,1,574,5,7,1,1,6,single-choice,spatial-relational,1|6,7,1/6,220307,1
1,3,22,308,1,616,2,6,2,2,4,single-choice,spatial-relational,2|4,7,2/4,220308,2
1,3,22,309,1,526,1,7,3,3,4,single-choice,spatial-relational,3|4,7,3/4,220309,3
1,3,22,310,1,598,4,6,1,1,5,single-choice,spatial-relational,1|5,7,1/5,220310,1
1,3,22,311,1,626,4,8,2,2,6,single-choice,spatial-relational,2|6,7,2/6,220311,2
1,3,22,312,1,641,2,4,1,1,3,single-choice,spatial-relational,1|3,7,1/3,220312,1
1,3,22,313,1,626,6,8,1,1,7,single-choice,spatial-relational,1|7,7,1/7,220313,1
1,3,22,314,1,634,1,11,5,5,6,single-choice,spatial-relational,5|6,7,5/6,220314,5
1,3,22,315,1,1253,1,7,3,3,4,single-choice,spatial-relational,3|4,7,3/4,220315,3
1,3,22,316,0,530,1,13,6,7,7,single-choice,spatial-relational,6|7,7,6/7,220316,6
1,3,22,317,1,696,3,11,4,4,7,single-choice,spatial-relational,4|7,7,4/7,220317,4
1,3,22,318,1,525,6,8,1,1,7,single-choice,spatial-relational,1|7,7,1/7,220318,1
1,3,22,319,1,617,2,8,3,3,5,single-choice,spatial-relational,3|5,7,3/5,220319,3
1,3,22,320,1,587,3,9,3,3,6,single-choice,spatial-relational,3|6,7,3/6,220320,3
1,3,22,321,1,600,4,10,3,3,7,single-choice,spatial-relational,3|7,7,3/7,220321,3
1,3,22,322,0,484,2,10,4,6,6,single-choice,spatial-relational,4|6,7,4/6,220322,4
1,3,22,323,1,709,2,8,3,3,5,single-choice,spatial-relational,3|5,7,3/5,220323,3
1,3,22,324,1,482,1,13,6,6,7,single-choice,spatial-relational,6|7,7,6/7,220324,6
1,3,22,325,1,584,4,6,1,1,5,single-choice,spatial-relational,1|5,7,1/5,220325,1
1,3,22,326,1,584,1,5,2,2,3,single-choice,spatial-relational,2|3,7,2/3,220326,2
1,3,22,327,1,636,5,7,1,1,6,single-choice,spatial-relational,1|6,7,1/6,220327,1
1,3,22,328,1,565,1,3,1,1,2,single-choice,spatial-relational,1|2,7,1/2,220328,1
1,3,22,329,1,559,4,8,2,2,6,single-choice,spatial-relational,2|6,7,2/6,220329,2
1,3,22,330,1,592,3,9,3,3,6,single-choice,spatial-relational,3|6,7,3/6,220330,3
1,3,22,331,1,559,2,6,2,2,4,single-choice,spatial-relational,2|4,7,2/4,220331,2
1,3,22,332,1,673,1,9,4,4,5,single-choice,spatial-relational,4|5,7,4/5,220332,4
1,3,22,333,1,623,1,5,2,2,3,single-choice,spatial-relational,2|3,7,2/3,220333,2
1,3,22,334,1,637,1,11,5,5,6,single-choice,spatial-relational,5|6,7,5/6,220334,5
1,3,22,335,1,635,1,3,1,1,2,single-choice,spatial-relational,1|2,7,1/2,220335,1
1,3,22,336,1,600,2,12,5,5,7,single-choice,spatial-relational,5|7,7,5/7,220336,5
1,3,22,337,1,505,6,8,1,1,7,single-choice,spatial-relational,1|7,7,1/7,220337,1
1,3,22,338,1,564,2,4,1,1,3,single-choice,spatial-relational,1|3,7,1/3,220338,1
1,3,22,339,0,608,4,6,1,5,5,single-choice,spatial-relational,1|5,7,1/5,220339,1
1,3,22,340,1,631,3,7,2,2,5,single-choice,spatial-relational,2|5,7,2/5,220340,2
1,3,22,341,1,510,1,7,3,3,4,single-choice,spatial-relational,3|4,7,3/4,220341,3
1,3,22,342,0,631,4,10,3,7,7,single-choice,spatial-relational,3|7,7,3/7,220342,3
1,3,22,343,1,593,2,4,1,1,3,single-choice,spatial-relational,1|3,7,1/3,220343,1
1,3,22,344,0,635,2,10,4,6,6,single-choice,spatial-relational,4|6,7,4/6,220344,4
1,3,22,345,1,494,2,6,2,2,4,single-choice,spatial-relational,2|4,7,2/4,220345,2
1,3,22,346,0,644,1,13,6,7,7,single-choice,spatial-relational,6|7,7,6/7,220346,6
1,3,22,347,1,672,2,8,3,3,5,single-choice,spatial-relational,3|5,7,3/5,220347,3
1,3,22,348,1,614,1,11,5,5,6,single-choice,spatial-relational,5|6,7,5/6,220348,5
1,3,22,349,1,1199,2,8,3,3,5,single-choice,spatial-relational,3|5,7,3/5,220349,3
1,3,22,350,1,678,1,9,4,4,5,single-choice,spatial-relational,4|5,7,4/5,220350,4
1,3,22,351,1,567,1,3,1,1,2,single-choice,spatial-relational,1|2,7,1/2,220351,1
1,3,22,352,1,594,6,8,1,1,7,single-choice,spatial-relational,1|7,7,1/7,220352,1
1,3,22,353,1,623,2,6,2,2,4,single-choice,spatial-relational,2|4,7,2/4,220353,2
1,3,22,354,1,541,3,9,3,3,6,single-choice,spatial-relational,3|6,7,3/6,220354,3
1,3,22,355,1,629,2,10,4,4,6,single-choice,spatial-relational,4|6,7,4/6,220355,4
1,3,22,356,1,587,1,7,3,3,4,single-choice,spatial-relational,3|4,7,3/4,220356,3
1,3,22,357,1,736,5,9,2,2,7,single-choice,spatial-relational,2|7,7,2/7,220357,2
1,3,22,358,1,564,2,12,5,5,7,single-choice,spatial-relational,5|7,7,5/7,220358,5
1,3,22,359,1,648,1,3,1,1,2,single-choice,spatial-relational,1|2,7,1/2,220359,1
1,3,22,360,1,536,1,11,5,5,6,single-choice,spatial-relational,5|6,7,5/6,220360,5
1,3,22,361,1,665,2,12,5,5,7,single-choice,spatial-relational,5|7,7,5/7,220361,5
1,3,22,362,1,604,1,5,2,2,3,single-choice,spatial-relational,2|3,7,2/3,220362,2
1,3,22,363,1,529,3,5,1,1,4,single-choice,spatial-relational,1|4,7,1/4,220363,1
1,3,22,364,1,599,3,5,1,1,4,single-choice,spatial-relational,1|4,7,1/4,220364,1
1,3,22,365,1,679,3,9,3,3,6,single-choice,spatial-relational,3|6,7,3/6,220365,3
1,3,22,366,0,3025,1,5,2,3,3,single-choice,spatial-relational,2|3,7,2/3,220366,2
1,3,22,367,1,564,4,8,2,2,6,single-choice,spatial-relational,2|6,7,2/6,220367,2
1,3,22,368,0,698,3,7,2,5,5,single-choice,spatial-relational,2|5,7,2/5,220368,2
1,3,22,369,1,558,3,11,4,4,7,single-choice,spatial-relational,4|7,7,4/7,220369,4
1,3,22,370,0,666,1,9,4,5,5,single-choice,spatial-relational,4|5,7,4/5,220370,4
1,3,22,371,1,602,5,9,2,2,7,single-choice,spatial-relational,2|7,7,2/7,220371,2
1,3,22,372,1,670,5,7,1,1,6,single-choice,spatial-relational,1|6,7,1/6,220372,1
1,3,22,373,0,662,3,11,4,7,7,single-choice,spatial-relational,4|7,7,4/7,220373,4
1,3,22,374,0,633,4,10,3,7,7,single-choice,spatial-relational,3|7,7,3/7,220374,3
1,3,22,375,1,510,5,7,1,1,6,single-choice,spatial-relational,1|6,7,1/6,220375,1
1,3,22,376,1,504,1,13,6,6,7,single-choice,spatial-relational,6|7,7,6/7,220376,6
1,3,22,377,1,658,4,8,2,2,6,single-choice,spatial-relational,2|6,7,2/6,220377,2
1,3,22,378,1,712,4,6,1,1,5,single-choice,spatial-relational,1|5,7,1/5,220378,1
1,3,22,379,0,674,3,7,2,5,5,single-choice,spatial-relational,2|5,7,2/5,220379,2
1,3,22,380,1,556,2,12,5,5,7,single-choice,spatial-relational,5|7,7,5/7,220380,5
1,3,22,381,1,552,3,9,3,3,6,single-choice,spatial-relational,3|6,7,3/6,220381,3
1,3,22,382,1,543,3,11,4,4,7,single-choice,spatial-relational,4|7,7,4/7,220382,4
1,3,22,383,1,607,1,3,1,1,2,single-choice,spatial-relational,1|2,7,1/2,220383,1
1,3,22,384,1,525,5,9,2,2,7,single-choice,spatial-relational,2|7,7,2/7,220384,2
1,3,22,385,1,611,3,5,1,1,4,single-choice,spatial-relational,1|4,7,1/4,220385,1
1,3,22,386,1,629,3,11,4,4,7,single-choice,spatial-relational,4|7,7,4/7,220386,4
1,3,22,387,1,761,5,9,2,2,7,single-choice,spatial-relational,2|7,7,2/7,220387,2
1,3,22,388,1,620,1,11,5,5,6,single-choice,spatial-relational,5|6,7,5/6,220388,5
1,3,22,389,1,802,1,7,3,3,4,single-choice,spatial-relational,3|4,7,3/4,220389,3
1,3,22,390,1,562,4,10,3,3,7,single-choice,spatial-relational,3|7,7,3/7,220390,3
1,3,22,391,1,635,2,8,3,3,5,single-choice,spatial-relational,3|5,7,3/5,220391,3
1,3,22,392,1,719,4,10,3,3,7,single-choice,spatial-relational,3|7,7,3/7,220392,3
1,3,22,393,1,647,1,9,4,4,5,single-choice,spatial-relational,4|5,7,4/5,220393,4
1,3,22,394,1,663,6,8,1,1,7,single-choice,spatial-relational,1|7,7,1/7,220394,1
1,3,22,395,0,723,1,9,4,5,5,single-choice,spatial-relational,4|5,7,4/5,220395,4
1,3,22,396,1,685,5,7,1,1,6,single-choice,spatial-relational,1|6,7,1/6,220396,1
1,3,22,397,0,728,2,8,3,5,5,single-choice,spatial-relational,3|5,7,3/5,220397,3
1,3,22,398,1,577,4,6,1,1,5,single-choice,spatial-relational,1|5,7,1/5,220398,1
1,3,22,399,1,600,6,8,1,1,7,single-choice,spatial-relational,1|7,7,1/7,220399,1
1,3,22,400,1,1162,1,5,2,2,3,single-choice,spatial-relational,2|3,7,2/3,220400,2
1,3,22,401,1,502,3,5,1,1,4,single-choice,spatial-relational,1|4,7,1/4,220401,1
1,3,22,402,1,484,1,13,6,6,7,single-choice,spatial-relational,6|7,7,6/7,220402,6
1,3,22,403,1,682,5,7,1,1,6,single-choice,spatial-relational,1|6,7,1/6,220403,1
1,3,22,404,1,485,2,10,4,4,6,single-choice,spatial-relational,4|6,7,4/6,220404,4
1,3,22,405,1,714,4,8,2,2,6,single-choice,spatial-relational,2|6,7,2/6,220405,2
1,3,22,406,1,671,2,12,5,5,7,single-choice,spatial-relational,5|7,7,5/7,220406,5
1,3,22,407,1,1215,1,5,2,2,3,single-choice,spatial-relational,2|3,7,2/3,220407,2
1,3,22,408,1,787,4,6,1,1,5,single-choice,spatial-relational,1|5,7,1/5,220408,1
1,3,22,409,1,624,2,4,1,1,3,single-choice,spatial-relational,1|3,7,1/3,220409,1
1,3,22,410,1,618,1,7,3,3,4,single-choice,spatial-relational,3|4,7,3/4,220410,3
1,3,22,411,1,560,2,6,2,2,4,single-choice,spatial-relational,2|4,7,2/4,220411,2
1,3,22,412,1,604,2,4,1,1,3,single-choice,spatial-relational,1|3,7,1/3,220412,1
1,3,22,413,1,688,3,9,3,3,6,single-choice,spatial-relational,3|6,7,3/6,220413,3
1,3,22,414,1,642,1,11,5,5,6,single-choice,spatial-relational,5|6,7,5/6,220414,5
1,3,22,415,1,645,4,8,2,2,6,single-choice,spatial-relational,2|6,7,2/6,220415,2
1,3,22,416,1,821,3,7,2,2,5,single-choice,spatial-relational,2|5,7,2/5,220416,2
1,3,22,417,1,659,2,6,2,2,4,single-choice,spatial-relational,2|4,7,2/4,220417,2
1,3,22,418,1,631,2,10,4,4,6,single-choice,spatial-relational,4|6,7,4/6,220418,4
1,3,22,419,0,575,1,13,6,7,7,single-choice,spatial-relational,6|7,7,6/7,220419,6
1,3,22,420,0,621,1,3,1,2,2,single-choice,spatial-relational,1|2,7,1/2,220420,1
1,3,22,421,1,584,2,4,1,1,3,single-choice,spatial-relational,1|3,7,1/3,220421,1
1,3,22,422,0,701,4,10,3,7,7,single-choice,spatial-relational,3|7,7,3/7,220422,3
1,3,22,423,1,680,1,7,3,3,4,single-choice,spatial-relational,3|4,7,3/4,220423,3
1,3,22,424,1,513,2,12,5,5,7,single-choice,spatial-relational,5|7,7,5/7,220424,5
1,3,22,425,0,721,3,9,3,6,6,single-choice,spatial-relational,3|6,7,3/6,220425,3
1,3,22,426,1,573,6,8,1,1,7,single-choice,spatial-relational,1|7,7,1/7,220426,1
1,3,22,427,1,631,1,5,2,2,3,single-choice,spatial-relational,2|3,7,2/3,220427,2
1,3,22,428,0,500,1,9,4,5,5,single-choice,spatial-relational,4|5,7,4/5,220428,4
1,3,22,429,0,703,4,10,3,7,7,single-choice,spatial-relational,3|7,7,3/7,220429,3
1,3,22,430,0,686,1,9,4,5,5,single-choice,spatial-relational,4|5,7,4/5,220430,4
1,3,22,431,1,611,1,5,2,2,3,single-choice,spatial-relational,2|3,7,2/3,220431,2
1,3,22,432,1,624,3,7,2,2,5,single-choice,spatial-relational,2|5,7,2/5,220432,2
1,3,22,433,0,595,3,11,4,7,7,single-choice,spatial-relational,4|7,7,4/7,220433,4
1,3,22,434,1,654,4,6,1,1,5,single-choice,spatial-relational,1|5,7,1/5,220434,1
1,3,22,435,1,678,4,6,1,1,5,single-choice,spatial-relational,1|5,7,1/5,220435,1
1,3,22,436,1,529,5,9,2,2,7,single-choice,spatial-relational,2|7,7,2/7,220436,2
1,3,22,437,1,617,2,6,2,2,4,single-choice,spatial-relational,2|4,7,2/4,220437,2
1,3,22,438,1,521,5,7,1,1,6,single-choice,spatial-relational,1|6,7,1/6,220438,1
1,3,22,439,1,501,1,7,3,3,4,single-choice,spatial-relational,3|4,7,3/4,220439,3
1,3,22,440,0,600,2,12,5,7,7,single-choice,spatial-relational,5|7,7,5/7,220440,5
1,3,22,441,1,552,2,8,3,3,5,single-choice,spatial-relational,3|5,7,3/5,220441,3
1,3,22,442,1,635,2,8,3,3,5,single-choice,spatial-relational,3|5,7,3/5,220442,3
1,3,22,443,1,526,2,10,4,4,6,single-choice,spatial-relational,4|6,7,4/6,220443,4
1,3,22,444,1,486,1,13,6,6,7,single-choice,spatial-relational,6|7,7,6/7,220444,6
1,3,22,445,1,655,2,10,4,4,6,single-choice,spatial-relational,4|6,7,4/6,220445,4
1,3,22,446,1,600,2,4,1,1,3,single-choice,spatial-relational,1|3,7,1/3,220446,1
1,3,22,447,1,608,6,8,1,1,7,single-choice,spatial-relational,1|7,7,1/7,220447,1
1,3,22,448,1,545,1,3,1,1,2,single-choice,spatial-relational,1|2,7,1/2,220448,1
1,3,22,449,0,641,1,11,5,6,6,single-choice,spatial-relational,5|6,7,5/6,220449,5
1,3,22,450,1,628,1,11,5,5,6,single-choice,spatial-relational,5|6,7,5/6,220450,5
1,3,22,451,1,502,3,11,4,4,7,single-choice,spatial-relational,4|7,7,4/7,220451,4
1,3,22,452,1,585,2,6,2,2,4,single-choice,spatial-relational,2|4,7,2/4,220452,2
1,3,22,453,1,668,5,7,1,1,6,single-choice,spatial-relational,1|6,7,1/6,220453,1
1,3,22,454,0,573,1,13,6,7,7,single-choice,spatial-relational,6|7,7,6/7,220454,6
1,3,22,455,1,569,3,5,1,1,4,single-choice,spatial-relational,1|4,7,1/4,220455,1
1,3,22,456,1,663,3,5,1,1,4,single-choice,spatial-relational,1|4,7,1/4,220456,1
1,3,22,457,1,615,1,3,1,1,2,single-choice,spatial-relational,1|2,7,1/2,220457,1
1,3,22,458,0,17695,3,7,2,5,5,single-choice,spatial-relational,2|5,7,2/5,220458,2
1,3,22,459,0,56,4,8,2,6,6,single-choice,spatial-relational,2|6,7,2/6,220459,2
1,3,22,460,1,817,4,8,2,2,6,single-choice,spatial-relational,2|6,7,2/6,220460,2
1,3,22,461,1,592,3,9,3,3,6,single-choice,spatial-relational,3|6,7,3/6,220461,3
1,3,22,462,1,647,5,9,2,2,7,single-choice,spatial-relational,2|7,7,2/7,220462,2
1,3,22,463,1,579,4,10,3,3,7,single-choice,spatial-relational,3|7,7,3/7,220463,3
1,3,22,464,1,600,1,9,4,4,5,single-choice,spatial-relational,4|5,7,4/5,220464,4
1,3,22,465,1,592,3,9,3,3,6,single-choice,spatial-relational,3|6,7,3/6,220465,3
1,3,22,466,1,534,4,8,2,2,6,single-choice,spatial-relational,2|6,7,2/6,220466,2
1,3,22,467,1,710,2,12,5,5,7,single-choice,spatial-relational,5|7,7,5/7,220467,5
1,3,22,468,1,534,2,6,2,2,4,single-choice,spatial-relational,2|4,7,2/4,220468,2
1,3,22,469,1,654,1,9,4,4,5,single-choice,spatial-relational,4|5,7,4/5,220469,4
1,3,22,470,1,705,2,8,3,3,5,single-choice,spatial-relational,3|5,7,3/5,220470,3
1,3,22,471,1,514,3,11,4,4,7,single-choice,spatial-relational,4|7,7,4/7,220471,4
1,3,22,472,1,536,6,8,1,1,7,single-choice,spatial-relational,1|7,7,1/7,220472,1
1,3,22,473,1,601,1,11,5,5,6,single-choice,spatial-relational,5|6,7,5/6,220473,5
1,3,22,474,1,623,5,9,2,2,7,single-choice,spatial-relational,2|7,7,2/7,220474,2
1,3,22,475,1,623,2,6,2,2,4,single-choice,spatial-relational,2|4,7,2/4,220475,2
1,3,22,476,1,615,1,3,1,1,2,single-choice,spatial-relational,1|2,7,1/2,220476,1
1,3,22,477,0,674,1,11,5,6,6,single-choice,spatial-relational,5|6,7,5/6,220477,5
1,3,22,478,1,565,5,7,1,1,6,single-choice,spatial-relational,1|6,7,1/6,220478,1
1,3,22,479,0,749,3,11,4,7,7,single-choice,spatial-relational,4|7,7,4/7,220479,4
1,3,22,480,1,497,1,13,6,6,7,single-choice,spatial-relational,6|7,7,6/7,220480,6
1,3,22,481,1,623,3,9,3,3,6,single-choice,spatial-relational,3|6,7,3/6,220481,3
1,3,22,482,1,788,2,12,5,5,7,single-choice,spatial-relational,5|7,7,5/7,220482,5
1,3,22,483,0,615,1,13,6,7,7,single-choice,spatial-relational,6|7,7,6/7,220483,6
1,3,22,484,1,591,3,5,1,1,4,single-choice,spatial-relational,1|4,7,1/4,220484,1
1,3,22,485,0,1248,1,7,3,4,4,single-choice,spatial-relational,3|4,7,3/4,220485,3
1,3,22,486,1,859,2,8,3,3,5,single-choice,spatial-relational,3|5,7,3/5,220486,3
1,3,22,487,0,653,1,3,1,2,2,single-choice,spatial-relational,1|2,7,1/2,220487,1
1,3,22,488,1,547,4,6,1,1,5,single-choice,spatial-relational,1|5,7,1/5,220488,1
1,3,22,489,0,561,1,5,2,3,3,single-choice,spatial-relational,2|3,7,2/3,220489,2
1,3,22,490,1,566,4,10,3,3,7,single-choice,spatial-relational,3|7,7,3/7,220490,3
1,3,22,491,0,1278,2,10,4,6,6,single-choice,spatial-relational,4|6,7,4/6,220491,4
1,3,22,492,1,645,1,7,3,3,4,single-choice,spatial-relational,3|4,7,3/4,220492,3
1,3,22,493,1,1332,3,7,2,2,5,single-choice,spatial-relational,2|5,7,2/5,220493,2
1,3,22,494,1,1380,4,6,1,1,5,single-choice,spatial-relational,1|5,7,1/5,220494,1
1,3,22,495,1,670,5,7,1,1,6,single-choice,spatial-relational,1|6,7,1/6,220495,1
1,3,22,496,1,690,4,8,2,2,6,single-choice,spatial-relational,2|6,7,2/6,220496,2
1,3,22,497,1,653,2,4,1,1,3,single-choice,spatial-relational,1|3,7,1/3,220497,1
1,3,22,498,1,643,3,5,1,1,4,single-choice,spatial-relational,1|4,7,1/4,220498,1
1,3,22,499,1,641,1,5,2,2,3,single-choice,spatial-relational,2|3,7,2/3,220499,2
1,3,22,500,1,602,6,8,1,1,7,single-choice,spatial-relational,1|7,7,1/7,220500,1
1,3,22,501,1,675,2,10,4,4,6,single-choice,spatial-relational,4|6,7,4/6,220501,4
1,3,22,502,1,562,2,4,1,1,3,single-choice,spatial-relational,1|3,7,1/3,220502,1
1,3,22,503,1,538,5,9,2,2,7,single-choice,spatial-relational,2|7,7,2/7,220503,2
1,3,22,504,1,623,3,7,2,2,5,single-choice,spatial-relational,2|5,7,2/5,220504,2
1,3,22,505,0,1282,1,7,3,4,4,single-choice,spatial-relational,3|4,7,3/4,220505,3
1,3,22,506,1,472,2,6,2,2,4,single-choice,spatial-relational,2|4,7,2/4,220506,2
1,3,22,507,1,600,1,5,2,2,3,single-choice,spatial-relational,2|3,7,2/3,220507,2
1,3,22,508,1,783,2,12,5,5,7,single-choice,spatial-relational,5|7,7,5/7,220508,5
1,3,22,509,1,577,1,9,4,4,5,single-choice,spatial-relational,4|5,7,4/5,220509,4
1,3,22,510,1,585,2,8,3,3,5,single-choice,spatial-relational,3|5,7,3/5,220510,3
1,3,22,511,1,538,5,7,1,1,6,single-choice,spatial-relational,1|6,7,1/6,220511,1
1,3,22,512,1,595,2,6,2,2,4,single-choice,spatial-relational,2|4,7,2/4,220512,2
1,3,22,513,1,495,4,10,3,3,7,single-choice,spatial-relational,3|7,7,3/7,220513,3
1,3,22,514,1,597,3,9,3,3,6,single-choice,spatial-relational,3|6,7,3/6,220514,3
1,3,22,515,1,587,2,4,1,1,3,single-choice,spatial-relational,1|3,7,1/3,220515,1
1,3,22,516,1,506,2,10,4,4,6,single-choice,spatial-relational,4|6,7,4/6,220516,4
1,3,22,517,1,551,1,5,2,2,3,single-choice,spatial-relational,2|3,7,2/3,220517,2
1,3,22,518,0,512,1,9,4,5,5,single-choice,spatial-relational,4|5,7,4/5,220518,4
1,3,22,519,1,492,6,8,1,1,7,single-choice,spatial-relational,1|7,7,1/7,220519,1
1,3,22,520,1,516,2,12,5,5,7,single-choice,spatial-relational,5|7,7,5/7,220520,5
1,3,22,521,1,1134,5,9,2,2,7,single-choice,spatial-relational,2|7,7,2/7,220521,2
1,3,22,522,1,616,4,6,1,1,5,single-choice,spatial-relational,1|5,7,1/5,220522,1
1,3,22,523,1,717,3,7,2,2,5,single-choice,spatial-relational,2|5,7,2/5,220523,2
1,3,22,524,1,642,5,7,1,1,6,single-choice,spatial-relational,1|6,7,1/6,220524,1
1,3,22,525,1,561,4,6,1,1,5,single-choice,spatial-relational,1|5,7,1/5,220525,1
1,3,22,526,1,607,1,3,1,1,2,single-choice,spatial-relational,1|2,7,1/2,220526,1
1,3,22,527,1,571,1,7,3,3,4,single-choice,spatial-relational,3|4,7,3/4,220527,3
1,3,22,528,1,495,3,9,3,3,6,single-choice,spatial-relational,3|6,7,3/6,220528,3
1,3,22,529,0,744,3,7,2,5,5,single-choice,spatial-relational,2|5,7,2/5,220529,2
1,3,22,530,1,519,4,8,2,2,6,single-choice,spatial-relational,2|6,7,2/6,220530,2
1,3,22,531,1,502,3,11,4,4,7,single-choice,spatial-relational,4|7,7,4/7,220531,4
1,3,22,532,0,557,3,11,4,7,7,single-choice,spatial-relational,4|7,7,4/7,220532,4
1,3,22,533,0,1089,2,4,1,3,3,single-choice,spatial-relational,1|3,7,1/3,220533,1
1,3,22,534,1,1268,6,8,1,1,7,single-choice,spatial-relational,1|7,7,1/7,220534,1
1,3,22,535,1,495,1,11,5,5,6,single-choice,spatial-relational,5|6,7,5/6,220535,5
1,3,22,536,1,592,1,3,1,1,2,single-choice,spatial-relational,1|2,7,1/2,220536,1
1,3,22,537,1,1162,2,10,4,4,6,single-choice,spatial-relational,4|6,7,4/6,220537,4
1,3,22,538,0,1399,1,11,5,6,6,single-choice,spatial-relational,5|6,7,5/6,220538,5
1,3,22,539,1,532,3,5,1,1,4,single-choice,spatial-relational,1|4,7,1/4,220539,1
1,3,22,540,1,613,4,10,3,3,7,single-choice,spatial-relational,3|7,7,3/7,220540,3
1,3,22,541,1,505,1,13,6,6,7,single-choice,spatial-relational,6|7,7,6/7,220541,6
1,3,22,542,0,561,1,13,6,7,7,single-choice,spatial-relational,6|7,7,6/7,220542,6
1,3,22,543,1,721,2,8,3,3,5,single-choice,spatial-relational,3|5,7,3/5,220543,3
1,3,22,544,1,616,4,8,2,2,6,single-choice,spatial-relational,2|6,7,2/6,220544,2
1,3,22,545,1,584,3,5,1,1,4,single-choice,spatial-relational,1|4,7,1/4,220545,1
1,3,22,546,1,558,5,9,2,2,7,single-choice,spatial-relational,2|7,7,2/7,220546,2
1,3,22,547,0,650,2,12,5,7,7,single-choice,spatial-relational,5|7,7,5/7,220547,5
1,3,22,548,1,621,3,9,3,3,6,single-choice,spatial-relational,3|6,7,3/6,220548,3
1,3,22,549,1,529,1,11,5,5,6,single-choice,spatial-relational,5|6,7,5/6,220549,5
1,3,22,550,1,596,1,3,1,1,2,single-choice,spatial-relational,1|2,7,1/2,220550,1
1,3,22,551,1,534,3,7,2,2,5,single-choice,spatial-relational,2|5,7,2/5,220551,2
1,3,22,552,1,624,1,5,2,2,3,single-choice,spatial-relational,2|3,7,2/3,220552,2
1,3,22,553,0,453,4,8,2,6,6,single-choice,spatial-relational,2|6,7,2/6,220553,2
1,3,22,554,1,648,3,5,1,1,4,single-choice,spatial-relational,1|4,7,1/4,220554,1
1,3,22,555,1,582,2,4,1,1,3,single-choice,spatial-relational,1|3,7,1/3,220555,1
1,3,22,556,1,647,3,7,2,2,5,single-choice,spatial-relational,2|5,7,2/5,220556,2
1,3,22,557,1,622,3,9,3,3,6,single-choice,spatial-relational,3|6,7,3/6,220557,3
1,3,22,558,1,569,6,8,1,1,7,single-choice,spatial-relational,1|7,7,1/7,220558,1
1,3,22,559,1,643,2,6,2,2,4,single-choice,spatial-relational,2|4,7,2/4,220559,2
1,3,22,560,1,595,1,9,4,4,5,single-choice,spatial-relational,4|5,7,4/5,220560,4
1,3,22,561,0,663,4,10,3,7,7,single-choice,spatial-relational,3|7,7,3/7,220561,3
1,3,22,562,1,515,3,11,4,4,7,single-choice,spatial-relational,4|7,7,4/7,220562,4
1,3,22,563,1,597,2,4,1,1,3,single-choice,spatial-relational,1|3,7,1/3,220563,1
1,3,22,564,0,729,3,11,4,7,7,single-choice,spatial-relational,4|7,7,4/7,220564,4
1,3,22,565,0,642,2,8,3,5,5,single-choice,spatial-relational,3|5,7,3/5,220565,3
1,3,22,566,1,666,2,8,3,3,5,single-choice,spatial-relational,3|5,7,3/5,220566,3
1,3,22,567,1,603,2,10,4,4,6,single-choice,spatial-relational,4|6,7,4/6,220567,4
1,3,22,568,1,713,2,10,4,4,6,single-choice,spatial-relational,4|6,7,4/6,220568,4
1,3,22,569,1,652,1,5,2,2,3,single-choice,spatial-relational,2|3,7,2/3,220569,2
1,3,22,570,1,746,1,11,5,5,6,single-choice,spatial-relational,5|6,7,5/6,220570,5
1,3,22,571,0,655,1,13,6,7,7,single-choice,spatial-relational,6|7,7,6/7,220571,6
1,3,22,572,1,675,2,6,2,2,4,single-choice,spatial-relational,2|4,7,2/4,220572,2
1,3,22,573,1,615,5,7,1,1,6,single-choice,spatial-relational,1|6,7,1/6,220573,1
1,3,22,574,0,522,1,9,4,5,5,single-choice,spatial-relational,4|5,7,4/5,220574,4
1,3,22,575,1,642,1,3,1,1,2,single-choice,spatial-relational,1|2,7,1/2,220575,1
1,3,22,576,1,654,4,6,1,1,5,single-choice,spatial-relational,1|5,7,1/5,220576,1
1,3,22,577,0,592,5,9,2,7,7,single-choice,spatial-relational,2|7,7,2/7,220577,2
1,3,22,578,1,531,5,7,1,1,6,single-choice,spatial-relational,1|6,7,1/6,220578,1
1,3,22,579,0,684,4,6,1,5,5,single-choice,spatial-relational,1|5,7,1/5,220579,1
1,3,22,580,1,615,1,13,6,6,7,single-choice,spatial-relational,6|7,7,6/7,220580,6
1,3,22,581,1,573,4,8,2,2,6,single-choice,spatial-relational,2|6,7,2/6,220581,2
1,3,22,582,1,662,3,5,1,1,4,single-choice,spatial-relational,1|4,7,1/4,220582,1
1,3,22,583,1,565,5,9,2,2,7,single-choice,spatial-relational,2|7,7,2/7,220583,2
1,3,22,584,1,549,4,10,3,3,7,single-choice,spatial-relational,3|7,7,3/7,220584,3
1,3,22,585,0,682,1,7,3,4,4,single-choice,spatial-relational,3|4,7,3/4,220585,3
1,3,22,586,1,582,1,7,3,3,4,single-choice,spatial-relational,3|4,7,3/4,220586,3
1,3,22,587,1,520,6,8,1,1,7,single-choice,spatial-relational,1|7,7,1/7,220587,1
1,3,22,588,1,491,2,12,5,5,7,single-choice,spatial-relational,5|7,7,5/7,220588,5
1,3,22,589,1,569,2,8,3,3,5,single-choice,spatial-relational,3|5,7,3/5,220589,3
1,3,22,590,1,608,1,11,5,5,6,single-choice,spatial-relational,5|6,7,5/6,220590,5
1,3,22,591,1,625,1,5,2,2,3,single-choice,spatial-relational,2|3,7,2/3,220591,2
1,3,22,592,1,724,5,9,2,2,7,single-choice,spatial-relational,2|7,7,2/7,220592,2
1,3,22,593,0,728,3,9,3,6,6,single-choice,spatial-relational,3|6,7,3/6,220593,3
1,3,22,594,1,711,3,7,2,2,5,single-choice,spatial-relational,2|5,7,2/5,220594,2
1,3,22,595,1,524,2,10,4,4,6,single-choice,spatial-relational,4|6,7,4/6,220595,4
1,3,22,596,1,521,1,13,6,6,7,single-choice,spatial-relational,6|7,7,6/7,220596,6
1,3,22,597,1,747,1,13,6,6,7,single-choice,spatial-relational,6|7,7,6/7,220597,6
1,3,22,598,1,734,1,3,1,1,2,single-choice,spatial-relational,1|2,7,1/2,220598,1
1,3,22,599,1,644,1,9,4,4,5,single-choice,spatial-relational,4|5,7,4/5,220599,4
1,3,22,600,1,662,6,8,1,1,7,single-choice,spatial-relational,1|7,7,1/7,220600,1
2,3,22,1,0,1117,6,8,1,7,7,single-choice,spatial-relational,1|7,7,1/7,220001,1
2,3,22,2,1,639,1,13,6,6,7,single-choice,spatial-relational,6|7,7,6/7,220002,6
2,3,22,3,0,716,6,8,1,7,7,single-choice,spatial-relational,1|7,7,1/7,220003,1
2,3,22,4,0,737,2,4,1,3,3,single-choice,spatial-relational,1|3,7,1/3,220004,1
2,3,22,5,1,526,3,9,3,3,6,single-choice,spatial-relational,3|6,7,3/6,220005,3
2,3,22,6,1,647,4,8,2,2,6,single-choice,spatial-relational,2|6,7,2/6,220006,2
2,3,22,7,1,575,2,12,5,5,7,single-choice,spatial-relational,5|7,7,5/7,220007,5
2,3,22,8,1,613,2,6,2,2,4,single-choice,spatial-relational,2|4,7,2/4,220008,2
2,3,22,9,1,568,4,10,3,3,7,single-choice,spatial-relational,3|7,7,3/7,220009,3
2,3,22,10,0,467,5,7,1,6,6,single-choice,spatial-relational,1|6,7,1/6,220010,1
2,3,22,11,0,56,3,11,4,7,7,single-choice,spatial-relational,4|7,7,4/7,220011,4
2,3,22,12,1,1421,4,6,1,1,5,single-choice,spatial-relational,1|5,7,1/5,220012,1
2,3,22,13,1,525,3,7,2,2,5,single-choice,spatial-relational,2|5,7,2/5,220013,2
2,3,22,14,0,596,1,5,2,3,3,single-choice,spatial-relational,2|3,7,2/3,220014,2
2,3,22,15,0,675,1,7,3,4,4,single-choice,spatial-relational,3|4,7,3/4,220015,3
2,3,22,16,1,518,3,5,1,1,4,single-choice,spatial-relational,1|4,7,1/4,220016,1
2,3,22,17,1,533,1,3,1,1,2,single-choice,spatial-relational,1|2,7,1/2,220017,1
2,3,22,18,1,493,2,12,5,5,7,single-choice,spatial-relational,5|7,7,5/7,220018,5
2,3,22,19,1,626,1,5,2,2,3,single-choice,spatial-relational,2|3,7,2/3,220019,2
2,3,22,20,0,485,1,11,5,6,6,single-choice,spatial-relational,5|6,7,5/6,220020,5
2,3,22,21,1,1858,3,7,2,2,5,single-choice,spatial-relational,2|5,7,2/5,220021,2
2,3,22,22,1,525,2,4,1,1,3,single-choice,spatial-relational,1|3,7,1/3,220022,1
2,3,22,23,1,485,5,9,2,2,7,single-choice,spatial-relational,2|7,7,2/7,220023,2
2,3,22,24,1,1150,3,9,3,3,6,single-choice,spatial-relational,3|6,7,3/6,220024,3
2,3,22,25,1,474,1,13,6,6,7,single-choice,spatial-relational,6|7,7,6/7,220025,6
2,3,22,26,1,685,5,7,1,1,6,single-choice,spatial-relational,1|6,7,1/6,220026,1
2,3,22,27,1,581,2,8,3,3,5,single-choice,spatial-relational,3|5,7,3/5,220027,3
2,3,22,28,0,1292,1,9,4,5,5,single-choice,spatial-relational,4|5,7,4/5,220028,4
2,3,22,29,0,679,4,8,2,6,6,single-choice,spatial-relational,2|6,7,2/6,220029,2
2,3,22,30,1,647,2,6,2,2,4,single-choice,spatial-relational,2|4,7,2/4,220030,2
2,3,22,31,1,483,3,11,4,4,7,single-choice,spatial-relational,4|7,7,4/7,220031,4
2,3,22,32,0,1341,2,10,4,6,6,single-choice,spatial-relational,4|6,7,4/6,220032,4
2,3,22,33,1,1233,5,9,2,2,7,single-choice,spatial-relational,2|7,7,2/7,220033,2
2,3,22,34,1,685,3,5,1,1,4,single-choice,spatial-relational,1|4,7,1/4,220034,1
2,3,22,35,1,654,1,3,1,1,2,single-choice,spatial-relational,1|2,7,1/2,220035,1
2,3,22,36,1,625,4,6,1,1,5,single-choice,spatial-relational,1|5,7,1/5,220036,1
2,3,22,37,1,571,4,10,3,3,7,single-choice,spatial-relational,3|7,7,3/7,220037,3
2,3,22,38,0,725,1,11,5,6,6,single-choice,spatial-relational,5|6,7,5/6,220038,5
2,3,22,39,1,549,2,8,3,3,5,single-choice,spatial-relational,3|5,7,3/5,220039,3
2,3,22,40,0,747,1,7,3,4,4,single-choice,spatial-relational,3|4,7,3/4,220040,3
2,3,22,41,1,1333,2,10,4,4,6,single-choice,spatial-relational,4|6,7,4/6,220041,4
2,3,22,42,0,564,1,9,4,5,5,single-choice,spatial-relational,4|5,7,4/5,220042,4
2,3,22,43,1,628,1,3,1,1,2,single-choice,spatial-relational,1|2,7,1/2,220043,1
2,3,22,44,1,1221,2,8,3,3,5,single-choice,spatial-relational,3|5,7,3/5,220044,3
2,3,22,45,1,553,3,9,3,3,6,single-choice,spatial-relational,3|6,7,3/6,220045,3
2,3,22,46,0,565,4,10,3,7,7,single-choice,spatial-relational,3|7,7,3/7,220046,3
2,3,22,47,1,503,4,10,3,3,7,single-choice,spatial-relational,3|7,7,3/7,220047,3
2,3,22,48,1,597,6,8,1,1,7,single-choice,spatial-relational,1|7,7,1/7,220048,1
2,3,22,49,1,627,2,4,1,1,3,single-choice,spatial-relational,1|3,7,1/3,220049,1
2,3,22,50,1,573,3,7,2,2,5,single-choice,spatial-relational,2|5,7,2/5,220050,2
2,3,22,51,0,635,1,9,4,5,5,single-choice,spatial-relational,4|5,7,4/5,220051,4
2,3,22,52,1,489,2,6,2,2,4,single-choice,spatial-relational,2|4,7,2/4,220052,2
2,3,22,53,1,476,5,9,2,2,7,single-choice,spatial-relational,2|7,7,2/7,220053,2
2,3,22,54,1,626,3,7,2,2,5,single-choice,spatial-relational,2|5,7,2/5,220054,2
2,3,22,55,1,493,6,8,1,1,7,single-choice,spatial-relational,1|7,7,1/7,220055,1
2,3,22,56,0,580,1,5,2,3,3,single-choice,spatial-relational,2|3,7,2/3,220056,2
2,3,22,57,1,635,3,9,3,3,6,single-choice,spatial-relational,3|6,7,3/6,220057,3
2,3,22,58,1,560,4,8,2,2,6,single-choice,spatial-relational,2|6,7,2/6,220058,2
2,3,22,59,1,515,1,13,6,6,7,single-choice,spatial-relational,6|7,7,6/7,220059,6
2,3,22,60,0,633,2,12,5,7,7,single-choice,spatial-relational,5|7,7,5/7,220060,5
2,3,22,61,1,572,2,6,2,2,4,single-choice,spatial-relational,2|4,7,2/4,220061,2
2,3,22,62,1,487,2,12,5,5,7,single-choice,spatial-relational,5|7,7,5/7,220062,5
2,3,22,63,1,548,1,7,3,3,4,single-choice,spatial-relational,3|4,7,3/4,220063,3
2,3,22,64,1,1228,5,7,1,1,6,single-choice,spatial-relational,1|6,7,1/6,220064,1
2,3,22,65,1,486,1,11,5,5,6,single-choice,spatial-relational,5|6,7,5/6,220065,5
2,3,22,66,1,585,1,3,1,1,2,single-choice,spatial-relational,1|2,7,1/2,220066,1
2,3,22,67,1,538,2,8,3,3,5,single-choice,spatial-relational,3|5,7,3/5,220067,3
2,3,22,68,1,1637,1,7,3,3,4,single-choice,spatial-relational,3|4,7,3/4,220068,3
2,3,22,69,1,454,2,10,4,4,6,single-choice,spatial-relational,4|6,7,4/6,220069,4
2,3,22,70,1,633,4,6,1,1,5,single-choice,spatial-relational,1|5,7,1/5,220070,1
2,3,22,71,1,576,2,4,1,1,3,single-choice,spatial-relational,1|3,7,1/3,220071,1
2,3,22,72,1,667,4,8,2,2,6,single-choice,spatial-relational,2|6,7,2/6,220072,2
2,3,22,73,1,592,5,7,1,1,6,single-choice,spatial-relational,1|6,7,1/6,220073,1
2,3,22,74,1,1090,2,10,4,4,6,single-choice,spatial-relational,4|6,7,4/6,220074,4
2,3,22,75,0,529,1,13,6,7,7,single-choice,spatial-relational,6|7,7,6/7,220075,6
2,3,22,76,1,571,1,5,2,2,3,single-choice,spatial-relational,2|3,7,2/3,220076,2
2,3,22,77,0,510,3,11,4,7,7,single-choice,spatial-relational,4|7,7,4/7,220077,4
2,3,22,78,1,787,4,6,1,1,5,single-choice,spatial-relational,1|5,7,1/5,220078,1
2,3,22,79,1,499,3,11,4,4,7,single-choice,spatial-relational,4|7,7,4/7,220079,4
2,3,22,80,1,684,1,11,5,5,6,single-choice,spatial-relational,5|6,7,5/6,220080,5
2,3,22,81,1,1250,1,9,4,4,5,single-choice,spatial-relational,4|5,7,4/5,220081,4
2,3,22,82,1,594,5,9,2,2,7,single-choice,spatial-relational,2|7,7,2/7,220082,2
2,3,22,83,1,502,3,5,1,1,4,single-choice,spatial-relational,1|4,7,1/4,220083,1
2,3,22,84,1,647,3,5,1,1,4,single-choice,spatial-relational,1|4,7,1/4,220084,1
2,3,22,85,1,470,1,13,6,6,7,single-choice,spatial-relational,6|7,7,6/7,220085,6
2,3,22,86,1,591,2,6,2,2,4,single-choice,spatial-relational,2|4,7,2/4,220086,2
2,3,22,87,1,576,3,5,1,1,4,single-choice,spatial-relational,1|4,7,1/4,220087,1
2,3,22,88,1,517,2,8,3,3,5,single-choice,spatial-relational,3|5,7,3/5,220088,3
2,3,22,89,1,623,3,7,2,2,5,single-choice,spatial-relational,2|5,7,2/5,220089,2
2,3,22,90,1,597,1,3,1,1,2,single-choice,spatial-relational,1|2,7,1/2,220090,1
2,3,22,91,1,470,3,9,3,3,6,single-choice,spatial-relational,3|6,7,3/6,220091,3
2,3,22,92,0,576,2,12,5,7,7,single-choice,spatial-relational,5|7,7,5/7,220092,5
2,3,22,93,0,742,5,7,1,6,6,single-choice,spatial-relational,1|6,7,1/6,220093,1
2,3,22,94,1,691,6,8,1,1,7,single-choice,spatial-relational,1|7,7,1/7,220094,1
2,3,22,95,1,537,2,4,1,1,3,single-choice,spatial-relational,1|3,7,1/3,220095,1
2,3,22,96,1,604,4,8,2,2,6,single-choice,spatial-relational,2|6,7,2/6,220096,2
2,3,22,97,0,534,1,9,4,5,5,single-choice,spatial-relational,4|5,7,4/5,220097,4
2,3,22,98,1,487,4,6,1,1,5,single-choice,spatial-relational,1|5,7,1/5,220098,1
2,3,22,99,1,583,2,10,4,4,6,single-choice,spatial-relational,4|6,7,4/6,220099,4
2,3,22,100,0,510,1,11,5,6,6,single-choice,spatial-relational,5|6,7,5/6,220100,5
2,3,22,101,1,442,1,3,1,1,2,single-choice,spatial-relational,1|2,7,1/2,220101,1
2,3,22,102,1,569,2,8,3,3,5,single-choice,spatial-relational,3|5,7,3/5,220102,3
2,3,22,103,1,728,1,9,4,4,5,single-choice,spatial-relational,4|5,7,4/5,220103,4
2,3,22,104,1,600,4,6,1,1,5,single-choice,spatial-relational,1|5,7,1/5,220104,1
2,3,22,105,1,509,1,7,3,3,4,single-choice,spatial-relational,3|4,7,3/4,220105,3
2,3,22,106,0,930,1,13,6,7,7,single-choice,spatial-relational,6|7,7,6/7,220106,6
2,3,22,107,0,676,4,10,3,7,7,single-choice,spatial-relational,3|7,7,3/7,220107,3
2,3,22,108,1,516,2,12,5,5,7,single-choice,spatial-relational,5|7,7,5/7,220108,5
2,3,22,109,1,547,2,10,4,4,6,single-choice,spatial-relational,4|6,7,4/6,220109,4
2,3,22,110,1,1187,3,9,3,3,6,single-choice,spatial-relational,3|6,7,3/6,220110,3
2,3,22,111,1,501,3,11,4,4,7,single-choice,spatial-relational,4|7,7,4/7,220111,4
2,3,22,112,1,601,2,4,1,1,3,single-choice,spatial-relational,1|3,7,1/3,220112,1
2,3,22,113,1,618,1,5,2,2,3,single-choice,spatial-relational,2|3,7,2/3,220113,2
2,3,22,114,1,654,1,7,3,3,4,single-choice,spatial-relational,3|4,7,3/4,220114,3
2,3,22,115,1,489,1,11,5,5,6,single-choice,spatial-relational,5|6,7,5/6,220115,5
2,3,22,116,1,570,3,5,1,1,4,single-choice,spatial-relational,1|4,7,1/4,220116,1
2,3,22,117,1,957,6,8,1,1,7,single-choice,spatial-relational,1|7,7,1/7,220117,1
2,3,22,118,1,503,4,10,3,3,7,single-choice,spatial-relational,3|7,7,3/7,220118,3
2,3,22,119,1,703,2,6,2,2,4,single-choice,spatial-relational,2|4,7,2/4,220119,2
2,3,22,120,1,587,4,8,2,2,6,single-choice,spatial-relational,2|6,7,2/6,220120,2
2,3,22,121,1,755,3,11,4,4,7,single-choice,spatial-relational,4|7,7,4/7,220121,4
2,3,22,122,0,585,1,5,2,3,3,single-choice,spatial-relational,2|3,7,2/3,220122,2
2,3,22,123,1,533,5,7,1,1,6,single-choice,spatial-relational,1|6,7,1/6,220123,1
2,3,22,124,1,624,5,9,2,2,7,single-choice,spatial-relational,2|7,7,2/7,220124,2
2,3,22,125,1,776,3,7,2,2,5,single-choice,spatial-relational,2|5,7,2/5,220125,2
2,3,22,126,1,625,5,9,2,2,7,single-choice,spatial-relational,2|7,7,2/7,220126,2
2,3,22,127,1,682,4,10,3,3,7,single-choice,spatial-relational,3|7,7,3/7,220127,3
2,3,22,128,1,615,1,5,2,2,3,single-choice,spatial-relational,2|3,7,2/3,220128,2
2,3,22,129,0,504,3,9,3,6,6,single-choice,spatial-relational,3|6,7,3/6,220129,3
2,3,22,130,1,558,3,5,1,1,4,single-choice,spatial-relational,1|4,7,1/4,220130,1
2,3,22,131,1,651,1,13,6,6,7,single-choice,spatial-relational,6|7,7,6/7,220131,6
2,3,22,132,1,1170,3,7,2,2,5,single-choice,spatial-relational,2|5,7,2/5,220132,2
2,3,22,133,1,607,1,5,2,2,3,single-choice,spatial-relational,2|3,7,2/3,220133,2
2,3,22,134,1,594,1,3,1,1,2,single-choice,spatial-relational,1|2,7,1/2,220134,1
2,3,22,135,1,643,1,7,3,3,4,single-choice,spatial-relational,3|4,7,3/4,220135,3
2,3,22,136,1,663,1,9,4,4,5,single-choice,spatial-relational,4|5,7,4/5,220136,4
2,3,22,137,1,1139,6,8,1,1,7,single-choice,spatial-relational,1|7,7,1/7,220137,1
2,3,22,138,1,510,3,9,3,3,6,single-choice,spatial-relational,3|6,7,3/6,220138,3
2,3,22,139,1,583,4,8,2,2,6,single-choice,spatial-relational,2|6,7,2/6,220139,2
2,3,22,140,1,654,2,6,2,2,4,single-choice,spatial-relational,2|4,7,2/4,220140,2
2,3,22,141,1,586,2,6,2,2,4,single-choice,spatial-relational,2|4,7,2/4,220141,2
2,3,22,142,1,710,4,8,2,2,6,single-choice,spatial-relational,2|6,7,2/6,220142,2
2,3,22,143,1,733,2,8,3,3,5,single-choice,spatial-relational,3|5,7,3/5,220143,3
2,3,22,144,1,618,6,8,1,1,7,single-choice,spatial-relational,1|7,7,1/7,220144,1
2,3,22,145,1,569,5,9,2,2,7,single-choice,spatial-relational,2|7,7,2/7,220145,2
2,3,22,146,1,472,3,11,4,4,7,single-choice,spatial-relational,4|7,7,4/7,220146,4
2,3,22,147,0,854,2,12,5,7,7,single-choice,spatial-relational,5|7,7,5/7,220147,5
2,3,22,148,1,615,5,7,1,1,6,single-choice,spatial-relational,1|6,7,1/6,220148,1
2,3,22,149,1,502,1,11,5,5,6,single-choice,spatial-relational,5|6,7,5/6,220149,5
2,3,22,150,0,1167,1,3,1,2,2,single-choice,spatial-relational,1|2,7,1/2,220150,1
2,3,22,151,1,591,4,6,1,1,5,single-choice,spatial-relational,1|5,7,1/5,220151,1
2,3,22,152,1,593,2,4,1,1,3,single-choice,spatial-relational,1|3,7,1/3,220152,1
2,3,22,153,1,483,5,9,2,2,7,single-choice,spatial-relational,2|7,7,2/7,220153,2
2,3,22,154,0,727,3,7,2,5,5,single-choice,spatial-relational,2|5,7,2/5,220154,2
2,3,22,155,0,798,1,9,4,5,5,single-choice,spatial-relational,4|5,7,4/5,220155,4
2,3,22,156,1,707,4,6,1,1,5,single-choice,spatial-relational,1|5,7,1/5,220156,1
2,3,22,157,1,517,1,7,3,3,4,single-choice,spatial-relational,3|4,7,3/4,220157,3
2,3,22,158,1,489,1,13,6,6,7,single-choice,spatial-relational,6|7,7,6/7,220158,6
2,3,22,159,1,556,4,10,3,3,7,single-choice,spatial-relational,3|7,7,3/7,220159,3
2,3,22,160,1,642,2,10,4,4,6,single-choice,spatial-relational,4|6,7,4/6,220160,4
2,3,22,161,1,737,5,7,1,1,6,single-choice,spatial-relational,1|6,7,1/6,220161,1
2,3,22,162,0,670,2,10,4,6,6,single-choice,spatial-relational,4|6,7,4/6,220162,4
2,3,22,163,1,782,2,4,1,1,3,single-choice,spatial-relational,1|3,7,1/3,220163,1
2,3,22,164,0,463,3,11,4,7,7,single-choice,spatial-relational,4|7,7,4/7,220164,4
2,3,22,165,0,594,1,11,5,6,6,single-choice,spatial-relational,5|6,7,5/6,220165,5
2,3,22,166,1,599,3,5,1,1,4,single-choice,spatial-relational,1|4,7,1/4,220166,1
2,3,22,167,1,534,2,8,3,3,5,single-choice,spatial-relational,3|5,7,3/5,220167,3
2,3,22,168,1,497,2,12,5,5,7,single-choice,spatial-relational,5|7,7,5/7,220168,5
2,3,22,169,1,611,2,4,1,1,3,single-choice,spatial-relational,1|3,7,1/3,220169,1
2,3,22,170,1,588,5,9,2,2,7,single-choice,spatial-relational,2|7,7,2/7,220170,2
2,3,22,171,1,590,1,5,2,2,3,single-choice,spatial-relational,2|3,7,2/3,220171,2
2,3,22,172,1,599,3,7,2,2,5,single-choice,spatial-relational,2|5,7,2/5,220172,2
2,3,22,173,1,657,1,9,4,4,5,single-choice,spatial-relational,4|5,7,4/5,220173,4
2,3,22,174,1,771,1,9,4,4,5,single-choice,spatial-relational,4|5,7,4/5,220174,4
2,3,22,175,1,634,2,6,2,2,4,single-choice,spatial-relational,2|4,7,2/4,220175,2
2,3,22,176,0,575,3,11,4,7,7,single-choice,spatial-relational,4|7,7,4/7,220176,4
2,3,22,177,1,604,2,4,1,1,3,single-choice,spatial-relational,1|3,7,1/3,220177,1
2,3,22,178,1,567,1,3,1,1,2,single-choice,spatial-relational,1|2,7,1/2,220178,1
2,3,22,179,1,670,5,7,1,1,6,single-choice,spatial-relational,1|6,7,1/6,220179,1
2,3,22,180,1,648,4,8,2,2,6,single-choice,spatial-relational,2|6,7,2/6,220180,2
2,3,22,181,1,765,2,12,5,5,7,single-choice,spatial-relational,5|7,7,5/7,220181,5
2,3,22,182,1,703,4,6,1,1,5,single-choice,spatial-relational,1|5,7,1/5,220182,1
2,3,22,183,1,614,1,7,3,3,4,single-choice,spatial-relational,3|4,7,3/4,220183,3
2,3,22,184,1,516,1,13,6,6,7,single-choice,spatial-relational,6|7,7,6/7,220184,6
2,3,22,185,1,623,6,8,1,1,7,single-choice,spatial-relational,1|7,7,1/7,220185,1
2,3,22,186,1,1178,1,5,2,2,3,single-choice,spatial-relational,2|3,7,2/3,220186,2
2,3,22,187,1,663,5,7,1,1,6,single-choice,spatial-relational,1|6,7,1/6,220187,1
2,3,22,188,1,635,4,10,3,3,7,single-choice,spatial-relational,3|7,7,3/7,220188,3
2,3,22,189,1,459,2,12,5,5,7,single-choice,spatial-relational,5|7,7,5/7,220189,5
2,3,22,190,1,544,4,6,1,1,5,single-choice,spatial-relational,1|5,7,1/5,220190,1
2,3,22,191,1,1183,3,5,1,1,4,single-choice,spatial-relational,1|4,7,1/4,220191,1
2,3,22,192,1,483,3,5,1,1,4,single-choice,spatial-relational,1|4,7,1/4,220192,1
2,3,22,193,0,1167,2,8,3,5,5,single-choice,spatial-relational,3|5,7,3/5,220193,3
2,3,22,194,0,651,2,10,4,6,6,single-choice,spatial-relational,4|6,7,4/6,220194,4
2,3,22,195,1,619,2,6,2,2,4,single-choice,spatial-relational,2|4,7,2/4,220195,2
2,3,22,196,1,664,1,3,1,1,2,single-choice,spatial-relational,1|2,7,1/2,220196,1
2,3,22,197,0,800,1,13,6,7,7,single-choice,spatial-relational,6|7,7,6/7,220197,6
2,3,22,198,1,631,1,11,5,5,6,single-choice,spatial-relational,5|6,7,5/6,220198,5
2,3,22,199,1,661,2,8,3,3,5,single-choice,spatial-relational,3|5,7,3/5,220199,3
2,3,22,200,1,476,3,11,4,4,7,single-choice,spatial-relational,4|7,7,4/7,220200,4
2,3,22,201,1,617,6,8,1,1,7,single-choice,spatial-relational,1|7,7,1/7,220201,1
2,3,22,202,0,705,1,7,3,4,4,single-choice,spatial-relational,3|4,7,3/4,220202,3
2,3,22,203,1,565,4,8,2,2,6,single-choice,spatial-relational,2|6,7,2/6,220203,2
2,3,22,204,0,620,2,10,4,6,6,single-choice,spatial-relational,4|6,7,4/6,220204,4
2,3,22,205,0,606,4,10,3,7,7,single-choice,spatial-relational,3|7,7,3/7,220205,3
2,3,22,206,1,657,3,7,2,2,5,single-choice,spatial-relational,2|5,7,2/5,220206,2
2,3,22,207,1,529,1,11,5,5,6,single-choice,spatial-relational,5|6,7,5/6,220207,5
2,3,22,208,1,1171,3,9,3,3,6,single-choice,spatial-relational,3|6,7,3/6,220208,3
2,3,22,209,1,645,5,9,2,2,7,single-choice,spatial-relational,2|7,7,2/7,220209,2
2,3,22,210,1,643,3,9,3,3,6,single-choice,spatial-relational,3|6,7,3/6,220210,3
2,3,22,211,1,673,4,10,3,3,7,single-choice,spatial-relational,3|7,7,3/7,220211,3
2,3,22,212,0,580,1,13,6,7,7,single-choice,spatial-relational,6|7,7,6/7,220212,6
2,3,22,213,1,526,2,4,1,1,3,single-choice,spatial-relational,1|3,7,1/3,220213,1
2,3,22,214,1,591,1,9,4,4,5,single-choice,spatial-relational,4|5,7,4/5,220214,4
2,3,22,215,1,1180,4,8,2,2,6,single-choice,spatial-relational,2|6,7,2/6,220215,2
2,3,22,216,1,506,2,6,2,2,4,single-choice,spatial-relational,2|4,7,2/4,220216,2
2,3,22,217,0,1726,1,11,5,6,6,single-choice,spatial-relational,5|6,7,5/6,220217,5
2,3,22,218,1,673,4,6,1,1,5,single-choice,spatial-relational,1|5,7,1/5,220218,1
2,3,22,219,1,683,2,8,3,3,5,single-choice,spatial-relational,3|5,7,3/5,220219,3
2,3,22,220,1,664,5,7,1,1,6,single-choice,spatial-relational,1|6,7,1/6,220220,1
2,3,22,221,1,508,5,7,1,1,6,single-choice,spatial-relational,1|6,7,1/6,220221,1
2,3,22,222,1,733,3,11,4,4,7,single-choice,spatial-relational,4|7,7,4/7,220222,4
2,3,22,223,1,616,3,9,3,3,6,single-choice,spatial-relational,3|6,7,3/6,220223,3
2,3,22,224,1,604,1,3,1,1,2,single-choice,spatial-relational,1|2,7,1/2,220224,1
2,3,22,225,1,541,4,6,1,1,5,single-choice,spatial-relational,1|5,7,1/5,220225,1
2,3,22,226,1,632,3,11,4,4,7,single-choice,spatial-relational,4|7,7,4/7,220226,4
2,3,22,227,1,662,3,9,3,3,6,single-choice,spatial-relational,3|6,7,3/6,220227,3
2,3,22,228,1,569,4,8,2,2,6,single-choice,spatial-relational,2|6,7,2/6,220228,2
2,3,22,229,1,606,3,5,1,1,4,single-choice,spatial-relational,1|4,7,1/4,220229,1
2,3,22,230,1,561,1,5,2,2,3,single-choice,spatial-relational,2|3,7,2/3,220230,2
2,3,22,231,1,497,6,8,1,1,7,single-choice,spatial-relational,1|7,7,1/7,220231,1
2,3,22,232,1,565,2,6,2,2,4,single-choice,spatial-relational,2|4,7,2/4,220232,2
2,3,22,233,1,578,6,8,1,1,7,single-choice,spatial-relational,1|7,7,1/7,220233,1
2,3,22,234,1,469,4,10,3,3,7,single-choice,spatial-relational,3|7,7,3/7,220234,3
2,3,22,235,1,636,3,7,2,2,5,single-choice,spatial-relational,2|5,7,2/5,220235,2
2,3,22,236,1,557,1,3,1,1,2,single-choice,spatial-relational,1|2,7,1/2,220236,1
2,3,22,237,0,615,1,9,4,5,5,single-choice,spatial-relational,4|5,7,4/5,220237,4
2,3,22,238,1,697,2,12,5,5,7,single-choice,spatial-relational,5|7,7,5/7,220238,5
2,3,22,239,1,491,2,12,5,5,7,single-choice,spatial-relational,5|7,7,5/7,220239,5
2,3,22,240,1,516,1,13,6,6,7,single-choice,spatial-relational,6|7,7,6/7,220240,6
2,3,22,241,1,1188,2,10,4,4,6,single-choice,spatial-relational,4|6,7,4/6,220241,4
2,3,22,242,1,640,5,9,2,2,7,single-choice,spatial-relational,2|7,7,2/7,220242,2
2,3,22,243,1,611,5,9,2,2,7,single-choice,spatial-relational,2|7,7,2/7,220243,2
2,3,22,244,0,479,1,11,5,6,6,single-choice,spatial-relational,5|6,7,5/6,220244,5
2,3,22,245,1,517,3,5,1,1,4,single-choice,spatial-relational,1|4,7,1/4,220245,1
2,3,22,246,1,548,1,7,3,3,4,single-choice,spatial-relational,3|4,7,3/4,220246,3
2,3,22,247,1,591,1,5,2,2,3,single-choice,spatial-relational,2|3,7,2/3,220247,2
2,3,22,248,0,717,2,8,3,5,5,single-choice,spatial-relational,3|5,7,3/5,220248,3
2,3,22,249,1,474,3,7,2,2,5,single-choice,spatial-relational,2|5,7,2/5,220249,2
2,3,22,250,1,593,2,4,1,1,3,single-choice,spatial-relational,1|3,7,1/3,220250,1
2,3,22,251,1,481,1,7,3,3,4,single-choice,spatial-relational,3|4,7,3/4,220251,3
2,3,22,252,0,642,2,10,4,6,6,single-choice,spatial-relational,4|6,7,4/6,220252,4
2,3,22,253,1,466,1,13,6,6,7,single-choice,spatial-relational,6|7,7,6/7,220253,6
2,3,22,254,1,592,5,9,2,2,7,single-choice,spatial-relational,2|7,7,2/7,220254,2
2,3,22,255,1,519,4,6,1,1,5,single-choice,spatial-relational,1|5,7,1/5,220255,1
2,3,22,256,1,525,2,12,5,5,7,single-choice,spatial-relational,5|7,7,5/7,220256,5
2,3,22,257,1,568,1,5,2,2,3,single-choice,spatial-relational,2|3,7,2/3,220257,2
2,3,22,258,0,832,2,8,3,5,5,single-choice,spatial-relational,3|5,7,3/5,220258,3
2,3,22,259,1,754,1,11,5,5,6,single-choice,spatial-relational,5|6,7,5/6,220259,5
2,3,22,260,1,606,6,8,1,1,7,single-choice,spatial-relational,1|7,7,1/7,220260,1
2,3,22,261,0,522,3,11,4,7,7,single-choice,spatial-relational,4|7,7,4/7,220261,4
2,3,22,262,1,534,2,10,4,4,6,single-choice,spatial-relational,4|6,7,4/6,220262,4
2,3,22,263,0,625,4,10,3,7,7,single-choice,spatial-relational,3|7,7,3/7,220263,3
2,3,22,264,1,620,3,11,4,4,7,single-choice,spatial-relational,4|7,7,4/7,220264,4
2,3,22,265,1,652,3,9,3,3,6,single-choice,spatial-relational,3|6,7,3/6,220265,3
2,3,22,266,1,540,5,7,1,1,6,single-choice,spatial-relational,1|6,7,1/6,220266,1
2,3,22,267,1,635,4,8,2,2,6,single-choice,spatial-relational,2|6,7,2/6,220267,2
2,3,22,268,1,571,1,3,1,1,2,single-choice,spatial-relational,1|2,7,1/2,220268,1
2,3,22,269,1,504,6,8,1,1,7,single-choice,spatial-relational,1|7,7,1/7,220269,1
2,3,22,270,0,537,1,5,2,3,3,single-choice,spatial-relational,2|3,7,2/3,220270,2
2,3,22,271,1,474,2,6,2,2,4,single-choice,spatial-relational,2|4,7,2/4,220271,2
2,3,22,272,1,543,2,4,1,1,3,single-choice,spatial-relational,1|3,7,1/3,220272,1
2,3,22,273,1,484,4,10,3,3,7,single-choice,spatial-relational,3|7,7,3/7,220273,3
2,3,22,274,1,525,1,7,3,3,4,single-choice,spatial-relational,3|4,7,3/4,220274,3
2,3,22,275,1,1209,2,4,1,1,3,single-choice,spatial-relational,1|3,7,1/3,220275,1
2,3,22,276,0,525,1,9,4,5,5,single-choice,spatial-relational,4|5,7,4/5,220276,4
2,3,22,277,1,734,1,13,6,6,7,single-choice,spatial-relational,6|7,7,6/7,220277,6
2,3,22,278,0,988,1,11,5,6,6,single-choice,spatial-relational,5|6,7,5/6,220278,5
2,3,22,279,1,526,4,8,2,2,6,single-choice,spatial-relational,2|6,7,2/6,220279,2
2,3,22,280,1,575,1,7,3,3,4,single-choice,spatial-relational,3|4,7,3/4,220280,3
2,3,22,281,1,540,2,8,3,3,5,single-choice,spatial-relational,3|5,7,3/5,220281,3
2,3,22,282,1,761,5,9,2,2,7,single-choice,spatial-relational,2|7,7,2/7,220282,2
2,3,22,283,1,680,2,6,2,2,4,single-choice,spatial-relational,2|4,7,2/4,220283,2
2,3,22,284,1,577,3,5,1,1,4,single-choice,spatial-relational,1|4,7,1/4,220284,1
2,3,22,285,1,640,3,7,2,2,5,single-choice,spatial-relational,2|5,7,2/5,220285,2
2,3,22,286,0,500,2,10,4,6,6,single-choice,spatial-relational,4|6,7,4/6,220286,4
2,3,22,287,1,488,3,5,1,1,4,single-choice,spatial-relational,1|4,7,1/4,220287,1
2,3,22,288,1,680,3,7,2,2,5,single-choice,spatial-relational,2|5,7,2/5,220288,2
2,3,22,289,1,650,5,7,1,1,6,single-choice,spatial-relational,1|6,7,1/6,220289,1
2,3,22,290,1,599,3,9,3,3,6,single-choice,spatial-relational,3|6,7,3/6,220290,3
2,3,22,291,1,581,1,9,4,4,5,single-choice,spatial-relational,4|5,7,4/5,220291,4
2,3,22,292,0,535,2,12,5,7,7,single-choice,spatial-relational,5|7,7,5/7,220292,5
2,3,22,293,1,535,1,3,1,1,2,single-choice,spatial-relational,1|2,7,1/2,220293,1
2,3,22,294,1,1220,4,6,1,1,5,single-choice,spatial-relational,1|5,7,1/5,220294,1
2,3,22,295,1,523,4,6,1,1,5,single-choice,spatial-relational,1|5,7,1/5,220295,1
2,3,22,296,1,505,2,12,5,5,7,single-choice,spatial-relational,5|7,7,5/7,220296,5
2,3,22,297,1,632,1,5,2,2,3,single-choice,spatial-relational,2|3,7,2/3,220297,2
2,3,22,298,1,525,2,4,1,1,3,single-choice,spatial-relational,1|3,7,1/3,220298,1
2,3,22,299,1,930,2,12,5,5,7,single-choice,spatial-relational,5|7,7,5/7,220299,5
2,3,22,300,0,641,1,13,6,7,7,single-choice,spatial-relational,6|7,7,6/7,220300,6
2,3,22,301,1,652,4,8,2,2,6,single-choice,spatial-relational,2|6,7,2/6,220301,2
2,3,22,302,1,500,4,10,3,3,7,single-choice,spatial-relational,3|7,7,3/7,220302,3
2,3,22,303,1,811,4,10,3,3,7,single-choice,spatial-relational,3|7,7,3/7,220303,3
2,3,22,304,1,671,6,8,1,1,7,single-choice,spatial-relational,1|7,7,1/7,220304,1
2,3,22,305,1,618,1,9,4,4,5,single-choice,spatial-relational,4|5,7,4/5,220305,4
2,3,22,306,1,531,1,11,5,5,6,single-choice,spatial-relational,5|6,7,5/6,220306,5
2,3,22,307,1,593,5,7,1,1,6,single-choice,spatial-relational,1|6,7,1/6,220307,1
2,3,22,308,0,704,1,3,1,2,2,single-choice,spatial-relational,1|2,7,1/2,220308,1
2,3,22,309,1,601,1,3,1,1,2,single-choice,spatial-relational,1|2,7,1/2,220309,1
2,3,22,310,1,822,4,8,2,2,6,single-choice,spatial-relational,2|6,7,2/6,220310,2
2,3,22,311,0,653,2,10,4,6,6,single-choice,spatial-relational,4|6,7,4/6,220311,4
2,3,22,312,1,1228,3,7,2,2,5,single-choice,spatial-relational,2|5,7,2/5,220312,2
2,3,22,313,1,702,5,9,2,2,7,single-choice,spatial-relational,2|7,7,2/7,220313,2
2,3,22,314,1,577,1,7,3,3,4,single-choice,spatial-relational,3|4,7,3/4,220314,3
2,3,22,315,1,663,3,9,3,3,6,single-choice,spatial-relational,3|6,7,3/6,220315,3
2,3,22,316,1,663,3,5,1,1,4,single-choice,spatial-relational,1|4,7,1/4,220316,1
2,3,22,317,1,634,6,8,1,1,7,single-choice,spatial-relational,1|7,7,1/7,220317,1
2,3,22,318,1,657,4,6,1,1,5,single-choice,spatial-relational,1|5,7,1/5,220318,1
2,3,22,319,1,631,2,10,4,4,6,single-choice,spatial-relational,4|6,7,4/6,220319,4
2,3,22,320,0,1308,1,7,3,4,4,single-choice,spatial-relational,3|4,7,3/4,220320,3
2,3,22,321,0,1337,2,8,3,5,5,single-choice,spatial-relational,3|5,7,3/5,220321,3
2,3,22,322,1,667,1,13,6,6,7,single-choice,spatial-relational,6|7,7,6/7,220322,6
2,3,22,323,1,631,2,4,1,1,3,single-choice,spatial-relational,1|3,7,1/3,220323,1
2,3,22,324,1,719,3,11,4,4,7,single-choice,spatial-relational,4|7,7,4/7,220324,4
2,3,22,325,0,725,1,11,5,6,6,single-choice,spatial-relational,5|6,7,5/6,220325,5
2,3,22,326,1,588,2,6,2,2,4,single-choice,spatial-relational,2|4,7,2/4,220326,2
2,3,22,327,1,1247,5,7,1,1,6,single-choice,spatial-relational,1|6,7,1/6,220327,1
2,3,22,328,1,556,3,11,4,4,7,single-choice,spatial-relational,4|7,7,4/7,220328,4
2,3,22,329,1,642,1,5,2,2,3,single-choice,spatial-relational,2|3,7,2/3,220329,2
2,3,22,330,1,617,3,5,1,1,4,single-choice,spatial-relational,1|4,7,1/4,220330,1
2,3,22,331,1,580,3,7,2,2,5,single-choice,spatial-relational,2|5,7,2/5,220331,2
2,3,22,332,1,602,2,6,2,2,4,single-choice,spatial-relational,2|4,7,2/4,220332,2
2,3,22,333,1,521,1,9,4,4,5,single-choice,spatial-relational,4|5,7,4/5,220333,4
2,3,22,334,0,743,3,9,3,6,6,single-choice,spatial-relational,3|6,7,3/6,220334,3
2,3,22,335,1,642,2,8,3,3,5,single-choice,spatial-relational,3|5,7,3/5,220335,3
2,3,22,336,1,639,5,9,2,2,7,single-choice,spatial-relational,2|7,7,2/7,220336,2
2,3,22,337,1,542,2,6,2,2,4,single-choice,spatial-relational,2|4,7,2/4,220337,2
2,3,22,338,1,582,6,8,1,1,7,single-choice,spatial-relational,1|7,7,1/7,220338,1
2,3,22,339,0,596,3,11,4,7,7,single-choice,spatial-relational,4|7,7,4/7,220339,4
2,3,22,340,1,589,1,7,3,3,4,single-choice,spatial-relational,3|4,7,3/4,220340,3
2,3,22,341,1,588,2,6,2,2,4,single-choice,spatial-relational,2|4,7,2/4,220341,2
2,3,22,342,1,704,4,8,2,2,6,single-choice,spatial-relational,2|6,7,2/6,220342,2
2,3,22,343,1,733,4,6,1,1,5,single-choice,spatial-relational,1|5,7,1/5,220343,1
2,3,22,344,1,592,1,5,2,2,3,single-choice,spatial-relational,2|3,7,2/3,220344,2
2,3,22,345,1,592,6,8,1,1,7,single-choice,spatial-relational,1|7,7,1/7,220345,1
2,3,22,346,1,509,5,7,1,1,6,single-choice,spatial-relational,1|6,7,1/6,220346,1
2,3,22,347,0,560,2,10,4,6,6,single-choice,spatial-relational,4|6,7,4/6,220347,4
2,3,22,348,1,536,5,9,2,2,7,single-choice,spatial-relational,2|7,7,2/7,220348,2
2,3,22,349,1,644,1,11,5,5,6,single-choice,spatial-relational,5|6,7,5/6,220349,5
2,3,22,350,1,1225,2,10,4,4,6,single-choice,spatial-relational,4|6,7,4/6,220350,4
2,3,22,351,1,1105,5,9,2,2,7,single-choice,spatial-relational,2|7,7,2/7,220351,2
2,3,22,352,1,663,3,7,2,2,5,single-choice,spatial-relational,2|5,7,2/5,220352,2
2,3,22,353,1,615,1,3,1,1,2,single-choice,spatial-relational,1|2,7,1/2,220353,1
2,3,22,354,1,615,2,8,3,3,5,single-choice,spatial-relational,3|5,7,3/5,220354,3
2,3,22,355,1,454,1,13,6,6,7,single-choice,spatial-relational,6|7,7,6/7,220355,6
2,3,22,356,1,655,3,9,3,3,6,single-choice,spatial-relational,3|6,7,3/6,220356,3
2,3,22,357,1,672,5,7,1,1,6,single-choice,spatial-relational,1|6,7,1/6,220357,1
2,3,22,358,0,744,3,11,4,7,7,single-choice,spatial-relational,4|7,7,4/7,220358,4
2,3,22,359,1,545,1,7,3,3,4,single-choice,spatial-relational,3|4,7,3/4,220359,3
2,3,22,360,1,1309,4,10,3,3,7,single-choice,spatial-relational,3|7,7,3/7,220360,3
2,3,22,361,1,742,3,7,2,2,5,single-choice,spatial-relational,2|5,7,2/5,220361,2
2,3,22,362,1,682,3,5,1,1,4,single-choice,spatial-relational,1|4,7,1/4,220362,1
2,3,22,363,1,543,1,9,4,4,5,single-choice,spatial-relational,4|5,7,4/5,220363,4
2,3,22,364,1,540,2,12,5,5,7,single-choice,spatial-relational,5|7,7,5/7,220364,5
2,3,22,365,0,644,2,12,5,7,7,single-choice,spatial-relational,5|7,7,5/7,220365,5
2,3,22,366,1,455,4,10,3,3,7,single-choice,spatial-relational,3|7,7,3/7,220366,3
2,3,22,367,0,704,3,5,1,4,4,single-choice,spatial-relational,1|4,7,1/4,220367,1
2,3,22,368,1,693,4,6,1,1,5,single-choice,spatial-relational,1|5,7,1/5,220368,1
2,3,22,369,1,712,4,8,2,2,6,single-choice,spatial-relational,2|6,7,2/6,220369,2
2,3,22,370,0,724,2,4,1,3,3,single-choice,spatial-relational,1|3,7,1/3,220370,1
2,3,22,371,1,642,1,9,4,4,5,single-choice,spatial-relational,4|5,7,4/5,220371,4
2,3,22,372,1,618,1,3,1,1,2,single-choice,spatial-relational,1|2,7,1/2,220372,1
2,3,22,373,0,701,2,8,3,5,5,single-choice,spatial-relational,3|5,7,3/5,220373,3
2,3,22,374,1,521,3,9,3,3,6,single-choice,spatial-relational,3|6,7,3/6,220374,3
2,3,22,375,1,586,2,4,1,1,3,single-choice,spatial-relational,1|3,7,1/3,220375,1
2,3,22,376,1,1255,1,11,5,5,6,single-choice,spatial-relational,5|6,7,5/6,220376,5
2,3,22,377,0,597,1,13,6,7,7,single-choice,spatial-relational,6|7,7,6/7,220377,6
2,3,22,378,1,660,1,5,2,2,3,single-choice,spatial-relational,2|3,7,2/3,220378,2
2,3,22,379,1,526,2,12,5,5,7,single-choice,spatial-relational,5|7,7,5/7,220379,5
2,3,22,380,1,710,3,7,2,2,5,single-choice,spatial-relational,2|5,7,2/5,220380,2
2,3,22,381,1,634,1,5,2,2,3,single-choice,spatial-relational,2|3,7,2/3,220381,2
2,3,22,382,1,526,2,10,4,4,6,single-choice,spatial-relational,4|6,7,4/6,220382,4
2,3,22,383,0,664,3,11,4,7,7,single-choice,spatial-relational,4|7,7,4/7,220383,4
2,3,22,384,0,653,1,3,1,2,2,single-choice,spatial-relational,1|2,7,1/2,220384,1
2,3,22,385,1,646,1,11,5,5,6,single-choice,spatial-relational,5|6,7,5/6,220385,5
2,3,22,386,1,567,3,9,3,3,6,single-choice,spatial-relational,3|6,7,3/6,220386,3
2,3,22,387,1,677,2,8,3,3,5,single-choice,spatial-relational,3|5,7,3/5,220387,3
2,3,22,388,1,684,4,6,1,1,5,single-choice,spatial-relational,1|5,7,1/5,220388,1
2,3,22,389,1,576,1,3,1,1,2,single-choice,spatial-relational,1|2,7,1/2,220389,1
2,3,22,390,1,462,1,13,6,6,7,single-choice,spatial-relational,6|7,7,6/7,220390,6
2,3,22,391,1,613,2,10,4,4,6,single-choice,spatial-relational,4|6,7,4/6,220391,4
2,3,22,392,1,570,1,7,3,3,4,single-choice,spatial-relational,3|4,7,3/4,220392,3
2,3,22,393,0,890,2,12,5,7,7,single-choice,spatial-relational,5|7,7,5/7,220393,5
2,3,22,394,1,667,4,8,2,2,6,single-choice,spatial-relational,2|6,7,2/6,220394,2
2,3,22,395,1,513,3,11,4,4,7,single-choice,spatial-relational,4|7,7,4/7,220395,4
2,3,22,396,1,524,4,10,3,3,7,single-choice,spatial-relational,3|7,7,3/7,220396,3
2,3,22,397,1,546,2,6,2,2,4,single-choice,spatial-relational,2|4,7,2/4,220397,2
2,3,22,398,1,507,6,8,1,1,7,single-choice,spatial-relational,1|7,7,1/7,220398,1
2,3,22,399,1,583,2,8,3,3,5,single-choice,spatial-relational,3|5,7,3/5,220399,3
2,3,22,400,1,707,4,8,2,2,6,single-choice,spatial-relational,2|6,7,2/6,220400,2
2,3,22,401,1,596,6,8,1,1,7,single-choice,spatial-relational,1|7,7,1/7,220401,1
2,3,22,402,1,534,2,4,1,1,3,single-choice,spatial-relational,1|3,7,1/3,220402,1
2,3,22,403,1,620,4,6,1,1,5,single-choice,spatial-relational,1|5,7,1/5,220403,1
2,3,22,404,1,610,2,6,2,2,4,single-choice,spatial-relational,2|4,7,2/4,220404,2
2,3,22,405,1,686,1,13,6,6,7,single-choice,spatial-relational,6|7,7,6/7,220405,6
2,3,22,406,0,1209,1,7,3,4,4,single-choice,spatial-relational,3|4,7,3/4,220406,3
2,3,22,407,1,573,4,10,3,3,7,single-choice,spatial-relational,3|7,7,3/7,220407,3
2,3,22,408,1,599,3,9,3,3,6,single-choice,spatial-relational,3|6,7,3/6,220408,3
2,3,22,409,0,517,1,11,5,6,6,single-choice,spatial-relational,5|6,7,5/6,220409,5
2,3,22,410,1,494,3,5,1,1,4,single-choice,spatial-relational,1|4,7,1/4,220410,1
2,3,22,411,1,580,5,9,2,2,7,single-choice,spatial-relational,2|7,7,2/7,220411,2
2,3,22,412,1,612,1,5,2,2,3,single-choice,spatial-relational,2|3,7,2/3,220412,2
2,3,22,413,1,613,5,7,1,1,6,single-choice,spatial-relational,1|6,7,1/6,220413,1
2,3,22,414,1,541,2,4,1,1,3,single-choice,spatial-relational,1|3,7,1/3,220414,1
2,3,22,415,1,515,5,9,2,2,7,single-choice,spatial-relational,2|7,7,2/7,220415,2
2,3,22,416,1,608,1,9,4,4,5,single-choice,spatial-relational,4|5,7,4/5,220416,4
2,3,22,417,0,1198,3,7,2,5,5,single-choice,spatial-relational,2|5,7,2/5,220417,2
2,3,22,418,0,701,1,9,4,5,5,single-choice,spatial-relational,4|5,7,4/5,220418,4
2,3,22,419,1,486,5,7,1,1,6,single-choice,spatial-relational,1|6,7,1/6,220419,1
2,3,22,420,1,714,3,5,1,1,4,single-choice,spatial-relational,1|4,7,1/4,220420,1
2,3,22,421,0,661,2,10,4,6,6,single-choice,spatial-relational,4|6,7,4/6,220421,4
2,3,22,422,1,611,2,6,2,2,4,single-choice,spatial-relational,2|4,7,2/4,220422,2
2,3,22,423,1,781,3,7,2,2,5,single-choice,spatial-relational,2|5,7,2/5,220423,2
2,3,22,424,0,668,2,12,5,7,7,single-choice,spatial-relational,5|7,7,5/7,220424,5
2,3,22,425,1,611,2,4,1,1,3,single-choice,spatial-relational,1|3,7,1/3,220425,1
2,3,22,426,1,582,3,5,1,1,4,single-choice,spatial-relational,1|4,7,1/4,220426,1
2,3,22,427,1,570,5,9,2,2,7,single-choice,spatial-relational,2|7,7,2/7,220427,2
2,3,22,428,1,683,3,11,4,4,7,single-choice,spatial-relational,4|7,7,4/7,220428,4
2,3,22,429,1,1126,3,9,3,3,6,single-choice,spatial-relational,3|6,7,3/6,220429,3
2,3,22,430,1,1198,1,11,5,5,6,single-choice,spatial-relational,5|6,7,5/6,220430,5
2,3,22,431,1,642,2,8,3,3,5,single-choice,spatial-relational,3|5,7,3/5,220431,3
2,3,22,432,1,1589,4,6,1,1,5,single-choice,spatial-relational,1|5,7,1/5,220432,1
2,3,22,433,1,615,5,7,1,1,6,single-choice,spatial-relational,1|6,7,1/6,220433,1
2,3,22,434,0,592,1,13,6,7,7,single-choice,spatial-relational,6|7,7,6/7,220434,6
2,3,22,435,1,572,1,7,3,3,4,single-choice,spatial-relational,3|4,7,3/4,220435,3
2,3,22,436,0,1135,2,4,1,3,3,single-choice,spatial-relational,1|3,7,1/3,220436,1
2,3,22,437,1,502,1,7,3,3,4,single-choice,spatial-relational,3|4,7,3/4,220437,3
2,3,22,438,1,624,5,7,1,1,6,single-choice,spatial-relational,1|6,7,1/6,220438,1
2,3,22,439,0,645,1,9,4,5,5,single-choice,spatial-relational,4|5,7,4/5,220439,4
2,3,22,440,1,504,4,10,3,3,7,single-choice,spatial-relational,3|7,7,3/7,220440,3
2,3,22,441,1,585,4,10,3,3,7,single-choice,spatial-relational,3|7,7,3/7,220441,3
2,3,22,442,1,610,1,5,2,2,3,single-choice,spatial-relational,2|3,7,2/3,220442,2
2,3,22,443,1,613,1,3,1,1,2,single-choice,spatial-relational,1|2,7,1/2,220443,1
2,3,22,444,1,624,1,3,1,1,2,single-choice,spatial-relational,1|2,7,1/2,220444,1
2,3,22,445,1,536,2,6,2,2,4,single-choice,spatial-relational,2|4,7,2/4,220445,2
2,3,22,446,1,530,6,8,1,1,7,single-choice,spatial-relational,1|7,7,1/7,220446,1
2,3,22,447,0,680,2,8,3,5,5,single-choice,spatial-relational,3|5,7,3/5,220447,3
2,3,22,448,1,775,4,6,1,1,5,single-choice,spatial-relational,1|5,7,1/5,220448,1
2,3,22,449,1,581,1,5,2,2,3,single-choice,spatial-relational,2|3,7,2/3,220449,2
2,3,22,450,0,659,1,11,5,6,6,single-choice,spatial-relational,5|6,7,5/6,220450,5
2,3,22,451,1,636,1,9,4,4,5,single-choice,spatial-relational,4|5,7,4/5,220451,4
2,3,22,452,1,583,3,7,2,2,5,single-choice,spatial-relational,2|5,7,2/5,220452,2
2,3,22,453,1,511,3,11,4,4,7,single-choice,spatial-relational,4|7,7,4/7,220453,4
2,3,22,454,1,661,2,10,4,4,6,single-choice,spatial-relational,4|6,7,4/6,220454,4
2,3,22,455,1,639,3,9,3,3,6,single-choice,spatial-relational,3|6,7,3/6,220455,3
2,3,22,456,1,627,6,8,1,1,7,single-choice,spatial-relational,1|7,7,1/7,220456,1
2,3,22,457,1,493,3,5,1,1,4,single-choice,spatial-relational,1|4,7,1/4,220457,1
2,3,22,458,1,484,1,13,6,6,7,single-choice,spatial-relational,6|7,7,6/7,220458,6
2,3,22,459,1,768,5,9,2,2,7,single-choice,spatial-relational,2|7,7,2/7,220459,2
2,3,22,460,1,526,2,12,5,5,7,single-choice,spatial-relational,5|7,7,5/7,220460,5
2,3,22,461,1,710,4,8,2,2,6,single-choice,spatial-relational,2|6,7,2/6,220461,2
2,3,22,462,1,693,4,8,2,2,6,single-choice,spatial-relational,2|6,7,2/6,220462,2
2,3,22,463,1,615,6,8,1,1,7,single-choice,spatial-relational,1|7,7,1/7,220463,1
2,3,22,464,1,530,3,5,1,1,4,single-choice,spatial-relational,1|4,7,1/4,220464,1
2,3,22,465,0,652,4,10,3,7,7,single-choice,spatial-relational,3|7,7,3/7,220465,3
2,3,22,466,1,633,3,9,3,3,6,single-choice,spatial-relational,3|6,7,3/6,220466,3
2,3,22,467,1,619,3,7,2,2,5,single-choice,spatial-relational,2|5,7,2/5,220467,2
2,3,22,468,1,556,1,3,1,1,2,single-choice,spatial-relational,1|2,7,1/2,220468,1
2,3,22,469,0,486,2,12,5,7,7,single-choice,spatial-relational,5|7,7,5/7,220469,5
2,3,22,470,1,668,4,8,2,2,6,single-choice,spatial-relational,2|6,7,2/6,220470,2
2,3,22,471,1,483,6,8,1,1,7,single-choice,spatial-relational,1|7,7,1/7,220471,1
2,3,22,472,1,597,4,10,3,3,7,single-choice,spatial-relational,3|7,7,3/7,220472,3
2,3,22,473,1,518,4,6,1,1,5,single-choice,spatial-relational,1|5,7,1/5,220473,1
2,3,22,474,1,606,2,10,4,4,6,single-choice,spatial-relational,4|6,7,4/6,220474,4
2,3,22,475,1,505,2,12,5,5,7,single-choice,spatial-relational,5|7,7,5/7,220475,5
2,3,22,476,1,520,2,6,2,2,4,single-choice,spatial-relational,2|4,7,2/4,220476,2
2,3,22,477,0,780,2,4,1,3,3,single-choice,spatial-relational,1|3,7,1/3,220477,1
2,3,22,478,1,1151,1,11,5,5,6,single-choice,spatial-relational,5|6,7,5/6,220478,5
2,3,22,479,0,874,3,11,4,7,7,single-choice,spatial-relational,4|7,7,4/7,220479,4
2,3,22,480,1,624,2,4,1,1,3,single-choice,spatial-relational,1|3,7,1/3,220480,1
2,3,22,481,1,470,3,11,4,4,7,single-choice,spatial-relational,4|7,7,4/7,220481,4
2,3,22,482,1,592,1,5,2,2,3,single-choice,spatial-relational,2|3,7,2/3,220482,2
2,3,22,483,1,615,2,8,3,3,5,single-choice,spatial-relational,3|5,7,3/5,220483,3
2,3,22,484,1,554,2,8,3,3,5,single-choice,spatial-relational,3|5,7,3/5,220484,3
2,3,22,485,1,547,3,9,3,3,6,single-choice,spatial-relational,3|6,7,3/6,220485,3
2,3,22,486,1,614,1,9,4,4,5,single-choice,spatial-relational,4|5,7,4/5,220486,4
2,3,22,487,1,513,2,10,4,4,6,single-choice,spatial-relational,4|6,7,4/6,220487,4
2,3,22,488,1,478,1,13,6,6,7,single-choice,spatial-relational,6|7,7,6/7,220488,6
2,3,22,489,1,1274,3,7,2,2,5,single-choice,spatial-relational,2|5,7,2/5,220489,2
2,3,22,490,1,592,1,3,1,1,2,single-choice,spatial-relational,1|2,7,1/2,220490,1
2,3,22,491,1,524,5,9,2,2,7,single-choice,spatial-relational,2|7,7,2/7,220491,2
2,3,22,492,1,580,1,7,3,3,4,single-choice,spatial-relational,3|4,7,3/4,220492,3
2,3,22,493,1,464,1,11,5,5,6,single-choice,spatial-relational,5|6,7,5/6,220493,5
2,3,22,494,1,621,4,6,1,1,5,single-choice,spatial-relational,1|5,7,1/5,220494,1
2,3,22,495,1,614,5,7,1,1,6,single-choice,spatial-relational,1|6,7,1/6,220495,1
2,3,22,496,1,625,5,9,2,2,7,single-choice,spatial-relational,2|7,7,2/7,220496,2
2,3,22,497,1,498,5,7,1,1,6,single-choice,spatial-relational,1|6,7,1/6,220497,1
2,3,22,498,0,636,1,7,3,4,4,single-choice,spatial-relational,3|4,7,3/4,220498,3
2,3,22,499,1,618,4,8,2,2,6,single-choice,spatial-relational,2|6,7,2/6,220499,2
2,3,22,500,1,604,3,5,1,1,4,single-choice,spatial-relational,1|4,7,1/4,220500,1
2,3,22,501,1,534,1,5,2,2,3,single-choice,spatial-relational,2|3,7,2/3,220501,2
2,3,22,502,0,532,1,13,6,7,7,single-choice,spatial-relational,6|7,7,6/7,220502,6
2,3,22,503,0,664,1,9,4,5,5,single-choice,spatial-relational,4|5,7,4/5,220503,4
2,3,22,504,1,608,2,6,2,2,4,single-choice,spatial-relational,2|4,7,2/4,220504,2
2,3,22,505,1,599,2,4,1,1,3,single-choice,spatial-relational,1|3,7,1/3,220505,1
2,3,22,506,0,511,1,13,6,7,7,single-choice,spatial-relational,6|7,7,6/7,220506,6
2,3,22,507,1,524,3,7,2,2,5,single-choice,spatial-relational,2|5,7,2/5,220507,2
2,3,22,508,1,561,1,5,2,2,3,single-choice,spatial-relational,2|3,7,2/3,220508,2
2,3,22,509,1,521,1,9,4,4,5,single-choice,spatial-relational,4|5,7,4/5,220509,4
2,3,22,510,1,495,5,7,1,1,6,single-choice,spatial-relational,1|6,7,1/6,220510,1
2,3,22,511,1,583,2,6,2,2,4,single-choice,spatial-relational,2|4,7,2/4,220511,2
2,3,22,512,0,519,3,11,4,7,7,single-choice,spatial-relational,4|7,7,4/7,220512,4
2,3,22,513,0,56,1,3,1,2,2,single-choice,spatial-relational,1|2,7,1/2,220513,1
2,3,22,514,1,556,5,9,2,2,7,single-choice,spatial-relational,2|7,7,2/7,220514,2
2,3,22,515,1,461,2,12,5,5,7,single-choice,spatial-relational,5|7,7,5/7,220515,5
2,3,22,516,1,489,3,11,4,4,7,single-choice,spatial-relational,4|7,7,4/7,220516,4
2,3,22,517,1,566,4,10,3,3,7,single-choice,spatial-relational,3|7,7,3/7,220517,3
2,3,22,518,0,502,4,8,2,6,6,single-choice,spatial-relational,2|6,7,2/6,220518,2
2,3,22,519,1,578,4,6,1,1,5,single-choice,spatial-relational,1|5,7,1/5,220519,1
2,3,22,520,1,574,3,5,1,1,4,single-choice,spatial-relational,1|4,7,1/4,220520,1
2,3,22,521,1,496,3,5,1,1,4,single-choice,spatial-relational,1|4,7,1/4,220521,1
2,3,22,522,0,604,1,3,1,2,2,single-choice,spatial-relational,1|2,7,1/2,220522,1
2,3,22,523,1,498,1,11,5,5,6,single-choice,spatial-relational,5|6,7,5/6,220523,5
2,3,22,524,1,583,2,4,1,1,3,single-choice,spatial-relational,1|3,7,1/3,220524,1
2,3,22,525,1,511,1,7,3,3,4,single-choice,spatial-relational,3|4,7,3/4,220525,3
2,3,22,526,1,537,3,9,3,3,6,single-choice,spatial-relational,3|6,7,3/6,220526,3
2,3,22,527,1,615,5,7,1,1,6,single-choice,spatial-relational,1|6,7,1/6,220527,1
2,3,22,528,1,646,2,12,5,5,7,single-choice,spatial-relational,5|7,7,5/7,220528,5
2,3,22,529,1,635,2,10,4,4,6,single-choice,spatial-relational,4|6,7,4/6,220529,4
2,3,22,530,1,634,2,8,3,3,5,single-choice,spatial-relational,3|5,7,3/5,220530,3
2,3,22,531,1,557,2,6,2,2,4,single-choice,spatial-relational,2|4,7,2/4,220531,2
2,3,22,532,1,632,3,9,3,3,6,single-choice,spatial-relational,3|6,7,3/6,220532,3
2,3,22,533,1,705,4,8,2,2,6,single-choice,spatial-relational,2|6,7,2/6,220533,2
2,3,22,534,1,627,3,7,2,2,5,single-choice,spatial-relational,2|5,7,2/5,220534,2
2,3,22,535,1,562,1,5,2,2,3,single-choice,spatial-relational,2|3,7,2/3,220535,2
2,3,22,536,1,552,5,9,2,2,7,single-choice,spatial-relational,2|7,7,2/7,220536,2
2,3,22,537,1,1167,6,8,1,1,7,single-choice,spatial-relational,1|7,7,1/7,220537,1
2,3,22,538,1,472,6,8,1,1,7,single-choice,spatial-relational,1|7,7,1/7,220538,1
2,3,22,539,0,643,2,8,3,5,5,single-choice,spatial-relational,3|5,7,3/5,220539,3
2,3,22,540,1,662,1,9,4,4,5,single-choice,spatial-relational,4|5,7,4/5,220540,4
2,3,22,541,1,496,1,13,6,6,7,single-choice,spatial-relational,6|7,7,6/7,220541,6
2,3,22,542,1,476,4,10,3,3,7,single-choice,spatial-relational,3|7,7,3/7,220542,3
2,3,22,543,0,588,2,10,4,6,6,single-choice,spatial-relational,4|6,7,4/6,220543,4
2,3,22,544,1,631,1,11,5,5,6,single-choice,spatial-relational,5|6,7,5/6,220544,5
2,3,22,545,1,561,4,6,1,1,5,single-choice,spatial-relational,1|5,7,1/5,220545,1
2,3,22,546,1,543,1,7,3,3,4,single-choice,spatial-relational,3|4,7,3/4,220546,3
2,3,22,547,1,565,4,10,3,3,7,single-choice,spatial-relational,3|7,7,3/7,220547,3
2,3,22,548,1,543,3,5,1,1,4,single-choice,spatial-relational,1|4,7,1/4,220548,1
2,3,22,549,1,498,6,8,1,1,7,single-choice,spatial-relational,1|7,7,1/7,220549,1
2,3,22,550,1,609,1,9,4,4,5,single-choice,spatial-relational,4|5,7,4/5,220550,4
2,3,22,551,1,588,4,10,3,3,7,single-choice,spatial-relational,3|7,7,3/7,220551,3
2,3,22,552,1,571,1,5,2,2,3,single-choice,spatial-relational,2|3,7,2/3,220552,2
2,3,22,553,0,624,1,3,1,2,2,single-choice,spatial-relational,1|2,7,1/2,220553,1
2,3,22,554,1,593,2,8,3,3,5,single-choice,spatial-relational,3|5,7,3/5,220554,3
2,3,22,555,1,648,2,8,3,3,5,single-choice,spatial-relational,3|5,7,3/5,220555,3
2,3,22,556,1,649,2,6,2,2,4,single-choice,spatial-relational,2|4,7,2/4,220556,2
2,3,22,557,0,589,1,9,4,5,5,single-choice,spatial-relational,4|5,7,4/5,220557,4
2,3,22,558,1,611,5,9,2,2,7,single-choice,spatial-relational,2|7,7,2/7,220558,2
2,3,22,559,1,488,1,13,6,6,7,single-choice,spatial-relational,6|7,7,6/7,220559,6
2,3,22,560,1,622,2,4,1,1,3,single-choice,spatial-relational,1|3,7,1/3,220560,1
2,3,22,561,1,587,3,9,3,3,6,single-choice,spatial-relational,3|6,7,3/6,220561,3
2,3,22,562,1,536,5,7,1,1,6,single-choice,spatial-relational,1|6,7,1/6,220562,1
2,3,22,563,1,567,1,3,1,1,2,single-choice,spatial-relational,1|2,7,1/2,220563,1
2,3,22,564,1,574,6,8,1,1,7,single-choice,spatial-relational,1|7,7,1/7,220564,1
2,3,22,565,1,583,1,7,3,3,4,single-choice,spatial-relational,3|4,7,3/4,220565,3
2,3,22,566,1,501,5,9,2,2,7,single-choice,spatial-relational,2|7,7,2/7,220566,2
2,3,22,567,1,900,4,6,1,1,5,single-choice,spatial-relational,1|5,7,1/5,220567,1
2,3,22,568,1,468,3,11,4,4,7,single-choice,spatial-relational,4|7,7,4/7,220568,4
2,3,22,569,1,605,4,8,2,2,6,single-choice,spatial-relational,2|6,7,2/6,220569,2
2,3,22,570,1,661,3,11,4,4,7,single-choice,spatial-relational,4|7,7,4/7,220570,4
2,3,22,571,1,687,2,10,4,4,6,single-choice,spatial-relational,4|6,7,4/6,220571,4
2,3,22,572,0,582,1,13,6,7,7,single-choice,spatial-relational,6|7,7,6/7,220572,6
2,3,22,573,1,580,2,6,2,2,4,single-choice,spatial-relational,2|4,7,2/4,220573,2
2,3,22,574,1,603,1,5,2,2,3,single-choice,spatial-relational,2|3,7,2/3,220574,2
2,3,22,575,0,517,1,11,5,6,6,single-choice,spatial-relational,5|6,7,5/6,220575,5
2,3,22,576,1,609,2,4,1,1,3,single-choice,spatial-relational,1|3,7,1/3,220576,1
2,3,22,577,1,497,3,9,3,3,6,single-choice,spatial-relational,3|6,7,3/6,220577,3
2,3,22,578,0,654,1,11,5,6,6,single-choice,spatial-relational,5|6,7,5/6,220578,5
2,3,22,579,1,579,5,7,1,1,6,single-choice,spatial-relational,1|6,7,1/6,220579,1
2,3,22,580,0,559,2,12,5,7,7,single-choice,spatial-relational,5|7,7,5/7,220580,5
2,3,22,581,1,622,3,5,1,1,4,single-choice,spatial-relational,1|4,7,1/4,220581,1
2,3,22,582,0,627,1,7,3,4,4,single-choice,spatial-relational,3|4,7,3/4,220582,3
2,3,22,583,1,541,4,6,1,1,5,single-choice,spatial-relational,1|5,7,1/5,220583,1
2,3,22,584,1,489,2,12,5,5,7,single-choice,spatial-relational,5|7,7,5/7,220584,5
2,3,22,585,1,630,3,7,2,2,5,single-choice,spatial-relational,2|5,7,2/5,220585,2
2,3,22,586,1,725,3,7,2,2,5,single-choice,spatial-relational,2|5,7,2/5,220586,2
2,3,22,587,1,1195,2,10,4,4,6,single-choice,spatial-relational,4|6,7,4/6,220587,4
2,3,22,588,1,537,4,8,2,2,6,single-choice,spatial-relational,2|6,7,2/6,220588,2
2,3,22,589,0,669,1,11,5,6,6,single-choice,spatial-relational,5|6,7,5/6,220589,5
2,3,22,590,0,602,4,10,3,7,7,single-choice,spatial-relational,3|7,7,3/7,220590,3
2,3,22,591,1,553,2,4,1,1,3,single-choice,spatial-relational,1|3,7,1/3,220591,1
2,3,22,592,0,527,1,13,6,7,7,single-choice,spatial-relational,6|7,7,6/7,220592,6
2,3,22,593,1,642,4,8,2,2,6,single-choice,spatial-relational,2|6,7,2/6,220593,2
2,3,22,594,1,593,3,5,1,1,4,single-choice,spatial-relational,1|4,7,1/4,220594,1
2,3,22,595,1,598,5,9,2,2,7,single-choice,spatial-relational,2|7,7,2/7,220595,2
2,3,22,596,1,500,5,7,1,1,6,single-choice,spatial-relational,1|6,7,1/6,220596,1
2,3,22,597,1,546,5,9,2,2,7,single-choice,spatial-relational,2|7,7,2/7,220597,2
2,3,22,598,1,583,3,9,3,3,6,single-choice,spatial-relational,3|6,7,3/6,220598,3
2,3,22,599,1,600,2,4,1,1,3,single-choice,spatial-relational,1|3,7,1/3,220599,1
2,3,22,600,1,665,3,5,1,1,4,single-choice,spatial-relational,1|4,7,1/4,220600,1
3,3,22,1,1,1124,1,3,1,1,2,single-choice,spatial-relational,1|2,7,1/2,220001,1
3,3,22,2,1,563,3,5,1,1,4,single-choice,spatial-relational,1|4,7,1/4,220002,1
3,3,22,3,0,606,1,9,4,5,5,single-choice,spatial-relational,4|5,7,4/5,220003,4
3,3,22,4,1,512,1,7,3,3,4,single-choice,spatial-relational,3|4,7,3/4,220004,3
3,3,22,5,0,681,2,10,4,6,6,single-choice,spatial-relational,4|6,7,4/6,220005,4
3,3,22,6,1,620,5,9,2,2,7,single-choice,spatial-relational,2|7,7,2/7,220006,2
3,3,22,7,1,584,4,8,2,2,6,single-choice,spatial-relational,2|6,7,2/6,220007,2
3,3,22,8,1,545,2,6,2,2,4,single-choice,spatial-relational,2|4,7,2/4,220008,2
3,3,22,9,0,454,2,12,5,7,7,single-choice,spatial-relational,5|7,7,5/7,220009,5
3,3,22,10,1,514,3,11,4,4,7,single-choice,spatial-relational,4|7,7,4/7,220010,4
3,3,22,11,1,638,3,9,3,3,6,single-choice,spatial-relational,3|6,7,3/6,220011,3
3,3,22,12,1,662,3,9,3,3,6,single-choice,spatial-relational,3|6,7,3/6,220012,3
3,3,22,13,0,596,3,7,2,5,5,single-choice,spatial-relational,2|5,7,2/5,220013,2
3,3,22,14,1,684,1,13,6,6,7,single-choice,spatial-relational,6|7,7,6/7,220014,6
3,3,22,15,0,1020,1,9,4,5,5,single-choice,spatial-relational,4|5,7,4/5,220015,4
3,3,22,16,1,674,2,10,4,4,6,single-choice,spatial-relational,4|6,7,4/6,220016,4
3,3,22,17,1,706,3,5,1,1,4,single-choice,spatial-relational,1|4,7,1/4,220017,1
3,3,22,18,1,774,1,5,2,2,3,single-choice,spatial-relational,2|3,7,2/3,220018,2
3,3,22,19,1,664,4,10,3,3,7,single-choice,spatial-relational,3|7,7,3/7,220019,3
3,3,22,20,0,1705,1,11,5,6,6,single-choice,spatial-relational,5|6,7,5/6,220020,5
3,3,22,21,1,720,5,7,1,1,6,single-choice,spatial-relational,1|6,7,1/6,220021,1
3,3,22,22,1,564,4,6,1,1,5,single-choice,spatial-relational,1|5,7,1/5,220022,1
3,3,22,23,1,36,5,7,1,1,6,single-choice,spatial-relational,1|6,7,1/6,220023,1
3,3,22,24,1,518,1,13,6,6,7,single-choice,spatial-relational,6|7,7,6/7,220024,6
3,3,22,25,0,971,2,8,3,5,5,single-choice,spatial-relational,3|5,7,3/5,220025,3
3,3,22,26,1,675,1,3,1,1,2,single-choice,spatial-relational,1|2,7,1/2,220026,1
3,3,22,27,0,517,3,7,2,5,5,single-choice,spatial-relational,2|5,7,2/5,220027,2
3,3,22,28,0,416,6,8,1,7,7,single-choice,spatial-relational,1|7,7,1/7,220028,1
3,3,22,29,1,507,4,6,1,1,5,single-choice,spatial-relational,1|5,7,1/5,220029,1
3,3,22,30,0,759,2,10,4,6,6,single-choice,spatial-relational,4|6,7,4/6,220030,4
3,3,22,31,1,496,3,7,2,2,5,single-choice,spatial-relational,2|5,7,2/5,220031,2
3,3,22,32,0,360,3,11,4,7,7,single-choice,spatial-relational,4|7,7,4/7,220032,4
3,3,22,33,0,357,4,8,2,6,6,single-choice,spatial-relational,2|6,7,2/6,220033,2
3,3,22,34,1,409,1,13,6,6,7,single-choice,spatial-relational,6|7,7,6/7,220034,6
3,3,22,35,1,522,2,6,2,2,4,single-choice,spatial-relational,2|4,7,2/4,220035,2
3,3,22,36,0,439,1,5,2,3,3,single-choice,spatial-relational,2|3,7,2/3,220036,2
3,3,22,37,0,371,3,5,1,4,4,single-choice,spatial-relational,1|4,7,1/4,220037,1
3,3,22,38,1,434,2,4,1,1,3,single-choice,spatial-relational,1|3,7,1/3,220038,1
3,3,22,39,1,524,4,6,1,1,5,single-choice,spatial-relational,1|5,7,1/5,220039,1
3,3,22,40,1,533,1,7,3,3,4,single-choice,spatial-relational,3|4,7,3/4,220040,3
3,3,22,41,1,532,1,9,4,4,5,single-choice,spatial-relational,4|5,7,4/5,220041,4
3,3,22,42,0,443,4,8,2,6,6,single-choice,spatial-relational,2|6,7,2/6,220042,2
3,3,22,43,1,500,3,5,1,1,4,single-choice,spatial-relational,1|4,7,1/4,220043,1
3,3,22,44,0,408,4,10,3,7,7,single-choice,spatial-relational,3|7,7,3/7,220044,3
3,3,22,45,1,487,5,7,1,1,6,single-choice,spatial-relational,1|6,7,1/6,220045,1
3,3,22,46,1,650,5,9,2,2,7,single-choice,spatial-relational,2|7,7,2/7,220046,2
3,3,22,47,0,412,1,11,5,6,6,single-choice,spatial-relational,5|6,7,5/6,220047,5
3,3,22,48,1,529,1,3,1,1,2,single-choice,spatial-relational,1|2,7,1/2,220048,1
3,3,22,49,1,552,2,8,3,3,5,single-choice,spatial-relational,3|5,7,3/5,220049,3
3,3,22,50,0,455,6,8,1,7,7,single-choice,spatial-relational,1|7,7,1/7,220050,1
3,3,22,51,1,600,2,12,5,5,7,single-choice,spatial-relational,5|7,7,5/7,220051,5
3,3,22,52,1,705,3,9,3,3,6,single-choice,spatial-relational,3|6,7,3/6,220052,3
3,3,22,53,1,537,2,4,1,1,3,single-choice,spatial-relational,1|3,7,1/3,220053,1
3,3,22,54,1,592,1,13,6,6,7,single-choice,spatial-relational,6|7,7,6/7,220054,6
3,3,22,55,1,523,2,6,2,2,4,single-choice,spatial-relational,2|4,7,2/4,220055,2
3,3,22,56,1,494,5,9,2,2,7,single-choice,spatial-relational,2|7,7,2/7,220056,2
3,3,22,57,1,565,2,8,3,3,5,single-choice,spatial-relational,3|5,7,3/5,220057,3
3,3,22,58,0,506,1,9,4,5,5,single-choice,spatial-relational,4|5,7,4/5,220058,4
3,3,22,59,0,40,2,12,5,7,7,single-choice,spatial-relational,5|7,7,5/7,220059,5
3,3,22,60,1,603,1,5,2,2,3,single-choice,spatial-relational,2|3,7,2/3,220060,2
3,3,22,61,0,588,1,7,3,4,4,single-choice,spatial-relational,3|4,7,3/4,220061,3
3,3,22,62,1,573,3,9,3,3,6,single-choice,spatial-relational,3|6,7,3/6,220062,3
3,3,22,63,1,586,2,10,4,4,6,single-choice,spatial-relational,4|6,7,4/6,220063,4
3,3,22,64,1,603,1,11,5,5,6,single-choice,spatial-relational,5|6,7,5/6,220064,5
3,3,22,65,0,623,3,11,4,7,7,single-choice,spatial-relational,4|7,7,4/7,220065,4
3,3,22,66,0,680,5,7,1,6,6,single-choice,spatial-relational,1|6,7,1/6,220066,1
3,3,22,67,1,550,4,10,3,3,7,single-choice,spatial-relational,3|7,7,3/7,220067,3
3,3,22,68,1,605,3,11,4,4,7,single-choice,spatial-relational,4|7,7,4/7,220068,4
3,3,22,69,1,621,2,8,3,3,5,single-choice,spatial-relational,3|5,7,3/5,220069,3
3,3,22,70,0,842,3,11,4,7,7,single-choice,spatial-relational,4|7,7,4/7,220070,4
3,3,22,71,1,612,4,8,2,2,6,single-choice,spatial-relational,2|6,7,2/6,220071,2
3,3,22,72,1,677,2,10,4,4,6,single-choice,spatial-relational,4|6,7,4/6,220072,4
3,3,22,73,1,622,2,10,4,4,6,single-choice,spatial-relational,4|6,7,4/6,220073,4
3,3,22,74,0,521,2,4,1,3,3,single-choice,spatial-relational,1|3,7,1/3,220074,1
3,3,22,75,1,483,4,10,3,3,7,single-choice,spatial-relational,3|7,7,3/7,220075,3
3,3,22,76,1,618,3,9,3,3,6,single-choice,spatial-relational,3|6,7,3/6,220076,3
3,3,22,77,1,858,1,11,5,5,6,single-choice,spatial-relational,5|6,7,5/6,220077,5
3,3,22,78,1,542,1,5,2,2,3,single-choice,spatial-relational,2|3,7,2/3,220078,2
3,3,22,79,1,595,2,6,2,2,4,single-choice,spatial-relational,2|4,7,2/4,220079,2
3,3,22,80,1,758,2,12,5,5,7,single-choice,spatial-relational,5|7,7,5/7,220080,5
3,3,22,81,0,544,1,13,6,7,7,single-choice,spatial-relational,6|7,7,6/7,220081,6
3,3,22,82,1,629,3,5,1,1,4,single-choice,spatial-relational,1|4,7,1/4,220082,1
3,3,22,83,1,514,6,8,1,1,7,single-choice,spatial-relational,1|7,7,1/7,220083,1
3,3,22,84,1,584,2,12,5,5,7,single-choice,spatial-relational,5|7,7,5/7,220084,5
3,3,22,85,0,540,1,3,1,2,2,single-choice,spatial-relational,1|2,7,1/2,220085,1
3,3,22,86,1,536,1,7,3,3,4,single-choice,spatial-relational,3|4,7,3/4,220086,3
3,3,22,87,1,591,2,4,1,1,3,single-choice,spatial-relational,1|3,7,1/3,220087,1
3,3,22,88,1,643,6,8,1,1,7,single-choice,spatial-relational,1|7,7,1/7,220088,1
3,3,22,89,1,587,1,7,3,3,4,single-choice,spatial-relational,3|4,7,3/4,220089,3
3,3,22,90,0,477,4,6,1,5,5,single-choice,spatial-relational,1|5,7,1/5,220090,1
3,3,22,91,1,462,3,5,1,1,4,single-choice,spatial-relational,1|4,7,1/4,220091,1
3,3,22,92,0,828,4,6,1,5,5,single-choice,spatial-relational,1|5,7,1/5,220092,1
3,3,22,93,0,624,1,11,5,6,6,single-choice,spatial-relational,5|6,7,5/6,220093,5
3,3,22,94,0,509,1,3,1,2,2,single-choice,spatial-relational,1|2,7,1/2,220094,1
3,3,22,95,0,48,1,9,4,5,5,single-choice,spatial-relational,4|5,7,4/5,220095,4
3,3,22,96,1,521,5,9,2,2,7,single-choice,spatial-relational,2|7,7,2/7,220096,2
3,3,22,97,1,607,3,9,3,3,6,single-choice,spatial-relational,3|6,7,3/6,220097,3
3,3,22,98,1,599,2,6,2,2,4,single-choice,spatial-relational,2|4,7,2/4,220098,2
3,3,22,99,0,517,3,7,2,5,5,single-choice,spatial-relational,2|5,7,2/5,220099,2
3,3,22,100,1,605,4,10,3,3,7,single-choice,spatial-relational,3|7,7,3/7,220100,3
3,3,22,101,1,672,5,7,1,1,6,single-choice,spatial-relational,1|6,7,1/6,220101,1
3,3,22,102,1,568,4,8,2,2,6,single-choice,spatial-relational,2|6,7,2/6,220102,2
3,3,22,103,0,703,1,13,6,7,7,single-choice,spatial-relational,6|7,7,6/7,220103,6
3,3,22,104,1,669,1,5,2,2,3,single-choice,spatial-relational,2|3,7,2/3,220104,2
3,3,22,105,1,663,5,9,2,2,7,single-choice,spatial-relational,2|7,7,2/7,220105,2
3,3,22,106,1,670,5,7,1,1,6,single-choice,spatial-relational,1|6,7,1/6,220106,1
3,3,22,107,1,711,2,8,3,3,5,single-choice,spatial-relational,3|5,7,3/5,220107,3
3,3,22,108,1,672,3,7,2,2,5,single-choice,spatial-relational,2|5,7,2/5,220108,2
3,3,22,109,1,681,1,9,4,4,5,single-choice,spatial-relational,4|5,7,4/5,220109,4
3,3,22,110,1,541,2,4,1,1,3,single-choice,spatial-relational,1|3,7,1/3,220110,1
3,3,22,111,1,646,2,12,5,5,7,single-choice,spatial-relational,5|7,7,5/7,220111,5
3,3,22,112,1,603,2,4,1,1,3,single-choice,spatial-relational,1|3,7,1/3,220112,1
3,3,22,113,1,623,4,10,3,3,7,single-choice,spatial-relational,3|7,7,3/7,220113,3
3,3,22,114,1,685,4,8,2,2,6,single-choice,spatial-relational,2|6,7,2/6,220114,2
3,3,22,115,0,637,1,7,3,4,4,single-choice,spatial-relational,3|4,7,3/4,220115,3
3,3,22,116,1,577,4,6,1,1,5,single-choice,spatial-relational,1|5,7,1/5,220116,1
3,3,22,117,1,564,2,6,2,2,4,single-choice,spatial-relational,2|4,7,2/4,220117,2
3,3,22,118,1,592,3,5,1,1,4,single-choice,spatial-relational,1|4,7,1/4,220118,1
3,3,22,119,1,574,1,7,3,3,4,single-choice,spatial-relational,3|4,7,3/4,220119,3
3,3,22,120,1,580,5,7,1,1,6,single-choice,spatial-relational,1|6,7,1/6,220120,1
3,3,22,121,0,494,3,7,2,5,5,single-choice,spatial-relational,2|5,7,2/5,220121,2
3,3,22,122,1,615,1,5,2,2,3,single-choice,spatial-relational,2|3,7,2/3,220122,2
3,3,22,123,1,625,3,9,3,3,6,single-choice,spatial-relational,3|6,7,3/6,220123,3
3,3,22,124,1,649,2,6,2,2,4,single-choice,spatial-relational,2|4,7,2/4,220124,2
3,3,22,125,1,630,3,11,4,4,7,single-choice,spatial-relational,4|7,7,4/7,220125,4
3,3,22,126,1,1082,2,10,4,4,6,single-choice,spatial-relational,4|6,7,4/6,220126,4
3,3,22,127,1,625,1,11,5,5,6,single-choice,spatial-relational,5|6,7,5/6,220127,5
3,3,22,128,0,714,1,3,1,2,2,single-choice,spatial-relational,1|2,7,1/2,220128,1
3,3,22,129,0,620,1,9,4,5,5,single-choice,spatial-relational,4|5,7,4/5,220129,4
3,3,22,130,0,982,5,7,1,6,6,single-choice,spatial-relational,1|6,7,1/6,220130,1
3,3,22,131,0,819,2,8,3,5,5,single-choice,spatial-relational,3|5,7,3/5,220131,3
3,3,22,132,1,650,2,10,4,4,6,single-choice,spatial-relational,4|6,7,4/6,220132,4
3,3,22,133,1,658,2,8,3,3,5,single-choice,spatial-relational,3|5,7,3/5,220133,3
3,3,22,134,1,685,4,10,3,3,7,single-choice,spatial-relational,3|7,7,3/7,220134,3
3,3,22,135,0,779,1,3,1,2,2,single-choice,spatial-relational,1|2,7,1/2,220135,1
3,3,22,136,1,480,3,5,1,1,4,single-choice,spatial-relational,1|4,7,1/4,220136,1
3,3,22,137,1,599,5,9,2,2,7,single-choice,spatial-relational,2|7,7,2/7,220137,2
3,3,22,138,1,629,1,13,6,6,7,single-choice,spatial-relational,6|7,7,6/7,220138,6
3,3,22,139,1,619,2,12,5,5,7,single-choice,spatial-relational,5|7,7,5/7,220139,5
3,3,22,140,1,733,6,8,1,1,7,single-choice,spatial-relational,1|7,7,1/7,220140,1
3,3,22,141,1,574,6,8,1,1,7,single-choice,spatial-relational,1|7,7,1/7,220141,1
3,3,22,142,1,590,1,9,4,4,5,single-choice,spatial-relational,4|5,7,4/5,220142,4
3,3,22,143,1,496,5,9,2,2,7,single-choice,spatial-relational,2|7,7,2/7,220143,2
3,3,22,144,0,721,3,9,3,6,6,single-choice,spatial-relational,3|6,7,3/6,220144,3
3,3,22,145,1,609,3,11,4,4,7,single-choice,spatial-relational,4|7,7,4/7,220145,4
3,3,22,146,0,744,1,13,6,7,7,single-choice,spatial-relational,6|7,7,6/7,220146,6
3,3,22,147,0,717,4,6,1,5,5,single-choice,spatial-relational,1|5,7,1/5,220147,1
3,3,22,148,1,644,3,7,2,2,5,single-choice,spatial-relational,2|5,7,2/5,220148,2
3,3,22,149,1,593,1,11,5,5,6,single-choice,spatial-relational,5|6,7,5/6,220149,5
3,3,22,150,1,591,1,5,2,2,3,single-choice,spatial-relational,2|3,7,2/3,220150,2
3,3,22,151,1,617,4,8,2,2,6,single-choice,spatial-relational,2|6,7,2/6,220151,2
3,3,22,152,0,686,4,10,3,7,7,single-choice,spatial-relational,3|7,7,3/7,220152,3
3,3,22,153,1,541,4,8,2,2,6,single-choice,spatial-relational,2|6,7,2/6,220153,2
3,3,22,154,1,631,1,5,2,2,3,single-choice,spatial-relational,2|3,7,2/3,220154,2
3,3,22,155,1,642,1,3,1,1,2,single-choice,spatial-relational,1|2,7,1/2,220155,1
3,3,22,156,1,599,1,5,2,2,3,single-choice,spatial-relational,2|3,7,2/3,220156,2
3,3,22,157,1,697,2,4,1,1,3,single-choice,spatial-relational,1|3,7,1/3,220157,1
3,3,22,158,0,558,1,9,4,5,5,single-choice,spatial-relational,4|5,7,4/5,220158,4
3,3,22,159,1,477,2,6,2,2,4,single-choice,spatial-relational,2|4,7,2/4,220159,2
3,3,22,160,1,793,5,7,1,1,6,single-choice,spatial-relational,1|6,7,1/6,220160,1
3,3,22,161,0,1018,4,6,1,5,5,single-choice,spatial-relational,1|5,7,1/5,220161,1
3,3,22,162,0,114,1,3,1,2,2,single-choice,spatial-relational,1|2,7,1/2,220162,1
3,3,22,163,1,60,2,12,5,5,7,single-choice,spatial-relational,5|7,7,5/7,220163,5
3,3,22,164,0,696,2,4,1,3,3,single-choice,spatial-relational,1|3,7,1/3,220164,1
3,3,22,165,1,1078,2,12,5,5,7,single-choice,spatial-relational,5|7,7,5/7,220165,5
3,3,22,166,1,577,2,10,4,4,6,single-choice,spatial-relational,4|6,7,4/6,220166,4
3,3,22,167,1,648,3,7,2,2,5,single-choice,spatial-relational,2|5,7,2/5,220167,2
3,3,22,168,1,834,2,10,4,4,6,single-choice,spatial-relational,4|6,7,4/6,220168,4
3,3,22,169,1,669,2,8,3,3,5,single-choice,spatial-relational,3|5,7,3/5,220169,3
3,3,22,170,0,724,1,9,4,5,5,single-choice,spatial-relational,4|5,7,4/5,220170,4
3,3,22,171,0,699,1,7,3,4,4,single-choice,spatial-relational,3|4,7,3/4,220171,3
3,3,22,172,0,783,1,13,6,7,7,single-choice,spatial-relational,6|7,7,6/7,220172,6
3,3,22,173,1,638,3,5,1,1,4,single-choice,spatial-relational,1|4,7,1/4,220173,1
3,3,22,174,1,543,1,11,5,5,6,single-choice,spatial-relational,5|6,7,5/6,220174,5
3,3,22,175,1,579,5,7,1,1,6,single-choice,spatial-relational,1|6,7,1/6,220175,1
3,3,22,176,1,603,2,6,2,2,4,single-choice,spatial-relational,2|4,7,2/4,220176,2
3,3,22,177,0,734,3,11,4,7,7,single-choice,spatial-relational,4|7,7,4/7,220177,4
3,3,22,178,1,55,3,9,3,3,6,single-choice,spatial-relational,3|6,7,3/6,220178,3
3,3,22,179,1,690,4,10,3,3,7,single-choice,spatial-relational,3|7,7,3/7,220179,3
3,3,22,180,1,703,1,13,6,6,7,single-choice,spatial-relational,6|7,7,6/7,220180,6
3,3,22,181,1,650,3,5,1,1,4,single-choice,spatial-relational,1|4,7,1/4,220181,1
3,3,22,182,1,639,6,8,1,1,7,single-choice,spatial-relational,1|7,7,1/7,220182,1
3,3,22,183,0,668,3,11,4,7,7,single-choice,spatial-relational,4|7,7,4/7,220183,4
3,3,22,184,1,628,4,6,1,1,5,single-choice,spatial-relational,1|5,7,1/5,220184,1
3,3,22,185,1,573,3,9,3,3,6,single-choice,spatial-relational,3|6,7,3/6,220185,3
3,3,22,186,1,596,2,8,3,3,5,single-choice,spatial-relational,3|5,7,3/5,220186,3
3,3,22,187,1,560,6,8,1,1,7,single-choice,spatial-relational,1|7,7,1/7,220187,1
3,3,22,188,1,596,4,8,2,2,6,single-choice,spatial-relational,2|6,7,2/6,220188,2
3,3,22,189,1,627,5,9,2,2,7,single-choice,spatial-relational,2|7,7,2/7,220189,2
3,3,22,190,1,589,1,7,3,3,4,single-choice,spatial-relational,3|4,7,3/4,220190,3
3,3,22,191,0,72,5,9,2,7,7,single-choice,spatial-relational,2|7,7,2/7,220191,2
3,3,22,192,1,685,1,11,5,5,6,single-choice,spatial-relational,5|6,7,5/6,220192,5
3,3,22,193,1,881,3,7,2,2,5,single-choice,spatial-relational,2|5,7,2/5,220193,2
3,3,22,194,1,583,3,9,3,3,6,single-choice,spatial-relational,3|6,7,3/6,220194,3
3,3,22,195,1,675,1,3,1,1,2,single-choice,spatial-relational,1|2,7,1/2,220195,1
3,3,22,196,1,734,3,11,4,4,7,single-choice,spatial-relational,4|7,7,4/7,220196,4
3,3,22,197,0,742,1,13,6,7,7,single-choice,spatial-relational,6|7,7,6/7,220197,6
3,3,22,198,1,619,3,7,2,2,5,single-choice,spatial-relational,2|5,7,2/5,220198,2
3,3,22,199,1,545,1,5,2,2,3,single-choice,spatial-relational,2|3,7,2/3,220199,2
3,3,22,200,1,556,3,5,1,1,4,single-choice,spatial-relational,1|4,7,1/4,220200,1
3,3,22,201,1,615,1,5,2,2,3,single-choice,spatial-relational,2|3,7,2/3,220201,2
3,3,22,202,1,564,6,8,1,1,7,single-choice,spatial-relational,1|7,7,1/7,220202,1
3,3,22,203,1,607,2,10,4,4,6,single-choice,spatial-relational,4|6,7,4/6,220203,4
3,3,22,204,0,514,2,4,1,3,3,single-choice,spatial-relational,1|3,7,1/3,220204,1
3,3,22,205,1,606,1,7,3,3,4,single-choice,spatial-relational,3|4,7,3/4,220205,3
3,3,22,206,0,576,1,9,4,5,5,single-choice,spatial-relational,4|5,7,4/5,220206,4
3,3,22,207,0,531,3,11,4,7,7,single-choice,spatial-relational,4|7,7,4/7,220207,4
3,3,22,208,1,543,1,7,3,3,4,single-choice,spatial-relational,3|4,7,3/4,220208,3
3,3,22,209,0,1438,4,8,2,6,6,single-choice,spatial-relational,2|6,7,2/6,220209,2
3,3,22,210,1,554,2,4,1,1,3,single-choice,spatial-relational,1|3,7,1/3,220210,1
3,3,22,211,1,560,2,12,5,5,7,single-choice,spatial-relational,5|7,7,5/7,220211,5
3,3,22,212,0,1367,2,8,3,5,5,single-choice,spatial-relational,3|5,7,3/5,220212,3
3,3,22,213,1,803,4,10,3,3,7,single-choice,spatial-relational,3|7,7,3/7,220213,3
3,3,22,214,1,971,3,9,3,3,6,single-choice,spatial-relational,3|6,7,3/6,220214,3
3,3,22,215,1,612,4,8,2,2,6,single-choice,spatial-relational,2|6,7,2/6,220215,2
3,3,22,216,0,811,4,6,1,5,5,single-choice,spatial-relational,1|5,7,1/5,220216,1
3,3,22,217,0,53,5,9,2,7,7,single-choice,spatial-relational,2|7,7,2/7,220217,2
3,3,22,218,1,522,5,7,1,1,6,single-choice,spatial-relational,1|6,7,1/6,220218,1
3,3,22,219,1,591,2,10,4,4,6,single-choice,spatial-relational,4|6,7,4/6,220219,4
3,3,22,220,1,572,1,11,5,5,6,single-choice,spatial-relational,5|6,7,5/6,220220,5
3,3,22,221,1,608,1,11,5,5,6,single-choice,spatial-relational,5|6,7,5/6,220221,5
3,3,22,222,1,774,4,6,1,1,5,single-choice,spatial-relational,1|5,7,1/5,220222,1
3,3,22,223,1,641,2,6,2,2,4,single-choice,spatial-relational,2|4,7,2/4,220223,2
3,3,22,224,1,567,2,8,3,3,5,single-choice,spatial-relational,3|5,7,3/5,220224,3
3,3,22,225,1,642,5,7,1,1,6,single-choice,spatial-relational,1|6,7,1/6,220225,1
3,3,22,226,1,565,2,12,5,5,7,single-choice,spatial-relational,5|7,7,5/7,220226,5
3,3,22,227,1,660,3,7,2,2,5,single-choice,spatial-relational,2|5,7,2/5,220227,2
3,3,22,228,1,612,1,9,4,4,5,single-choice,spatial-relational,4|5,7,4/5,220228,4
3,3,22,229,1,630,4,10,3,3,7,single-choice,spatial-relational,3|7,7,3/7,220229,3
3,3,22,230,0,552,1,3,1,2,2,single-choice,spatial-relational,1|2,7,1/2,220230,1
3,3,22,231,1,520,3,5,1,1,4,single-choice,spatial-relational,1|4,7,1/4,220231,1
3,3,22,232,1,600,5,9,2,2,7,single-choice,spatial-relational,2|7,7,2/7,220232,2
3,3,22,233,1,619,6,8,1,1,7,single-choice,spatial-relational,1|7,7,1/7,220233,1
3,3,22,234,1,1234,1,13,6,6,7,single-choice,spatial-relational,6|7,7,6/7,220234,6
3,3,22,235,1,581,2,6,2,2,4,single-choice,spatial-relational,2|4,7,2/4,220235,2
3,3,22,236,1,654,2,10,4,4,6,single-choice,spatial-relational,4|6,7,4/6,220236,4
3,3,22,237,0,576,4,6,1,5,5,single-choice,spatial-relational,1|5,7,1/5,220237,1
3,3,22,238,1,532,5,9,2,2,7,single-choice,spatial-relational,2|7,7,2/7,220238,2
3,3,22,239,1,580,2,12,5,5,7,single-choice,spatial-relational,5|7,7,5/7,220239,5
3,3,22,240,0,549,2,8,3,5,5,single-choice,spatial-relational,3|5,7,3/5,220240,3
3,3,22,241,0,667,2,4,1,3,3,single-choice,spatial-relational,1|3,7,1/3,220241,1
3,3,22,242,1,78,5,9,2,2,7,single-choice,spatial-relational,2|7,7,2/7,220242,2
3,3,22,243,1,603,4,6,1,1,5,single-choice,spatial-relational,1|5,7,1/5,220243,1
3,3,22,244,1,641,5,7,1,1,6,single-choice,spatial-relational,1|6,7,1/6,220244,1
3,3,22,245,1,659,1,5,2,2,3,single-choice,spatial-relational,2|3,7,2/3,220245,2
3,3,22,246,1,526,2,6,2,2,4,single-choice,spatial-relational,2|4,7,2/4,220246,2
3,3,22,247,1,623,3,9,3,3,6,single-choice,spatial-relational,3|6,7,3/6,220247,3
3,3,22,248,1,519,4,10,3,3,7,single-choice,spatial-relational,3|7,7,3/7,220248,3
3,3,22,249,1,703,3,7,2,2,5,single-choice,spatial-relational,2|5,7,2/5,220249,2
3,3,22,250,1,694,1,9,4,4,5,single-choice,spatial-relational,4|5,7,4/5,220250,4
3,3,22,251,1,1150,3,9,3,3,6,single-choice,spatial-relational,3|6,7,3/6,220251,3
3,3,22,252,1,588,3,11,4,4,7,single-choice,spatial-relational,4|7,7,4/7,220252,4
3,3,22,253,1,646,2,6,2,2,4,single-choice,spatial-relational,2|4,7,2/4,220253,2
3,3,22,254,0,706,3,5,1,4,4,single-choice,spatial-relational,1|4,7,1/4,220254,1
3,3,22,255,1,49,3,5,1,1,4,single-choice,spatial-relational,1|4,7,1/4,220255,1
3,3,22,256,1,536,1,5,2,2,3,single-choice,spatial-relational,2|3,7,2/3,220256,2
3,3,22,257,0,467,4,8,2,6,6,single-choice,spatial-relational,2|6,7,2/6,220257,2
3,3,22,258,1,564,2,4,1,1,3,single-choice,spatial-relational,1|3,7,1/3,220258,1
3,3,22,259,0,663,1,7,3,4,4,single-choice,spatial-relational,3|4,7,3/4,220259,3
3,3,22,260,0,40,3,11,4,7,7,single-choice,spatial-relational,4|7,7,4/7,220260,4
3,3,22,261,1,906,2,8,3,3,5,single-choice,spatial-relational,3|5,7,3/5,220261,3
3,3,22,262,0,634,1,11,5,6,6,single-choice,spatial-relational,5|6,7,5/6,220262,5
3,3,22,263,1,604,1,3,1,1,2,single-choice,spatial-relational,1|2,7,1/2,220263,1
3,3,22,264,1,557,5,7,1,1,6,single-choice,spatial-relational,1|6,7,1/6,220264,1
3,3,22,265,1,519,1,7,3,3,4,single-choice,spatial-relational,3|4,7,3/4,220265,3
3,3,22,266,1,552,4,10,3,3,7,single-choice,spatial-relational,3|7,7,3/7,220266,3
3,3,22,267,1,583,1,11,5,5,6,single-choice,spatial-relational,5|6,7,5/6,220267,5
3,3,22,268,1,1108,1,9,4,4,5,single-choice,spatial-relational,4|5,7,4/5,220268,4
3,3,22,269,1,650,1,13,6,6,7,single-choice,spatial-relational,6|7,7,6/7,220269,6
3,3,22,270,1,650,6,8,1,1,7,single-choice,spatial-relational,1|7,7,1/7,220270,1
3,3,22,271,1,953,4,8,2,2,6,single-choice,spatial-relational,2|6,7,2/6,220271,2
3,3,22,272,0,509,3,7,2,5,5,single-choice,spatial-relational,2|5,7,2/5,220272,2
3,3,22,273,1,502,1,13,6,6,7,single-choice,spatial-relational,6|7,7,6/7,220273,6
3,3,22,274,0,737,2,12,5,7,7,single-choice,spatial-relational,5|7,7,5/7,220274,5
3,3,22,275,1,576,6,8,1,1,7,single-choice,spatial-relational,1|7,7,1/7,220275,1
3,3,22,276,1,603,2,10,4,4,6,single-choice,spatial-relational,4|6,7,4/6,220276,4
3,3,22,277,0,556,1,3,1,2,2,single-choice,spatial-relational,1|2,7,1/2,220277,1
3,3,22,278,1,572,3,7,2,2,5,single-choice,spatial-relational,2|5,7,2/5,220278,2
3,3,22,279,1,509,1,5,2,2,3,single-choice,spatial-relational,2|3,7,2/3,220279,2
3,3,22,280,1,492,1,3,1,1,2,single-choice,spatial-relational,1|2,7,1/2,220280,1
3,3,22,281,0,623,1,7,3,4,4,single-choice,spatial-relational,3|4,7,3/4,220281,3
3,3,22,282,1,574,1,13,6,6,7,single-choice,spatial-relational,6|7,7,6/7,220282,6
3,3,22,283,0,564,2,8,3,5,5,single-choice,spatial-relational,3|5,7,3/5,220283,3
3,3,22,284,0,60,3,11,4,7,7,single-choice,spatial-relational,4|7,7,4/7,220284,4
3,3,22,285,1,521,4,6,1,1,5,single-choice,spatial-relational,1|5,7,1/5,220285,1
3,3,22,286,1,533,5,9,2,2,7,single-choice,spatial-relational,2|7,7,2/7,220286,2
3,3,22,287,1,570,2,4,1,1,3,single-choice,spatial-relational,1|3,7,1/3,220287,1
3,3,22,288,1,595,4,8,2,2,6,single-choice,spatial-relational,2|6,7,2/6,220288,2
3,3,22,289,0,620,1,9,4,5,5,single-choice,spatial-relational,4|5,7,4/5,220289,4
3,3,22,290,1,537,3,9,3,3,6,single-choice,spatial-relational,3|6,7,3/6,220290,3
3,3,22,291,1,545,1,11,5,5,6,single-choice,spatial-relational,5|6,7,5/6,220291,5
3,3,22,292,1,559,1,11,5,5,6,single-choice,spatial-relational,5|6,7,5/6,220292,5
3,3,22,293,1,540,3,7,2,2,5,single-choice,spatial-relational,2|5,7,2/5,220293,2
3,3,22,294,1,1189,3,5,1,1,4,single-choice,spatial-relational,1|4,7,1/4,220294,1
3,3,22,295,1,538,3,5,1,1,4,single-choice,spatial-relational,1|4,7,1/4,220295,1
3,3,22,296,1,525,5,9,2,2,7,single-choice,spatial-relational,2|7,7,2/7,220296,2
3,3,22,297,1,696,2,4,1,1,3,single-choice,spatial-relational,1|3,7,1/3,220297,1
3,3,22,298,1,565,1,7,3,3,4,single-choice,spatial-relational,3|4,7,3/4,220298,3
3,3,22,299,1,606,4,6,1,1,5,single-choice,spatial-relational,1|5,7,1/5,220299,1
3,3,22,300,1,482,4,10,3,3,7,single-choice,spatial-relational,3|7,7,3/7,220300,3
3,3,22,301,1,560,4,10,3,3,7,single-choice,spatial-relational,3|7,7,3/7,220301,3
3,3,22,302,1,858,2,12,5,5,7,single-choice,spatial-relational,5|7,7,5/7,220302,5
3,3,22,303,1,770,5,7,1,1,6,single-choice,spatial-relational,1|6,7,1/6,220303,1
3,3,22,304,1,595,6,8,1,1,7,single-choice,spatial-relational,1|7,7,1/7,220304,1
3,3,22,305,0,584,3,11,4,7,7,single-choice,spatial-relational,4|7,7,4/7,220305,4
3,3,22,306,1,564,2,8,3,3,5,single-choice,spatial-relational,3|5,7,3/5,220306,3
3,3,22,307,0,592,1,13,6,7,7,single-choice,spatial-relational,6|7,7,6/7,220307,6
3,3,22,308,1,513,1,5,2,2,3,single-choice,spatial-relational,2|3,7,2/3,220308,2
3,3,22,309,0,490,2,6,2,4,4,single-choice,spatial-relational,2|4,7,2/4,220309,2
3,3,22,310,0,607,1,3,1,2,2,single-choice,spatial-relational,1|2,7,1/2,220310,1
3,3,22,311,1,682,3,9,3,3,6,single-choice,spatial-relational,3|6,7,3/6,220311,3
3,3,22,312,1,541,2,12,5,5,7,single-choice,spatial-relational,5|7,7,5/7,220312,5
3,3,22,313,1,545,5,7,1,1,6,single-choice,spatial-relational,1|6,7,1/6,220313,1
3,3,22,314,0,569,1,9,4,5,5,single-choice,spatial-relational,4|5,7,4/5,220314,4
3,3,22,315,1,791,2,10,4,4,6,single-choice,spatial-relational,4|6,7,4/6,220315,4
3,3,22,316,1,642,4,8,2,2,6,single-choice,spatial-relational,2|6,7,2/6,220316,2
3,3,22,317,1,612,2,6,2,2,4,single-choice,spatial-relational,2|4,7,2/4,220317,2
3,3,22,318,1,611,2,10,4,4,6,single-choice,spatial-relational,4|6,7,4/6,220318,4
3,3,22,319,1,580,6,8,1,1,7,single-choice,spatial-relational,1|7,7,1/7,220319,1
3,3,22,320,1,701,4,8,2,2,6,single-choice,spatial-relational,2|6,7,2/6,220320,2
3,3,22,321,0,803,1,7,3,4,4,single-choice,spatial-relational,3|4,7,3/4,220321,3
3,3,22,322,0,601,1,13,6,7,7,single-choice,spatial-relational,6|7,7,6/7,220322,6
3,3,22,323,1,652,3,7,2,2,5,single-choice,spatial-relational,2|5,7,2/5,220323,2
3,3,22,324,0,529,1,3,1,2,2,single-choice,spatial-relational,1|2,7,1/2,220324,1
3,3,22,325,0,637,1,13,6,7,7,single-choice,spatial-relational,6|7,7,6/7,220325,6
3,3,22,326,1,1341,1,11,5,5,6,single-choice,spatial-relational,5|6,7,5/6,220326,5
3,3,22,327,1,572,5,9,2,2,7,single-choice,spatial-relational,2|7,7,2/7,220327,2
3,3,22,328,1,565,1,3,1,1,2,single-choice,spatial-relational,1|2,7,1/2,220328,1
3,3,22,329,1,639,2,4,1,1,3,single-choice,spatial-relational,1|3,7,1/3,220329,1
3,3,22,330,0,765,3,11,4,7,7,single-choice,spatial-relational,4|7,7,4/7,220330,4
3,3,22,331,1,666,1,9,4,4,5,single-choice,spatial-relational,4|5,7,4/5,220331,4
3,3,22,332,1,574,4,8,2,2,6,single-choice,spatial-relational,2|6,7,2/6,220332,2
3,3,22,333,1,608,6,8,1,1,7,single-choice,spatial-relational,1|7,7,1/7,220333,1
3,3,22,334,1,521,1,7,3,3,4,single-choice,spatial-relational,3|4,7,3/4,220334,3
3,3,22,335,1,574,5,7,1,1,6,single-choice,spatial-relational,1|6,7,1/6,220335,1
3,3,22,336,1,639,2,10,4,4,6,single-choice,spatial-relational,4|6,7,4/6,220336,4
3,3,22,337,1,482,5,9,2,2,7,single-choice,spatial-relational,2|7,7,2/7,220337,2
3,3,22,338,1,643,1,11,5,5,6,single-choice,spatial-relational,5|6,7,5/6,220338,5
3,3,22,339,1,832,2,6,2,2,4,single-choice,spatial-relational,2|4,7,2/4,220339,2
3,3,22,340,1,604,4,6,1,1,5,single-choice,spatial-relational,1|5,7,1/5,220340,1
3,3,22,341,1,642,2,10,4,4,6,single-choice,spatial-relational,4|6,7,4/6,220341,4
3,3,22,342,1,564,3,9,3,3,6,single-choice,spatial-relational,3|6,7,3/6,220342,3
3,3,22,343,1,639,2,4,1,1,3,single-choice,spatial-relational,1|3,7,1/3,220343,1
3,3,22,344,1,601,2,6,2,2,4,single-choice,spatial-relational,2|4,7,2/4,220344,2
3,3,22,345,1,733,4,6,1,1,5,single-choice,spatial-relational,1|5,7,1/5,220345,1
3,3,22,346,0,600,1,9,4,5,5,single-choice,spatial-relational,4|5,7,4/5,220346,4
3,3,22,347,1,513,3,5,1,1,4,single-choice,spatial-relational,1|4,7,1/4,220347,1
3,3,22,348,1,535,3,5,1,1,4,single-choice,spatial-relational,1|4,7,1/4,220348,1
3,3,22,349,1,590,1,5,2,2,3,single-choice,spatial-relational,2|3,7,2/3,220349,2
3,3,22,350,1,588,1,5,2,2,3,single-choice,spatial-relational,2|3,7,2/3,220350,2
3,3,22,351,1,718,3,7,2,2,5,single-choice,spatial-relational,2|5,7,2/5,220351,2
3,3,22,352,1,803,2,8,3,3,5,single-choice,spatial-relational,3|5,7,3/5,220352,3
3,3,22,353,1,577,2,8,3,3,5,single-choice,spatial-relational,3|5,7,3/5,220353,3
3,3,22,354,1,645,4,10,3,3,7,single-choice,spatial-relational,3|7,7,3/7,220354,3
3,3,22,355,0,676,2,12,5,7,7,single-choice,spatial-relational,5|7,7,5/7,220355,5
3,3,22,356,1,592,5,7,1,1,6,single-choice,spatial-relational,1|6,7,1/6,220356,1
3,3,22,357,1,588,6,8,1,1,7,single-choice,spatial-relational,1|7,7,1/7,220357,1
3,3,22,358,1,603,3,9,3,3,6,single-choice,spatial-relational,3|6,7,3/6,220358,3
3,3,22,359,0,722,3,11,4,7,7,single-choice,spatial-relational,4|7,7,4/7,220359,4
3,3,22,360,1,718,2,12,5,5,7,single-choice,spatial-relational,5|7,7,5/7,220360,5
3,3,22,361,1,545,4,10,3,3,7,single-choice,spatial-relational,3|7,7,3/7,220361,3
3,3,22,362,1,637,3,5,1,1,4,single-choice,spatial-relational,1|4,7,1/4,220362,1
3,3,22,363,1,582,2,6,2,2,4,single-choice,spatial-relational,2|4,7,2/4,220363,2
3,3,22,364,1,776,6,8,1,1,7,single-choice,spatial-relational,1|7,7,1/7,220364,1
3,3,22,365,1,1178,1,9,4,4,5,single-choice,spatial-relational,4|5,7,4/5,220365,4
3,3,22,366,1,596,1,13,6,6,7,single-choice,spatial-relational,6|7,7,6/7,220366,6
3,3,22,367,0,717,4,8,2,6,6,single-choice,spatial-relational,2|6,7,2/6,220367,2
3,3,22,368,0,55,1,3,1,2,2,single-choice,spatial-relational,1|2,7,1/2,220368,1
3,3,22,369,1,650,5,7,1,1,6,single-choice,spatial-relational,1|6,7,1/6,220369,1
3,3,22,370,1,551,1,11,5,5,6,single-choice,spatial-relational,5|6,7,5/6,220370,5
3,3,22,371,1,1103,4,6,1,1,5,single-choice,spatial-relational,1|5,7,1/5,220371,1
3,3,22,372,1,721,1,7,3,3,4,single-choice,spatial-relational,3|4,7,3/4,220372,3
3,3,22,373,1,607,2,4,1,1,3,single-choice,spatial-relational,1|3,7,1/3,220373,1
3,3,22,374,0,620,1,13,6,7,7,single-choice,spatial-relational,6|7,7,6/7,220374,6
3,3,22,375,1,564,2,6,2,2,4,single-choice,spatial-relational,2|4,7,2/4,220375,2
3,3,22,376,0,675,3,11,4,7,7,single-choice,spatial-relational,4|7,7,4/7,220376,4
3,3,22,377,1,596,3,7,2,2,5,single-choice,spatial-relational,2|5,7,2/5,220377,2
3,3,22,378,1,601,4,8,2,2,6,single-choice,spatial-relational,2|6,7,2/6,220378,2
3,3,22,379,1,634,2,10,4,4,6,single-choice,spatial-relational,4|6,7,4/6,220379,4
3,3,22,380,0,718,3,9,3,6,6,single-choice,spatial-relational,3|6,7,3/6,220380,3
3,3,22,381,1,490,5,7,1,1,6,single-choice,spatial-relational,1|6,7,1/6,220381,1
3,3,22,382,1,639,2,10,4,4,6,single-choice,spatial-relational,4|6,7,4/6,220382,4
3,3,22,383,1,580,1,5,2,2,3,single-choice,spatial-relational,2|3,7,2/3,220383,2
3,3,22,384,1,730,3,7,2,2,5,single-choice,spatial-relational,2|5,7,2/5,220384,2
3,3,22,385,0,568,2,4,1,3,3,single-choice,spatial-relational,1|3,7,1/3,220385,1
3,3,22,386,0,657,3,11,4,7,7,single-choice,spatial-relational,4|7,7,4/7,220386,4
3,3,22,387,0,60,6,8,1,7,7,single-choice,spatial-relational,1|7,7,1/7,220387,1
3,3,22,388,1,553,3,5,1,1,4,single-choice,spatial-relational,1|4,7,1/4,220388,1
3,3,22,389,1,514,1,7,3,3,4,single-choice,spatial-relational,3|4,7,3/4,220389,3
3,3,22,390,1,1070,2,12,5,5,7,single-choice,spatial-relational,5|7,7,5/7,220390,5
3,3,22,391,1,582,4,10,3,3,7,single-choice,spatial-relational,3|7,7,3/7,220391,3
3,3,22,392,0,564,1,3,1,2,2,single-choice,spatial-relational,1|2,7,1/2,220392,1
3,3,22,393,1,557,5,9,2,2,7,single-choice,spatial-relational,2|7,7,2/7,220393,2
3,3,22,394,1,654,1,5,2,2,3,single-choice,spatial-relational,2|3,7,2/3,220394,2
3,3,22,395,1,615,5,9,2,2,7,single-choice,spatial-relational,2|7,7,2/7,220395,2
3,3,22,396,1,585,2,8,3,3,5,single-choice,spatial-relational,3|5,7,3/5,220396,3
3,3,22,397,0,595,1,9,4,5,5,single-choice,spatial-relational,4|5,7,4/5,220397,4
3,3,22,398,1,1310,3,9,3,3,6,single-choice,spatial-relational,3|6,7,3/6,220398,3
3,3,22,399,1,635,4,10,3,3,7,single-choice,spatial-relational,3|7,7,3/7,220399,3
3,3,22,400,0,670,4,6,1,5,5,single-choice,spatial-relational,1|5,7,1/5,220400,1
3,3,22,401,0,613,1,11,5,6,6,single-choice,spatial-relational,5|6,7,5/6,220401,5
3,3,22,402,1,612,2,12,5,5,7,single-choice,spatial-relational,5|7,7,5/7,220402,5
3,3,22,403,1,910,2,8,3,3,5,single-choice,spatial-relational,3|5,7,3/5,220403,3
3,3,22,404,1,614,2,12,5,5,7,single-choice,spatial-relational,5|7,7,5/7,220404,5
3,3,22,405,1,752,2,12,5,5,7,single-choice,spatial-relational,5|7,7,5/7,220405,5
3,3,22,406,1,673,2,4,1,1,3,single-choice,spatial-relational,1|3,7,1/3,220406,1
3,3,22,407,1,668,3,5,1,1,4,single-choice,spatial-relational,1|4,7,1/4,220407,1
3,3,22,408,1,541,1,7,3,3,4,single-choice,spatial-relational,3|4,7,3/4,220408,3
3,3,22,409,0,670,1,7,3,4,4,single-choice,spatial-relational,3|4,7,3/4,220409,3
3,3,22,410,0,662,2,10,4,6,6,single-choice,spatial-relational,4|6,7,4/6,220410,4
3,3,22,411,0,660,1,9,4,5,5,single-choice,spatial-relational,4|5,7,4/5,220411,4
3,3,22,412,0,704,2,8,3,5,5,single-choice,spatial-relational,3|5,7,3/5,220412,3
3,3,22,413,0,855,1,13,6,7,7,single-choice,spatial-relational,6|7,7,6/7,220413,6
3,3,22,414,1,651,3,7,2,2,5,single-choice,spatial-relational,2|5,7,2/5,220414,2
3,3,22,415,1,598,6,8,1,1,7,single-choice,spatial-relational,1|7,7,1/7,220415,1
3,3,22,416,1,580,4,8,2,2,6,single-choice,spatial-relational,2|6,7,2/6,220416,2
3,3,22,417,0,566,1,3,1,2,2,single-choice,spatial-relational,1|2,7,1/2,220417,1
3,3,22,418,1,1332,1,11,5,5,6,single-choice,spatial-relational,5|6,7,5/6,220418,5
3,3,22,419,1,646,2,4,1,1,3,single-choice,spatial-relational,1|3,7,1/3,220419,1
3,3,22,420,1,689,5,7,1,1,6,single-choice,spatial-relational,1|6,7,1/6,220420,1
3,3,22,421,1,593,3,9,3,3,6,single-choice,spatial-relational,3|6,7,3/6,220421,3
3,3,22,422,1,1314,2,10,4,4,6,single-choice,spatial-relational,4|6,7,4/6,220422,4
3,3,22,423,1,570,1,11,5,5,6,single-choice,spatial-relational,5|6,7,5/6,220423,5
3,3,22,424,1,1212,1,13,6,6,7,single-choice,spatial-relational,6|7,7,6/7,220424,6
3,3,22,425,1,1465,1,5,2,2,3,single-choice,spatial-relational,2|3,7,2/3,220425,2
3,3,22,426,1,650,5,9,2,2,7,single-choice,spatial-relational,2|7,7,2/7,220426,2
3,3,22,427,0,693,3,7,2,5,5,single-choice,spatial-relational,2|5,7,2/5,220427,2
3,3,22,428,1,627,1,5,2,2,3,single-choice,spatial-relational,2|3,7,2/3,220428,2
3,3,22,429,1,790,4,8,2,2,6,single-choice,spatial-relational,2|6,7,2/6,220429,2
3,3,22,430,1,752,3,11,4,4,7,single-choice,spatial-relational,4|7,7,4/7,220430,4
3,3,22,431,1,924,2,8,3,3,5,single-choice,spatial-relational,3|5,7,3/5,220431,3
3,3,22,432,1,788,4,6,1,1,5,single-choice,spatial-relational,1|5,7,1/5,220432,1
3,3,22,433,1,670,5,9,2,2,7,single-choice,spatial-relational,2|7,7,2/7,220433,2
3,3,22,434,1,625,3,5,1,1,4,single-choice,spatial-relational,1|4,7,1/4,220434,1
3,3,22,435,1,607,4,10,3,3,7,single-choice,spatial-relational,3|7,7,3/7,220435,3
3,3,22,436,1,611,2,6,2,2,4,single-choice,spatial-relational,2|4,7,2/4,220436,2
3,3,22,437,0,764,3,11,4,7,7,single-choice,spatial-relational,4|7,7,4/7,220437,4
3,3,22,438,1,623,4,10,3,3,7,single-choice,spatial-relational,3|7,7,3/7,220438,3
3,3,22,439,1,603,4,6,1,1,5,single-choice,spatial-relational,1|5,7,1/5,220439,1
3,3,22,440,0,642,1,9,4,5,5,single-choice,spatial-relational,4|5,7,4/5,220440,4
3,3,22,441,1,619,6,8,1,1,7,single-choice,spatial-relational,1|7,7,1/7,220441,1
3,3,22,442,1,597,3,9,3,3,6,single-choice,spatial-relational,3|6,7,3/6,220442,3
3,3,22,443,1,614,1,3,1,1,2,single-choice,spatial-relational,1|2,7,1/2,220443,1
3,3,22,444,1,618,5,7,1,1,6,single-choice,spatial-relational,1|6,7,1/6,220444,1
3,3,22,445,1,502,2,6,2,2,4,single-choice,spatial-relational,2|4,7,2/4,220445,2
3,3,22,446,1,572,1,7,3,3,4,single-choice,spatial-relational,3|4,7,3/4,220446,3
3,3,22,447,0,674,3,11,4,7,7,single-choice,spatial-relational,4|7,7,4/7,220447,4
3,3,22,448,1,603,2,10,4,4,6,single-choice,spatial-relational,4|6,7,4/6,220448,4
3,3,22,449,1,702,1,11,5,5,6,single-choice,spatial-relational,5|6,7,5/6,220449,5
3,3,22,450,0,899,5,9,2,7,7,single-choice,spatial-relational,2|7,7,2/7,220450,2
3,3,22,451,1,650,3,7,2,2,5,single-choice,spatial-relational,2|5,7,2/5,220451,2
3,3,22,452,1,752,3,7,2,2,5,single-choice,spatial-relational,2|5,7,2/5,220452,2
3,3,22,453,1,636,3,9,3,3,6,single-choice,spatial-relational,3|6,7,3/6,220453,3
3,3,22,454,1,693,2,4,1,1,3,single-choice,spatial-relational,1|3,7,1/3,220454,1
3,3,22,455,1,596,1,5,2,2,3,single-choice,spatial-relational,2|3,7,2/3,220455,2
3,3,22,456,1,666,5,7,1,1,6,single-choice,spatial-relational,1|6,7,1/6,220456,1
3,3,22,457,1,561,4,8,2,2,6,single-choice,spatial-relational,2|6,7,2/6,220457,2
3,3,22,458,1,594,5,9,2,2,7,single-choice,spatial-relational,2|7,7,2/7,220458,2
3,3,22,459,1,842,2,12,5,5,7,single-choice,spatial-relational,5|7,7,5/7,220459,5
3,3,22,460,0,694,1,13,6,7,7,single-choice,spatial-relational,6|7,7,6/7,220460,6
3,3,22,461,1,670,4,6,1,1,5,single-choice,spatial-relational,1|5,7,1/5,220461,1
3,3,22,462,1,576,2,8,3,3,5,single-choice,spatial-relational,3|5,7,3/5,220462,3
3,3,22,463,0,730,4,10,3,7,7,single-choice,spatial-relational,3|7,7,3/7,220463,3
3,3,22,464,0,690,1,7,3,4,4,single-choice,spatial-relational,3|4,7,3/4,220464,3
3,3,22,465,1,642,1,3,1,1,2,single-choice,spatial-relational,1|2,7,1/2,220465,1
3,3,22,466,0,545,1,9,4,5,5,single-choice,spatial-relational,4|5,7,4/5,220466,4
3,3,22,467,0,613,1,3,1,2,2,single-choice,spatial-relational,1|2,7,1/2,220467,1
3,3,22,468,1,560,3,5,1,1,4,single-choice,spatial-relational,1|4,7,1/4,220468,1
3,3,22,469,1,592,3,5,1,1,4,single-choice,spatial-relational,1|4,7,1/4,220469,1
3,3,22,470,1,763,5,7,1,1,6,single-choice,spatial-relational,1|6,7,1/6,220470,1
3,3,22,471,0,643,1,9,4,5,5,single-choice,spatial-relational,4|5,7,4/5,220471,4
3,3,22,472,1,584,2,8,3,3,5,single-choice,spatial-relational,3|5,7,3/5,220472,3
3,3,22,473,1,792,1,13,6,6,7,single-choice,spatial-relational,6|7,7,6/7,220473,6
3,3,22,474,0,634,1,11,5,6,6,single-choice,spatial-relational,5|6,7,5/6,220474,5
3,3,22,475,1,545,3,9,3,3,6,single-choice,spatial-relational,3|6,7,3/6,220475,3
3,3,22,476,1,599,6,8,1,1,7,single-choice,spatial-relational,1|7,7,1/7,220476,1
3,3,22,477,1,591,4,10,3,3,7,single-choice,spatial-relational,3|7,7,3/7,220477,3
3,3,22,478,1,596,2,6,2,2,4,single-choice,spatial-relational,2|4,7,2/4,220478,2
3,3,22,479,1,674,4,8,2,2,6,single-choice,spatial-relational,2|6,7,2/6,220479,2
3,3,22,480,1,580,2,12,5,5,7,single-choice,spatial-relational,5|7,7,5/7,220480,5
3,3,22,481,1,821,2,10,4,4,6,single-choice,spatial-relational,4|6,7,4/6,220481,4
3,3,22,482,1,626,3,11,4,4,7,single-choice,spatial-relational,4|7,7,4/7,220482,4
3,3,22,483,1,540,2,6,2,2,4,single-choice,spatial-relational,2|4,7,2/4,220483,2
3,3,22,484,1,572,4,6,1,1,5,single-choice,spatial-relational,1|5,7,1/5,220484,1
3,3,22,485,0,765,1,5,2,3,3,single-choice,spatial-relational,2|3,7,2/3,220485,2
3,3,22,486,1,562,2,4,1,1,3,single-choice,spatial-relational,1|3,7,1/3,220486,1
3,3,22,487,1,549,6,8,1,1,7,single-choice,spatial-relational,1|7,7,1/7,220487,1
3,3,22,488,0,614,2,4,1,3,3,single-choice,spatial-relational,1|3,7,1/3,220488,1
3,3,22,489,0,764,1,9,4,5,5,single-choice,spatial-relational,4|5,7,4/5,220489,4
3,3,22,490,1,623,4,8,2,2,6,single-choice,spatial-relational,2|6,7,2/6,220490,2
3,3,22,491,1,541,3,9,3,3,6,single-choice,spatial-relational,3|6,7,3/6,220491,3
3,3,22,492,0,654,2,12,5,7,7,single-choice,spatial-relational,5|7,7,5/7,220492,5
3,3,22,493,0,38,3,9,3,6,6,single-choice,spatial-relational,3|6,7,3/6,220493,3
3,3,22,494,0,48,2,4,1,3,3,single-choice,spatial-relational,1|3,7,1/3,220494,1
3,3,22,495,1,563,6,8,1,1,7,single-choice,spatial-relational,1|7,7,1/7,220495,1
3,3,22,496,1,576,3,7,2,2,5,single-choice,spatial-relational,2|5,7,2/5,220496,2
3,3,22,497,0,635,2,10,4,6,6,single-choice,spatial-relational,4|6,7,4/6,220497,4
3,3,22,498,1,731,3,5,1,1,4,single-choice,spatial-relational,1|4,7,1/4,220498,1
3,3,22,499,1,643,5,7,1,1,6,single-choice,spatial-relational,1|6,7,1/6,220499,1
3,3,22,500,1,537,1,3,1,1,2,single-choice,spatial-relational,1|2,7,1/2,220500,1
3,3,22,501,1,588,3,11,4,4,7,single-choice,spatial-relational,4|7,7,4/7,220501,4
3,3,22,502,1,556,2,12,5,5,7,single-choice,spatial-relational,5|7,7,5/7,220502,5
3,3,22,503,1,700,1,11,5,5,6,single-choice,spatial-relational,5|6,7,5/6,220503,5
3,3,22,504,1,576,2,6,2,2,4,single-choice,spatial-relational,2|4,7,2/4,220504,2
3,3,22,505,1,591,4,10,3,3,7,single-choice,spatial-relational,3|7,7,3/7,220505,3
3,3,22,506,0,666,4,8,2,6,6,single-choice,spatial-relational,2|6,7,2/6,220506,2
3,3,22,507,1,1082,2,8,3,3,5,single-choice,spatial-relational,3|5,7,3/5,220507,3
3,3,22,508,0,846,4,10,3,7,7,single-choice,spatial-relational,3|7,7,3/7,220508,3
3,3,22,509,1,464,1,7,3,3,4,single-choice,spatial-relational,3|4,7,3/4,220509,3
3,3,22,510,1,530,3,5,1,1,4,single-choice,spatial-relational,1|4,7,1/4,220510,1
3,3,22,511,1,506,1,13,6,6,7,single-choice,spatial-relational,6|7,7,6/7,220511,6
3,3,22,512,1,691,3,11,4,4,7,single-choice,spatial-relational,4|7,7,4/7,220512,4
3,3,22,513,1,549,1,7,3,3,4,single-choice,spatial-relational,3|4,7,3/4,220513,3
3,3,22,514,0,623,2,10,4,6,6,single-choice,spatial-relational,4|6,7,4/6,220514,4
3,3,22,515,1,580,1,5,2,2,3,single-choice,spatial-relational,2|3,7,2/3,220515,2
3,3,22,516,1,564,1,5,2,2,3,single-choice,spatial-relational,2|3,7,2/3,220516,2
3,3,22,517,1,611,5,7,1,1,6,single-choice,spatial-relational,1|6,7,1/6,220517,1
3,3,22,518,0,880,4,6,1,5,5,single-choice,spatial-relational,1|5,7,1/5,220518,1
3,3,22,519,1,850,3,7,2,2,5,single-choice,spatial-relational,2|5,7,2/5,220519,2
3,3,22,520,0,1021,2,8,3,5,5,single-choice,spatial-relational,3|5,7,3/5,220520,3
3,3,22,521,1,662,1,3,1,1,2,single-choice,spatial-relational,1|2,7,1/2,220521,1
3,3,22,522,1,505,5,9,2,2,7,single-choice,spatial-relational,2|7,7,2/7,220522,2
3,3,22,523,1,572,2,6,2,2,4,single-choice,spatial-relational,2|4,7,2/4,220523,2
3,3,22,524,1,619,1,9,4,4,5,single-choice,spatial-relational,4|5,7,4/5,220524,4
3,3,22,525,1,849,1,13,6,6,7,single-choice,spatial-relational,6|7,7,6/7,220525,6
3,3,22,526,1,791,4,6,1,1,5,single-choice,spatial-relational,1|5,7,1/5,220526,1
3,3,22,527,1,577,5,9,2,2,7,single-choice,spatial-relational,2|7,7,2/7,220527,2
3,3,22,528,1,620,1,11,5,5,6,single-choice,spatial-relational,5|6,7,5/6,220528,5
3,3,22,529,1,635,6,8,1,1,7,single-choice,spatial-relational,1|7,7,1/7,220529,1
3,3,22,530,1,591,4,6,1,1,5,single-choice,spatial-relational,1|5,7,1/5,220530,1
3,3,22,531,1,637,2,6,2,2,4,single-choice,spatial-relational,2|4,7,2/4,220531,2
3,3,22,532,1,612,3,11,4,4,7,single-choice,spatial-relational,4|7,7,4/7,220532,4
3,3,22,533,1,691,2,10,4,4,6,single-choice,spatial-relational,4|6,7,4/6,220533,4
3,3,22,534,0,567,1,3,1,2,2,single-choice,spatial-relational,1|2,7,1/2,220534,1
3,3,22,535,1,552,4,8,2,2,6,single-choice,spatial-relational,2|6,7,2/6,220535,2
3,3,22,536,1,653,6,8,1,1,7,single-choice,spatial-relational,1|7,7,1/7,220536,1
3,3,22,537,1,583,4,10,3,3,7,single-choice,spatial-relational,3|7,7,3/7,220537,3
3,3,22,538,1,573,6,8,1,1,7,single-choice,spatial-relational,1|7,7,1/7,220538,1
3,3,22,539,0,709,3,9,3,6,6,single-choice,spatial-relational,3|6,7,3/6,220539,3
3,3,22,540,1,452,3,5,1,1,4,single-choice,spatial-relational,1|4,7,1/4,220540,1
3,3,22,541,0,625,3,11,4,7,7,single-choice,spatial-relational,4|7,7,4/7,220541,4
3,3,22,542,1,636,2,6,2,2,4,single-choice,spatial-relational,2|4,7,2/4,220542,2
3,3,22,543,1,679,5,7,1,1,6,single-choice,spatial-relational,1|6,7,1/6,220543,1
3,3,22,544,1,697,3,7,2,2,5,single-choice,spatial-relational,2|5,7,2/5,220544,2
3,3,22,545,1,584,3,7,2,2,5,single-choice,spatial-relational,2|5,7,2/5,220545,2
3,3,22,546,0,839,1,9,4,5,5,single-choice,spatial-relational,4|5,7,4/5,220546,4
3,3,22,547,1,575,1,13,6,6,7,single-choice,spatial-relational,6|7,7,6/7,220547,6
3,3,22,548,0,688,2,10,4,6,6,single-choice,spatial-relational,4|6,7,4/6,220548,4
3,3,22,549,1,561,1,5,2,2,3,single-choice,spatial-relational,2|3,7,2/3,220549,2
3,3,22,550,0,724,5,7,1,6,6,single-choice,spatial-relational,1|6,7,1/6,220550,1
3,3,22,551,1,1460,1,11,5,5,6,single-choice,spatial-relational,5|6,7,5/6,220551,5
3,3,22,552,1,724,4,6,1,1,5,single-choice,spatial-relational,1|5,7,1/5,220552,1
3,3,22,553,0,743,2,8,3,5,5,single-choice,spatial-relational,3|5,7,3/5,220553,3
3,3,22,554,1,564,2,12,5,5,7,single-choice,spatial-relational,5|7,7,5/7,220554,5
3,3,22,555,0,60,2,8,3,5,5,single-choice,spatial-relational,3|5,7,3/5,220555,3
3,3,22,556,1,969,2,12,5,5,7,single-choice,spatial-relational,5|7,7,5/7,220556,5
3,3,22,557,0,738,1,7,3,4,4,single-choice,spatial-relational,3|4,7,3/4,220557,3
3,3,22,558,1,775,1,9,4,4,5,single-choice,spatial-relational,4|5,7,4/5,220558,4
3,3,22,559,1,582,5,9,2,2,7,single-choice,spatial-relational,2|7,7,2/7,220559,2
3,3,22,560,1,615,1,3,1,1,2,single-choice,spatial-relational,1|2,7,1/2,220560,1
3,3,22,561,0,548,4,8,2,6,6,single-choice,spatial-relational,2|6,7,2/6,220561,2
3,3,22,562,1,632,1,13,6,6,7,single-choice,spatial-relational,6|7,7,6/7,220562,6
3,3,22,563,1,1018,5,9,2,2,7,single-choice,spatial-relational,2|7,7,2/7,220563,2
3,3,22,564,1,623,2,4,1,1,3,single-choice,spatial-relational,1|3,7,1/3,220564,1
3,3,22,565,1,613,4,10,3,3,7,single-choice,spatial-relational,3|7,7,3/7,220565,3
3,3,22,566,0,626,1,11,5,6,6,single-choice,spatial-relational,5|6,7,5/6,220566,5
3,3,22,567,1,585,1,7,3,3,4,single-choice,spatial-relational,3|4,7,3/4,220567,3
3,3,22,568,1,731,1,5,2,2,3,single-choice,spatial-relational,2|3,7,2/3,220568,2
3,3,22,569,1,583,3,5,1,1,4,single-choice,spatial-relational,1|4,7,1/4,220569,1
3,3,22,570,1,595,3,9,3,3,6,single-choice,spatial-relational,3|6,7,3/6,220570,3
3,3,22,571,1,722,2,4,1,1,3,single-choice,spatial-relational,1|3,7,1/3,220571,1
3,3,22,572,1,654,1,11,5,5,6,single-choice,spatial-relational,5|6,7,5/6,220572,5
3,3,22,573,1,580,3,11,4,4,7,single-choice,spatial-relational,4|7,7,4/7,220573,4
3,3,22,574,1,611,3,7,2,2,5,single-choice,spatial-relational,2|5,7,2/5,220574,2
3,3,22,575,1,605,5,9,2,2,7,single-choice,spatial-relational,2|7,7,2/7,220575,2
3,3,22,576,1,791,2,12,5,5,7,single-choice,spatial-relational,5|7,7,5/7,220576,5
3,3,22,577,1,576,5,7,1,1,6,single-choice,spatial-relational,1|6,7,1/6,220577,1
3,3,22,578,1,565,1,5,2,2,3,single-choice,spatial-relational,2|3,7,2/3,220578,2
3,3,22,579,1,622,3,5,1,1,4,single-choice,spatial-relational,1|4,7,1/4,220579,1
3,3,22,580,1,642,1,7,3,3,4,single-choice,spatial-relational,3|4,7,3/4,220580,3
3,3,22,581,0,610,1,3,1,2,2,single-choice,spatial-relational,1|2,7,1/2,220581,1
3,3,22,582,1,775,3,11,4,4,7,single-choice,spatial-relational,4|7,7,4/7,220582,4
3,3,22,583,1,670,1,13,6,6,7,single-choice,spatial-relational,6|7,7,6/7,220583,6
3,3,22,584,0,657,1,9,4,5,5,single-choice,spatial-relational,4|5,7,4/5,220584,4
3,3,22,585,1,596,1,5,2,2,3,single-choice,spatial-relational,2|3,7,2/3,220585,2
3,3,22,586,0,625,4,6,1,5,5,single-choice,spatial-relational,1|5,7,1/5,220586,1
3,3,22,587,0,65,4,10,3,7,7,single-choice,spatial-relational,3|7,7,3/7,220587,3
3,3,22,588,1,72,6,8,1,1,7,single-choice,spatial-relational,1|7,7,1/7,220588,1
3,3,22,589,1,579,1,9,4,4,5,single-choice,spatial-relational,4|5,7,4/5,220589,4
3,3,22,590,1,614,4,10,3,3,7,single-choice,spatial-relational,3|7,7,3/7,220590,3
3,3,22,591,1,580,6,8,1,1,7,single-choice,spatial-relational,1|7,7,1/7,220591,1
3,3,22,592,0,532,2,4,1,3,3,single-choice,spatial-relational,1|3,7,1/3,220592,1
3,3,22,593,1,1139,2,10,4,4,6,single-choice,spatial-relational,4|6,7,4/6,220593,4
3,3,22,594,1,625,3,5,1,1,4,single-choice,spatial-relational,1|4,7,1/4,220594,1
3,3,22,595,0,744,4,6,1,5,5,single-choice,spatial-relational,1|5,7,1/5,220595,1
3,3,22,596,1,486,3,7,2,2,5,single-choice,spatial-relational,2|5,7,2/5,220596,2
3,3,22,597,1,686,4,8,2,2,6,single-choice,spatial-relational,2|6,7,2/6,220597,2
3,3,22,598,1,821,5,7,1,1,6,single-choice,spatial-relational,1|6,7,1/6,220598,1
3,3,22,599,0,642,2,8,3,5,5,single-choice,spatial-relational,3|5,7,3/5,220599,3
3,3,22,600,1,585,2,4,1,1,3,single-choice,spatial-relational,1|3,7,1/3,220600,1
3,3,22,601,1,642,1,3,1,1,2,single-choice,spatial-relational,1|2,7,1/2,220601,1
3,3,22,602,1,697,2,8,3,3,5,single-choice,spatial-relational,3|5,7,3/5,220602,3
3,3,22,603,1,674,1,11,5,5,6,single-choice,spatial-relational,5|6,7,5/6,220603,5
3,3,22,604,0,696,1,13,6,7,7,single-choice,spatial-relational,6|7,7,6/7,220604,6
3,3,22,605,1,527,2,12,5,5,7,single-choice,spatial-relational,5|7,7,5/7,220605,5
3,3,22,606,0,719,3,9,3,6,6,single-choice,spatial-relational,3|6,7,3/6,220606,3
3,3,22,607,1,652,2,10,4,4,6,single-choice,spatial-relational,4|6,7,4/6,220607,4
3,3,22,608,1,490,5,9,2,2,7,single-choice,spatial-relational,2|7,7,2/7,220608,2
3,3,22,609,1,577,2,6,2,2,4,single-choice,spatial-relational,2|4,7,2/4,220609,2
3,3,22,610,1,537,2,6,2,2,4,single-choice,spatial-relational,2|4,7,2/4,220610,2
3,3,22,611,1,623,3,9,3,3,6,single-choice,spatial-relational,3|6,7,3/6,220611,3
3,3,22,612,1,594,4,8,2,2,6,single-choice,spatial-relational,2|6,7,2/6,220612,2
3,3,22,613,0,724,1,7,3,4,4,single-choice,spatial-relational,3|4,7,3/4,220613,3
3,3,22,614,1,50,4,6,1,1,5,single-choice,spatial-relational,1|5,7,1/5,220614,1
3,3,22,615,1,730,1,11,5,5,6,single-choice,spatial-relational,5|6,7,5/6,220615,5
3,3,22,616,1,592,3,5,1,1,4,single-choice,spatial-relational,1|4,7,1/4,220616,1
3,3,22,617,0,731,1,7,3,4,4,single-choice,spatial-relational,3|4,7,3/4,220617,3
3,3,22,618,1,517,3,5,1,1,4,single-choice,spatial-relational,1|4,7,1/4,220618,1
3,3,22,619,1,587,3,9,3,3,6,single-choice,spatial-relational,3|6,7,3/6,220619,3
3,3,22,620,1,589,4,10,3,3,7,single-choice,spatial-relational,3|7,7,3/7,220620,3
3,3,22,621,1,653,2,10,4,4,6,single-choice,spatial-relational,4|6,7,4/6,220621,4
3,3,22,622,1,516,2,12,5,5,7,single-choice,spatial-relational,5|7,7,5/7,220622,5
3,3,22,623,1,741,3,7,2,2,5,single-choice,spatial-relational,2|5,7,2/5,220623,2
3,3,22,624,0,589,6,8,1,7,7,single-choice,spatial-relational,1|7,7,1/7,220624,1
3,3,22,625,1,1288,1,7,3,3,4,single-choice,spatial-relational,3|4,7,3/4,220625,3
1,3,23,1,1,1749,1,9,4,4,5,single-choice,spatial-relational,4|5,7,4/5,230001,4
1,3,23,2,1,2063,1,3,1,1,2,single-choice,spatial-relational,1|2,7,1/2,230002,1
1,3,23,3,0,864,1,5,2,3,3,single-choice,spatial-relational,2|3,7,2/3,230003,2
1,3,23,4,1,1048,1,13,6,6,7,single-choice,spatial-relational,6|7,7,6/7,230004,6
1,3,23,5,0,712,1,9,4,5,5,single-choice,spatial-relational,4|5,7,4/5,230005,4
1,3,23,6,0,737,1,7,3,4,4,single-choice,spatial-relational,3|4,7,3/4,230006,3
1,3,23,7,0,503,1,11,5,6,6,single-choice,spatial-relational,5|6,7,5/6,230007,5
1,3,23,8,0,681,1,13,6,7,7,single-choice,spatial-relational,6|7,7,6/7,230008,6
1,3,23,9,1,650,1,5,2,2,3,single-choice,spatial-relational,2|3,7,2/3,230009,2
1,3,23,10,0,684,1,11,5,6,6,single-choice,spatial-relational,5|6,7,5/6,230010,5
1,3,23,11,0,1412,1,7,3,4,4,single-choice,spatial-relational,3|4,7,3/4,230011,3
1,3,23,12,1,735,1,3,1,1,2,single-choice,spatial-relational,1|2,7,1/2,230012,1
1,3,23,13,1,659,1,3,1,1,2,single-choice,spatial-relational,1|2,7,1/2,230013,1
1,3,23,14,0,643,1,7,3,4,4,single-choice,spatial-relational,3|4,7,3/4,230014,3
1,3,23,15,1,693,1,13,6,6,7,single-choice,spatial-relational,6|7,7,6/7,230015,6
1,3,23,16,0,627,1,9,4,5,5,single-choice,spatial-relational,4|5,7,4/5,230016,4
1,3,23,17,1,616,1,5,2,2,3,single-choice,spatial-relational,2|3,7,2/3,230017,2
1,3,23,18,0,619,1,5,2,3,3,single-choice,spatial-relational,2|3,7,2/3,230018,2
1,3,23,19,1,609,1,13,6,6,7,single-choice,spatial-relational,6|7,7,6/7,230019,6
1,3,23,20,0,611,1,11,5,6,6,single-choice,spatial-relational,5|6,7,5/6,230020,5
1,3,23,21,1,773,1,11,5,5,6,single-choice,spatial-relational,5|6,7,5/6,230021,5
1,3,23,22,1,669,1,3,1,1,2,single-choice,spatial-relational,1|2,7,1/2,230022,1
1,3,23,23,0,1048,1,9,4,5,5,single-choice,spatial-relational,4|5,7,4/5,230023,4
1,3,23,24,1,737,1,7,3,3,4,single-choice,spatial-relational,3|4,7,3/4,230024,3
1,3,23,25,0,646,1,11,5,6,6,single-choice,spatial-relational,5|6,7,5/6,230025,5
1,3,23,26,1,740,1,9,4,4,5,single-choice,spatial-relational,4|5,7,4/5,230026,4
1,3,23,27,1,790,1,3,1,1,2,single-choice,spatial-relational,1|2,7,1/2,230027,1
1,3,23,28,1,691,1,13,6,6,7,single-choice,spatial-relational,6|7,7,6/7,230028,6
1,3,23,29,1,697,1,9,4,4,5,single-choice,spatial-relational,4|5,7,4/5,230029,4
1,3,23,30,0,771,1,7,3,4,4,single-choice,spatial-relational,3|4,7,3/4,230030,3
1,3,23,31,0,670,1,7,3,4,4,single-choice,spatial-relational,3|4,7,3/4,230031,3
1,3,23,32,0,695,1,11,5,6,6,single-choice,spatial-relational,5|6,7,5/6,230032,5
1,3,23,33,1,677,1,5,2,2,3,single-choice,spatial-relational,2|3,7,2/3,230033,2
1,3,23,34,0,638,1,5,2,3,3,single-choice,spatial-relational,2|3,7,2/3,230034,2
1,3,23,35,0,671,1,3,1,2,2,single-choice,spatial-relational,1|2,7,1/2,230035,1
1,3,23,36,0,783,1,13,6,7,7,single-choice,spatial-relational,6|7,7,6/7,230036,6
1,3,23,37,0,638,1,7,3,4,4,single-choice,spatial-relational,3|4,7,3/4,230037,3
1,3,23,38,1,886,1,13,6,6,7,single-choice,spatial-relational,6|7,7,6/7,230038,6
1,3,23,39,0,1102,1,7,3,4,4,single-choice,spatial-relational,3|4,7,3/4,230039,3
1,3,23,40,1,764,1,9,4,4,5,single-choice,spatial-relational,4|5,7,4/5,230040,4
1,3,23,41,1,704,1,3,1,1,2,single-choice,spatial-relational,1|2,7,1/2,230041,1
1,3,23,42,1,939,1,9,4,4,5,single-choice,spatial-relational,4|5,7,4/5,230042,4
1,3,23,43,1,709,1,5,2,2,3,single-choice,spatial-relational,2|3,7,2/3,230043,2
1,3,23,44,0,735,1,11,5,6,6,single-choice,spatial-relational,5|6,7,5/6,230044,5
1,3,23,45,0,837,1,13,6,7,7,single-choice,spatial-relational,6|7,7,6/7,230045,6
1,3,23,46,0,1022,1,11,5,6,6,single-choice,spatial-relational,5|6,7,5/6,230046,5
1,3,23,47,0,702,1,3,1,2,2,single-choice,spatial-relational,1|2,7,1/2,230047,1
1,3,23,48,0,803,1,5,2,3,3,single-choice,spatial-relational,2|3,7,2/3,230048,2
1,3,23,49,0,580,1,7,3,4,4,single-choice,spatial-relational,3|4,7,3/4,230049,3
1,3,23,50,0,691,1,5,2,3,3,single-choice,spatial-relational,2|3,7,2/3,230050,2
1,3,23,51,0,820,1,11,5,6,6,single-choice,spatial-relational,5|6,7,5/6,230051,5
1,3,23,52,0,656,1,13,6,7,7,single-choice,spatial-relational,6|7,7,6/7,230052,6
1,3,23,53,0,772,1,9,4,5,5,single-choice,spatial-relational,4|5,7,4/5,230053,4
1,3,23,54,0,906,1,9,4,5,5,single-choice,spatial-relational,4|5,7,4/5,230054,4
1,3,23,55,1,822,1,5,2,2,3,single-choice,spatial-relational,2|3,7,2/3,230055,2
1,3,23,56,0,707,1,7,3,4,4,single-choice,spatial-relational,3|4,7,3/4,230056,3
1,3,23,57,0,783,1,3,1,2,2,single-choice,spatial-relational,1|2,7,1/2,230057,1
1,3,23,58,0,692,1,13,6,7,7,single-choice,spatial-relational,6|7,7,6/7,230058,6
1,3,23,59,1,892,1,11,5,5,6,single-choice,spatial-relational,5|6,7,5/6,230059,5
1,3,23,60,1,723,1,3,1,1,2,single-choice,spatial-relational,1|2,7,1/2,230060,1
1,3,23,61,0,1021,1,9,4,5,5,single-choice,spatial-relational,4|5,7,4/5,230061,4
1,3,23,62,0,658,1,5,2,3,3,single-choice,spatial-relational,2|3,7,2/3,230062,2
1,3,23,63,1,832,1,3,1,1,2,single-choice,spatial-relational,1|2,7,1/2,230063,1
1,3,23,64,1,760,1,7,3,3,4,single-choice,spatial-relational,3|4,7,3/4,230064,3
1,3,23,65,1,821,1,7,3,3,4,single-choice,spatial-relational,3|4,7,3/4,230065,3
1,3,23,66,1,1173,1,5,2,2,3,single-choice,spatial-relational,2|3,7,2/3,230066,2
1,3,23,67,1,915,1,13,6,6,7,single-choice,spatial-relational,6|7,7,6/7,230067,6
1,3,23,68,1,845,1,9,4,4,5,single-choice,spatial-relational,4|5,7,4/5,230068,4
1,3,23,69,0,732,1,3,1,2,2,single-choice,spatial-relational,1|2,7,1/2,230069,1
1,3,23,70,0,722,1,11,5,6,6,single-choice,spatial-relational,5|6,7,5/6,230070,5
1,3,23,71,0,753,1,11,5,6,6,single-choice,spatial-relational,5|6,7,5/6,230071,5
1,3,23,72,0,705,1,13,6,7,7,single-choice,spatial-relational,6|7,7,6/7,230072,6
1,3,23,73,1,671,1,7,3,3,4,single-choice,spatial-relational,3|4,7,3/4,230073,3
1,3,23,74,0,849,1,13,6,7,7,single-choice,spatial-relational,6|7,7,6/7,230074,6
1,3,23,75,0,732,1,11,5,6,6,single-choice,spatial-relational,5|6,7,5/6,230075,5
1,3,23,76,0,861,1,9,4,5,5,single-choice,spatial-relational,4|5,7,4/5,230076,4
1,3,23,77,1,994,1,3,1,1,2,single-choice,spatial-relational,1|2,7,1/2,230077,1
1,3,23,78,1,636,1,7,3,3,4,single-choice,spatial-relational,3|4,7,3/4,230078,3
1,3,23,79,1,732,1,3,1,1,2,single-choice,spatial-relational,1|2,7,1/2,230079,1
1,3,23,80,0,705,1,9,4,5,5,single-choice,spatial-relational,4|5,7,4/5,230080,4
1,3,23,81,0,703,1,11,5,6,6,single-choice,spatial-relational,5|6,7,5/6,230081,5
1,3,23,82,0,593,1,5,2,3,3,single-choice,spatial-relational,2|3,7,2/3,230082,2
1,3,23,83,0,651,1,13,6,7,7,single-choice,spatial-relational,6|7,7,6/7,230083,6
1,3,23,84,0,699,1,5,2,3,3,single-choice,spatial-relational,2|3,7,2/3,230084,2
1,3,23,85,1,690,1,9,4,4,5,single-choice,spatial-relational,4|5,7,4/5,230085,4
1,3,23,86,1,744,1,3,1,1,2,single-choice,spatial-relational,1|2,7,1/2,230086,1
1,3,23,87,1,673,1,7,3,3,4,single-choice,spatial-relational,3|4,7,3/4,230087,3
1,3,23,88,0,983,1,13,6,7,7,single-choice,spatial-relational,6|7,7,6/7,230088,6
1,3,23,89,0,822,1,11,5,6,6,single-choice,spatial-relational,5|6,7,5/6,230089,5
1,3,23,90,0,753,1,5,2,3,3,single-choice,spatial-relational,2|3,7,2/3,230090,2
1,3,23,91,0,663,1,11,5,6,6,single-choice,spatial-relational,5|6,7,5/6,230091,5
1,3,23,92,1,575,1,3,1,1,2,single-choice,spatial-relational,1|2,7,1/2,230092,1
1,3,23,93,1,615,1,9,4,4,5,single-choice,spatial-relational,4|5,7,4/5,230093,4
1,3,23,94,0,681,1,13,6,7,7,single-choice,spatial-relational,6|7,7,6/7,230094,6
1,3,23,95,0,622,1,5,2,3,3,single-choice,spatial-relational,2|3,7,2/3,230095,2
1,3,23,96,1,572,1,7,3,3,4,single-choice,spatial-relational,3|4,7,3/4,230096,3
1,3,23,97,0,801,1,13,6,7,7,single-choice,spatial-relational,6|7,7,6/7,230097,6
1,3,23,98,0,964,1,9,4,5,5,single-choice,spatial-relational,4|5,7,4/5,230098,4
1,3,23,99,1,567,1,9,4,4,5,single-choice,spatial-relational,4|5,7,4/5,230099,4
1,3,23,100,1,732,1,7,3,3,4,single-choice,spatial-relational,3|4,7,3/4,230100,3
1,3,23,101,1,803,1,3,1,1,2,single-choice,spatial-relational,1|2,7,1/2,230101,1
1,3,23,102,0,760,1,5,2,3,3,single-choice,spatial-relational,2|3,7,2/3,230102,2
1,3,23,103,0,891,1,7,3,4,4,single-choice,spatial-relational,3|4,7,3/4,230103,3
1,3,23,104,1,697,1,3,1,1,2,single-choice,spatial-relational,1|2,7,1/2,230104,1
1,3,23,105,0,651,1,5,2,3,3,single-choice,spatial-relational,2|3,7,2/3,230105,2
1,3,23,106,0,613,1,11,5,6,6,single-choice,spatial-relational,5|6,7,5/6,230106,5
1,3,23,107,1,852,1,11,5,5,6,single-choice,spatial-relational,5|6,7,5/6,230107,5
1,3,23,108,0,670,1,13,6,7,7,single-choice,spatial-relational,6|7,7,6/7,230108,6
1,3,23,109,1,719,1,5,2,2,3,single-choice,spatial-relational,2|3,7,2/3,230109,2
1,3,23,110,1,654,1,9,4,4,5,single-choice,spatial-relational,4|5,7,4/5,230110,4
1,3,23,111,1,686,1,7,3,3,4,single-choice,spatial-relational,3|4,7,3/4,230111,3
1,3,23,112,1,718,1,3,1,1,2,single-choice,spatial-relational,1|2,7,1/2,230112,1
1,3,23,113,0,666,1,5,2,3,3,single-choice,spatial-relational,2|3,7,2/3,230113,2
1,3,23,114,1,603,1,3,1,1,2,single-choice,spatial-relational,1|2,7,1/2,230114,1
1,3,23,115,1,587,1,13,6,6,7,single-choice,spatial-relational,6|7,7,6/7,230115,6
1,3,23,116,0,650,1,13,6,7,7,single-choice,spatial-relational,6|7,7,6/7,230116,6
1,3,23,117,1,675,1,9,4,4,5,single-choice,spatial-relational,4|5,7,4/5,230117,4
1,3,23,118,0,654,1,11,5,6,6,single-choice,spatial-relational,5|6,7,5/6,230118,5
1,3,23,119,0,753,1,11,5,6,6,single-choice,spatial-relational,5|6,7,5/6,230119,5
1,3,23,120,1,809,1,7,3,3,4,single-choice,spatial-relational,3|4,7,3/4,230120,3
1,3,23,121,0,853,1,5,2,3,3,single-choice,spatial-relational,2|3,7,2/3,230121,2
1,3,23,122,0,724,1,5,2,3,3,single-choice,spatial-relational,2|3,7,2/3,230122,2
1,3,23,123,1,829,1,13,6,6,7,single-choice,spatial-relational,6|7,7,6/7,230123,6
1,3,23,124,1,733,1,13,6,6,7,single-choice,spatial-relational,6|7,7,6/7,230124,6
1,3,23,125,0,652,1,7,3,4,4,single-choice,spatial-relational,3|4,7,3/4,230125,3
1,3,23,126,1,705,1,3,1,1,2,single-choice,spatial-relational,1|2,7,1/2,230126,1
1,3,23,127,1,631,1,9,4,4,5,single-choice,spatial-relational,4|5,7,4/5,230127,4
1,3,23,128,1,671,1,9,4,4,5,single-choice,spatial-relational,4|5,7,4/5,230128,4
1,3,23,129,1,627,1,7,3,3,4,single-choice,spatial-relational,3|4,7,3/4,230129,3
1,3,23,130,1,878,1,11,5,5,6,single-choice,spatial-relational,5|6,7,5/6,230130,5
1,3,23,131,0,608,1,11,5,6,6,single-choice,spatial-relational,5|6,7,5/6,230131,5
1,3,23,132,1,885,1,3,1,1,2,single-choice,spatial-relational,1|2,7,1/2,230132,1
1,3,23,133,0,644,1,7,3,4,4,single-choice,spatial-relational,3|4,7,3/4,230133,3
1,3,23,134,0,650,1,5,2,3,3,single-choice,spatial-relational,2|3,7,2/3,230134,2
1,3,23,135,1,651,1,9,4,4,5,single-choice,spatial-relational,4|5,7,4/5,230135,4
1,3,23,136,1,832,1,3,1,1,2,single-choice,spatial-relational,1|2,7,1/2,230136,1
1,3,23,137,1,654,1,13,6,6,7,single-choice,spatial-relational,6|7,7,6/7,230137,6
1,3,23,138,0,789,1,5,2,3,3,single-choice,spatial-relational,2|3,7,2/3,230138,2
1,3,23,139,1,766,1,9,4,4,5,single-choice,spatial-relational,4|5,7,4/5,230139,4
1,3,23,140,1,615,1,7,3,3,4,single-choice,spatial-relational,3|4,7,3/4,230140,3
1,3,23,141,0,1795,1,3,1,2,2,single-choice,spatial-relational,1|2,7,1/2,230141,1
1,3,23,142,0,726,1,13,6,7,7,single-choice,spatial-relational,6|7,7,6/7,230142,6
1,3,23,143,1,808,1,11,5,5,6,single-choice,spatial-relational,5|6,7,5/6,230143,5
1,3,23,144,1,950,1,11,5,5,6,single-choice,spatial-relational,5|6,7,5/6,230144,5
1,3,23,145,1,700,1,3,1,1,2,single-choice,spatial-relational,1|2,7,1/2,230145,1
1,3,23,146,0,720,1,5,2,3,3,single-choice,spatial-relational,2|3,7,2/3,230146,2
1,3,23,147,0,670,1,11,5,6,6,single-choice,spatial-relational,5|6,7,5/6,230147,5
1,3,23,148,1,756,1,9,4,4,5,single-choice,spatial-relational,4|5,7,4/5,230148,4
1,3,23,149,1,1278,1,11,5,5,6,single-choice,spatial-relational,5|6,7,5/6,230149,5
1,3,23,150,1,890,1,13,6,6,7,single-choice,spatial-relational,6|7,7,6/7,230150,6
1,3,23,151,0,814,1,7,3,4,4,single-choice,spatial-relational,3|4,7,3/4,230151,3
1,3,23,152,1,929,1,5,2,2,3,single-choice,spatial-relational,2|3,7,2/3,230152,2
1,3,23,153,1,678,1,13,6,6,7,single-choice,spatial-relational,6|7,7,6/7,230153,6
1,3,23,154,1,596,1,9,4,4,5,single-choice,spatial-relational,4|5,7,4/5,230154,4
1,3,23,155,0,640,1,7,3,4,4,single-choice,spatial-relational,3|4,7,3/4,230155,3
1,3,23,156,0,826,1,3,1,2,2,single-choice,spatial-relational,1|2,7,1/2,230156,1
1,3,23,157,1,881,1,3,1,1,2,single-choice,spatial-relational,1|2,7,1/2,230157,1
1,3,23,158,0,627,1,7,3,4,4,single-choice,spatial-relational,3|4,7,3/4,230158,3
1,3,23,159,0,863,1,11,5,6,6,single-choice,spatial-relational,5|6,7,5/6,230159,5
1,3,23,160,0,843,1,11,5,6,6,single-choice,spatial-relational,5|6,7,5/6,230160,5
1,3,23,161,1,733,1,5,2,2,3,single-choice,spatial-relational,2|3,7,2/3,230161,2
1,3,23,162,0,646,1,13,6,7,7,single-choice,spatial-relational,6|7,7,6/7,230162,6
1,3,23,163,1,1505,1,9,4,4,5,single-choice,spatial-relational,4|5,7,4/5,230163,4
1,3,23,164,0,760,1,13,6,7,7,single-choice,spatial-relational,6|7,7,6/7,230164,6
1,3,23,165,1,1052,1,7,3,3,4,single-choice,spatial-relational,3|4,7,3/4,230165,3
1,3,23,166,0,763,1,5,2,3,3,single-choice,spatial-relational,2|3,7,2/3,230166,2
1,3,23,167,1,681,1,3,1,1,2,single-choice,spatial-relational,1|2,7,1/2,230167,1
1,3,23,168,1,639,1,9,4,4,5,single-choice,spatial-relational,4|5,7,4/5,230168,4
1,3,23,169,0,689,1,7,3,4,4,single-choice,spatial-relational,3|4,7,3/4,230169,3
1,3,23,170,0,1824,1,11,5,6,6,single-choice,spatial-relational,5|6,7,5/6,230170,5
1,3,23,171,1,721,1,9,4,4,5,single-choice,spatial-relational,4|5,7,4/5,230171,4
1,3,23,172,1,792,1,5,2,2,3,single-choice,spatial-relational,2|3,7,2/3,230172,2
1,3,23,173,1,733,1,13,6,6,7,single-choice,spatial-relational,6|7,7,6/7,230173,6
1,3,23,174,1,967,1,11,5,5,6,single-choice,spatial-relational,5|6,7,5/6,230174,5
1,3,23,175,0,636,1,7,3,4,4,single-choice,spatial-relational,3|4,7,3/4,230175,3
1,3,23,176,0,682,1,5,2,3,3,single-choice,spatial-relational,2|3,7,2/3,230176,2
1,3,23,177,1,642,1,9,4,4,5,single-choice,spatial-relational,4|5,7,4/5,230177,4
1,3,23,178,0,720,1,13,6,7,7,single-choice,spatial-relational,6|7,7,6/7,230178,6
1,3,23,179,1,712,1,3,1,1,2,single-choice,spatial-relational,1|2,7,1/2,230179,1
1,3,23,180,1,709,1,3,1,1,2,single-choice,spatial-relational,1|2,7,1/2,230180,1
1,3,23,181,0,646,1,7,3,4,4,single-choice,spatial-relational,3|4,7,3/4,230181,3
1,3,23,182,0,819,1,5,2,3,3,single-choice,spatial-relational,2|3,7,2/3,230182,2
1,3,23,183,1,666,1,9,4,4,5,single-choice,spatial-relational,4|5,7,4/5,230183,4
1,3,23,184,0,752,1,11,5,6,6,single-choice,spatial-relational,5|6,7,5/6,230184,5
1,3,23,185,1,773,1,3,1,1,2,single-choice,spatial-relational,1|2,7,1/2,230185,1
1,3,23,186,0,643,1,13,6,7,7,single-choice,spatial-relational,6|7,7,6/7,230186,6
1,3,23,187,1,568,1,9,4,4,5,single-choice,spatial-relational,4|5,7,4/5,230187,4
1,3,23,188,0,736,1,3,1,2,2,single-choice,spatial-relational,1|2,7,1/2,230188,1
1,3,23,189,0,570,1,7,3,4,4,single-choice,spatial-relational,3|4,7,3/4,230189,3
1,3,23,190,1,694,1,5,2,2,3,single-choice,spatial-relational,2|3,7,2/3,230190,2
1,3,23,191,1,631,1,11,5,5,6,single-choice,spatial-relational,5|6,7,5/6,230191,5
1,3,23,192,1,673,1,13,6,6,7,single-choice,spatial-relational,6|7,7,6/7,230192,6
1,3,23,193,0,734,1,3,1,2,2,single-choice,spatial-relational,1|2,7,1/2,230193,1
1,3,23,194,1,1405,1,11,5,5,6,single-choice,spatial-relational,5|6,7,5/6,230194,5
1,3,23,195,1,868,1,5,2,2,3,single-choice,spatial-relational,2|3,7,2/3,230195,2
1,3,23,196,0,689,1,7,3,4,4,single-choice,spatial-relational,3|4,7,3/4,230196,3
1,3,23,197,0,661,1,11,5,6,6,single-choice,spatial-relational,5|6,7,5/6,230197,5
1,3,23,198,0,602,1,13,6,7,7,single-choice,spatial-relational,6|7,7,6/7,230198,6
1,3,23,199,0,681,1,7,3,4,4,single-choice,spatial-relational,3|4,7,3/4,230199,3
1,3,23,200,1,784,1,13,6,6,7,single-choice,spatial-relational,6|7,7,6/7,230200,6
1,3,23,201,0,850,1,5,2,3,3,single-choice,spatial-relational,2|3,7,2/3,230201,2
1,3,23,202,1,56,1,3,1,1,2,single-choice,spatial-relational,1|2,7,1/2,230202,1
1,3,23,203,1,638,1,9,4,4,5,single-choice,spatial-relational,4|5,7,4/5,230203,4
1,3,23,204,1,596,1,9,4,4,5,single-choice,spatial-relational,4|5,7,4/5,230204,4
1,3,23,205,1,619,1,11,5,5,6,single-choice,spatial-relational,5|6,7,5/6,230205,5
1,3,23,206,0,721,1,3,1,2,2,single-choice,spatial-relational,1|2,7,1/2,230206,1
1,3,23,207,1,52,1,9,4,4,5,single-choice,spatial-relational,4|5,7,4/5,230207,4
1,3,23,208,0,602,1,5,2,3,3,single-choice,spatial-relational,2|3,7,2/3,230208,2
1,3,23,209,0,646,1,7,3,4,4,single-choice,spatial-relational,3|4,7,3/4,230209,3
1,3,23,210,1,959,1,7,3,3,4,single-choice,spatial-relational,3|4,7,3/4,230210,3
1,3,23,211,0,1134,1,5,2,3,3,single-choice,spatial-relational,2|3,7,2/3,230211,2
1,3,23,212,1,779,1,3,1,1,2,single-choice,spatial-relational,1|2,7,1/2,230212,1
1,3,23,213,0,611,1,11,5,6,6,single-choice,spatial-relational,5|6,7,5/6,230213,5
1,3,23,214,1,821,1,13,6,6,7,single-choice,spatial-relational,6|7,7,6/7,230214,6
1,3,23,215,1,720,1,13,6,6,7,single-choice,spatial-relational,6|7,7,6/7,230215,6
1,3,23,216,1,733,1,9,4,4,5,single-choice,spatial-relational,4|5,7,4/5,230216,4
1,3,23,217,1,691,1,13,6,6,7,single-choice,spatial-relational,6|7,7,6/7,230217,6
1,3,23,218,1,619,1,11,5,5,6,single-choice,spatial-relational,5|6,7,5/6,230218,5
1,3,23,219,0,716,1,7,3,4,4,single-choice,spatial-relational,3|4,7,3/4,230219,3
1,3,23,220,1,752,1,9,4,4,5,single-choice,spatial-relational,4|5,7,4/5,230220,4
1,3,23,221,0,876,1,5,2,3,3,single-choice,spatial-relational,2|3,7,2/3,230221,2
1,3,23,222,0,962,1,9,4,5,5,single-choice,spatial-relational,4|5,7,4/5,230222,4
1,3,23,223,0,913,1,3,1,2,2,single-choice,spatial-relational,1|2,7,1/2,230223,1
1,3,23,224,0,643,1,11,5,6,6,single-choice,spatial-relational,5|6,7,5/6,230224,5
1,3,23,225,1,759,1,7,3,3,4,single-choice,spatial-relational,3|4,7,3/4,230225,3
1,3,23,226,1,714,1,3,1,1,2,single-choice,spatial-relational,1|2,7,1/2,230226,1
1,3,23,227,1,810,1,5,2,2,3,single-choice,spatial-relational,2|3,7,2/3,230227,2
1,3,23,228,0,706,1,13,6,7,7,single-choice,spatial-relational,6|7,7,6/7,230228,6
1,3,23,229,1,54,1,11,5,5,6,single-choice,spatial-relational,5|6,7,5/6,230229,5
1,3,23,230,1,642,1,11,5,5,6,single-choice,spatial-relational,5|6,7,5/6,230230,5
1,3,23,231,1,723,1,9,4,4,5,single-choice,spatial-relational,4|5,7,4/5,230231,4
1,3,23,232,1,690,1,13,6,6,7,single-choice,spatial-relational,6|7,7,6/7,230232,6
1,3,23,233,0,734,1,7,3,4,4,single-choice,spatial-relational,3|4,7,3/4,230233,3
1,3,23,234,0,905,1,5,2,3,3,single-choice,spatial-relational,2|3,7,2/3,230234,2
1,3,23,235,0,674,1,3,1,2,2,single-choice,spatial-relational,1|2,7,1/2,230235,1
1,3,23,236,0,909,1,13,6,7,7,single-choice,spatial-relational,6|7,7,6/7,230236,6
1,3,23,237,1,829,1,7,3,3,4,single-choice,spatial-relational,3|4,7,3/4,230237,3
1,3,23,238,1,768,1,3,1,1,2,single-choice,spatial-relational,1|2,7,1/2,230238,1
1,3,23,239,1,704,1,9,4,4,5,single-choice,spatial-relational,4|5,7,4/5,230239,4
1,3,23,240,1,736,1,5,2,2,3,single-choice,spatial-relational,2|3,7,2/3,230240,2
1,3,23,241,0,833,1,3,1,2,2,single-choice,spatial-relational,1|2,7,1/2,230241,1
1,3,23,242,1,697,1,11,5,5,6,single-choice,spatial-relational,5|6,7,5/6,230242,5
1,3,23,243,0,634,1,13,6,7,7,single-choice,spatial-relational,6|7,7,6/7,230243,6
1,3,23,244,0,1182,1,3,1,2,2,single-choice,spatial-relational,1|2,7,1/2,230244,1
1,3,23,245,0,891,1,11,5,6,6,single-choice,spatial-relational,5|6,7,5/6,230245,5
1,3,23,246,1,652,1,9,4,4,5,single-choice,spatial-relational,4|5,7,4/5,230246,4
1,3,23,247,1,641,1,9,4,4,5,single-choice,spatial-relational,4|5,7,4/5,230247,4
1,3,23,248,0,678,1,7,3,4,4,single-choice,spatial-relational,3|4,7,3/4,230248,3
1,3,23,249,1,863,1,5,2,2,3,single-choice,spatial-relational,2|3,7,2/3,230249,2
1,3,23,250,1,608,1,13,6,6,7,single-choice,spatial-relational,6|7,7,6/7,230250,6
1,3,23,251,0,821,1,7,3,4,4,single-choice,spatial-relational,3|4,7,3/4,230251,3
1,3,23,252,0,809,1,5,2,3,3,single-choice,spatial-relational,2|3,7,2/3,230252,2
1,3,23,253,0,1022,1,9,4,5,5,single-choice,spatial-relational,4|5,7,4/5,230253,4
1,3,23,254,1,732,1,7,3,3,4,single-choice,spatial-relational,3|4,7,3/4,230254,3
1,3,23,255,0,611,1,9,4,5,5,single-choice,spatial-relational,4|5,7,4/5,230255,4
1,3,23,256,0,1053,1,11,5,6,6,single-choice,spatial-relational,5|6,7,5/6,230256,5
1,3,23,257,0,695,1,5,2,3,3,single-choice,spatial-relational,2|3,7,2/3,230257,2
1,3,23,258,0,994,1,3,1,2,2,single-choice,spatial-relational,1|2,7,1/2,230258,1
1,3,23,259,0,888,1,13,6,7,7,single-choice,spatial-relational,6|7,7,6/7,230259,6
1,3,23,260,1,44,1,5,2,2,3,single-choice,spatial-relational,2|3,7,2/3,230260,2
1,3,23,261,0,666,1,11,5,6,6,single-choice,spatial-relational,5|6,7,5/6,230261,5
1,3,23,262,1,1092,1,13,6,6,7,single-choice,spatial-relational,6|7,7,6/7,230262,6
1,3,23,263,1,674,1,7,3,3,4,single-choice,spatial-relational,3|4,7,3/4,230263,3
1,3,23,264,0,792,1,3,1,2,2,single-choice,spatial-relational,1|2,7,1/2,230264,1
1,3,23,265,1,40,1,5,2,2,3,single-choice,spatial-relational,2|3,7,2/3,230265,2
1,3,23,266,0,615,1,13,6,7,7,single-choice,spatial-relational,6|7,7,6/7,230266,6
1,3,23,267,1,701,1,9,4,4,5,single-choice,spatial-relational,4|5,7,4/5,230267,4
1,3,23,268,0,744,1,3,1,2,2,single-choice,spatial-relational,1|2,7,1/2,230268,1
1,3,23,269,1,955,1,11,5,5,6,single-choice,spatial-relational,5|6,7,5/6,230269,5
1,3,23,270,1,615,1,11,5,5,6,single-choice,spatial-relational,5|6,7,5/6,230270,5
1,3,23,271,1,744,1,3,1,1,2,single-choice,spatial-relational,1|2,7,1/2,230271,1
1,3,23,272,1,641,1,7,3,3,4,single-choice,spatial-relational,3|4,7,3/4,230272,3
1,3,23,273,1,670,1,5,2,2,3,single-choice,spatial-relational,2|3,7,2/3,230273,2
1,3,23,274,0,793,1,7,3,4,4,single-choice,spatial-relational,3|4,7,3/4,230274,3
1,3,23,275,0,1462,1,9,4,5,5,single-choice,spatial-relational,4|5,7,4/5,230275,4
1,3,23,276,1,681,1,13,6,6,7,single-choice,spatial-relational,6|7,7,6/7,230276,6
1,3,23,277,1,1308,1,11,5,5,6,single-choice,spatial-relational,5|6,7,5/6,230277,5
1,3,23,278,0,662,1,13,6,7,7,single-choice,spatial-relational,6|7,7,6/7,230278,6
1,3,23,279,0,764,1,5,2,3,3,single-choice,spatial-relational,2|3,7,2/3,230279,2
1,3,23,280,1,78,1,7,3,3,4,single-choice,spatial-relational,3|4,7,3/4,230280,3
1,3,23,281,0,762,1,3,1,2,2,single-choice,spatial-relational,1|2,7,1/2,230281,1
1,3,23,282,1,979,1,11,5,5,6,single-choice,spatial-relational,5|6,7,5/6,230282,5
1,3,23,283,0,682,1,9,4,5,5,single-choice,spatial-relational,4|5,7,4/5,230283,4
1,3,23,284,1,642,1,13,6,6,7,single-choice,spatial-relational,6|7,7,6/7,230284,6
1,3,23,285,0,757,1,3,1,2,2,single-choice,spatial-relational,1|2,7,1/2,230285,1
1,3,23,286,1,643,1,7,3,3,4,single-choice,spatial-relational,3|4,7,3/4,230286,3
1,3,23,287,0,875,1,9,4,5,5,single-choice,spatial-relational,4|5,7,4/5,230287,4
1,3,23,288,1,714,1,5,2,2,3,single-choice,spatial-relational,2|3,7,2/3,230288,2
1,3,23,289,0,868,1,5,2,3,3,single-choice,spatial-relational,2|3,7,2/3,230289,2
1,3,23,290,0,739,1,3,1,2,2,single-choice,spatial-relational,1|2,7,1/2,230290,1
1,3,23,291,1,44,1,3,1,1,2,single-choice,spatial-relational,1|2,7,1/2,230291,1
1,3,23,292,1,713,1,7,3,3,4,single-choice,spatial-relational,3|4,7,3/4,230292,3
1,3,23,293,0,630,1,11,5,6,6,single-choice,spatial-relational,5|6,7,5/6,230293,5
1,3,23,294,1,870,1,9,4,4,5,single-choice,spatial-relational,4|5,7,4/5,230294,4
1,3,23,295,0,630,1,5,2,3,3,single-choice,spatial-relational,2|3,7,2/3,230295,2
1,3,23,296,0,44,1,11,5,6,6,single-choice,spatial-relational,5|6,7,5/6,230296,5
1,3,23,297,0,755,1,13,6,7,7,single-choice,spatial-relational,6|7,7,6/7,230297,6
1,3,23,298,1,811,1,7,3,3,4,single-choice,spatial-relational,3|4,7,3/4,230298,3
1,3,23,299,0,650,1,9,4,5,5,single-choice,spatial-relational,4|5,7,4/5,230299,4
1,3,23,300,1,1380,1,13,6,6,7,single-choice,spatial-relational,6|7,7,6/7,230300,6
1,3,23,301,1,929,1,7,3,3,4,single-choice,spatial-relational,3|4,7,3/4,230301,3
1,3,23,302,0,702,1,9,4,5,5,single-choice,spatial-relational,4|5,7,4/5,230302,4
1,3,23,303,1,860,1,11,5,5,6,single-choice,spatial-relational,5|6,7,5/6,230303,5
1,3,23,304,0,725,1,5,2,3,3,single-choice,spatial-relational,2|3,7,2/3,230304,2
1,3,23,305,0,651,1,3,1,2,2,single-choice,spatial-relational,1|2,7,1/2,230305,1
1,3,23,306,1,814,1,13,6,6,7,single-choice,spatial-relational,6|7,7,6/7,230306,6
1,3,23,307,1,742,1,7,3,3,4,single-choice,spatial-relational,3|4,7,3/4,230307,3
1,3,23,308,1,742,1,3,1,1,2,single-choice,spatial-relational,1|2,7,1/2,230308,1
1,3,23,309,0,734,1,5,2,3,3,single-choice,spatial-relational,2|3,7,2/3,230309,2
1,3,23,310,1,811,1,13,6,6,7,single-choice,spatial-relational,6|7,7,6/7,230310,6
1,3,23,311,0,992,1,9,4,5,5,single-choice,spatial-relational,4|5,7,4/5,230311,4
1,3,23,312,0,896,1,11,5,6,6,single-choice,spatial-relational,5|6,7,5/6,230312,5
1,3,23,313,1,812,1,3,1,1,2,single-choice,spatial-relational,1|2,7,1/2,230313,1
1,3,23,314,0,702,1,5,2,3,3,single-choice,spatial-relational,2|3,7,2/3,230314,2
1,3,23,315,1,701,1,5,2,2,3,single-choice,spatial-relational,2|3,7,2/3,230315,2
1,3,23,316,0,690,1,9,4,5,5,single-choice,spatial-relational,4|5,7,4/5,230316,4
1,3,23,317,0,711,1,9,4,5,5,single-choice,spatial-relational,4|5,7,4/5,230317,4
1,3,23,318,0,716,1,13,6,7,7,single-choice,spatial-relational,6|7,7,6/7,230318,6
1,3,23,319,0,793,1,13,6,7,7,single-choice,spatial-relational,6|7,7,6/7,230319,6
1,3,23,320,0,44,1,7,3,4,4,single-choice,spatial-relational,3|4,7,3/4,230320,3
1,3,23,321,0,704,1,11,5,6,6,single-choice,spatial-relational,5|6,7,5/6,230321,5
1,3,23,322,1,56,1,7,3,3,4,single-choice,spatial-relational,3|4,7,3/4,230322,3
1,3,23,323,0,721,1,3,1,2,2,single-choice,spatial-relational,1|2,7,1/2,230323,1
1,3,23,324,1,44,1,11,5,5,6,single-choice,spatial-relational,5|6,7,5/6,230324,5
1,3,23,325,1,888,1,7,3,3,4,single-choice,spatial-relational,3|4,7,3/4,230325,3
1,3,23,326,1,779,1,11,5,5,6,single-choice,spatial-relational,5|6,7,5/6,230326,5
1,3,23,327,1,769,1,13,6,6,7,single-choice,spatial-relational,6|7,7,6/7,230327,6
1,3,23,328,0,674,1,11,5,6,6,single-choice,spatial-relational,5|6,7,5/6,230328,5
1,3,23,329,1,648,1,5,2,2,3,single-choice,spatial-relational,2|3,7,2/3,230329,2
1,3,23,330,0,828,1,13,6,7,7,single-choice,spatial-relational,6|7,7,6/7,230330,6
1,3,23,331,0,640,1,3,1,2,2,single-choice,spatial-relational,1|2,7,1/2,230331,1
1,3,23,332,1,834,1,3,1,1,2,single-choice,spatial-relational,1|2,7,1/2,230332,1
1,3,23,333,0,731,1,9,4,5,5,single-choice,spatial-relational,4|5,7,4/5,230333,4
1,3,23,334,0,1129,1,9,4,5,5,single-choice,spatial-relational,4|5,7,4/5,230334,4
1,3,23,335,0,726,1,5,2,3,3,single-choice,spatial-relational,2|3,7,2/3,230335,2
1,3,23,336,1,855,1,7,3,3,4,single-choice,spatial-relational,3|4,7,3/4,230336,3
1,3,23,337,0,737,1,3,1,2,2,single-choice,spatial-relational,1|2,7,1/2,230337,1
1,3,23,338,1,52,1,7,3,3,4,single-choice,spatial-relational,3|4,7,3/4,230338,3
1,3,23,339,1,724,1,11,5,5,6,single-choice,spatial-relational,5|6,7,5/6,230339,5
1,3,23,340,1,673,1,13,6,6,7,single-choice,spatial-relational,6|7,7,6/7,230340,6
1,3,23,341,1,794,1,3,1,1,2,single-choice,spatial-relational,1|2,7,1/2,230341,1
1,3,23,342,0,649,1,11,5,6,6,single-choice,spatial-relational,5|6,7,5/6,230342,5
1,3,23,343,0,656,1,9,4,5,5,single-choice,spatial-relational,4|5,7,4/5,230343,4
1,3,23,344,1,683,1,7,3,3,4,single-choice,spatial-relational,3|4,7,3/4,230344,3
1,3,23,345,0,833,1,5,2,3,3,single-choice,spatial-relational,2|3,7,2/3,230345,2
1,3,23,346,1,671,1,5,2,2,3,single-choice,spatial-relational,2|3,7,2/3,230346,2
1,3,23,347,0,642,1,13,6,7,7,single-choice,spatial-relational,6|7,7,6/7,230347,6
1,3,23,348,0,859,1,9,4,5,5,single-choice,spatial-relational,4|5,7,4/5,230348,4
1,3,23,349,1,85,1,11,5,5,6,single-choice,spatial-relational,5|6,7,5/6,230349,5
1,3,23,350,1,892,1,7,3,3,4,single-choice,spatial-relational,3|4,7,3/4,230350,3
1,3,23,351,1,694,1,11,5,5,6,single-choice,spatial-relational,5|6,7,5/6,230351,5
1,3,23,352,0,705,1,13,6,7,7,single-choice,spatial-relational,6|7,7,6/7,230352,6
1,3,23,353,1,722,1,13,6,6,7,single-choice,spatial-relational,6|7,7,6/7,230353,6
1,3,23,354,0,787,1,3,1,2,2,single-choice,spatial-relational,1|2,7,1/2,230354,1
1,3,23,355,1,618,1,7,3,3,4,single-choice,spatial-relational,3|4,7,3/4,230355,3
1,3,23,356,0,1188,1,5,2,3,3,single-choice,spatial-relational,2|3,7,2/3,230356,2
1,3,23,357,0,918,1,9,4,5,5,single-choice,spatial-relational,4|5,7,4/5,230357,4
1,3,23,358,1,48,1,5,2,2,3,single-choice,spatial-relational,2|3,7,2/3,230358,2
1,3,23,359,1,767,1,3,1,1,2,single-choice,spatial-relational,1|2,7,1/2,230359,1
1,3,23,360,0,642,1,9,4,5,5,single-choice,spatial-relational,4|5,7,4/5,230360,4
1,3,23,361,0,661,1,11,5,6,6,single-choice,spatial-relational,5|6,7,5/6,230361,5
1,3,23,362,1,700,1,13,6,6,7,single-choice,spatial-relational,6|7,7,6/7,230362,6
1,3,23,363,1,1011,1,7,3,3,4,single-choice,spatial-relational,3|4,7,3/4,230363,3
1,3,23,364,0,701,1,13,6,7,7,single-choice,spatial-relational,6|7,7,6/7,230364,6
1,3,23,365,1,716,1,7,3,3,4,single-choice,spatial-relational,3|4,7,3/4,230365,3
1,3,23,366,0,736,1,3,1,2,2,single-choice,spatial-relational,1|2,7,1/2,230366,1
1,3,23,367,0,795,1,3,1,2,2,single-choice,spatial-relational,1|2,7,1/2,230367,1
1,3,23,368,0,649,1,9,4,5,5,single-choice,spatial-relational,4|5,7,4/5,230368,4
1,3,23,369,0,209,1,11,5,6,6,single-choice,spatial-relational,5|6,7,5/6,230369,5
1,3,23,370,1,1101,1,5,2,2,3,single-choice,spatial-relational,2|3,7,2/3,230370,2
1,3,23,371,1,833,1,9,4,4,5,single-choice,spatial-relational,4|5,7,4/5,230371,4
1,3,23,372,1,1035,1,5,2,2,3,single-choice,spatial-relational,2|3,7,2/3,230372,2
1,3,23,373,1,701,1,7,3,3,4,single-choice,spatial-relational,3|4,7,3/4,230373,3
1,3,23,374,0,637,1,13,6,7,7,single-choice,spatial-relational,6|7,7,6/7,230374,6
1,3,23,375,0,660,1,9,4,5,5,single-choice,spatial-relational,4|5,7,4/5,230375,4
1,3,23,376,1,802,1,5,2,2,3,single-choice,spatial-relational,2|3,7,2/3,230376,2
1,3,23,377,0,888,1,9,4,5,5,single-choice,spatial-relational,4|5,7,4/5,230377,4
1,3,23,378,1,1235,1,13,6,6,7,single-choice,spatial-relational,6|7,7,6/7,230378,6
1,3,23,379,0,790,1,11,5,6,6,single-choice,spatial-relational,5|6,7,5/6,230379,5
1,3,23,380,0,755,1,3,1,2,2,single-choice,spatial-relational,1|2,7,1/2,230380,1
1,3,23,381,0,687,1,3,1,2,2,single-choice,spatial-relational,1|2,7,1/2,230381,1
1,3,23,382,1,825,1,11,5,5,6,single-choice,spatial-relational,5|6,7,5/6,230382,5
1,3,23,383,1,704,1,5,2,2,3,single-choice,spatial-relational,2|3,7,2/3,230383,2
1,3,23,384,1,862,1,7,3,3,4,single-choice,spatial-relational,3|4,7,3/4,230384,3
1,3,23,385,0,607,1,5,2,3,3,single-choice,spatial-relational,2|3,7,2/3,230385,2
1,3,23,386,1,684,1,13,6,6,7,single-choice,spatial-relational,6|7,7,6/7,230386,6
1,3,23,387,1,766,1,9,4,4,5,single-choice,spatial-relational,4|5,7,4/5,230387,4
1,3,23,388,0,1034,1,5,2,3,3,single-choice,spatial-relational,2|3,7,2/3,230388,2
1,3,23,389,0,1958,1,11,5,6,6,single-choice,spatial-relational,5|6,7,5/6,230389,5
1,3,23,390,1,685,1,7,3,3,4,single-choice,spatial-relational,3|4,7,3/4,230390,3
1,3,23,391,1,822,1,7,3,3,4,single-choice,spatial-relational,3|4,7,3/4,230391,3
1,3,23,392,0,904,1,3,1,2,2,single-choice,spatial-relational,1|2,7,1/2,230392,1
1,3,23,393,1,780,1,13,6,6,7,single-choice,spatial-relational,6|7,7,6/7,230393,6
1,3,23,394,0,778,1,3,1,2,2,single-choice,spatial-relational,1|2,7,1/2,230394,1
1,3,23,395,1,660,1,9,4,4,5,single-choice,spatial-relational,4|5,7,4/5,230395,4
1,3,23,396,0,666,1,11,5,6,6,single-choice,spatial-relational,5|6,7,5/6,230396,5
1,3,23,397,1,681,1,13,6,6,7,single-choice,spatial-relational,6|7,7,6/7,230397,6
1,3,23,398,0,596,1,5,2,3,3,single-choice,spatial-relational,2|3,7,2/3,230398,2
1,3,23,399,1,725,1,7,3,3,4,single-choice,spatial-relational,3|4,7,3/4,230399,3
1,3,23,400,1,748,1,11,5,5,6,single-choice,spatial-relational,5|6,7,5/6,230400,5
1,3,23,401,1,944,1,11,5,5,6,single-choice,spatial-relational,5|6,7,5/6,230401,5
1,3,23,402,1,678,1,9,4,4,5,single-choice,spatial-relational,4|5,7,4/5,230402,4
1,3,23,403,0,735,1,3,1,2,2,single-choice,spatial-relational,1|2,7,1/2,230403,1
1,3,23,404,0,881,1,9,4,5,5,single-choice,spatial-relational,4|5,7,4/5,230404,4
1,3,23,405,0,32,1,13,6,7,7,single-choice,spatial-relational,6|7,7,6/7,230405,6
1,3,23,406,0,688,1,5,2,3,3,single-choice,spatial-relational,2|3,7,2/3,230406,2
1,3,23,407,0,935,1,3,1,2,2,single-choice,spatial-relational,1|2,7,1/2,230407,1
1,3,23,408,0,675,1,7,3,4,4,single-choice,spatial-relational,3|4,7,3/4,230408,3
1,3,23,409,0,724,1,5,2,3,3,single-choice,spatial-relational,2|3,7,2/3,230409,2
1,3,23,410,0,60,1,13,6,7,7,single-choice,spatial-relational,6|7,7,6/7,230410,6
1,3,23,411,1,922,1,5,2,2,3,single-choice,spatial-relational,2|3,7,2/3,230411,2
1,3,23,412,1,1458,1,11,5,5,6,single-choice,spatial-relational,5|6,7,5/6,230412,5
1,3,23,413,1,896,1,7,3,3,4,single-choice,spatial-relational,3|4,7,3/4,230413,3
1,3,23,414,0,658,1,9,4,5,5,single-choice,spatial-relational,4|5,7,4/5,230414,4
1,3,23,415,0,911,1,9,4,5,5,single-choice,spatial-relational,4|5,7,4/5,230415,4
1,3,23,416,0,842,1,3,1,2,2,single-choice,spatial-relational,1|2,7,1/2,230416,1
1,3,23,417,0,845,1,13,6,7,7,single-choice,spatial-relational,6|7,7,6/7,230417,6
1,3,23,418,1,908,1,11,5,5,6,single-choice,spatial-relational,5|6,7,5/6,230418,5
1,3,23,419,1,658,1,7,3,3,4,single-choice,spatial-relational,3|4,7,3/4,230419,3
1,3,23,420,1,733,1,3,1,1,2,single-choice,spatial-relational,1|2,7,1/2,230420,1
1,3,23,421,1,654,1,11,5,5,6,single-choice,spatial-relational,5|6,7,5/6,230421,5
1,3,23,422,1,887,1,9,4,4,5,single-choice,spatial-relational,4|5,7,4/5,230422,4
1,3,23,423,1,765,1,5,2,2,3,single-choice,spatial-relational,2|3,7,2/3,230423,2
1,3,23,424,0,764,1,9,4,5,5,single-choice,spatial-relational,4|5,7,4/5,230424,4
1,3,23,425,1,886,1,13,6,6,7,single-choice,spatial-relational,6|7,7,6/7,230425,6
1,3,23,426,1,971,1,7,3,3,4,single-choice,spatial-relational,3|4,7,3/4,230426,3
1,3,23,427,1,772,1,3,1,1,2,single-choice,spatial-relational,1|2,7,1/2,230427,1
1,3,23,428,1,670,1,13,6,6,7,single-choice,spatial-relational,6|7,7,6/7,230428,6
1,3,23,429,0,973,1,3,1,2,2,single-choice,spatial-relational,1|2,7,1/2,230429,1
1,3,23,430,0,664,1,5,2,3,3,single-choice,spatial-relational,2|3,7,2/3,230430,2
1,3,23,431,1,698,1,7,3,3,4,single-choice,spatial-relational,3|4,7,3/4,230431,3
1,3,23,432,0,692,1,11,5,6,6,single-choice,spatial-relational,5|6,7,5/6,230432,5
1,3,23,433,1,718,1,3,1,1,2,single-choice,spatial-relational,1|2,7,1/2,230433,1
1,3,23,434,0,814,1,5,2,3,3,single-choice,spatial-relational,2|3,7,2/3,230434,2
1,3,23,435,0,686,1,9,4,5,5,single-choice,spatial-relational,4|5,7,4/5,230435,4
1,3,23,436,1,666,1,7,3,3,4,single-choice,spatial-relational,3|4,7,3/4,230436,3
1,3,23,437,1,705,1,13,6,6,7,single-choice,spatial-relational,6|7,7,6/7,230437,6
1,3,23,438,1,776,1,9,4,4,5,single-choice,spatial-relational,4|5,7,4/5,230438,4
1,3,23,439,1,669,1,11,5,5,6,single-choice,spatial-relational,5|6,7,5/6,230439,5
1,3,23,440,0,705,1,11,5,6,6,single-choice,spatial-relational,5|6,7,5/6,230440,5
1,3,23,441,0,669,1,3,1,2,2,single-choice,spatial-relational,1|2,7,1/2,230441,1
1,3,23,442,1,619,1,5,2,2,3,single-choice,spatial-relational,2|3,7,2/3,230442,2
1,3,23,443,1,810,1,7,3,3,4,single-choice,spatial-relational,3|4,7,3/4,230443,3
1,3,23,444,1,750,1,13,6,6,7,single-choice,spatial-relational,6|7,7,6/7,230444,6
1,3,23,445,0,978,1,7,3,4,4,single-choice,spatial-relational,3|4,7,3/4,230445,3
1,3,23,446,0,1120,1,9,4,5,5,single-choice,spatial-relational,4|5,7,4/5,230446,4
1,3,23,447,1,819,1,13,6,6,7,single-choice,spatial-relational,6|7,7,6/7,230447,6
1,3,23,448,0,490,1,13,6,7,7,single-choice,spatial-relational,6|7,7,6/7,230448,6
1,3,23,449,0,695,1,11,5,6,6,single-choice,spatial-relational,5|6,7,5/6,230449,5
1,3,23,450,0,725,1,9,4,5,5,single-choice,spatial-relational,4|5,7,4/5,230450,4
1,3,23,451,1,778,1,5,2,2,3,single-choice,spatial-relational,2|3,7,2/3,230451,2
1,3,23,452,1,1049,1,5,2,2,3,single-choice,spatial-relational,2|3,7,2/3,230452,2
1,3,23,453,0,769,1,3,1,2,2,single-choice,spatial-relational,1|2,7,1/2,230453,1
1,3,23,454,0,984,1,11,5,6,6,single-choice,spatial-relational,5|6,7,5/6,230454,5
1,3,23,455,1,757,1,7,3,3,4,single-choice,spatial-relational,3|4,7,3/4,230455,3
1,3,23,456,1,755,1,3,1,1,2,single-choice,spatial-relational,1|2,7,1/2,230456,1
1,3,23,457,1,658,1,3,1,1,2,single-choice,spatial-relational,1|2,7,1/2,230457,1
1,3,23,458,0,634,1,9,4,5,5,single-choice,spatial-relational,4|5,7,4/5,230458,4
1,3,23,459,0,763,1,11,5,6,6,single-choice,spatial-relational,5|6,7,5/6,230459,5
1,3,23,460,1,1379,1,13,6,6,7,single-choice,spatial-relational,6|7,7,6/7,230460,6
1,3,23,461,1,951,1,11,5,5,6,single-choice,spatial-relational,5|6,7,5/6,230461,5
1,3,23,462,1,654,1,7,3,3,4,single-choice,spatial-relational,3|4,7,3/4,230462,3
1,3,23,463,0,805,1,5,2,3,3,single-choice,spatial-relational,2|3,7,2/3,230463,2
1,3,23,464,1,779,1,13,6,6,7,single-choice,spatial-relational,6|7,7,6/7,230464,6
1,3,23,465,1,850,1,5,2,2,3,single-choice,spatial-relational,2|3,7,2/3,230465,2
1,3,23,466,1,776,1,3,1,1,2,single-choice,spatial-relational,1|2,7,1/2,230466,1
1,3,23,467,1,883,1,7,3,3,4,single-choice,spatial-relational,3|4,7,3/4,230467,3
1,3,23,468,0,1088,1,9,4,5,5,single-choice,spatial-relational,4|5,7,4/5,230468,4
1,3,23,469,1,52,1,9,4,4,5,single-choice,spatial-relational,4|5,7,4/5,230469,4
1,3,23,470,1,740,1,11,5,5,6,single-choice,spatial-relational,5|6,7,5/6,230470,5
1,3,23,471,1,697,1,7,3,3,4,single-choice,spatial-relational,3|4,7,3/4,230471,3
1,3,23,472,1,849,1,7,3,3,4,single-choice,spatial-relational,3|4,7,3/4,230472,3
1,3,23,473,1,922,1,5,2,2,3,single-choice,spatial-relational,2|3,7,2/3,230473,2
1,3,23,474,0,627,1,11,5,6,6,single-choice,spatial-relational,5|6,7,5/6,230474,5
1,3,23,475,0,717,1,3,1,2,2,single-choice,spatial-relational,1|2,7,1/2,230475,1
1,3,23,476,1,853,1,13,6,6,7,single-choice,spatial-relational,6|7,7,6/7,230476,6
1,3,23,477,1,763,1,5,2,2,3,single-choice,spatial-relational,2|3,7,2/3,230477,2
1,3,23,478,1,810,1,3,1,1,2,single-choice,spatial-relational,1|2,7,1/2,230478,1
1,3,23,479,1,692,1,13,6,6,7,single-choice,spatial-relational,6|7,7,6/7,230479,6
1,3,23,480,0,846,1,9,4,5,5,single-choice,spatial-relational,4|5,7,4/5,230480,4
1,3,23,481,1,763,1,5,2,2,3,single-choice,spatial-relational,2|3,7,2/3,230481,2
1,3,23,482,0,837,1,3,1,2,2,single-choice,spatial-relational,1|2,7,1/2,230482,1
1,3,23,483,1,1531,1,9,4,4,5,single-choice,spatial-relational,4|5,7,4/5,230483,4
1,3,23,484,1,900,1,5,2,2,3,single-choice,spatial-relational,2|3,7,2/3,230484,2
1,3,23,485,0,658,1,9,4,5,5,single-choice,spatial-relational,4|5,7,4/5,230485,4
1,3,23,486,0,748,1,11,5,6,6,single-choice,spatial-relational,5|6,7,5/6,230486,5
1,3,23,487,1,752,1,13,6,6,7,single-choice,spatial-relational,6|7,7,6/7,230487,6
1,3,23,488,1,799,1,13,6,6,7,single-choice,spatial-relational,6|7,7,6/7,230488,6
1,3,23,489,1,841,1,7,3,3,4,single-choice,spatial-relational,3|4,7,3/4,230489,3
1,3,23,490,1,806,1,7,3,3,4,single-choice,spatial-relational,3|4,7,3/4,230490,3
1,3,23,491,1,709,1,11,5,5,6,single-choice,spatial-relational,5|6,7,5/6,230491,5
1,3,23,492,0,898,1,3,1,2,2,single-choice,spatial-relational,1|2,7,1/2,230492,1
1,3,23,493,1,863,1,11,5,5,6,single-choice,spatial-relational,5|6,7,5/6,230493,5
1,3,23,494,1,797,1,13,6,6,7,single-choice,spatial-relational,6|7,7,6/7,230494,6
1,3,23,495,1,884,1,7,3,3,4,single-choice,spatial-relational,3|4,7,3/4,230495,3
1,3,23,496,0,702,1,9,4,5,5,single-choice,spatial-relational,4|5,7,4/5,230496,4
1,3,23,497,1,904,1,11,5,5,6,single-choice,spatial-relational,5|6,7,5/6,230497,5
1,3,23,498,1,792,1,5,2,2,3,single-choice,spatial-relational,2|3,7,2/3,230498,2
1,3,23,499,0,705,1,3,1,2,2,single-choice,spatial-relational,1|2,7,1/2,230499,1
1,3,23,500,1,666,1,13,6,6,7,single-choice,spatial-relational,6|7,7,6/7,230500,6
1,3,23,501,1,860,1,5,2,2,3,single-choice,spatial-relational,2|3,7,2/3,230501,2
1,3,23,502,1,713,1,3,1,1,2,single-choice,spatial-relational,1|2,7,1/2,230502,1
1,3,23,503,0,717,1,9,4,5,5,single-choice,spatial-relational,4|5,7,4/5,230503,4
1,3,23,504,1,623,1,7,3,3,4,single-choice,spatial-relational,3|4,7,3/4,230504,3
1,3,23,505,1,717,1,7,3,3,4,single-choice,spatial-relational,3|4,7,3/4,230505,3
1,3,23,506,1,952,1,5,2,2,3,single-choice,spatial-relational,2|3,7,2/3,230506,2
1,3,23,507,1,665,1,5,2,2,3,single-choice,spatial-relational,2|3,7,2/3,230507,2
1,3,23,508,0,677,1,3,1,2,2,single-choice,spatial-relational,1|2,7,1/2,230508,1
1,3,23,509,1,930,1,11,5,5,6,single-choice,spatial-relational,5|6,7,5/6,230509,5
1,3,23,510,1,1571,1,3,1,1,2,single-choice,spatial-relational,1|2,7,1/2,230510,1
1,3,23,511,0,657,1,11,5,6,6,single-choice,spatial-relational,5|6,7,5/6,230511,5
1,3,23,512,1,685,1,7,3,3,4,single-choice,spatial-relational,3|4,7,3/4,230512,3
1,3,23,513,1,859,1,13,6,6,7,single-choice,spatial-relational,6|7,7,6/7,230513,6
1,3,23,514,1,815,1,9,4,4,5,single-choice,spatial-relational,4|5,7,4/5,230514,4
1,3,23,515,0,1726,1,9,4,5,5,single-choice,spatial-relational,4|5,7,4/5,230515,4
1,3,23,516,1,745,1,13,6,6,7,single-choice,spatial-relational,6|7,7,6/7,230516,6
1,3,23,517,0,582,1,13,6,7,7,single-choice,spatial-relational,6|7,7,6/7,230517,6
1,3,23,518,0,730,1,3,1,2,2,single-choice,spatial-relational,1|2,7,1/2,230518,1
1,3,23,519,0,659,1,9,4,5,5,single-choice,spatial-relational,4|5,7,4/5,230519,4
1,3,23,520,1,595,1,7,3,3,4,single-choice,spatial-relational,3|4,7,3/4,230520,3
1,3,23,521,0,706,1,13,6,7,7,single-choice,spatial-relational,6|7,7,6/7,230521,6
1,3,23,522,1,846,1,11,5,5,6,single-choice,spatial-relational,5|6,7,5/6,230522,5
1,3,23,523,1,674,1,5,2,2,3,single-choice,spatial-relational,2|3,7,2/3,230523,2
1,3,23,524,0,674,1,9,4,5,5,single-choice,spatial-relational,4|5,7,4/5,230524,4
1,3,23,525,0,736,1,11,5,6,6,single-choice,spatial-relational,5|6,7,5/6,230525,5
1,3,23,526,1,682,1,7,3,3,4,single-choice,spatial-relational,3|4,7,3/4,230526,3
1,3,23,527,0,740,1,3,1,2,2,single-choice,spatial-relational,1|2,7,1/2,230527,1
1,3,23,528,1,765,1,5,2,2,3,single-choice,spatial-relational,2|3,7,2/3,230528,2
1,3,23,529,0,819,1,11,5,6,6,single-choice,spatial-relational,5|6,7,5/6,230529,5
1,3,23,530,1,798,1,5,2,2,3,single-choice,spatial-relational,2|3,7,2/3,230530,2
1,3,23,531,1,754,1,7,3,3,4,single-choice,spatial-relational,3|4,7,3/4,230531,3
1,3,23,532,0,627,1,9,4,5,5,single-choice,spatial-relational,4|5,7,4/5,230532,4
1,3,23,533,1,917,1,5,2,2,3,single-choice,spatial-relational,2|3,7,2/3,230533,2
1,3,23,534,0,709,1,11,5,6,6,single-choice,spatial-relational,5|6,7,5/6,230534,5
1,3,23,535,0,201,1,9,4,5,5,single-choice,spatial-relational,4|5,7,4/5,230535,4
1,3,23,536,1,1014,1,13,6,6,7,single-choice,spatial-relational,6|7,7,6/7,230536,6
1,3,23,537,1,646,1,7,3,3,4,single-choice,spatial-relational,3|4,7,3/4,230537,3
1,3,23,538,1,750,1,3,1,1,2,single-choice,spatial-relational,1|2,7,1/2,230538,1
1,3,23,539,1,752,1,13,6,6,7,single-choice,spatial-relational,6|7,7,6/7,230539,6
1,3,23,540,0,681,1,3,1,2,2,single-choice,spatial-relational,1|2,7,1/2,230540,1
1,3,23,541,0,681,1,13,6,7,7,single-choice,spatial-relational,6|7,7,6/7,230541,6
1,3,23,542,0,850,1,11,5,6,6,single-choice,spatial-relational,5|6,7,5/6,230542,5
1,3,23,543,1,779,1,3,1,1,2,single-choice,spatial-relational,1|2,7,1/2,230543,1
1,3,23,544,1,685,1,3,1,1,2,single-choice,spatial-relational,1|2,7,1/2,230544,1
1,3,23,545,1,1146,1,9,4,4,5,single-choice,spatial-relational,4|5,7,4/5,230545,4
1,3,23,546,0,772,1,5,2,3,3,single-choice,spatial-relational,2|3,7,2/3,230546,2
1,3,23,547,1,881,1,11,5,5,6,single-choice,spatial-relational,5|6,7,5/6,230547,5
1,3,23,548,1,742,1,9,4,4,5,single-choice,spatial-relational,4|5,7,4/5,230548,4
1,3,23,549,1,619,1,7,3,3,4,single-choice,spatial-relational,3|4,7,3/4,230549,3
1,3,23,550,1,701,1,7,3,3,4,single-choice,spatial-relational,3|4,7,3/4,230550,3
1,3,23,551,1,603,1,5,2,2,3,single-choice,spatial-relational,2|3,7,2/3,230551,2
1,3,23,552,0,654,1,13,6,7,7,single-choice,spatial-relational,6|7,7,6/7,230552,6
1,3,23,553,0,639,1,9,4,5,5,single-choice,spatial-relational,4|5,7,4/5,230553,4
1,3,23,554,0,622,1,3,1,2,2,single-choice,spatial-relational,1|2,7,1/2,230554,1
1,3,23,555,1,615,1,13,6,6,7,single-choice,spatial-relational,6|7,7,6/7,230555,6
1,3,23,556,0,744,1,9,4,5,5,single-choice,spatial-relational,4|5,7,4/5,230556,4
1,3,23,557,0,625,1,5,2,3,3,single-choice,spatial-relational,2|3,7,2/3,230557,2
1,3,23,558,0,802,1,11,5,6,6,single-choice,spatial-relational,5|6,7,5/6,230558,5
1,3,23,559,1,589,1,7,3,3,4,single-choice,spatial-relational,3|4,7,3/4,230559,3
1,3,23,560,1,754,1,11,5,5,6,single-choice,spatial-relational,5|6,7,5/6,230560,5
1,3,23,561,1,646,1,5,2,2,3,single-choice,spatial-relational,2|3,7,2/3,230561,2
1,3,23,562,0,720,1,7,3,4,4,single-choice,spatial-relational,3|4,7,3/4,230562,3
1,3,23,563,0,680,1,3,1,2,2,single-choice,spatial-relational,1|2,7,1/2,230563,1
1,3,23,564,1,64,1,13,6,6,7,single-choice,spatial-relational,6|7,7,6/7,230564,6
1,3,23,565,1,705,1,5,2,2,3,single-choice,spatial-relational,2|3,7,2/3,230565,2
1,3,23,566,1,734,1,3,1,1,2,single-choice,spatial-relational,1|2,7,1/2,230566,1
1,3,23,567,0,904,1,9,4,5,5,single-choice,spatial-relational,4|5,7,4/5,230567,4
1,3,23,568,1,577,1,7,3,3,4,single-choice,spatial-relational,3|4,7,3/4,230568,3
1,3,23,569,1,709,1,11,5,5,6,single-choice,spatial-relational,5|6,7,5/6,230569,5
1,3,23,570,1,869,1,13,6,6,7,single-choice,spatial-relational,6|7,7,6/7,230570,6
1,3,23,571,0,678,1,5,2,3,3,single-choice,spatial-relational,2|3,7,2/3,230571,2
1,3,23,572,1,697,1,13,6,6,7,single-choice,spatial-relational,6|7,7,6/7,230572,6
1,3,23,573,1,720,1,7,3,3,4,single-choice,spatial-relational,3|4,7,3/4,230573,3
1,3,23,574,0,11089,1,11,5,6,6,single-choice,spatial-relational,5|6,7,5/6,230574,5
1,3,23,575,1,678,1,3,1,1,2,single-choice,spatial-relational,1|2,7,1/2,230575,1
1,3,23,576,0,630,1,9,4,5,5,single-choice,spatial-relational,4|5,7,4/5,230576,4
1,3,23,577,0,958,1,9,4,5,5,single-choice,spatial-relational,4|5,7,4/5,230577,4
1,3,23,578,1,651,1,7,3,3,4,single-choice,spatial-relational,3|4,7,3/4,230578,3
1,3,23,579,1,1085,1,5,2,2,3,single-choice,spatial-relational,2|3,7,2/3,230579,2
1,3,23,580,1,701,1,13,6,6,7,single-choice,spatial-relational,6|7,7,6/7,230580,6
1,3,23,581,0,884,1,3,1,2,2,single-choice,spatial-relational,1|2,7,1/2,230581,1
1,3,23,582,1,783,1,5,2,2,3,single-choice,spatial-relational,2|3,7,2/3,230582,2
1,3,23,583,0,681,1,3,1,2,2,single-choice,spatial-relational,1|2,7,1/2,230583,1
1,3,23,584,0,693,1,9,4,5,5,single-choice,spatial-relational,4|5,7,4/5,230584,4
1,3,23,585,1,653,1,13,6,6,7,single-choice,spatial-relational,6|7,7,6/7,230585,6
1,3,23,586,0,642,1,11,5,6,6,single-choice,spatial-relational,5|6,7,5/6,230586,5
1,3,23,587,0,608,1,11,5,6,6,single-choice,spatial-relational,5|6,7,5/6,230587,5
1,3,23,588,1,759,1,7,3,3,4,single-choice,spatial-relational,3|4,7,3/4,230588,3
1,3,23,589,1,1108,1,3,1,1,2,single-choice,spatial-relational,1|2,7,1/2,230589,1
1,3,23,590,1,679,1,3,1,1,2,single-choice,spatial-relational,1|2,7,1/2,230590,1
1,3,23,591,1,763,1,5,2,2,3,single-choice,spatial-relational,2|3,7,2/3,230591,2
1,3,23,592,1,702,1,13,6,6,7,single-choice,spatial-relational,6|7,7,6/7,230592,6
1,3,23,593,0,631,1,11,5,6,6,single-choice,spatial-relational,5|6,7,5/6,230593,5
1,3,23,594,0,862,1,9,4,5,5,single-choice,spatial-relational,4|5,7,4/5,230594,4
1,3,23,595,1,709,1,13,6,6,7,single-choice,spatial-relational,6|7,7,6/7,230595,6
1,3,23,596,0,756,1,5,2,3,3,single-choice,spatial-relational,2|3,7,2/3,230596,2
1,3,23,597,1,646,1,9,4,4,5,single-choice,spatial-relational,4|5,7,4/5,230597,4
1,3,23,598,1,596,1,7,3,3,4,single-choice,spatial-relational,3|4,7,3/4,230598,3
1,3,23,599,0,669,1,11,5,6,6,single-choice,spatial-relational,5|6,7,5/6,230599,5
1,3,23,600,1,759,1,7,3,3,4,single-choice,spatial-relational,3|4,7,3/4,230600,3
2,3,23,1,0,28,1,11,5,6,6,single-choice,spatial-relational,5|6,7,5/6,230001,5
2,3,23,2,1,877,1,3,1,1,2,single-choice,spatial-relational,1|2,7,1/2,230002,1
2,3,23,3,1,670,1,13,6,6,7,single-choice,spatial-relational,6|7,7,6/7,230003,6
2,3,23,4,1,804,1,7,3,3,4,single-choice,spatial-relational,3|4,7,3/4,230004,3
2,3,23,5,0,681,1,3,1,2,2,single-choice,spatial-relational,1|2,7,1/2,230005,1
2,3,23,6,0,1427,1,9,4,5,5,single-choice,spatial-relational,4|5,7,4/5,230006,4
2,3,23,7,1,586,1,7,3,3,4,single-choice,spatial-relational,3|4,7,3/4,230007,3
2,3,23,8,0,612,1,5,2,3,3,single-choice,spatial-relational,2|3,7,2/3,230008,2
2,3,23,9,0,855,1,9,4,5,5,single-choice,spatial-relational,4|5,7,4/5,230009,4
2,3,23,10,0,617,1,5,2,3,3,single-choice,spatial-relational,2|3,7,2/3,230010,2
2,3,23,11,0,701,1,11,5,6,6,single-choice,spatial-relational,5|6,7,5/6,230011,5
2,3,23,12,1,690,1,13,6,6,7,single-choice,spatial-relational,6|7,7,6/7,230012,6
2,3,23,13,0,532,1,11,5,6,6,single-choice,spatial-relational,5|6,7,5/6,230013,5
2,3,23,14,1,771,1,13,6,6,7,single-choice,spatial-relational,6|7,7,6/7,230014,6
2,3,23,15,0,701,1,7,3,4,4,single-choice,spatial-relational,3|4,7,3/4,230015,3
2,3,23,16,0,644,1,11,5,6,6,single-choice,spatial-relational,5|6,7,5/6,230016,5
2,3,23,17,0,615,1,3,1,2,2,single-choice,spatial-relational,1|2,7,1/2,230017,1
2,3,23,18,0,526,1,13,6,7,7,single-choice,spatial-relational,6|7,7,6/7,230018,6
2,3,23,19,0,744,1,9,4,5,5,single-choice,spatial-relational,4|5,7,4/5,230019,4
2,3,23,20,1,597,1,7,3,3,4,single-choice,spatial-relational,3|4,7,3/4,230020,3
2,3,23,21,1,681,1,5,2,2,3,single-choice,spatial-relational,2|3,7,2/3,230021,2
2,3,23,22,0,804,1,5,2,3,3,single-choice,spatial-relational,2|3,7,2/3,230022,2
2,3,23,23,0,742,1,9,4,5,5,single-choice,spatial-relational,4|5,7,4/5,230023,4
2,3,23,24,0,685,1,3,1,2,2,single-choice,spatial-relational,1|2,7,1/2,230024,1
2,3,23,25,0,838,1,5,2,3,3,single-choice,spatial-relational,2|3,7,2/3,230025,2
2,3,23,26,1,589,1,5,2,2,3,single-choice,spatial-relational,2|3,7,2/3,230026,2
2,3,23,27,0,1092,1,3,1,2,2,single-choice,spatial-relational,1|2,7,1/2,230027,1
2,3,23,28,0,586,1,3,1,2,2,single-choice,spatial-relational,1|2,7,1/2,230028,1
2,3,23,29,1,583,1,7,3,3,4,single-choice,spatial-relational,3|4,7,3/4,230029,3
2,3,23,30,1,705,1,7,3,3,4,single-choice,spatial-relational,3|4,7,3/4,230030,3
2,3,23,31,1,1131,1,13,6,6,7,single-choice,spatial-relational,6|7,7,6/7,230031,6
2,3,23,32,0,642,1,11,5,6,6,single-choice,spatial-relational,5|6,7,5/6,230032,5
2,3,23,33,0,958,1,11,5,6,6,single-choice,spatial-relational,5|6,7,5/6,230033,5
2,3,23,34,1,672,1,13,6,6,7,single-choice,spatial-relational,6|7,7,6/7,230034,6
2,3,23,35,0,799,1,9,4,5,5,single-choice,spatial-relational,4|5,7,4/5,230035,4
2,3,23,36,0,690,1,9,4,5,5,single-choice,spatial-relational,4|5,7,4/5,230036,4
2,3,23,37,1,688,1,3,1,1,2,single-choice,spatial-relational,1|2,7,1/2,230037,1
2,3,23,38,0,615,1,9,4,5,5,single-choice,spatial-relational,4|5,7,4/5,230038,4
2,3,23,39,1,703,1,5,2,2,3,single-choice,spatial-relational,2|3,7,2/3,230039,2
2,3,23,40,0,672,1,11,5,6,6,single-choice,spatial-relational,5|6,7,5/6,230040,5
2,3,23,41,0,717,1,3,1,2,2,single-choice,spatial-relational,1|2,7,1/2,230041,1
2,3,23,42,1,729,1,7,3,3,4,single-choice,spatial-relational,3|4,7,3/4,230042,3
2,3,23,43,1,608,1,13,6,6,7,single-choice,spatial-relational,6|7,7,6/7,230043,6
2,3,23,44,0,595,1,13,6,7,7,single-choice,spatial-relational,6|7,7,6/7,230044,6
2,3,23,45,1,683,1,7,3,3,4,single-choice,spatial-relational,3|4,7,3/4,230045,3
2,3,23,46,1,1337,1,11,5,5,6,single-choice,spatial-relational,5|6,7,5/6,230046,5
2,3,23,47,0,979,1,9,4,5,5,single-choice,spatial-relational,4|5,7,4/5,230047,4
2,3,23,48,1,823,1,5,2,2,3,single-choice,spatial-relational,2|3,7,2/3,230048,2
2,3,23,49,1,774,1,11,5,5,6,single-choice,spatial-relational,5|6,7,5/6,230049,5
2,3,23,50,0,1196,1,9,4,5,5,single-choice,spatial-relational,4|5,7,4/5,230050,4
2,3,23,51,1,588,1,7,3,3,4,single-choice,spatial-relational,3|4,7,3/4,230051,3
2,3,23,52,1,623,1,13,6,6,7,single-choice,spatial-relational,6|7,7,6/7,230052,6
2,3,23,53,0,717,1,11,5,6,6,single-choice,spatial-relational,5|6,7,5/6,230053,5
2,3,23,54,0,695,1,9,4,5,5,single-choice,spatial-relational,4|5,7,4/5,230054,4
2,3,23,55,1,778,1,3,1,1,2,single-choice,spatial-relational,1|2,7,1/2,230055,1
2,3,23,56,1,732,1,5,2,2,3,single-choice,spatial-relational,2|3,7,2/3,230056,2
2,3,23,57,0,734,1,3,1,2,2,single-choice,spatial-relational,1|2,7,1/2,230057,1
2,3,23,58,1,684,1,7,3,3,4,single-choice,spatial-relational,3|4,7,3/4,230058,3
2,3,23,59,0,582,1,13,6,7,7,single-choice,spatial-relational,6|7,7,6/7,230059,6
2,3,23,60,1,795,1,5,2,2,3,single-choice,spatial-relational,2|3,7,2/3,230060,2
2,3,23,61,0,658,1,3,1,2,2,single-choice,spatial-relational,1|2,7,1/2,230061,1
2,3,23,62,0,733,1,9,4,5,5,single-choice,spatial-relational,4|5,7,4/5,230062,4
2,3,23,63,1,1082,1,11,5,5,6,single-choice,spatial-relational,5|6,7,5/6,230063,5
2,3,23,64,0,916,1,3,1,2,2,single-choice,spatial-relational,1|2,7,1/2,230064,1
2,3,23,65,1,648,1,5,2,2,3,single-choice,spatial-relational,2|3,7,2/3,230065,2
2,3,23,66,0,1148,1,9,4,5,5,single-choice,spatial-relational,4|5,7,4/5,230066,4
2,3,23,67,1,779,1,7,3,3,4,single-choice,spatial-relational,3|4,7,3/4,230067,3
2,3,23,68,1,661,1,11,5,5,6,single-choice,spatial-relational,5|6,7,5/6,230068,5
2,3,23,69,1,1266,1,13,6,6,7,single-choice,spatial-relational,6|7,7,6/7,230069,6
2,3,23,70,0,654,1,5,2,3,3,single-choice,spatial-relational,2|3,7,2/3,230070,2
2,3,23,71,0,36,1,7,3,4,4,single-choice,spatial-relational,3|4,7,3/4,230071,3
2,3,23,72,1,174,1,13,6,6,7,single-choice,spatial-relational,6|7,7,6/7,230072,6
2,3,23,73,0,1037,1,5,2,3,3,single-choice,spatial-relational,2|3,7,2/3,230073,2
2,3,23,74,1,825,1,11,5,5,6,single-choice,spatial-relational,5|6,7,5/6,230074,5
2,3,23,75,0,753,1,9,4,5,5,single-choice,spatial-relational,4|5,7,4/5,230075,4
2,3,23,76,0,52,1,13,6,7,7,single-choice,spatial-relational,6|7,7,6/7,230076,6
2,3,23,77,0,575,1,9,4,5,5,single-choice,spatial-relational,4|5,7,4/5,230077,4
2,3,23,78,1,1360,1,7,3,3,4,single-choice,spatial-relational,3|4,7,3/4,230078,3
2,3,23,79,1,793,1,11,5,5,6,single-choice,spatial-relational,5|6,7,5/6,230079,5
2,3,23,80,1,774,1,5,2,2,3,single-choice,spatial-relational,2|3,7,2/3,230080,2
2,3,23,81,0,998,1,3,1,2,2,single-choice,spatial-relational,1|2,7,1/2,230081,1
2,3,23,82,0,752,1,7,3,4,4,single-choice,spatial-relational,3|4,7,3/4,230082,3
2,3,23,83,1,1467,1,3,1,1,2,single-choice,spatial-relational,1|2,7,1/2,230083,1
2,3,23,84,1,831,1,13,6,6,7,single-choice,spatial-relational,6|7,7,6/7,230084,6
2,3,23,85,1,622,1,3,1,1,2,single-choice,spatial-relational,1|2,7,1/2,230085,1
2,3,23,86,1,627,1,7,3,3,4,single-choice,spatial-relational,3|4,7,3/4,230086,3
2,3,23,87,1,754,1,5,2,2,3,single-choice,spatial-relational,2|3,7,2/3,230087,2
2,3,23,88,1,670,1,13,6,6,7,single-choice,spatial-relational,6|7,7,6/7,230088,6
2,3,23,89,1,678,1,13,6,6,7,single-choice,spatial-relational,6|7,7,6/7,230089,6
2,3,23,90,1,945,1,11,5,5,6,single-choice,spatial-relational,5|6,7,5/6,230090,5
2,3,23,91,1,1084,1,11,5,5,6,single-choice,spatial-relational,5|6,7,5/6,230091,5
2,3,23,92,0,673,1,9,4,5,5,single-choice,spatial-relational,4|5,7,4/5,230092,4
2,3,23,93,0,723,1,9,4,5,5,single-choice,spatial-relational,4|5,7,4/5,230093,4
2,3,23,94,1,1032,1,7,3,3,4,single-choice,spatial-relational,3|4,7,3/4,230094,3
2,3,23,95,1,687,1,5,2,2,3,single-choice,spatial-relational,2|3,7,2/3,230095,2
2,3,23,96,0,1057,1,3,1,2,2,single-choice,spatial-relational,1|2,7,1/2,230096,1
2,3,23,97,1,1111,1,13,6,6,7,single-choice,spatial-relational,6|7,7,6/7,230097,6
2,3,23,98,1,615,1,13,6,6,7,single-choice,spatial-relational,6|7,7,6/7,230098,6
2,3,23,99,1,651,1,11,5,5,6,single-choice,spatial-relational,5|6,7,5/6,230099,5
2,3,23,100,0,814,1,9,4,5,5,single-choice,spatial-relational,4|5,7,4/5,230100,4
2,3,23,101,1,607,1,3,1,1,2,single-choice,spatial-relational,1|2,7,1/2,230101,1
2,3,23,102,1,763,1,11,5,5,6,single-choice,spatial-relational,5|6,7,5/6,230102,5
2,3,23,103,0,595,1,5,2,3,3,single-choice,spatial-relational,2|3,7,2/3,230103,2
2,3,23,104,0,617,1,3,1,2,2,single-choice,spatial-relational,1|2,7,1/2,230104,1
2,3,23,105,1,634,1,5,2,2,3,single-choice,spatial-relational,2|3,7,2/3,230105,2
2,3,23,106,1,791,1,7,3,3,4,single-choice,spatial-relational,3|4,7,3/4,230106,3
2,3,23,107,0,802,1,9,4,5,5,single-choice,spatial-relational,4|5,7,4/5,230107,4
2,3,23,108,1,1061,1,7,3,3,4,single-choice,spatial-relational,3|4,7,3/4,230108,3
2,3,23,109,1,952,1,11,5,5,6,single-choice,spatial-relational,5|6,7,5/6,230109,5
2,3,23,110,0,868,1,9,4,5,5,single-choice,spatial-relational,4|5,7,4/5,230110,4
2,3,23,111,1,652,1,13,6,6,7,single-choice,spatial-relational,6|7,7,6/7,230111,6
2,3,23,112,1,602,1,7,3,3,4,single-choice,spatial-relational,3|4,7,3/4,230112,3
2,3,23,113,0,701,1,9,4,5,5,single-choice,spatial-relational,4|5,7,4/5,230113,4
2,3,23,114,1,670,1,3,1,1,2,single-choice,spatial-relational,1|2,7,1/2,230114,1
2,3,23,115,1,712,1,7,3,3,4,single-choice,spatial-relational,3|4,7,3/4,230115,3
2,3,23,116,0,674,1,3,1,2,2,single-choice,spatial-relational,1|2,7,1/2,230116,1
2,3,23,117,1,846,1,11,5,5,6,single-choice,spatial-relational,5|6,7,5/6,230117,5
2,3,23,118,1,700,1,5,2,2,3,single-choice,spatial-relational,2|3,7,2/3,230118,2
2,3,23,119,0,951,1,5,2,3,3,single-choice,spatial-relational,2|3,7,2/3,230119,2
2,3,23,120,1,1184,1,13,6,6,7,single-choice,spatial-relational,6|7,7,6/7,230120,6
2,3,23,121,0,650,1,3,1,2,2,single-choice,spatial-relational,1|2,7,1/2,230121,1
2,3,23,122,0,676,1,9,4,5,5,single-choice,spatial-relational,4|5,7,4/5,230122,4
2,3,23,123,1,1190,1,13,6,6,7,single-choice,spatial-relational,6|7,7,6/7,230123,6
2,3,23,124,1,723,1,5,2,2,3,single-choice,spatial-relational,2|3,7,2/3,230124,2
2,3,23,125,1,630,1,3,1,1,2,single-choice,spatial-relational,1|2,7,1/2,230125,1
2,3,23,126,1,708,1,5,2,2,3,single-choice,spatial-relational,2|3,7,2/3,230126,2
2,3,23,127,1,750,1,11,5,5,6,single-choice,spatial-relational,5|6,7,5/6,230127,5
2,3,23,128,1,872,1,9,4,4,5,single-choice,spatial-relational,4|5,7,4/5,230128,4
2,3,23,129,1,819,1,7,3,3,4,single-choice,spatial-relational,3|4,7,3/4,230129,3
2,3,23,130,1,637,1,7,3,3,4,single-choice,spatial-relational,3|4,7,3/4,230130,3
2,3,23,131,1,771,1,11,5,5,6,single-choice,spatial-relational,5|6,7,5/6,230131,5
2,3,23,132,1,611,1,13,6,6,7,single-choice,spatial-relational,6|7,7,6/7,230132,6
2,3,23,133,1,975,1,11,5,5,6,single-choice,spatial-relational,5|6,7,5/6,230133,5
2,3,23,134,0,893,1,9,4,5,5,single-choice,spatial-relational,4|5,7,4/5,230134,4
2,3,23,135,1,693,1,7,3,3,4,single-choice,spatial-relational,3|4,7,3/4,230135,3
2,3,23,136,0,705,1,9,4,5,5,single-choice,spatial-relational,4|5,7,4/5,230136,4
2,3,23,137,0,661,1,3,1,2,2,single-choice,spatial-relational,1|2,7,1/2,230137,1
2,3,23,138,1,774,1,13,6,6,7,single-choice,spatial-relational,6|7,7,6/7,230138,6
2,3,23,139,1,666,1,5,2,2,3,single-choice,spatial-relational,2|3,7,2/3,230139,2
2,3,23,140,1,588,1,7,3,3,4,single-choice,spatial-relational,3|4,7,3/4,230140,3
2,3,23,141,1,780,1,11,5,5,6,single-choice,spatial-relational,5|6,7,5/6,230141,5
2,3,23,142,1,1018,1,13,6,6,7,single-choice,spatial-relational,6|7,7,6/7,230142,6
2,3,23,143,0,624,1,5,2,3,3,single-choice,spatial-relational,2|3,7,2/3,230143,2
2,3,23,144,1,721,1,3,1,1,2,single-choice,spatial-relational,1|2,7,1/2,230144,1
2,3,23,145,1,600,1,7,3,3,4,single-choice,spatial-relational,3|4,7,3/4,230145,3
2,3,23,146,1,642,1,7,3,3,4,single-choice,spatial-relational,3|4,7,3/4,230146,3
2,3,23,147,0,872,1,9,4,5,5,single-choice,spatial-relational,4|5,7,4/5,230147,4
2,3,23,148,1,846,1,11,5,5,6,single-choice,spatial-relational,5|6,7,5/6,230148,5
2,3,23,149,0,666,1,9,4,5,5,single-choice,spatial-relational,4|5,7,4/5,230149,4
2,3,23,150,0,59,1,3,1,2,2,single-choice,spatial-relational,1|2,7,1/2,230150,1
2,3,23,151,0,1603,1,5,2,3,3,single-choice,spatial-relational,2|3,7,2/3,230151,2
2,3,23,152,0,58,1,11,5,6,6,single-choice,spatial-relational,5|6,7,5/6,230152,5
2,3,23,153,1,604,1,13,6,6,7,single-choice,spatial-relational,6|7,7,6/7,230153,6
2,3,23,154,0,701,1,3,1,2,2,single-choice,spatial-relational,1|2,7,1/2,230154,1
2,3,23,155,1,642,1,5,2,2,3,single-choice,spatial-relational,2|3,7,2/3,230155,2
2,3,23,156,0,529,1,13,6,7,7,single-choice,spatial-relational,6|7,7,6/7,230156,6
2,3,23,157,0,697,1,9,4,5,5,single-choice,spatial-relational,4|5,7,4/5,230157,4
2,3,23,158,1,755,1,5,2,2,3,single-choice,spatial-relational,2|3,7,2/3,230158,2
2,3,23,159,1,686,1,11,5,5,6,single-choice,spatial-relational,5|6,7,5/6,230159,5
2,3,23,160,0,679,1,9,4,5,5,single-choice,spatial-relational,4|5,7,4/5,230160,4
2,3,23,161,1,861,1,7,3,3,4,single-choice,spatial-relational,3|4,7,3/4,230161,3
2,3,23,162,1,1158,1,13,6,6,7,single-choice,spatial-relational,6|7,7,6/7,230162,6
2,3,23,163,1,611,1,3,1,1,2,single-choice,spatial-relational,1|2,7,1/2,230163,1
2,3,23,164,1,570,1,13,6,6,7,single-choice,spatial-relational,6|7,7,6/7,230164,6
2,3,23,165,1,580,1,7,3,3,4,single-choice,spatial-relational,3|4,7,3/4,230165,3
2,3,23,166,0,848,1,5,2,3,3,single-choice,spatial-relational,2|3,7,2/3,230166,2
2,3,23,167,0,691,1,3,1,2,2,single-choice,spatial-relational,1|2,7,1/2,230167,1
2,3,23,168,1,626,1,11,5,5,6,single-choice,spatial-relational,5|6,7,5/6,230168,5
2,3,23,169,0,802,1,5,2,3,3,single-choice,spatial-relational,2|3,7,2/3,230169,2
2,3,23,170,1,1401,1,11,5,5,6,single-choice,spatial-relational,5|6,7,5/6,230170,5
2,3,23,171,0,650,1,9,4,5,5,single-choice,spatial-relational,4|5,7,4/5,230171,4
2,3,23,172,1,1204,1,9,4,4,5,single-choice,spatial-relational,4|5,7,4/5,230172,4
2,3,23,173,1,700,1,7,3,3,4,single-choice,spatial-relational,3|4,7,3/4,230173,3
2,3,23,174,0,521,1,13,6,7,7,single-choice,spatial-relational,6|7,7,6/7,230174,6
2,3,23,175,1,698,1,5,2,2,3,single-choice,spatial-relational,2|3,7,2/3,230175,2
2,3,23,176,0,909,1,3,1,2,2,single-choice,spatial-relational,1|2,7,1/2,230176,1
2,3,23,177,1,682,1,7,3,3,4,single-choice,spatial-relational,3|4,7,3/4,230177,3
2,3,23,178,1,693,1,11,5,5,6,single-choice,spatial-relational,5|6,7,5/6,230178,5
2,3,23,179,1,592,1,3,1,1,2,single-choice,spatial-relational,1|2,7,1/2,230179,1
2,3,23,180,1,608,1,13,6,6,7,single-choice,spatial-relational,6|7,7,6/7,230180,6
2,3,23,181,0,896,1,9,4,5,5,single-choice,spatial-relational,4|5,7,4/5,230181,4
2,3,23,182,1,631,1,3,1,1,2,single-choice,spatial-relational,1|2,7,1/2,230182,1
2,3,23,183,1,619,1,5,2,2,3,single-choice,spatial-relational,2|3,7,2/3,230183,2
2,3,23,184,1,762,1,13,6,6,7,single-choice,spatial-relational,6|7,7,6/7,230184,6
2,3,23,185,0,897,1,7,3,4,4,single-choice,spatial-relational,3|4,7,3/4,230185,3
2,3,23,186,1,44,1,11,5,5,6,single-choice,spatial-relational,5|6,7,5/6,230186,5
2,3,23,187,1,992,1,13,6,6,7,single-choice,spatial-relational,6|7,7,6/7,230187,6
2,3,23,188,1,1063,1,11,5,5,6,single-choice,spatial-relational,5|6,7,5/6,230188,5
2,3,23,189,1,616,1,7,3,3,4,single-choice,spatial-relational,3|4,7,3/4,230189,3
2,3,23,190,0,1256,1,3,1,2,2,single-choice,spatial-relational,1|2,7,1/2,230190,1
2,3,23,191,1,619,1,5,2,2,3,single-choice,spatial-relational,2|3,7,2/3,230191,2
2,3,23,192,1,831,1,9,4,4,5,single-choice,spatial-relational,4|5,7,4/5,230192,4
2,3,23,193,0,1077,1,9,4,5,5,single-choice,spatial-relational,4|5,7,4/5,230193,4
2,3,23,194,0,658,1,11,5,6,6,single-choice,spatial-relational,5|6,7,5/6,230194,5
2,3,23,195,1,822,1,7,3,3,4,single-choice,spatial-relational,3|4,7,3/4,230195,3
2,3,23,196,0,589,1,3,1,2,2,single-choice,spatial-relational,1|2,7,1/2,230196,1
2,3,23,197,1,579,1,5,2,2,3,single-choice,spatial-relational,2|3,7,2/3,230197,2
2,3,23,198,1,1108,1,13,6,6,7,single-choice,spatial-relational,6|7,7,6/7,230198,6
2,3,23,199,1,810,1,11,5,5,6,single-choice,spatial-relational,5|6,7,5/6,230199,5
2,3,23,200,0,865,1,9,4,5,5,single-choice,spatial-relational,4|5,7,4/5,230200,4
2,3,23,201,1,656,1,3,1,1,2,single-choice,spatial-relational,1|2,7,1/2,230201,1
2,3,23,202,1,675,1,5,2,2,3,single-choice,spatial-relational,2|3,7,2/3,230202,2
2,3,23,203,1,615,1,13,6,6,7,single-choice,spatial-relational,6|7,7,6/7,230203,6
2,3,23,204,1,638,1,7,3,3,4,single-choice,spatial-relational,3|4,7,3/4,230204,3
2,3,23,205,1,1239,1,13,6,6,7,single-choice,spatial-relational,6|7,7,6/7,230205,6
2,3,23,206,1,621,1,3,1,1,2,single-choice,spatial-relational,1|2,7,1/2,230206,1
2,3,23,207,1,565,1,13,6,6,7,single-choice,spatial-relational,6|7,7,6/7,230207,6
2,3,23,208,0,595,1,5,2,3,3,single-choice,spatial-relational,2|3,7,2/3,230208,2
2,3,23,209,1,650,1,11,5,5,6,single-choice,spatial-relational,5|6,7,5/6,230209,5
2,3,23,210,1,774,1,9,4,4,5,single-choice,spatial-relational,4|5,7,4/5,230210,4
2,3,23,211,0,802,1,3,1,2,2,single-choice,spatial-relational,1|2,7,1/2,230211,1
2,3,23,212,1,817,1,7,3,3,4,single-choice,spatial-relational,3|4,7,3/4,230212,3
2,3,23,213,1,603,1,7,3,3,4,single-choice,spatial-relational,3|4,7,3/4,230213,3
2,3,23,214,0,576,1,9,4,5,5,single-choice,spatial-relational,4|5,7,4/5,230214,4
2,3,23,215,0,576,1,11,5,6,6,single-choice,spatial-relational,5|6,7,5/6,230215,5
2,3,23,216,1,678,1,5,2,2,3,single-choice,spatial-relational,2|3,7,2/3,230216,2
2,3,23,217,0,548,1,9,4,5,5,single-choice,spatial-relational,4|5,7,4/5,230217,4
2,3,23,218,1,697,1,11,5,5,6,single-choice,spatial-relational,5|6,7,5/6,230218,5
2,3,23,219,1,557,1,5,2,2,3,single-choice,spatial-relational,2|3,7,2/3,230219,2
2,3,23,220,0,576,1,3,1,2,2,single-choice,spatial-relational,1|2,7,1/2,230220,1
2,3,23,221,1,677,1,5,2,2,3,single-choice,spatial-relational,2|3,7,2/3,230221,2
2,3,23,222,1,1188,1,13,6,6,7,single-choice,spatial-relational,6|7,7,6/7,230222,6
2,3,23,223,1,691,1,7,3,3,4,single-choice,spatial-relational,3|4,7,3/4,230223,3
2,3,23,224,1,571,1,13,6,6,7,single-choice,spatial-relational,6|7,7,6/7,230224,6
2,3,23,225,1,799,1,7,3,3,4,single-choice,spatial-relational,3|4,7,3/4,230225,3
2,3,23,226,1,695,1,11,5,5,6,single-choice,spatial-relational,5|6,7,5/6,230226,5
2,3,23,227,1,605,1,3,1,1,2,single-choice,spatial-relational,1|2,7,1/2,230227,1
2,3,23,228,0,608,1,9,4,5,5,single-choice,spatial-relational,4|5,7,4/5,230228,4
2,3,23,229,1,592,1,3,1,1,2,single-choice,spatial-relational,1|2,7,1/2,230229,1
2,3,23,230,1,651,1,5,2,2,3,single-choice,spatial-relational,2|3,7,2/3,230230,2
2,3,23,231,1,632,1,5,2,2,3,single-choice,spatial-relational,2|3,7,2/3,230231,2
2,3,23,232,1,642,1,11,5,5,6,single-choice,spatial-relational,5|6,7,5/6,230232,5
2,3,23,233,1,595,1,13,6,6,7,single-choice,spatial-relational,6|7,7,6/7,230233,6
2,3,23,234,0,607,1,3,1,2,2,single-choice,spatial-relational,1|2,7,1/2,230234,1
2,3,23,235,1,654,1,11,5,5,6,single-choice,spatial-relational,5|6,7,5/6,230235,5
2,3,23,236,1,778,1,7,3,3,4,single-choice,spatial-relational,3|4,7,3/4,230236,3
2,3,23,237,0,623,1,13,6,7,7,single-choice,spatial-relational,6|7,7,6/7,230237,6
2,3,23,238,0,661,1,9,4,5,5,single-choice,spatial-relational,4|5,7,4/5,230238,4
2,3,23,239,0,633,1,9,4,5,5,single-choice,spatial-relational,4|5,7,4/5,230239,4
2,3,23,240,1,654,1,7,3,3,4,single-choice,spatial-relational,3|4,7,3/4,230240,3
2,3,23,241,0,656,1,5,2,3,3,single-choice,spatial-relational,2|3,7,2/3,230241,2
2,3,23,242,1,655,1,13,6,6,7,single-choice,spatial-relational,6|7,7,6/7,230242,6
2,3,23,243,1,1257,1,11,5,5,6,single-choice,spatial-relational,5|6,7,5/6,230243,5
2,3,23,244,0,967,1,9,4,5,5,single-choice,spatial-relational,4|5,7,4/5,230244,4
2,3,23,245,1,1172,1,13,6,6,7,single-choice,spatial-relational,6|7,7,6/7,230245,6
2,3,23,246,1,685,1,7,3,3,4,single-choice,spatial-relational,3|4,7,3/4,230246,3
2,3,23,247,0,661,1,3,1,2,2,single-choice,spatial-relational,1|2,7,1/2,230247,1
2,3,23,248,1,1492,1,3,1,1,2,single-choice,spatial-relational,1|2,7,1/2,230248,1
2,3,23,249,0,645,1,9,4,5,5,single-choice,spatial-relational,4|5,7,4/5,230249,4
2,3,23,250,1,731,1,5,2,2,3,single-choice,spatial-relational,2|3,7,2/3,230250,2
2,3,23,251,1,624,1,7,3,3,4,single-choice,spatial-relational,3|4,7,3/4,230251,3
2,3,23,252,1,680,1,11,5,5,6,single-choice,spatial-relational,5|6,7,5/6,230252,5
2,3,23,253,1,610,1,7,3,3,4,single-choice,spatial-relational,3|4,7,3/4,230253,3
2,3,23,254,0,846,1,7,3,4,4,single-choice,spatial-relational,3|4,7,3/4,230254,3
2,3,23,255,1,919,1,11,5,5,6,single-choice,spatial-relational,5|6,7,5/6,230255,5
2,3,23,256,0,635,1,3,1,2,2,single-choice,spatial-relational,1|2,7,1/2,230256,1
2,3,23,257,0,189,1,13,6,7,7,single-choice,spatial-relational,6|7,7,6/7,230257,6
2,3,23,258,1,888,1,5,2,2,3,single-choice,spatial-relational,2|3,7,2/3,230258,2
2,3,23,259,1,623,1,5,2,2,3,single-choice,spatial-relational,2|3,7,2/3,230259,2
2,3,23,260,0,762,1,3,1,2,2,single-choice,spatial-relational,1|2,7,1/2,230260,1
2,3,23,261,1,962,1,9,4,4,5,single-choice,spatial-relational,4|5,7,4/5,230261,4
2,3,23,262,0,835,1,11,5,6,6,single-choice,spatial-relational,5|6,7,5/6,230262,5
2,3,23,263,0,593,1,9,4,5,5,single-choice,spatial-relational,4|5,7,4/5,230263,4
2,3,23,264,1,607,1,13,6,6,7,single-choice,spatial-relational,6|7,7,6/7,230264,6
2,3,23,265,1,1245,1,13,6,6,7,single-choice,spatial-relational,6|7,7,6/7,230265,6
2,3,23,266,1,779,1,9,4,4,5,single-choice,spatial-relational,4|5,7,4/5,230266,4
2,3,23,267,0,604,1,5,2,3,3,single-choice,spatial-relational,2|3,7,2/3,230267,2
2,3,23,268,0,643,1,9,4,5,5,single-choice,spatial-relational,4|5,7,4/5,230268,4
2,3,23,269,1,664,1,11,5,5,6,single-choice,spatial-relational,5|6,7,5/6,230269,5
2,3,23,270,1,678,1,11,5,5,6,single-choice,spatial-relational,5|6,7,5/6,230270,5
2,3,23,271,1,673,1,7,3,3,4,single-choice,spatial-relational,3|4,7,3/4,230271,3
2,3,23,272,1,603,1,7,3,3,4,single-choice,spatial-relational,3|4,7,3/4,230272,3
2,3,23,273,1,586,1,5,2,2,3,single-choice,spatial-relational,2|3,7,2/3,230273,2
2,3,23,274,1,584,1,13,6,6,7,single-choice,spatial-relational,6|7,7,6/7,230274,6
2,3,23,275,0,603,1,3,1,2,2,single-choice,spatial-relational,1|2,7,1/2,230275,1
2,3,23,276,1,603,1,3,1,1,2,single-choice,spatial-relational,1|2,7,1/2,230276,1
2,3,23,277,0,812,1,5,2,3,3,single-choice,spatial-relational,2|3,7,2/3,230277,2
2,3,23,278,1,52,1,13,6,6,7,single-choice,spatial-relational,6|7,7,6/7,230278,6
2,3,23,279,0,614,1,9,4,5,5,single-choice,spatial-relational,4|5,7,4/5,230279,4
2,3,23,280,1,1198,1,13,6,6,7,single-choice,spatial-relational,6|7,7,6/7,230280,6
2,3,23,281,0,577,1,3,1,2,2,single-choice,spatial-relational,1|2,7,1/2,230281,1
2,3,23,282,1,723,1,7,3,3,4,single-choice,spatial-relational,3|4,7,3/4,230282,3
2,3,23,283,0,657,1,9,4,5,5,single-choice,spatial-relational,4|5,7,4/5,230283,4
2,3,23,284,1,612,1,5,2,2,3,single-choice,spatial-relational,2|3,7,2/3,230284,2
2,3,23,285,1,599,1,3,1,1,2,single-choice,spatial-relational,1|2,7,1/2,230285,1
2,3,23,286,1,721,1,11,5,5,6,single-choice,spatial-relational,5|6,7,5/6,230286,5
2,3,23,287,1,674,1,11,5,5,6,single-choice,spatial-relational,5|6,7,5/6,230287,5
2,3,23,288,1,560,1,7,3,3,4,single-choice,spatial-relational,3|4,7,3/4,230288,3
2,3,23,289,1,599,1,5,2,2,3,single-choice,spatial-relational,2|3,7,2/3,230289,2
2,3,23,290,1,587,1,13,6,6,7,single-choice,spatial-relational,6|7,7,6/7,230290,6
2,3,23,291,1,662,1,11,5,5,6,single-choice,spatial-relational,5|6,7,5/6,230291,5
2,3,23,292,1,865,1,7,3,3,4,single-choice,spatial-relational,3|4,7,3/4,230292,3
2,3,23,293,0,623,1,9,4,5,5,single-choice,spatial-relational,4|5,7,4/5,230293,4
2,3,23,294,1,1050,1,3,1,1,2,single-choice,spatial-relational,1|2,7,1/2,230294,1
2,3,23,295,1,631,1,13,6,6,7,single-choice,spatial-relational,6|7,7,6/7,230295,6
2,3,23,296,1,735,1,5,2,2,3,single-choice,spatial-relational,2|3,7,2/3,230296,2
2,3,23,297,1,1191,1,3,1,1,2,single-choice,spatial-relational,1|2,7,1/2,230297,1
2,3,23,298,1,717,1,7,3,3,4,single-choice,spatial-relational,3|4,7,3/4,230298,3
2,3,23,299,1,652,1,11,5,5,6,single-choice,spatial-relational,5|6,7,5/6,230299,5
2,3,23,300,0,900,1,9,4,5,5,single-choice,spatial-relational,4|5,7,4/5,230300,4
2,3,23,301,0,734,1,7,3,4,4,single-choice,spatial-relational,3|4,7,3/4,230301,3
2,3,23,302,0,650,1,9,4,5,5,single-choice,spatial-relational,4|5,7,4/5,230302,4
2,3,23,303,0,974,1,11,5,6,6,single-choice,spatial-relational,5|6,7,5/6,230303,5
2,3,23,304,0,771,1,11,5,6,6,single-choice,spatial-relational,5|6,7,5/6,230304,5
2,3,23,305,1,827,1,5,2,2,3,single-choice,spatial-relational,2|3,7,2/3,230305,2
2,3,23,306,1,762,1,7,3,3,4,single-choice,spatial-relational,3|4,7,3/4,230306,3
2,3,23,307,1,545,1,13,6,6,7,single-choice,spatial-relational,6|7,7,6/7,230307,6
2,3,23,308,0,567,1,3,1,2,2,single-choice,spatial-relational,1|2,7,1/2,230308,1
2,3,23,309,1,651,1,13,6,6,7,single-choice,spatial-relational,6|7,7,6/7,230309,6
2,3,23,310,1,592,1,3,1,1,2,single-choice,spatial-relational,1|2,7,1/2,230310,1
2,3,23,311,0,662,1,9,4,5,5,single-choice,spatial-relational,4|5,7,4/5,230311,4
2,3,23,312,0,1635,1,5,2,3,3,single-choice,spatial-relational,2|3,7,2/3,230312,2
2,3,23,313,0,1199,1,11,5,6,6,single-choice,spatial-relational,5|6,7,5/6,230313,5
2,3,23,314,0,48,1,7,3,4,4,single-choice,spatial-relational,3|4,7,3/4,230314,3
2,3,23,315,0,600,1,9,4,5,5,single-choice,spatial-relational,4|5,7,4/5,230315,4
2,3,23,316,1,596,1,13,6,6,7,single-choice,spatial-relational,6|7,7,6/7,230316,6
2,3,23,317,1,599,1,3,1,1,2,single-choice,spatial-relational,1|2,7,1/2,230317,1
2,3,23,318,1,671,1,5,2,2,3,single-choice,spatial-relational,2|3,7,2/3,230318,2
2,3,23,319,0,824,1,3,1,2,2,single-choice,spatial-relational,1|2,7,1/2,230319,1
2,3,23,320,0,796,1,7,3,4,4,single-choice,spatial-relational,3|4,7,3/4,230320,3
2,3,23,321,1,692,1,11,5,5,6,single-choice,spatial-relational,5|6,7,5/6,230321,5
2,3,23,322,1,1091,1,13,6,6,7,single-choice,spatial-relational,6|7,7,6/7,230322,6
2,3,23,323,0,638,1,5,2,3,3,single-choice,spatial-relational,2|3,7,2/3,230323,2
2,3,23,324,0,679,1,9,4,5,5,single-choice,spatial-relational,4|5,7,4/5,230324,4
2,3,23,325,1,818,1,7,3,3,4,single-choice,spatial-relational,3|4,7,3/4,230325,3
2,3,23,326,0,743,1,3,1,2,2,single-choice,spatial-relational,1|2,7,1/2,230326,1
2,3,23,327,1,673,1,9,4,4,5,single-choice,spatial-relational,4|5,7,4/5,230327,4
2,3,23,328,1,670,1,3,1,1,2,single-choice,spatial-relational,1|2,7,1/2,230328,1
2,3,23,329,0,556,1,9,4,5,5,single-choice,spatial-relational,4|5,7,4/5,230329,4
2,3,23,330,1,565,1,13,6,6,7,single-choice,spatial-relational,6|7,7,6/7,230330,6
2,3,23,331,0,732,1,7,3,4,4,single-choice,spatial-relational,3|4,7,3/4,230331,3
2,3,23,332,1,758,1,5,2,2,3,single-choice,spatial-relational,2|3,7,2/3,230332,2
2,3,23,333,1,634,1,11,5,5,6,single-choice,spatial-relational,5|6,7,5/6,230333,5
2,3,23,334,1,816,1,5,2,2,3,single-choice,spatial-relational,2|3,7,2/3,230334,2
2,3,23,335,1,611,1,13,6,6,7,single-choice,spatial-relational,6|7,7,6/7,230335,6
2,3,23,336,0,686,1,11,5,6,6,single-choice,spatial-relational,5|6,7,5/6,230336,5
2,3,23,337,1,786,1,5,2,2,3,single-choice,spatial-relational,2|3,7,2/3,230337,2
2,3,23,338,1,607,1,7,3,3,4,single-choice,spatial-relational,3|4,7,3/4,230338,3
2,3,23,339,1,751,1,11,5,5,6,single-choice,spatial-relational,5|6,7,5/6,230339,5
2,3,23,340,1,1271,1,5,2,2,3,single-choice,spatial-relational,2|3,7,2/3,230340,2
2,3,23,341,1,731,1,11,5,5,6,single-choice,spatial-relational,5|6,7,5/6,230341,5
2,3,23,342,1,56,1,3,1,1,2,single-choice,spatial-relational,1|2,7,1/2,230342,1
2,3,23,343,1,666,1,3,1,1,2,single-choice,spatial-relational,1|2,7,1/2,230343,1
2,3,23,344,0,951,1,9,4,5,5,single-choice,spatial-relational,4|5,7,4/5,230344,4
2,3,23,345,1,601,1,13,6,6,7,single-choice,spatial-relational,6|7,7,6/7,230345,6
2,3,23,346,0,638,1,9,4,5,5,single-choice,spatial-relational,4|5,7,4/5,230346,4
2,3,23,347,1,705,1,13,6,6,7,single-choice,spatial-relational,6|7,7,6/7,230347,6
2,3,23,348,1,615,1,7,3,3,4,single-choice,spatial-relational,3|4,7,3/4,230348,3
2,3,23,349,1,740,1,11,5,5,6,single-choice,spatial-relational,5|6,7,5/6,230349,5
2,3,23,350,0,783,1,13,6,7,7,single-choice,spatial-relational,6|7,7,6/7,230350,6
2,3,23,351,0,703,1,3,1,2,2,single-choice,spatial-relational,1|2,7,1/2,230351,1
2,3,23,352,0,908,1,5,2,3,3,single-choice,spatial-relational,2|3,7,2/3,230352,2
2,3,23,353,0,615,1,9,4,5,5,single-choice,spatial-relational,4|5,7,4/5,230353,4
2,3,23,354,0,744,1,5,2,3,3,single-choice,spatial-relational,2|3,7,2/3,230354,2
2,3,23,355,1,773,1,7,3,3,4,single-choice,spatial-relational,3|4,7,3/4,230355,3
2,3,23,356,1,679,1,13,6,6,7,single-choice,spatial-relational,6|7,7,6/7,230356,6
2,3,23,357,1,662,1,7,3,3,4,single-choice,spatial-relational,3|4,7,3/4,230357,3
2,3,23,358,0,794,1,9,4,5,5,single-choice,spatial-relational,4|5,7,4/5,230358,4
2,3,23,359,1,955,1,3,1,1,2,single-choice,spatial-relational,1|2,7,1/2,230359,1
2,3,23,360,1,812,1,11,5,5,6,single-choice,spatial-relational,5|6,7,5/6,230360,5
2,3,23,361,0,681,1,3,1,2,2,single-choice,spatial-relational,1|2,7,1/2,230361,1
2,3,23,362,0,685,1,5,2,3,3,single-choice,spatial-relational,2|3,7,2/3,230362,2
2,3,23,363,1,690,1,9,4,4,5,single-choice,spatial-relational,4|5,7,4/5,230363,4
2,3,23,364,0,814,1,11,5,6,6,single-choice,spatial-relational,5|6,7,5/6,230364,5
2,3,23,365,1,599,1,5,2,2,3,single-choice,spatial-relational,2|3,7,2/3,230365,2
2,3,23,366,1,611,1,7,3,3,4,single-choice,spatial-relational,3|4,7,3/4,230366,3
2,3,23,367,0,611,1,13,6,7,7,single-choice,spatial-relational,6|7,7,6/7,230367,6
2,3,23,368,0,645,1,9,4,5,5,single-choice,spatial-relational,4|5,7,4/5,230368,4
2,3,23,369,1,599,1,13,6,6,7,single-choice,spatial-relational,6|7,7,6/7,230369,6
2,3,23,370,0,695,1,7,3,4,4,single-choice,spatial-relational,3|4,7,3/4,230370,3
2,3,23,371,0,705,1,11,5,6,6,single-choice,spatial-relational,5|6,7,5/6,230371,5
2,3,23,372,0,685,1,3,1,2,2,single-choice,spatial-relational,1|2,7,1/2,230372,1
2,3,23,373,1,701,1,11,5,5,6,single-choice,spatial-relational,5|6,7,5/6,230373,5
2,3,23,374,1,706,1,7,3,3,4,single-choice,spatial-relational,3|4,7,3/4,230374,3
2,3,23,375,1,663,1,13,6,6,7,single-choice,spatial-relational,6|7,7,6/7,230375,6
2,3,23,376,0,951,1,9,4,5,5,single-choice,spatial-relational,4|5,7,4/5,230376,4
2,3,23,377,0,657,1,9,4,5,5,single-choice,spatial-relational,4|5,7,4/5,230377,4
2,3,23,378,1,654,1,5,2,2,3,single-choice,spatial-relational,2|3,7,2/3,230378,2
2,3,23,379,1,711,1,11,5,5,6,single-choice,spatial-relational,5|6,7,5/6,230379,5
2,3,23,380,0,634,1,5,2,3,3,single-choice,spatial-relational,2|3,7,2/3,230380,2
2,3,23,381,1,717,1,7,3,3,4,single-choice,spatial-relational,3|4,7,3/4,230381,3
2,3,23,382,0,643,1,3,1,2,2,single-choice,spatial-relational,1|2,7,1/2,230382,1
2,3,23,383,1,588,1,3,1,1,2,single-choice,spatial-relational,1|2,7,1/2,230383,1
2,3,23,384,1,638,1,13,6,6,7,single-choice,spatial-relational,6|7,7,6/7,230384,6
2,3,23,385,0,617,1,5,2,3,3,single-choice,spatial-relational,2|3,7,2/3,230385,2
2,3,23,386,1,781,1,11,5,5,6,single-choice,spatial-relational,5|6,7,5/6,230386,5
2,3,23,387,1,650,1,11,5,5,6,single-choice,spatial-relational,5|6,7,5/6,230387,5
2,3,23,388,1,764,1,13,6,6,7,single-choice,spatial-relational,6|7,7,6/7,230388,6
2,3,23,389,1,701,1,3,1,1,2,single-choice,spatial-relational,1|2,7,1/2,230389,1
2,3,23,390,1,713,1,5,2,2,3,single-choice,spatial-relational,2|3,7,2/3,230390,2
2,3,23,391,1,992,1,7,3,3,4,single-choice,spatial-relational,3|4,7,3/4,230391,3
2,3,23,392,1,671,1,7,3,3,4,single-choice,spatial-relational,3|4,7,3/4,230392,3
2,3,23,393,0,693,1,3,1,2,2,single-choice,spatial-relational,1|2,7,1/2,230393,1
2,3,23,394,1,1190,1,13,6,6,7,single-choice,spatial-relational,6|7,7,6/7,230394,6
2,3,23,395,1,1225,1,9,4,4,5,single-choice,spatial-relational,4|5,7,4/5,230395,4
2,3,23,396,0,700,1,9,4,5,5,single-choice,spatial-relational,4|5,7,4/5,230396,4
2,3,23,397,1,592,1,13,6,6,7,single-choice,spatial-relational,6|7,7,6/7,230397,6
2,3,23,398,0,679,1,9,4,5,5,single-choice,spatial-relational,4|5,7,4/5,230398,4
2,3,23,399,1,818,1,7,3,3,4,single-choice,spatial-relational,3|4,7,3/4,230399,3
2,3,23,400,1,632,1,13,6,6,7,single-choice,spatial-relational,6|7,7,6/7,230400,6
2,3,23,401,1,673,1,3,1,1,2,single-choice,spatial-relational,1|2,7,1/2,230401,1
2,3,23,402,0,674,1,9,4,5,5,single-choice,spatial-relational,4|5,7,4/5,230402,4
2,3,23,403,0,739,1,5,2,3,3,single-choice,spatial-relational,2|3,7,2/3,230403,2
2,3,23,404,1,759,1,7,3,3,4,single-choice,spatial-relational,3|4,7,3/4,230404,3
2,3,23,405,0,692,1,3,1,2,2,single-choice,spatial-relational,1|2,7,1/2,230405,1
2,3,23,406,1,744,1,11,5,5,6,single-choice,spatial-relational,5|6,7,5/6,230406,5
2,3,23,407,1,647,1,5,2,2,3,single-choice,spatial-relational,2|3,7,2/3,230407,2
2,3,23,408,1,768,1,11,5,5,6,single-choice,spatial-relational,5|6,7,5/6,230408,5
2,3,23,409,0,679,1,13,6,7,7,single-choice,spatial-relational,6|7,7,6/7,230409,6
2,3,23,410,1,832,1,9,4,4,5,single-choice,spatial-relational,4|5,7,4/5,230410,4
2,3,23,411,1,904,1,13,6,6,7,single-choice,spatial-relational,6|7,7,6/7,230411,6
2,3,23,412,1,912,1,9,4,4,5,single-choice,spatial-relational,4|5,7,4/5,230412,4
2,3,23,413,1,677,1,11,5,5,6,single-choice,spatial-relational,5|6,7,5/6,230413,5
2,3,23,414,1,683,1,5,2,2,3,single-choice,spatial-relational,2|3,7,2/3,230414,2
2,3,23,415,1,970,1,11,5,5,6,single-choice,spatial-relational,5|6,7,5/6,230415,5
2,3,23,416,0,681,1,7,3,4,4,single-choice,spatial-relational,3|4,7,3/4,230416,3
2,3,23,417,1,701,1,3,1,1,2,single-choice,spatial-relational,1|2,7,1/2,230417,1
2,3,23,418,0,623,1,3,1,2,2,single-choice,spatial-relational,1|2,7,1/2,230418,1
2,3,23,419,1,1023,1,7,3,3,4,single-choice,spatial-relational,3|4,7,3/4,230419,3
2,3,23,420,1,822,1,5,2,2,3,single-choice,spatial-relational,2|3,7,2/3,230420,2
2,3,23,421,1,643,1,13,6,6,7,single-choice,spatial-relational,6|7,7,6/7,230421,6
2,3,23,422,1,748,1,11,5,5,6,single-choice,spatial-relational,5|6,7,5/6,230422,5
2,3,23,423,1,748,1,11,5,5,6,single-choice,spatial-relational,5|6,7,5/6,230423,5
2,3,23,424,0,681,1,7,3,4,4,single-choice,spatial-relational,3|4,7,3/4,230424,3
2,3,23,425,1,747,1,9,4,4,5,single-choice,spatial-relational,4|5,7,4/5,230425,4
2,3,23,426,1,734,1,5,2,2,3,single-choice,spatial-relational,2|3,7,2/3,230426,2
2,3,23,427,1,717,1,13,6,6,7,single-choice,spatial-relational,6|7,7,6/7,230427,6
2,3,23,428,1,908,1,9,4,4,5,single-choice,spatial-relational,4|5,7,4/5,230428,4
2,3,23,429,1,697,1,5,2,2,3,single-choice,spatial-relational,2|3,7,2/3,230429,2
2,3,23,430,0,797,1,3,1,2,2,single-choice,spatial-relational,1|2,7,1/2,230430,1
2,3,23,431,1,1489,1,7,3,3,4,single-choice,spatial-relational,3|4,7,3/4,230431,3
2,3,23,432,0,720,1,3,1,2,2,single-choice,spatial-relational,1|2,7,1/2,230432,1
2,3,23,433,1,706,1,11,5,5,6,single-choice,spatial-relational,5|6,7,5/6,230433,5
2,3,23,434,1,737,1,5,2,2,3,single-choice,spatial-relational,2|3,7,2/3,230434,2
2,3,23,435,1,3343,1,3,1,1,2,single-choice,spatial-relational,1|2,7,1/2,230435,1
2,3,23,436,0,688,1,9,4,5,5,single-choice,spatial-relational,4|5,7,4/5,230436,4
2,3,23,437,1,849,1,7,3,3,4,single-choice,spatial-relational,3|4,7,3/4,230437,3
2,3,23,438,1,583,1,7,3,3,4,single-choice,spatial-relational,3|4,7,3/4,230438,3
2,3,23,439,0,577,1,13,6,7,7,single-choice,spatial-relational,6|7,7,6/7,230439,6
2,3,23,440,1,773,1,9,4,4,5,single-choice,spatial-relational,4|5,7,4/5,230440,4
2,3,23,441,0,731,1,11,5,6,6,single-choice,spatial-relational,5|6,7,5/6,230441,5
2,3,23,442,1,706,1,5,2,2,3,single-choice,spatial-relational,2|3,7,2/3,230442,2
2,3,23,443,1,599,1,13,6,6,7,single-choice,spatial-relational,6|7,7,6/7,230443,6
2,3,23,444,0,581,1,3,1,2,2,single-choice,spatial-relational,1|2,7,1/2,230444,1
2,3,23,445,0,656,1,9,4,5,5,single-choice,spatial-relational,4|5,7,4/5,230445,4
2,3,23,446,1,610,1,13,6,6,7,single-choice,spatial-relational,6|7,7,6/7,230446,6
2,3,23,447,1,760,1,7,3,3,4,single-choice,spatial-relational,3|4,7,3/4,230447,3
2,3,23,448,1,567,1,13,6,6,7,single-choice,spatial-relational,6|7,7,6/7,230448,6
2,3,23,449,1,605,1,3,1,1,2,single-choice,spatial-relational,1|2,7,1/2,230449,1
2,3,23,450,1,588,1,7,3,3,4,single-choice,spatial-relational,3|4,7,3/4,230450,3
2,3,23,451,1,640,1,11,5,5,6,single-choice,spatial-relational,5|6,7,5/6,230451,5
2,3,23,452,0,665,1,3,1,2,2,single-choice,spatial-relational,1|2,7,1/2,230452,1
2,3,23,453,0,1381,1,5,2,3,3,single-choice,spatial-relational,2|3,7,2/3,230453,2
2,3,23,454,1,656,1,11,5,5,6,single-choice,spatial-relational,5|6,7,5/6,230454,5
2,3,23,455,0,656,1,9,4,5,5,single-choice,spatial-relational,4|5,7,4/5,230455,4
2,3,23,456,1,676,1,5,2,2,3,single-choice,spatial-relational,2|3,7,2/3,230456,2
2,3,23,457,1,831,1,11,5,5,6,single-choice,spatial-relational,5|6,7,5/6,230457,5
2,3,23,458,1,635,1,13,6,6,7,single-choice,spatial-relational,6|7,7,6/7,230458,6
2,3,23,459,1,638,1,13,6,6,7,single-choice,spatial-relational,6|7,7,6/7,230459,6
2,3,23,460,1,783,1,5,2,2,3,single-choice,spatial-relational,2|3,7,2/3,230460,2
2,3,23,461,1,773,1,9,4,4,5,single-choice,spatial-relational,4|5,7,4/5,230461,4
2,3,23,462,1,629,1,3,1,1,2,single-choice,spatial-relational,1|2,7,1/2,230462,1
2,3,23,463,1,1136,1,7,3,3,4,single-choice,spatial-relational,3|4,7,3/4,230463,3
2,3,23,464,1,642,1,11,5,5,6,single-choice,spatial-relational,5|6,7,5/6,230464,5
2,3,23,465,1,576,1,7,3,3,4,single-choice,spatial-relational,3|4,7,3/4,230465,3
2,3,23,466,1,571,1,5,2,2,3,single-choice,spatial-relational,2|3,7,2/3,230466,2
2,3,23,467,1,673,1,9,4,4,5,single-choice,spatial-relational,4|5,7,4/5,230467,4
2,3,23,468,0,585,1,3,1,2,2,single-choice,spatial-relational,1|2,7,1/2,230468,1
2,3,23,469,1,673,1,5,2,2,3,single-choice,spatial-relational,2|3,7,2/3,230469,2
2,3,23,470,1,842,1,7,3,3,4,single-choice,spatial-relational,3|4,7,3/4,230470,3
2,3,23,471,1,689,1,9,4,4,5,single-choice,spatial-relational,4|5,7,4/5,230471,4
2,3,23,472,1,643,1,3,1,1,2,single-choice,spatial-relational,1|2,7,1/2,230472,1
2,3,23,473,1,709,1,7,3,3,4,single-choice,spatial-relational,3|4,7,3/4,230473,3
2,3,23,474,0,673,1,3,1,2,2,single-choice,spatial-relational,1|2,7,1/2,230474,1
2,3,23,475,1,647,1,13,6,6,7,single-choice,spatial-relational,6|7,7,6/7,230475,6
2,3,23,476,1,598,1,13,6,6,7,single-choice,spatial-relational,6|7,7,6/7,230476,6
2,3,23,477,1,560,1,5,2,2,3,single-choice,spatial-relational,2|3,7,2/3,230477,2
2,3,23,478,0,648,1,9,4,5,5,single-choice,spatial-relational,4|5,7,4/5,230478,4
2,3,23,479,0,650,1,11,5,6,6,single-choice,spatial-relational,5|6,7,5/6,230479,5
2,3,23,480,0,57,1,11,5,6,6,single-choice,spatial-relational,5|6,7,5/6,230480,5
2,3,23,481,1,703,1,7,3,3,4,single-choice,spatial-relational,3|4,7,3/4,230481,3
2,3,23,482,0,603,1,11,5,6,6,single-choice,spatial-relational,5|6,7,5/6,230482,5
2,3,23,483,1,840,1,7,3,3,4,single-choice,spatial-relational,3|4,7,3/4,230483,3
2,3,23,484,1,603,1,5,2,2,3,single-choice,spatial-relational,2|3,7,2/3,230484,2
2,3,23,485,1,560,1,5,2,2,3,single-choice,spatial-relational,2|3,7,2/3,230485,2
2,3,23,486,1,685,1,11,5,5,6,single-choice,spatial-relational,5|6,7,5/6,230486,5
2,3,23,487,0,611,1,9,4,5,5,single-choice,spatial-relational,4|5,7,4/5,230487,4
2,3,23,488,1,661,1,3,1,1,2,single-choice,spatial-relational,1|2,7,1/2,230488,1
2,3,23,489,1,549,1,13,6,6,7,single-choice,spatial-relational,6|7,7,6/7,230489,6
2,3,23,490,0,604,1,9,4,5,5,single-choice,spatial-relational,4|5,7,4/5,230490,4
2,3,23,491,0,569,1,3,1,2,2,single-choice,spatial-relational,1|2,7,1/2,230491,1
2,3,23,492,1,629,1,13,6,6,7,single-choice,spatial-relational,6|7,7,6/7,230492,6
2,3,23,493,0,677,1,11,5,6,6,single-choice,spatial-relational,5|6,7,5/6,230493,5
2,3,23,494,0,630,1,3,1,2,2,single-choice,spatial-relational,1|2,7,1/2,230494,1
2,3,23,495,1,579,1,5,2,2,3,single-choice,spatial-relational,2|3,7,2/3,230495,2
2,3,23,496,1,628,1,5,2,2,3,single-choice,spatial-relational,2|3,7,2/3,230496,2
2,3,23,497,1,619,1,13,6,6,7,single-choice,spatial-relational,6|7,7,6/7,230497,6
2,3,23,498,1,741,1,7,3,3,4,single-choice,spatial-relational,3|4,7,3/4,230498,3
2,3,23,499,1,622,1,7,3,3,4,single-choice,spatial-relational,3|4,7,3/4,230499,3
2,3,23,500,0,599,1,13,6,7,7,single-choice,spatial-relational,6|7,7,6/7,230500,6
2,3,23,501,1,728,1,11,5,5,6,single-choice,spatial-relational,5|6,7,5/6,230501,5
2,3,23,502,0,717,1,3,1,2,2,single-choice,spatial-relational,1|2,7,1/2,230502,1
2,3,23,503,1,686,1,9,4,4,5,single-choice,spatial-relational,4|5,7,4/5,230503,4
2,3,23,504,0,637,1,9,4,5,5,single-choice,spatial-relational,4|5,7,4/5,230504,4
2,3,23,505,1,630,1,3,1,1,2,single-choice,spatial-relational,1|2,7,1/2,230505,1
2,3,23,506,0,584,1,9,4,5,5,single-choice,spatial-relational,4|5,7,4/5,230506,4
2,3,23,507,1,595,1,7,3,3,4,single-choice,spatial-relational,3|4,7,3/4,230507,3
2,3,23,508,1,721,1,9,4,4,5,single-choice,spatial-relational,4|5,7,4/5,230508,4
2,3,23,509,0,576,1,3,1,2,2,single-choice,spatial-relational,1|2,7,1/2,230509,1
2,3,23,510,1,760,1,7,3,3,4,single-choice,spatial-relational,3|4,7,3/4,230510,3
2,3,23,511,1,603,1,13,6,6,7,single-choice,spatial-relational,6|7,7,6/7,230511,6
2,3,23,512,1,666,1,5,2,2,3,single-choice,spatial-relational,2|3,7,2/3,230512,2
2,3,23,513,1,702,1,11,5,5,6,single-choice,spatial-relational,5|6,7,5/6,230513,5
2,3,23,514,1,830,1,11,5,5,6,single-choice,spatial-relational,5|6,7,5/6,230514,5
2,3,23,515,1,666,1,5,2,2,3,single-choice,spatial-relational,2|3,7,2/3,230515,2
2,3,23,516,1,562,1,13,6,6,7,single-choice,spatial-relational,6|7,7,6/7,230516,6
2,3,23,517,0,689,1,7,3,4,4,single-choice,spatial-relational,3|4,7,3/4,230517,3
2,3,23,518,1,624,1,13,6,6,7,single-choice,spatial-relational,6|7,7,6/7,230518,6
2,3,23,519,0,549,1,9,4,5,5,single-choice,spatial-relational,4|5,7,4/5,230519,4
2,3,23,520,0,639,1,11,5,6,6,single-choice,spatial-relational,5|6,7,5/6,230520,5
2,3,23,521,1,543,1,13,6,6,7,single-choice,spatial-relational,6|7,7,6/7,230521,6
2,3,23,522,0,716,1,9,4,5,5,single-choice,spatial-relational,4|5,7,4/5,230522,4
2,3,23,523,1,67,1,5,2,2,3,single-choice,spatial-relational,2|3,7,2/3,230523,2
2,3,23,524,1,677,1,3,1,1,2,single-choice,spatial-relational,1|2,7,1/2,230524,1
2,3,23,525,1,669,1,3,1,1,2,single-choice,spatial-relational,1|2,7,1/2,230525,1
2,3,23,526,1,736,1,5,2,2,3,single-choice,spatial-relational,2|3,7,2/3,230526,2
2,3,23,527,0,717,1,7,3,4,4,single-choice,spatial-relational,3|4,7,3/4,230527,3
2,3,23,528,1,567,1,11,5,5,6,single-choice,spatial-relational,5|6,7,5/6,230528,5
2,3,23,529,1,615,1,13,6,6,7,single-choice,spatial-relational,6|7,7,6/7,230529,6
2,3,23,530,0,608,1,9,4,5,5,single-choice,spatial-relational,4|5,7,4/5,230530,4
2,3,23,531,1,653,1,7,3,3,4,single-choice,spatial-relational,3|4,7,3/4,230531,3
2,3,23,532,1,673,1,11,5,5,6,single-choice,spatial-relational,5|6,7,5/6,230532,5
2,3,23,533,0,697,1,13,6,7,7,single-choice,spatial-relational,6|7,7,6/7,230533,6
2,3,23,534,1,786,1,7,3,3,4,single-choice,spatial-relational,3|4,7,3/4,230534,3
2,3,23,535,0,657,1,3,1,2,2,single-choice,spatial-relational,1|2,7,1/2,230535,1
2,3,23,536,0,666,1,3,1,2,2,single-choice,spatial-relational,1|2,7,1/2,230536,1
2,3,23,537,1,697,1,9,4,4,5,single-choice,spatial-relational,4|5,7,4/5,230537,4
2,3,23,538,1,713,1,11,5,5,6,single-choice,spatial-relational,5|6,7,5/6,230538,5
2,3,23,539,1,743,1,5,2,2,3,single-choice,spatial-relational,2|3,7,2/3,230539,2
2,3,23,540,1,670,1,5,2,2,3,single-choice,spatial-relational,2|3,7,2/3,230540,2
2,3,23,541,0,618,1,13,6,7,7,single-choice,spatial-relational,6|7,7,6/7,230541,6
2,3,23,542,1,585,1,11,5,5,6,single-choice,spatial-relational,5|6,7,5/6,230542,5
2,3,23,543,0,1252,1,3,1,2,2,single-choice,spatial-relational,1|2,7,1/2,230543,1
2,3,23,544,1,675,1,9,4,4,5,single-choice,spatial-relational,4|5,7,4/5,230544,4
2,3,23,545,1,697,1,13,6,6,7,single-choice,spatial-relational,6|7,7,6/7,230545,6
2,3,23,546,1,739,1,11,5,5,6,single-choice,spatial-relational,5|6,7,5/6,230546,5
2,3,23,547,1,891,1,9,4,4,5,single-choice,spatial-relational,4|5,7,4/5,230547,4
2,3,23,548,1,851,1,7,3,3,4,single-choice,spatial-relational,3|4,7,3/4,230548,3
2,3,23,549,1,604,1,5,2,2,3,single-choice,spatial-relational,2|3,7,2/3,230549,2
2,3,23,550,1,630,1,5,2,2,3,single-choice,spatial-relational,2|3,7,2/3,230550,2
2,3,23,551,0,705,1,3,1,2,2,single-choice,spatial-relational,1|2,7,1/2,230551,1
2,3,23,552,1,689,1,7,3,3,4,single-choice,spatial-relational,3|4,7,3/4,230552,3
2,3,23,553,1,693,1,11,5,5,6,single-choice,spatial-relational,5|6,7,5/6,230553,5
2,3,23,554,1,572,1,7,3,3,4,single-choice,spatial-relational,3|4,7,3/4,230554,3
2,3,23,555,1,884,1,7,3,3,4,single-choice,spatial-relational,3|4,7,3/4,230555,3
2,3,23,556,1,732,1,9,4,4,5,single-choice,spatial-relational,4|5,7,4/5,230556,4
2,3,23,557,1,599,1,13,6,6,7,single-choice,spatial-relational,6|7,7,6/7,230557,6
2,3,23,558,0,615,1,11,5,6,6,single-choice,spatial-relational,5|6,7,5/6,230558,5
2,3,23,559,1,643,1,3,1,1,2,single-choice,spatial-relational,1|2,7,1/2,230559,1
2,3,23,560,0,571,1,9,4,5,5,single-choice,spatial-relational,4|5,7,4/5,230560,4
2,3,23,561,1,1044,1,5,2,2,3,single-choice,spatial-relational,2|3,7,2/3,230561,2
2,3,23,562,1,614,1,13,6,6,7,single-choice,spatial-relational,6|7,7,6/7,230562,6
2,3,23,563,1,617,1,5,2,2,3,single-choice,spatial-relational,2|3,7,2/3,230563,2
2,3,23,564,0,662,1,3,1,2,2,single-choice,spatial-relational,1|2,7,1/2,230564,1
2,3,23,565,1,838,1,11,5,5,6,single-choice,spatial-relational,5|6,7,5/6,230565,5
2,3,23,566,0,640,1,9,4,5,5,single-choice,spatial-relational,4|5,7,4/5,230566,4
2,3,23,567,1,601,1,13,6,6,7,single-choice,spatial-relational,6|7,7,6/7,230567,6
2,3,23,568,0,1346,1,3,1,2,2,single-choice,spatial-relational,1|2,7,1/2,230568,1
2,3,23,569,1,634,1,5,2,2,3,single-choice,spatial-relational,2|3,7,2/3,230569,2
2,3,23,570,0,665,1,9,4,5,5,single-choice,spatial-relational,4|5,7,4/5,230570,4
2,3,23,571,1,616,1,13,6,6,7,single-choice,spatial-relational,6|7,7,6/7,230571,6
2,3,23,572,1,765,1,5,2,2,3,single-choice,spatial-relational,2|3,7,2/3,230572,2
2,3,23,573,1,1010,1,11,5,5,6,single-choice,spatial-relational,5|6,7,5/6,230573,5
2,3,23,574,1,595,1,3,1,1,2,single-choice,spatial-relational,1|2,7,1/2,230574,1
2,3,23,575,1,577,1,7,3,3,4,single-choice,spatial-relational,3|4,7,3/4,230575,3
2,3,23,576,1,576,1,7,3,3,4,single-choice,spatial-relational,3|4,7,3/4,230576,3
2,3,23,577,0,608,1,9,4,5,5,single-choice,spatial-relational,4|5,7,4/5,230577,4
2,3,23,578,1,639,1,13,6,6,7,single-choice,spatial-relational,6|7,7,6/7,230578,6
2,3,23,579,1,711,1,11,5,5,6,single-choice,spatial-relational,5|6,7,5/6,230579,5
2,3,23,580,1,595,1,5,2,2,3,single-choice,spatial-relational,2|3,7,2/3,230580,2
2,3,23,581,0,680,1,9,4,5,5,single-choice,spatial-relational,4|5,7,4/5,230581,4
2,3,23,582,1,539,1,7,3,3,4,single-choice,spatial-relational,3|4,7,3/4,230582,3
2,3,23,583,1,580,1,7,3,3,4,single-choice,spatial-relational,3|4,7,3/4,230583,3
2,3,23,584,1,643,1,5,2,2,3,single-choice,spatial-relational,2|3,7,2/3,230584,2
2,3,23,585,1,745,1,11,5,5,6,single-choice,spatial-relational,5|6,7,5/6,230585,5
2,3,23,586,1,771,1,3,1,1,2,single-choice,spatial-relational,1|2,7,1/2,230586,1
2,3,23,587,0,756,1,3,1,2,2,single-choice,spatial-relational,1|2,7,1/2,230587,1
2,3,23,588,1,557,1,13,6,6,7,single-choice,spatial-relational,6|7,7,6/7,230588,6
2,3,23,589,1,541,1,13,6,6,7,single-choice,spatial-relational,6|7,7,6/7,230589,6
2,3,23,590,0,635,1,3,1,2,2,single-choice,spatial-relational,1|2,7,1/2,230590,1
2,3,23,591,1,630,1,13,6,6,7,single-choice,spatial-relational,6|7,7,6/7,230591,6
2,3,23,592,1,588,1,7,3,3,4,single-choice,spatial-relational,3|4,7,3/4,230592,3
2,3,23,593,1,733,1,5,2,2,3,single-choice,spatial-relational,2|3,7,2/3,230593,2
2,3,23,594,1,1068,1,3,1,1,2,single-choice,spatial-relational,1|2,7,1/2,230594,1
2,3,23,595,0,669,1,9,4,5,5,single-choice,spatial-relational,4|5,7,4/5,230595,4
2,3,23,596,0,571,1,9,4,5,5,single-choice,spatial-relational,4|5,7,4/5,230596,4
2,3,23,597,1,588,1,7,3,3,4,single-choice,spatial-relational,3|4,7,3/4,230597,3
2,3,23,598,1,662,1,5,2,2,3,single-choice,spatial-relational,2|3,7,2/3,230598,2
2,3,23,599,1,671,1,11,5,5,6,single-choice,spatial-relational,5|6,7,5/6,230599,5
2,3,23,600,1,568,1,11,5,5,6,single-choice,spatial-relational,5|6,7,5/6,230600,5
3,3,23,1,1,1280,1,9,4,4,5,single-choice,spatial-relational,4|5,7,4/5,230001,4
3,3,23,2,0,638,1,9,4,5,5,single-choice,spatial-relational,4|5,7,4/5,230002,4
3,3,23,3,1,831,1,13,6,6,7,single-choice,spatial-relational,6|7,7,6/7,230003,6
3,3,23,4,1,545,1,13,6,6,7,single-choice,spatial-relational,6|7,7,6/7,230004,6
3,3,23,5,1,668,1,3,1,1,2,single-choice,spatial-relational,1|2,7,1/2,230005,1
3,3,23,6,1,619,1,11,5,5,6,single-choice,spatial-relational,5|6,7,5/6,230006,5
3,3,23,7,1,613,1,7,3,3,4,single-choice,spatial-relational,3|4,7,3/4,230007,3
3,3,23,8,1,795,1,5,2,2,3,single-choice,spatial-relational,2|3,7,2/3,230008,2
3,3,23,9,1,608,1,3,1,1,2,single-choice,spatial-relational,1|2,7,1/2,230009,1
3,3,23,10,1,560,1,5,2,2,3,single-choice,spatial-relational,2|3,7,2/3,230010,2
3,3,23,11,1,576,1,7,3,3,4,single-choice,spatial-relational,3|4,7,3/4,230011,3
3,3,23,12,0,494,1,11,5,6,6,single-choice,spatial-relational,5|6,7,5/6,230012,5
3,3,23,13,1,577,1,13,6,6,7,single-choice,spatial-relational,6|7,7,6/7,230013,6
3,3,23,14,0,593,1,3,1,2,2,single-choice,spatial-relational,1|2,7,1/2,230014,1
3,3,23,15,1,561,1,7,3,3,4,single-choice,spatial-relational,3|4,7,3/4,230015,3
3,3,23,16,1,537,1,5,2,2,3,single-choice,spatial-relational,2|3,7,2/3,230016,2
3,3,23,17,1,566,1,11,5,5,6,single-choice,spatial-relational,5|6,7,5/6,230017,5
3,3,23,18,1,785,1,13,6,6,7,single-choice,spatial-relational,6|7,7,6/7,230018,6
3,3,23,19,0,552,1,5,2,3,3,single-choice,spatial-relational,2|3,7,2/3,230019,2
3,3,23,20,0,533,1,9,4,5,5,single-choice,spatial-relational,4|5,7,4/5,230020,4
3,3,23,21,1,595,1,11,5,5,6,single-choice,spatial-relational,5|6,7,5/6,230021,5
3,3,23,22,1,675,1,3,1,1,2,single-choice,spatial-relational,1|2,7,1/2,230022,1
3,3,23,23,0,620,1,7,3,4,4,single-choice,spatial-relational,3|4,7,3/4,230023,3
3,3,23,24,1,565,1,9,4,4,5,single-choice,spatial-relational,4|5,7,4/5,230024,4
3,3,23,25,1,604,1,3,1,1,2,single-choice,spatial-relational,1|2,7,1/2,230025,1
3,3,23,26,1,607,1,13,6,6,7,single-choice,spatial-relational,6|7,7,6/7,230026,6
3,3,23,27,1,581,1,7,3,3,4,single-choice,spatial-relational,3|4,7,3/4,230027,3
3,3,23,28,0,611,1,9,4,5,5,single-choice,spatial-relational,4|5,7,4/5,230028,4
3,3,23,29,1,558,1,11,5,5,6,single-choice,spatial-relational,5|6,7,5/6,230029,5
3,3,23,30,1,594,1,13,6,6,7,single-choice,spatial-relational,6|7,7,6/7,230030,6
3,3,23,31,1,802,1,7,3,3,4,single-choice,spatial-relational,3|4,7,3/4,230031,3
3,3,23,32,1,570,1,5,2,2,3,single-choice,spatial-relational,2|3,7,2/3,230032,2
3,3,23,33,1,584,1,3,1,1,2,single-choice,spatial-relational,1|2,7,1/2,230033,1
3,3,23,34,1,616,1,5,2,2,3,single-choice,spatial-relational,2|3,7,2/3,230034,2
3,3,23,35,0,512,1,9,4,5,5,single-choice,spatial-relational,4|5,7,4/5,230035,4
3,3,23,36,1,615,1,11,5,5,6,single-choice,spatial-relational,5|6,7,5/6,230036,5
3,3,23,37,1,576,1,11,5,5,6,single-choice,spatial-relational,5|6,7,5/6,230037,5
3,3,23,38,1,654,1,13,6,6,7,single-choice,spatial-relational,6|7,7,6/7,230038,6
3,3,23,39,0,783,1,5,2,3,3,single-choice,spatial-relational,2|3,7,2/3,230039,2
3,3,23,40,1,482,1,3,1,1,2,single-choice,spatial-relational,1|2,7,1/2,230040,1
3,3,23,41,1,553,1,7,3,3,4,single-choice,spatial-relational,3|4,7,3/4,230041,3
3,3,23,42,1,565,1,13,6,6,7,single-choice,spatial-relational,6|7,7,6/7,230042,6
3,3,23,43,0,663,1,9,4,5,5,single-choice,spatial-relational,4|5,7,4/5,230043,4
3,3,23,44,1,599,1,5,2,2,3,single-choice,spatial-relational,2|3,7,2/3,230044,2
3,3,23,45,0,577,1,11,5,6,6,single-choice,spatial-relational,5|6,7,5/6,230045,5
3,3,23,46,1,916,1,7,3,3,4,single-choice,spatial-relational,3|4,7,3/4,230046,3
3,3,23,47,0,533,1,9,4,5,5,single-choice,spatial-relational,4|5,7,4/5,230047,4
3,3,23,48,0,646,1,3,1,2,2,single-choice,spatial-relational,1|2,7,1/2,230048,1
3,3,23,49,1,672,1,11,5,5,6,single-choice,spatial-relational,5|6,7,5/6,230049,5
3,3,23,50,1,703,1,3,1,1,2,single-choice,spatial-relational,1|2,7,1/2,230050,1
3,3,23,51,1,682,1,3,1,1,2,single-choice,spatial-relational,1|2,7,1/2,230051,1
3,3,23,52,1,595,1,11,5,5,6,single-choice,spatial-relational,5|6,7,5/6,230052,5
3,3,23,53,0,506,1,13,6,7,7,single-choice,spatial-relational,6|7,7,6/7,230053,6
3,3,23,54,1,511,1,13,6,6,7,single-choice,spatial-relational,6|7,7,6/7,230054,6
3,3,23,55,1,645,1,9,4,4,5,single-choice,spatial-relational,4|5,7,4/5,230055,4
3,3,23,56,1,662,1,5,2,2,3,single-choice,spatial-relational,2|3,7,2/3,230056,2
3,3,23,57,1,783,1,7,3,3,4,single-choice,spatial-relational,3|4,7,3/4,230057,3
3,3,23,58,0,557,1,9,4,5,5,single-choice,spatial-relational,4|5,7,4/5,230058,4
3,3,23,59,1,687,1,7,3,3,4,single-choice,spatial-relational,3|4,7,3/4,230059,3
3,3,23,60,1,690,1,5,2,2,3,single-choice,spatial-relational,2|3,7,2/3,230060,2
3,3,23,61,1,618,1,13,6,6,7,single-choice,spatial-relational,6|7,7,6/7,230061,6
3,3,23,62,1,769,1,5,2,2,3,single-choice,spatial-relational,2|3,7,2/3,230062,2
3,3,23,63,1,579,1,11,5,5,6,single-choice,spatial-relational,5|6,7,5/6,230063,5
3,3,23,64,1,697,1,7,3,3,4,single-choice,spatial-relational,3|4,7,3/4,230064,3
3,3,23,65,0,648,1,13,6,7,7,single-choice,spatial-relational,6|7,7,6/7,230065,6
3,3,23,66,1,656,1,9,4,4,5,single-choice,spatial-relational,4|5,7,4/5,230066,4
3,3,23,67,1,701,1,3,1,1,2,single-choice,spatial-relational,1|2,7,1/2,230067,1
3,3,23,68,0,783,1,3,1,2,2,single-choice,spatial-relational,1|2,7,1/2,230068,1
3,3,23,69,1,621,1,5,2,2,3,single-choice,spatial-relational,2|3,7,2/3,230069,2
3,3,23,70,0,525,1,9,4,5,5,single-choice,spatial-relational,4|5,7,4/5,230070,4
3,3,23,71,1,542,1,11,5,5,6,single-choice,spatial-relational,5|6,7,5/6,230071,5
3,3,23,72,1,560,1,7,3,3,4,single-choice,spatial-relational,3|4,7,3/4,230072,3
3,3,23,73,1,674,1,11,5,5,6,single-choice,spatial-relational,5|6,7,5/6,230073,5
3,3,23,74,0,711,1,7,3,4,4,single-choice,spatial-relational,3|4,7,3/4,230074,3
3,3,23,75,1,521,1,9,4,4,5,single-choice,spatial-relational,4|5,7,4/5,230075,4
3,3,23,76,1,600,1,11,5,5,6,single-choice,spatial-relational,5|6,7,5/6,230076,5
3,3,23,77,1,580,1,3,1,1,2,single-choice,spatial-relational,1|2,7,1/2,230077,1
3,3,23,78,1,502,1,13,6,6,7,single-choice,spatial-relational,6|7,7,6/7,230078,6
3,3,23,79,0,599,1,3,1,2,2,single-choice,spatial-relational,1|2,7,1/2,230079,1
3,3,23,80,1,594,1,13,6,6,7,single-choice,spatial-relational,6|7,7,6/7,230080,6
3,3,23,81,0,553,1,9,4,5,5,single-choice,spatial-relational,4|5,7,4/5,230081,4
3,3,23,82,1,44,1,5,2,2,3,single-choice,spatial-relational,2|3,7,2/3,230082,2
3,3,23,83,1,705,1,5,2,2,3,single-choice,spatial-relational,2|3,7,2/3,230083,2
3,3,23,84,1,815,1,7,3,3,4,single-choice,spatial-relational,3|4,7,3/4,230084,3
3,3,23,85,1,612,1,9,4,4,5,single-choice,spatial-relational,4|5,7,4/5,230085,4
3,3,23,86,1,745,1,5,2,2,3,single-choice,spatial-relational,2|3,7,2/3,230086,2
3,3,23,87,0,673,1,7,3,4,4,single-choice,spatial-relational,3|4,7,3/4,230087,3
3,3,23,88,0,517,1,9,4,5,5,single-choice,spatial-relational,4|5,7,4/5,230088,4
3,3,23,89,1,629,1,3,1,1,2,single-choice,spatial-relational,1|2,7,1/2,230089,1
3,3,23,90,1,533,1,13,6,6,7,single-choice,spatial-relational,6|7,7,6/7,230090,6
3,3,23,91,0,627,1,3,1,2,2,single-choice,spatial-relational,1|2,7,1/2,230091,1
3,3,23,92,0,44,1,13,6,7,7,single-choice,spatial-relational,6|7,7,6/7,230092,6
3,3,23,93,0,713,1,5,2,3,3,single-choice,spatial-relational,2|3,7,2/3,230093,2
3,3,23,94,1,584,1,11,5,5,6,single-choice,spatial-relational,5|6,7,5/6,230094,5
3,3,23,95,1,612,1,11,5,5,6,single-choice,spatial-relational,5|6,7,5/6,230095,5
3,3,23,96,1,576,1,7,3,3,4,single-choice,spatial-relational,3|4,7,3/4,230096,3
3,3,23,97,0,482,1,9,4,5,5,single-choice,spatial-relational,4|5,7,4/5,230097,4
3,3,23,98,1,487,1,7,3,3,4,single-choice,spatial-relational,3|4,7,3/4,230098,3
3,3,23,99,1,563,1,11,5,5,6,single-choice,spatial-relational,5|6,7,5/6,230099,5
3,3,23,100,1,625,1,5,2,2,3,single-choice,spatial-relational,2|3,7,2/3,230100,2
3,3,23,101,1,654,1,9,4,4,5,single-choice,spatial-relational,4|5,7,4/5,230101,4
3,3,23,102,1,767,1,13,6,6,7,single-choice,spatial-relational,6|7,7,6/7,230102,6
3,3,23,103,1,795,1,11,5,5,6,single-choice,spatial-relational,5|6,7,5/6,230103,5
3,3,23,104,1,592,1,13,6,6,7,single-choice,spatial-relational,6|7,7,6/7,230104,6
3,3,23,105,0,613,1,3,1,2,2,single-choice,spatial-relational,1|2,7,1/2,230105,1
3,3,23,106,1,562,1,7,3,3,4,single-choice,spatial-relational,3|4,7,3/4,230106,3
3,3,23,107,1,718,1,5,2,2,3,single-choice,spatial-relational,2|3,7,2/3,230107,2
3,3,23,108,1,630,1,3,1,1,2,single-choice,spatial-relational,1|2,7,1/2,230108,1
3,3,23,109,1,736,1,7,3,3,4,single-choice,spatial-relational,3|4,7,3/4,230109,3
3,3,23,110,1,644,1,5,2,2,3,single-choice,spatial-relational,2|3,7,2/3,230110,2
3,3,23,111,1,619,1,9,4,4,5,single-choice,spatial-relational,4|5,7,4/5,230111,4
3,3,23,112,1,642,1,7,3,3,4,single-choice,spatial-relational,3|4,7,3/4,230112,3
3,3,23,113,0,1329,1,11,5,6,6,single-choice,spatial-relational,5|6,7,5/6,230113,5
3,3,23,114,0,1266,1,11,5,6,6,single-choice,spatial-relational,5|6,7,5/6,230114,5
3,3,23,115,0,478,1,9,4,5,5,single-choice,spatial-relational,4|5,7,4/5,230115,4
3,3,23,116,0,635,1,3,1,2,2,single-choice,spatial-relational,1|2,7,1/2,230116,1
3,3,23,117,1,499,1,5,2,2,3,single-choice,spatial-relational,2|3,7,2/3,230117,2
3,3,23,118,0,513,1,13,6,7,7,single-choice,spatial-relational,6|7,7,6/7,230118,6
3,3,23,119,1,36,1,13,6,6,7,single-choice,spatial-relational,6|7,7,6/7,230119,6
3,3,23,120,0,620,1,3,1,2,2,single-choice,spatial-relational,1|2,7,1/2,230120,1
3,3,23,121,1,689,1,7,3,3,4,single-choice,spatial-relational,3|4,7,3/4,230121,3
3,3,23,122,1,592,1,3,1,1,2,single-choice,spatial-relational,1|2,7,1/2,230122,1
3,3,23,123,1,601,1,7,3,3,4,single-choice,spatial-relational,3|4,7,3/4,230123,3
3,3,23,124,1,531,1,11,5,5,6,single-choice,spatial-relational,5|6,7,5/6,230124,5
3,3,23,125,0,603,1,13,6,7,7,single-choice,spatial-relational,6|7,7,6/7,230125,6
3,3,23,126,0,149,1,5,2,3,3,single-choice,spatial-relational,2|3,7,2/3,230126,2
3,3,23,127,1,624,1,11,5,5,6,single-choice,spatial-relational,5|6,7,5/6,230127,5
3,3,23,128,1,678,1,9,4,4,5,single-choice,spatial-relational,4|5,7,4/5,230128,4
3,3,23,129,1,777,1,5,2,2,3,single-choice,spatial-relational,2|3,7,2/3,230129,2
3,3,23,130,1,611,1,13,6,6,7,single-choice,spatial-relational,6|7,7,6/7,230130,6
3,3,23,131,0,693,1,3,1,2,2,single-choice,spatial-relational,1|2,7,1/2,230131,1
3,3,23,132,0,52,1,9,4,5,5,single-choice,spatial-relational,4|5,7,4/5,230132,4
3,3,23,133,1,844,1,11,5,5,6,single-choice,spatial-relational,5|6,7,5/6,230133,5
3,3,23,134,1,690,1,7,3,3,4,single-choice,spatial-relational,3|4,7,3/4,230134,3
3,3,23,135,1,584,1,11,5,5,6,single-choice,spatial-relational,5|6,7,5/6,230135,5
3,3,23,136,1,599,1,3,1,1,2,single-choice,spatial-relational,1|2,7,1/2,230136,1
3,3,23,137,1,625,1,13,6,6,7,single-choice,spatial-relational,6|7,7,6/7,230137,6
3,3,23,138,1,563,1,13,6,6,7,single-choice,spatial-relational,6|7,7,6/7,230138,6
3,3,23,139,1,576,1,7,3,3,4,single-choice,spatial-relational,3|4,7,3/4,230139,3
3,3,23,140,1,679,1,5,2,2,3,single-choice,spatial-relational,2|3,7,2/3,230140,2
3,3,23,141,0,525,1,9,4,5,5,single-choice,spatial-relational,4|5,7,4/5,230141,4
3,3,23,142,0,629,1,3,1,2,2,single-choice,spatial-relational,1|2,7,1/2,230142,1
3,3,23,143,1,731,1,5,2,2,3,single-choice,spatial-relational,2|3,7,2/3,230143,2
3,3,23,144,1,654,1,9,4,4,5,single-choice,spatial-relational,4|5,7,4/5,230144,4
3,3,23,145,1,628,1,11,5,5,6,single-choice,spatial-relational,5|6,7,5/6,230145,5
3,3,23,146,0,935,1,7,3,4,4,single-choice,spatial-relational,3|4,7,3/4,230146,3
3,3,23,147,1,600,1,5,2,2,3,single-choice,spatial-relational,2|3,7,2/3,230147,2
3,3,23,148,1,642,1,9,4,4,5,single-choice,spatial-relational,4|5,7,4/5,230148,4
3,3,23,149,0,595,1,9,4,5,5,single-choice,spatial-relational,4|5,7,4/5,230149,4
3,3,23,150,0,664,1,3,1,2,2,single-choice,spatial-relational,1|2,7,1/2,230150,1
3,3,23,151,1,774,1,7,3,3,4,single-choice,spatial-relational,3|4,7,3/4,230151,3
3,3,23,152,0,610,1,3,1,2,2,single-choice,spatial-relational,1|2,7,1/2,230152,1
3,3,23,153,1,658,1,5,2,2,3,single-choice,spatial-relational,2|3,7,2/3,230153,2
3,3,23,154,1,504,1,13,6,6,7,single-choice,spatial-relational,6|7,7,6/7,230154,6
3,3,23,155,1,604,1,13,6,6,7,single-choice,spatial-relational,6|7,7,6/7,230155,6
3,3,23,156,1,834,1,11,5,5,6,single-choice,spatial-relational,5|6,7,5/6,230156,5
3,3,23,157,1,603,1,7,3,3,4,single-choice,spatial-relational,3|4,7,3/4,230157,3
3,3,23,158,1,693,1,5,2,2,3,single-choice,spatial-relational,2|3,7,2/3,230158,2
3,3,23,159,1,911,1,9,4,4,5,single-choice,spatial-relational,4|5,7,4/5,230159,4
3,3,23,160,0,753,1,3,1,2,2,single-choice,spatial-relational,1|2,7,1/2,230160,1
3,3,23,161,1,1224,1,9,4,4,5,single-choice,spatial-relational,4|5,7,4/5,230161,4
3,3,23,162,1,681,1,13,6,6,7,single-choice,spatial-relational,6|7,7,6/7,230162,6
3,3,23,163,1,717,1,11,5,5,6,single-choice,spatial-relational,5|6,7,5/6,230163,5
3,3,23,164,1,715,1,11,5,5,6,single-choice,spatial-relational,5|6,7,5/6,230164,5
3,3,23,165,0,593,1,3,1,2,2,single-choice,spatial-relational,1|2,7,1/2,230165,1
3,3,23,166,1,624,1,5,2,2,3,single-choice,spatial-relational,2|3,7,2/3,230166,2
3,3,23,167,1,655,1,7,3,3,4,single-choice,spatial-relational,3|4,7,3/4,230167,3
3,3,23,168,1,602,1,13,6,6,7,single-choice,spatial-relational,6|7,7,6/7,230168,6
3,3,23,169,1,673,1,9,4,4,5,single-choice,spatial-relational,4|5,7,4/5,230169,4
3,3,23,170,0,563,1,3,1,2,2,single-choice,spatial-relational,1|2,7,1/2,230170,1
3,3,23,171,1,48,1,5,2,2,3,single-choice,spatial-relational,2|3,7,2/3,230171,2
3,3,23,172,1,603,1,13,6,6,7,single-choice,spatial-relational,6|7,7,6/7,230172,6
3,3,23,173,1,654,1,13,6,6,7,single-choice,spatial-relational,6|7,7,6/7,230173,6
3,3,23,174,1,648,1,5,2,2,3,single-choice,spatial-relational,2|3,7,2/3,230174,2
3,3,23,175,1,634,1,11,5,5,6,single-choice,spatial-relational,5|6,7,5/6,230175,5
3,3,23,176,0,623,1,9,4,5,5,single-choice,spatial-relational,4|5,7,4/5,230176,4
3,3,23,177,1,726,1,11,5,5,6,single-choice,spatial-relational,5|6,7,5/6,230177,5
3,3,23,178,1,615,1,3,1,1,2,single-choice,spatial-relational,1|2,7,1/2,230178,1
3,3,23,179,1,612,1,7,3,3,4,single-choice,spatial-relational,3|4,7,3/4,230179,3
3,3,23,180,0,643,1,7,3,4,4,single-choice,spatial-relational,3|4,7,3/4,230180,3
3,3,23,181,1,588,1,5,2,2,3,single-choice,spatial-relational,2|3,7,2/3,230181,2
3,3,23,182,0,634,1,3,1,2,2,single-choice,spatial-relational,1|2,7,1/2,230182,1
3,3,23,183,1,654,1,13,6,6,7,single-choice,spatial-relational,6|7,7,6/7,230183,6
3,3,23,184,1,664,1,7,3,3,4,single-choice,spatial-relational,3|4,7,3/4,230184,3
3,3,23,185,1,685,1,11,5,5,6,single-choice,spatial-relational,5|6,7,5/6,230185,5
3,3,23,186,0,585,1,3,1,2,2,single-choice,spatial-relational,1|2,7,1/2,230186,1
3,3,23,187,1,617,1,7,3,3,4,single-choice,spatial-relational,3|4,7,3/4,230187,3
3,3,23,188,0,545,1,9,4,5,5,single-choice,spatial-relational,4|5,7,4/5,230188,4
3,3,23,189,1,663,1,9,4,4,5,single-choice,spatial-relational,4|5,7,4/5,230189,4
3,3,23,190,1,588,1,13,6,6,7,single-choice,spatial-relational,6|7,7,6/7,230190,6
3,3,23,191,1,758,1,11,5,5,6,single-choice,spatial-relational,5|6,7,5/6,230191,5
3,3,23,192,0,533,1,5,2,3,3,single-choice,spatial-relational,2|3,7,2/3,230192,2
3,3,23,193,1,517,1,7,3,3,4,single-choice,spatial-relational,3|4,7,3/4,230193,3
3,3,23,194,1,620,1,11,5,5,6,single-choice,spatial-relational,5|6,7,5/6,230194,5
3,3,23,195,0,861,1,9,4,5,5,single-choice,spatial-relational,4|5,7,4/5,230195,4
3,3,23,196,1,654,1,11,5,5,6,single-choice,spatial-relational,5|6,7,5/6,230196,5
3,3,23,197,1,744,1,7,3,3,4,single-choice,spatial-relational,3|4,7,3/4,230197,3
3,3,23,198,1,669,1,5,2,2,3,single-choice,spatial-relational,2|3,7,2/3,230198,2
3,3,23,199,1,608,1,13,6,6,7,single-choice,spatial-relational,6|7,7,6/7,230199,6
3,3,23,200,0,678,1,9,4,5,5,single-choice,spatial-relational,4|5,7,4/5,230200,4
3,3,23,201,0,670,1,3,1,2,2,single-choice,spatial-relational,1|2,7,1/2,230201,1
3,3,23,202,1,48,1,13,6,6,7,single-choice,spatial-relational,6|7,7,6/7,230202,6
3,3,23,203,1,624,1,5,2,2,3,single-choice,spatial-relational,2|3,7,2/3,230203,2
3,3,23,204,0,709,1,3,1,2,2,single-choice,spatial-relational,1|2,7,1/2,230204,1
3,3,23,205,0,52,1,7,3,4,4,single-choice,spatial-relational,3|4,7,3/4,230205,3
3,3,23,206,0,468,1,3,1,2,2,single-choice,spatial-relational,1|2,7,1/2,230206,1
3,3,23,207,1,658,1,13,6,6,7,single-choice,spatial-relational,6|7,7,6/7,230207,6
3,3,23,208,1,559,1,13,6,6,7,single-choice,spatial-relational,6|7,7,6/7,230208,6
3,3,23,209,1,626,1,11,5,5,6,single-choice,spatial-relational,5|6,7,5/6,230209,5
3,3,23,210,0,748,1,3,1,2,2,single-choice,spatial-relational,1|2,7,1/2,230210,1
3,3,23,211,1,665,1,11,5,5,6,single-choice,spatial-relational,5|6,7,5/6,230211,5
3,3,23,212,1,591,1,5,2,2,3,single-choice,spatial-relational,2|3,7,2/3,230212,2
3,3,23,213,1,765,1,9,4,4,5,single-choice,spatial-relational,4|5,7,4/5,230213,4
3,3,23,214,1,904,1,7,3,3,4,single-choice,spatial-relational,3|4,7,3/4,230214,3
3,3,23,215,0,602,1,5,2,3,3,single-choice,spatial-relational,2|3,7,2/3,230215,2
3,3,23,216,0,549,1,9,4,5,5,single-choice,spatial-relational,4|5,7,4/5,230216,4
3,3,23,217,1,194,1,13,6,6,7,single-choice,spatial-relational,6|7,7,6/7,230217,6
3,3,23,218,1,662,1,5,2,2,3,single-choice,spatial-relational,2|3,7,2/3,230218,2
3,3,23,219,1,666,1,7,3,3,4,single-choice,spatial-relational,3|4,7,3/4,230219,3
3,3,23,220,1,608,1,13,6,6,7,single-choice,spatial-relational,6|7,7,6/7,230220,6
3,3,23,221,1,650,1,11,5,5,6,single-choice,spatial-relational,5|6,7,5/6,230221,5
3,3,23,222,1,548,1,11,5,5,6,single-choice,spatial-relational,5|6,7,5/6,230222,5
3,3,23,223,1,568,1,3,1,1,2,single-choice,spatial-relational,1|2,7,1/2,230223,1
3,3,23,224,0,846,1,9,4,5,5,single-choice,spatial-relational,4|5,7,4/5,230224,4
3,3,23,225,1,614,1,3,1,1,2,single-choice,spatial-relational,1|2,7,1/2,230225,1
3,3,23,226,1,562,1,5,2,2,3,single-choice,spatial-relational,2|3,7,2/3,230226,2
3,3,23,227,1,720,1,7,3,3,4,single-choice,spatial-relational,3|4,7,3/4,230227,3
3,3,23,228,1,766,1,9,4,4,5,single-choice,spatial-relational,4|5,7,4/5,230228,4
3,3,23,229,1,734,1,11,5,5,6,single-choice,spatial-relational,5|6,7,5/6,230229,5
3,3,23,230,0,863,1,9,4,5,5,single-choice,spatial-relational,4|5,7,4/5,230230,4
3,3,23,231,1,674,1,11,5,5,6,single-choice,spatial-relational,5|6,7,5/6,230231,5
3,3,23,232,1,587,1,5,2,2,3,single-choice,spatial-relational,2|3,7,2/3,230232,2
3,3,23,233,1,627,1,3,1,1,2,single-choice,spatial-relational,1|2,7,1/2,230233,1
3,3,23,234,1,533,1,13,6,6,7,single-choice,spatial-relational,6|7,7,6/7,230234,6
3,3,23,235,1,626,1,7,3,3,4,single-choice,spatial-relational,3|4,7,3/4,230235,3
3,3,23,236,0,573,1,13,6,7,7,single-choice,spatial-relational,6|7,7,6/7,230236,6
3,3,23,237,0,660,1,3,1,2,2,single-choice,spatial-relational,1|2,7,1/2,230237,1
3,3,23,238,1,233,1,9,4,4,5,single-choice,spatial-relational,4|5,7,4/5,230238,4
3,3,23,239,1,594,1,5,2,2,3,single-choice,spatial-relational,2|3,7,2/3,230239,2
3,3,23,240,1,803,1,7,3,3,4,single-choice,spatial-relational,3|4,7,3/4,230240,3
3,3,23,241,1,631,1,7,3,3,4,single-choice,spatial-relational,3|4,7,3/4,230241,3
3,3,23,242,0,556,1,9,4,5,5,single-choice,spatial-relational,4|5,7,4/5,230242,4
3,3,23,243,1,613,1,5,2,2,3,single-choice,spatial-relational,2|3,7,2/3,230243,2
3,3,23,244,1,620,1,9,4,4,5,single-choice,spatial-relational,4|5,7,4/5,230244,4
3,3,23,245,1,681,1,5,2,2,3,single-choice,spatial-relational,2|3,7,2/3,230245,2
3,3,23,246,1,602,1,13,6,6,7,single-choice,spatial-relational,6|7,7,6/7,230246,6
3,3,23,247,1,565,1,3,1,1,2,single-choice,spatial-relational,1|2,7,1/2,230247,1
3,3,23,248,1,725,1,11,5,5,6,single-choice,spatial-relational,5|6,7,5/6,230248,5
3,3,23,249,0,565,1,3,1,2,2,single-choice,spatial-relational,1|2,7,1/2,230249,1
3,3,23,250,1,552,1,7,3,3,4,single-choice,spatial-relational,3|4,7,3/4,230250,3
3,3,23,251,1,603,1,11,5,5,6,single-choice,spatial-relational,5|6,7,5/6,230251,5
3,3,23,252,1,642,1,13,6,6,7,single-choice,spatial-relational,6|7,7,6/7,230252,6
3,3,23,253,1,635,1,7,3,3,4,single-choice,spatial-relational,3|4,7,3/4,230253,3
3,3,23,254,1,596,1,9,4,4,5,single-choice,spatial-relational,4|5,7,4/5,230254,4
3,3,23,255,0,752,1,11,5,6,6,single-choice,spatial-relational,5|6,7,5/6,230255,5
3,3,23,256,1,684,1,3,1,1,2,single-choice,spatial-relational,1|2,7,1/2,230256,1
3,3,23,257,1,869,1,9,4,4,5,single-choice,spatial-relational,4|5,7,4/5,230257,4
3,3,23,258,1,611,1,13,6,6,7,single-choice,spatial-relational,6|7,7,6/7,230258,6
3,3,23,259,1,650,1,3,1,1,2,single-choice,spatial-relational,1|2,7,1/2,230259,1
3,3,23,260,1,517,1,13,6,6,7,single-choice,spatial-relational,6|7,7,6/7,230260,6
3,3,23,261,1,877,1,7,3,3,4,single-choice,spatial-relational,3|4,7,3/4,230261,3
3,3,23,262,1,532,1,5,2,2,3,single-choice,spatial-relational,2|3,7,2/3,230262,2
3,3,23,263,1,644,1,11,5,5,6,single-choice,spatial-relational,5|6,7,5/6,230263,5
3,3,23,264,0,662,1,5,2,3,3,single-choice,spatial-relational,2|3,7,2/3,230264,2
3,3,23,265,1,587,1,3,1,1,2,single-choice,spatial-relational,1|2,7,1/2,230265,1
3,3,23,266,1,615,1,5,2,2,3,single-choice,spatial-relational,2|3,7,2/3,230266,2
3,3,23,267,1,655,1,11,5,5,6,single-choice,spatial-relational,5|6,7,5/6,230267,5
3,3,23,268,1,557,1,13,6,6,7,single-choice,spatial-relational,6|7,7,6/7,230268,6
3,3,23,269,1,588,1,7,3,3,4,single-choice,spatial-relational,3|4,7,3/4,230269,3
3,3,23,270,1,594,1,13,6,6,7,single-choice,spatial-relational,6|7,7,6/7,230270,6
3,3,23,271,0,559,1,9,4,5,5,single-choice,spatial-relational,4|5,7,4/5,230271,4
3,3,23,272,0,584,1,9,4,5,5,single-choice,spatial-relational,4|5,7,4/5,230272,4
3,3,23,273,0,732,1,7,3,4,4,single-choice,spatial-relational,3|4,7,3/4,230273,3
3,3,23,274,1,44,1,5,2,2,3,single-choice,spatial-relational,2|3,7,2/3,230274,2
3,3,23,275,0,622,1,3,1,2,2,single-choice,spatial-relational,1|2,7,1/2,230275,1
3,3,23,276,1,630,1,11,5,5,6,single-choice,spatial-relational,5|6,7,5/6,230276,5
3,3,23,277,0,545,1,5,2,3,3,single-choice,spatial-relational,2|3,7,2/3,230277,2
3,3,23,278,1,555,1,11,5,5,6,single-choice,spatial-relational,5|6,7,5/6,230278,5
3,3,23,279,0,536,1,3,1,2,2,single-choice,spatial-relational,1|2,7,1/2,230279,1
3,3,23,280,1,609,1,7,3,3,4,single-choice,spatial-relational,3|4,7,3/4,230280,3
3,3,23,281,1,655,1,13,6,6,7,single-choice,spatial-relational,6|7,7,6/7,230281,6
3,3,23,282,1,505,1,13,6,6,7,single-choice,spatial-relational,6|7,7,6/7,230282,6
3,3,23,283,1,565,1,3,1,1,2,single-choice,spatial-relational,1|2,7,1/2,230283,1
3,3,23,284,1,609,1,7,3,3,4,single-choice,spatial-relational,3|4,7,3/4,230284,3
3,3,23,285,0,763,1,5,2,3,3,single-choice,spatial-relational,2|3,7,2/3,230285,2
3,3,23,286,1,730,1,9,4,4,5,single-choice,spatial-relational,4|5,7,4/5,230286,4
3,3,23,287,1,1316,1,11,5,5,6,single-choice,spatial-relational,5|6,7,5/6,230287,5
3,3,23,288,0,576,1,9,4,5,5,single-choice,spatial-relational,4|5,7,4/5,230288,4
3,3,23,289,1,700,1,11,5,5,6,single-choice,spatial-relational,5|6,7,5/6,230289,5
3,3,23,290,1,690,1,5,2,2,3,single-choice,spatial-relational,2|3,7,2/3,230290,2
3,3,23,291,1,675,1,9,4,4,5,single-choice,spatial-relational,4|5,7,4/5,230291,4
3,3,23,292,0,750,1,9,4,5,5,single-choice,spatial-relational,4|5,7,4/5,230292,4
3,3,23,293,0,48,1,11,5,6,6,single-choice,spatial-relational,5|6,7,5/6,230293,5
3,3,23,294,1,516,1,7,3,3,4,single-choice,spatial-relational,3|4,7,3/4,230294,3
3,3,23,295,0,583,1,3,1,2,2,single-choice,spatial-relational,1|2,7,1/2,230295,1
3,3,23,296,0,44,1,7,3,4,4,single-choice,spatial-relational,3|4,7,3/4,230296,3
3,3,23,297,1,596,1,5,2,2,3,single-choice,spatial-relational,2|3,7,2/3,230297,2
3,3,23,298,1,537,1,13,6,6,7,single-choice,spatial-relational,6|7,7,6/7,230298,6
3,3,23,299,1,564,1,3,1,1,2,single-choice,spatial-relational,1|2,7,1/2,230299,1
3,3,23,300,1,681,1,13,6,6,7,single-choice,spatial-relational,6|7,7,6/7,230300,6
3,3,23,301,1,562,1,5,2,2,3,single-choice,spatial-relational,2|3,7,2/3,230301,2
3,3,23,302,0,595,1,9,4,5,5,single-choice,spatial-relational,4|5,7,4/5,230302,4
3,3,23,303,0,66,1,13,6,7,7,single-choice,spatial-relational,6|7,7,6/7,230303,6
3,3,23,304,1,705,1,11,5,5,6,single-choice,spatial-relational,5|6,7,5/6,230304,5
3,3,23,305,1,660,1,11,5,5,6,single-choice,spatial-relational,5|6,7,5/6,230305,5
3,3,23,306,1,642,1,7,3,3,4,single-choice,spatial-relational,3|4,7,3/4,230306,3
3,3,23,307,1,1133,1,5,2,2,3,single-choice,spatial-relational,2|3,7,2/3,230307,2
3,3,23,308,0,707,1,3,1,2,2,single-choice,spatial-relational,1|2,7,1/2,230308,1
3,3,23,309,1,635,1,3,1,1,2,single-choice,spatial-relational,1|2,7,1/2,230309,1
3,3,23,310,1,576,1,9,4,4,5,single-choice,spatial-relational,4|5,7,4/5,230310,4
3,3,23,311,1,614,1,13,6,6,7,single-choice,spatial-relational,6|7,7,6/7,230311,6
3,3,23,312,1,572,1,7,3,3,4,single-choice,spatial-relational,3|4,7,3/4,230312,3
3,3,23,313,0,632,1,3,1,2,2,single-choice,spatial-relational,1|2,7,1/2,230313,1
3,3,23,314,0,52,1,3,1,2,2,single-choice,spatial-relational,1|2,7,1/2,230314,1
3,3,23,315,1,637,1,13,6,6,7,single-choice,spatial-relational,6|7,7,6/7,230315,6
3,3,23,316,1,630,1,5,2,2,3,single-choice,spatial-relational,2|3,7,2/3,230316,2
3,3,23,317,1,701,1,7,3,3,4,single-choice,spatial-relational,3|4,7,3/4,230317,3
3,3,23,318,1,695,1,11,5,5,6,single-choice,spatial-relational,5|6,7,5/6,230318,5
3,3,23,319,1,568,1,5,2,2,3,single-choice,spatial-relational,2|3,7,2/3,230319,2
3,3,23,320,0,646,1,9,4,5,5,single-choice,spatial-relational,4|5,7,4/5,230320,4
3,3,23,321,1,619,1,9,4,4,5,single-choice,spatial-relational,4|5,7,4/5,230321,4
3,3,23,322,0,709,1,7,3,4,4,single-choice,spatial-relational,3|4,7,3/4,230322,3
3,3,23,323,1,655,1,11,5,5,6,single-choice,spatial-relational,5|6,7,5/6,230323,5
3,3,23,324,1,607,1,13,6,6,7,single-choice,spatial-relational,6|7,7,6/7,230324,6
3,3,23,325,1,670,1,5,2,2,3,single-choice,spatial-relational,2|3,7,2/3,230325,2
3,3,23,326,1,713,1,7,3,3,4,single-choice,spatial-relational,3|4,7,3/4,230326,3
3,3,23,327,0,705,1,3,1,2,2,single-choice,spatial-relational,1|2,7,1/2,230327,1
3,3,23,328,0,597,1,3,1,2,2,single-choice,spatial-relational,1|2,7,1/2,230328,1
3,3,23,329,1,643,1,7,3,3,4,single-choice,spatial-relational,3|4,7,3/4,230329,3
3,3,23,330,1,607,1,11,5,5,6,single-choice,spatial-relational,5|6,7,5/6,230330,5
3,3,23,331,1,615,1,13,6,6,7,single-choice,spatial-relational,6|7,7,6/7,230331,6
3,3,23,332,1,639,1,11,5,5,6,single-choice,spatial-relational,5|6,7,5/6,230332,5
3,3,23,333,1,710,1,13,6,6,7,single-choice,spatial-relational,6|7,7,6/7,230333,6
3,3,23,334,1,690,1,9,4,4,5,single-choice,spatial-relational,4|5,7,4/5,230334,4
3,3,23,335,1,829,1,9,4,4,5,single-choice,spatial-relational,4|5,7,4/5,230335,4
3,3,23,336,1,696,1,5,2,2,3,single-choice,spatial-relational,2|3,7,2/3,230336,2
3,3,23,337,1,615,1,3,1,1,2,single-choice,spatial-relational,1|2,7,1/2,230337,1
3,3,23,338,1,724,1,7,3,3,4,single-choice,spatial-relational,3|4,7,3/4,230338,3
3,3,23,339,0,642,1,9,4,5,5,single-choice,spatial-relational,4|5,7,4/5,230339,4
3,3,23,340,1,1015,1,11,5,5,6,single-choice,spatial-relational,5|6,7,5/6,230340,5
3,3,23,341,0,620,1,7,3,4,4,single-choice,spatial-relational,3|4,7,3/4,230341,3
3,3,23,342,1,501,1,3,1,1,2,single-choice,spatial-relational,1|2,7,1/2,230342,1
3,3,23,343,1,526,1,13,6,6,7,single-choice,spatial-relational,6|7,7,6/7,230343,6
3,3,23,344,1,543,1,5,2,2,3,single-choice,spatial-relational,2|3,7,2/3,230344,2
3,3,23,345,1,623,1,13,6,6,7,single-choice,spatial-relational,6|7,7,6/7,230345,6
3,3,23,346,0,1024,1,11,5,6,6,single-choice,spatial-relational,5|6,7,5/6,230346,5
3,3,23,347,0,685,1,5,2,3,3,single-choice,spatial-relational,2|3,7,2/3,230347,2
3,3,23,348,1,782,1,9,4,4,5,single-choice,spatial-relational,4|5,7,4/5,230348,4
3,3,23,349,1,670,1,11,5,5,6,single-choice,spatial-relational,5|6,7,5/6,230349,5
3,3,23,350,1,721,1,7,3,3,4,single-choice,spatial-relational,3|4,7,3/4,230350,3
3,3,23,351,0,541,1,9,4,5,5,single-choice,spatial-relational,4|5,7,4/5,230351,4
3,3,23,352,1,635,1,11,5,5,6,single-choice,spatial-relational,5|6,7,5/6,230352,5
3,3,23,353,1,805,1,13,6,6,7,single-choice,spatial-relational,6|7,7,6/7,230353,6
3,3,23,354,1,641,1,5,2,2,3,single-choice,spatial-relational,2|3,7,2/3,230354,2
3,3,23,355,1,631,1,5,2,2,3,single-choice,spatial-relational,2|3,7,2/3,230355,2
3,3,23,356,1,596,1,13,6,6,7,single-choice,spatial-relational,6|7,7,6/7,230356,6
3,3,23,357,0,762,1,7,3,4,4,single-choice,spatial-relational,3|4,7,3/4,230357,3
3,3,23,358,1,619,1,3,1,1,2,single-choice,spatial-relational,1|2,7,1/2,230358,1
3,3,23,359,0,662,1,3,1,2,2,single-choice,spatial-relational,1|2,7,1/2,230359,1
3,3,23,360,1,72,1,9,4,4,5,single-choice,spatial-relational,4|5,7,4/5,230360,4
3,3,23,361,0,686,1,3,1,2,2,single-choice,spatial-relational,1|2,7,1/2,230361,1
3,3,23,362,1,53,1,3,1,1,2,single-choice,spatial-relational,1|2,7,1/2,230362,1
3,3,23,363,1,518,1,13,6,6,7,single-choice,spatial-relational,6|7,7,6/7,230363,6
3,3,23,364,0,603,1,11,5,6,6,single-choice,spatial-relational,5|6,7,5/6,230364,5
3,3,23,365,0,537,1,9,4,5,5,single-choice,spatial-relational,4|5,7,4/5,230365,4
3,3,23,366,1,598,1,9,4,4,5,single-choice,spatial-relational,4|5,7,4/5,230366,4
3,3,23,367,1,603,1,7,3,3,4,single-choice,spatial-relational,3|4,7,3/4,230367,3
3,3,23,368,1,756,1,7,3,3,4,single-choice,spatial-relational,3|4,7,3/4,230368,3
3,3,23,369,1,591,1,5,2,2,3,single-choice,spatial-relational,2|3,7,2/3,230369,2
3,3,23,370,0,763,1,11,5,6,6,single-choice,spatial-relational,5|6,7,5/6,230370,5
3,3,23,371,1,647,1,13,6,6,7,single-choice,spatial-relational,6|7,7,6/7,230371,6
3,3,23,372,0,746,1,5,2,3,3,single-choice,spatial-relational,2|3,7,2/3,230372,2
3,3,23,373,1,48,1,5,2,2,3,single-choice,spatial-relational,2|3,7,2/3,230373,2
3,3,23,374,1,615,1,5,2,2,3,single-choice,spatial-relational,2|3,7,2/3,230374,2
3,3,23,375,1,596,1,3,1,1,2,single-choice,spatial-relational,1|2,7,1/2,230375,1
3,3,23,376,0,672,1,7,3,4,4,single-choice,spatial-relational,3|4,7,3/4,230376,3
3,3,23,377,1,622,1,11,5,5,6,single-choice,spatial-relational,5|6,7,5/6,230377,5
3,3,23,378,0,614,1,9,4,5,5,single-choice,spatial-relational,4|5,7,4/5,230378,4
3,3,23,379,1,744,1,11,5,5,6,single-choice,spatial-relational,5|6,7,5/6,230379,5
3,3,23,380,1,634,1,7,3,3,4,single-choice,spatial-relational,3|4,7,3/4,230380,3
3,3,23,381,1,630,1,13,6,6,7,single-choice,spatial-relational,6|7,7,6/7,230381,6
3,3,23,382,1,640,1,13,6,6,7,single-choice,spatial-relational,6|7,7,6/7,230382,6
3,3,23,383,1,771,1,3,1,1,2,single-choice,spatial-relational,1|2,7,1/2,230383,1
3,3,23,384,0,556,1,9,4,5,5,single-choice,spatial-relational,4|5,7,4/5,230384,4
3,3,23,385,1,68,1,9,4,4,5,single-choice,spatial-relational,4|5,7,4/5,230385,4
3,3,23,386,0,726,1,3,1,2,2,single-choice,spatial-relational,1|2,7,1/2,230386,1
3,3,23,387,1,60,1,11,5,5,6,single-choice,spatial-relational,5|6,7,5/6,230387,5
3,3,23,388,0,581,1,3,1,2,2,single-choice,spatial-relational,1|2,7,1/2,230388,1
3,3,23,389,1,612,1,13,6,6,7,single-choice,spatial-relational,6|7,7,6/7,230389,6
3,3,23,390,1,564,1,13,6,6,7,single-choice,spatial-relational,6|7,7,6/7,230390,6
3,3,23,391,1,642,1,7,3,3,4,single-choice,spatial-relational,3|4,7,3/4,230391,3
3,3,23,392,0,561,1,9,4,5,5,single-choice,spatial-relational,4|5,7,4/5,230392,4
3,3,23,393,1,607,1,5,2,2,3,single-choice,spatial-relational,2|3,7,2/3,230393,2
3,3,23,394,1,693,1,7,3,3,4,single-choice,spatial-relational,3|4,7,3/4,230394,3
3,3,23,395,0,579,1,11,5,6,6,single-choice,spatial-relational,5|6,7,5/6,230395,5
3,3,23,396,1,533,1,5,2,2,3,single-choice,spatial-relational,2|3,7,2/3,230396,2
3,3,23,397,0,482,1,11,5,6,6,single-choice,spatial-relational,5|6,7,5/6,230397,5
3,3,23,398,1,52,1,3,1,1,2,single-choice,spatial-relational,1|2,7,1/2,230398,1
3,3,23,399,1,545,1,13,6,6,7,single-choice,spatial-relational,6|7,7,6/7,230399,6
3,3,23,400,1,561,1,13,6,6,7,single-choice,spatial-relational,6|7,7,6/7,230400,6
3,3,23,401,1,736,1,3,1,1,2,single-choice,spatial-relational,1|2,7,1/2,230401,1
3,3,23,402,0,607,1,9,4,5,5,single-choice,spatial-relational,4|5,7,4/5,230402,4
3,3,23,403,1,646,1,5,2,2,3,single-choice,spatial-relational,2|3,7,2/3,230403,2
3,3,23,404,1,635,1,11,5,5,6,single-choice,spatial-relational,5|6,7,5/6,230404,5
3,3,23,405,0,533,1,5,2,3,3,single-choice,spatial-relational,2|3,7,2/3,230405,2
3,3,23,406,0,584,1,9,4,5,5,single-choice,spatial-relational,4|5,7,4/5,230406,4
3,3,23,407,1,32,1,7,3,3,4,single-choice,spatial-relational,3|4,7,3/4,230407,3
3,3,23,408,1,773,1,7,3,3,4,single-choice,spatial-relational,3|4,7,3/4,230408,3
3,3,23,409,0,534,1,7,3,4,4,single-choice,spatial-relational,3|4,7,3/4,230409,3
3,3,23,410,1,669,1,5,2,2,3,single-choice,spatial-relational,2|3,7,2/3,230410,2
3,3,23,411,0,592,1,11,5,6,6,single-choice,spatial-relational,5|6,7,5/6,230411,5
3,3,23,412,0,533,1,9,4,5,5,single-choice,spatial-relational,4|5,7,4/5,230412,4
3,3,23,413,1,702,1,3,1,1,2,single-choice,spatial-relational,1|2,7,1/2,230413,1
3,3,23,414,1,543,1,13,6,6,7,single-choice,spatial-relational,6|7,7,6/7,230414,6
3,3,23,415,1,549,1,13,6,6,7,single-choice,spatial-relational,6|7,7,6/7,230415,6
3,3,23,416,1,615,1,9,4,4,5,single-choice,spatial-relational,4|5,7,4/5,230416,4
3,3,23,417,1,666,1,5,2,2,3,single-choice,spatial-relational,2|3,7,2/3,230417,2
3,3,23,418,1,677,1,3,1,1,2,single-choice,spatial-relational,1|2,7,1/2,230418,1
3,3,23,419,1,630,1,11,5,5,6,single-choice,spatial-relational,5|6,7,5/6,230419,5
3,3,23,420,0,721,1,7,3,4,4,single-choice,spatial-relational,3|4,7,3/4,230420,3
3,3,23,421,0,615,1,3,1,2,2,single-choice,spatial-relational,1|2,7,1/2,230421,1
3,3,23,422,1,643,1,7,3,3,4,single-choice,spatial-relational,3|4,7,3/4,230422,3
3,3,23,423,0,567,1,11,5,6,6,single-choice,spatial-relational,5|6,7,5/6,230423,5
3,3,23,424,1,572,1,3,1,1,2,single-choice,spatial-relational,1|2,7,1/2,230424,1
3,3,23,425,1,552,1,11,5,5,6,single-choice,spatial-relational,5|6,7,5/6,230425,5
3,3,23,426,0,655,1,9,4,5,5,single-choice,spatial-relational,4|5,7,4/5,230426,4
3,3,23,427,1,572,1,13,6,6,7,single-choice,spatial-relational,6|7,7,6/7,230427,6
3,3,23,428,0,564,1,5,2,3,3,single-choice,spatial-relational,2|3,7,2/3,230428,2
3,3,23,429,1,595,1,13,6,6,7,single-choice,spatial-relational,6|7,7,6/7,230429,6
3,3,23,430,1,642,1,5,2,2,3,single-choice,spatial-relational,2|3,7,2/3,230430,2
3,3,23,431,1,674,1,7,3,3,4,single-choice,spatial-relational,3|4,7,3/4,230431,3
3,3,23,432,0,655,1,9,4,5,5,single-choice,spatial-relational,4|5,7,4/5,230432,4
3,3,23,433,1,697,1,9,4,4,5,single-choice,spatial-relational,4|5,7,4/5,230433,4
3,3,23,434,0,666,1,3,1,2,2,single-choice,spatial-relational,1|2,7,1/2,230434,1
3,3,23,435,1,611,1,5,2,2,3,single-choice,spatial-relational,2|3,7,2/3,230435,2
3,3,23,436,1,573,1,3,1,1,2,single-choice,spatial-relational,1|2,7,1/2,230436,1
3,3,23,437,1,693,1,13,6,6,7,single-choice,spatial-relational,6|7,7,6/7,230437,6
3,3,23,438,1,681,1,11,5,5,6,single-choice,spatial-relational,5|6,7,5/6,230438,5
3,3,23,439,1,657,1,7,3,3,4,single-choice,spatial-relational,3|4,7,3/4,230439,3
3,3,23,440,1,526,1,13,6,6,7,single-choice,spatial-relational,6|7,7,6/7,230440,6
3,3,23,441,0,576,1,9,4,5,5,single-choice,spatial-relational,4|5,7,4/5,230441,4
3,3,23,442,1,693,1,11,5,5,6,single-choice,spatial-relational,5|6,7,5/6,230442,5
3,3,23,443,1,563,1,7,3,3,4,single-choice,spatial-relational,3|4,7,3/4,230443,3
3,3,23,444,1,876,1,5,2,2,3,single-choice,spatial-relational,2|3,7,2/3,230444,2
3,3,23,445,1,615,1,13,6,6,7,single-choice,spatial-relational,6|7,7,6/7,230445,6
3,3,23,446,0,708,1,3,1,2,2,single-choice,spatial-relational,1|2,7,1/2,230446,1
3,3,23,447,1,552,1,5,2,2,3,single-choice,spatial-relational,2|3,7,2/3,230447,2
3,3,23,448,1,649,1,11,5,5,6,single-choice,spatial-relational,5|6,7,5/6,230448,5
3,3,23,449,0,580,1,9,4,5,5,single-choice,spatial-relational,4|5,7,4/5,230449,4
3,3,23,450,1,616,1,13,6,6,7,single-choice,spatial-relational,6|7,7,6/7,230450,6
3,3,23,451,1,630,1,7,3,3,4,single-choice,spatial-relational,3|4,7,3/4,230451,3
3,3,23,452,1,768,1,11,5,5,6,single-choice,spatial-relational,5|6,7,5/6,230452,5
3,3,23,453,1,705,1,5,2,2,3,single-choice,spatial-relational,2|3,7,2/3,230453,2
3,3,23,454,0,560,1,3,1,2,2,single-choice,spatial-relational,1|2,7,1/2,230454,1
3,3,23,455,1,803,1,7,3,3,4,single-choice,spatial-relational,3|4,7,3/4,230455,3
3,3,23,456,1,358,1,9,4,4,5,single-choice,spatial-relational,4|5,7,4/5,230456,4
3,3,23,457,1,734,1,9,4,4,5,single-choice,spatial-relational,4|5,7,4/5,230457,4
3,3,23,458,1,782,1,7,3,3,4,single-choice,spatial-relational,3|4,7,3/4,230458,3
3,3,23,459,1,552,1,13,6,6,7,single-choice,spatial-relational,6|7,7,6/7,230459,6
3,3,23,460,1,763,1,3,1,1,2,single-choice,spatial-relational,1|2,7,1/2,230460,1
3,3,23,461,1,736,1,5,2,2,3,single-choice,spatial-relational,2|3,7,2/3,230461,2
3,3,23,462,1,614,1,5,2,2,3,single-choice,spatial-relational,2|3,7,2/3,230462,2
3,3,23,463,0,610,1,9,4,5,5,single-choice,spatial-relational,4|5,7,4/5,230463,4
3,3,23,464,0,580,1,3,1,2,2,single-choice,spatial-relational,1|2,7,1/2,230464,1
3,3,23,465,1,610,1,11,5,5,6,single-choice,spatial-relational,5|6,7,5/6,230465,5
3,3,23,466,0,688,1,7,3,4,4,single-choice,spatial-relational,3|4,7,3/4,230466,3
3,3,23,467,0,521,1,11,5,6,6,single-choice,spatial-relational,5|6,7,5/6,230467,5
3,3,23,468,1,648,1,13,6,6,7,single-choice,spatial-relational,6|7,7,6/7,230468,6
3,3,23,469,0,699,1,9,4,5,5,single-choice,spatial-relational,4|5,7,4/5,230469,4
3,3,23,470,1,657,1,13,6,6,7,single-choice,spatial-relational,6|7,7,6/7,230470,6
3,3,23,471,1,730,1,7,3,3,4,single-choice,spatial-relational,3|4,7,3/4,230471,3
3,3,23,472,1,3550,1,3,1,1,2,single-choice,spatial-relational,1|2,7,1/2,230472,1
3,3,23,473,1,639,1,13,6,6,7,single-choice,spatial-relational,6|7,7,6/7,230473,6
3,3,23,474,0,561,1,3,1,2,2,single-choice,spatial-relational,1|2,7,1/2,230474,1
3,3,23,475,1,798,1,9,4,4,5,single-choice,spatial-relational,4|5,7,4/5,230475,4
3,3,23,476,1,622,1,5,2,2,3,single-choice,spatial-relational,2|3,7,2/3,230476,2
3,3,23,477,0,669,1,11,5,6,6,single-choice,spatial-relational,5|6,7,5/6,230477,5
3,3,23,478,1,558,1,11,5,5,6,single-choice,spatial-relational,5|6,7,5/6,230478,5
3,3,23,479,1,684,1,7,3,3,4,single-choice,spatial-relational,3|4,7,3/4,230479,3
3,3,23,480,1,627,1,5,2,2,3,single-choice,spatial-relational,2|3,7,2/3,230480,2
3,3,23,481,0,546,1,13,6,7,7,single-choice,spatial-relational,6|7,7,6/7,230481,6
3,3,23,482,0,616,1,3,1,2,2,single-choice,spatial-relational,1|2,7,1/2,230482,1
3,3,23,483,1,510,1,7,3,3,4,single-choice,spatial-relational,3|4,7,3/4,230483,3
3,3,23,484,0,639,1,9,4,5,5,single-choice,spatial-relational,4|5,7,4/5,230484,4
3,3,23,485,1,601,1,9,4,4,5,single-choice,spatial-relational,4|5,7,4/5,230485,4
3,3,23,486,0,619,1,11,5,6,6,single-choice,spatial-relational,5|6,7,5/6,230486,5
3,3,23,487,0,634,1,3,1,2,2,single-choice,spatial-relational,1|2,7,1/2,230487,1
3,3,23,488,1,625,1,11,5,5,6,single-choice,spatial-relational,5|6,7,5/6,230488,5
3,3,23,489,1,613,1,13,6,6,7,single-choice,spatial-relational,6|7,7,6/7,230489,6
3,3,23,490,1,580,1,5,2,2,3,single-choice,spatial-relational,2|3,7,2/3,230490,2
3,3,23,491,0,623,1,5,2,3,3,single-choice,spatial-relational,2|3,7,2/3,230491,2
3,3,23,492,1,672,1,7,3,3,4,single-choice,spatial-relational,3|4,7,3/4,230492,3
3,3,23,493,0,634,1,3,1,2,2,single-choice,spatial-relational,1|2,7,1/2,230493,1
3,3,23,494,1,622,1,7,3,3,4,single-choice,spatial-relational,3|4,7,3/4,230494,3
3,3,23,495,1,2207,1,3,1,1,2,single-choice,spatial-relational,1|2,7,1/2,230495,1
3,3,23,496,1,579,1,13,6,6,7,single-choice,spatial-relational,6|7,7,6/7,230496,6
3,3,23,497,1,1122,1,5,2,2,3,single-choice,spatial-relational,2|3,7,2/3,230497,2
3,3,23,498,1,680,1,9,4,4,5,single-choice,spatial-relational,4|5,7,4/5,230498,4
3,3,23,499,1,581,1,11,5,5,6,single-choice,spatial-relational,5|6,7,5/6,230499,5
3,3,23,500,1,770,1,9,4,4,5,single-choice,spatial-relational,4|5,7,4/5,230500,4
3,3,23,501,1,655,1,5,2,2,3,single-choice,spatial-relational,2|3,7,2/3,230501,2
3,3,23,502,0,646,1,11,5,6,6,single-choice,spatial-relational,5|6,7,5/6,230502,5
3,3,23,503,1,682,1,7,3,3,4,single-choice,spatial-relational,3|4,7,3/4,230503,3
3,3,23,504,1,780,1,13,6,6,7,single-choice,spatial-relational,6|7,7,6/7,230504,6
3,3,23,505,1,723,1,11,5,5,6,single-choice,spatial-relational,5|6,7,5/6,230505,5
3,3,23,506,1,640,1,7,3,3,4,single-choice,spatial-relational,3|4,7,3/4,230506,3
3,3,23,507,1,549,1,11,5,5,6,single-choice,spatial-relational,5|6,7,5/6,230507,5
3,3,23,508,1,663,1,13,6,6,7,single-choice,spatial-relational,6|7,7,6/7,230508,6
3,3,23,509,0,718,1,3,1,2,2,single-choice,spatial-relational,1|2,7,1/2,230509,1
3,3,23,510,0,654,1,3,1,2,2,single-choice,spatial-relational,1|2,7,1/2,230510,1
3,3,23,511,0,60,1,9,4,5,5,single-choice,spatial-relational,4|5,7,4/5,230511,4
3,3,23,512,1,560,1,5,2,2,3,single-choice,spatial-relational,2|3,7,2/3,230512,2
3,3,23,513,1,656,1,13,6,6,7,single-choice,spatial-relational,6|7,7,6/7,230513,6
3,3,23,514,0,1001,1,5,2,3,3,single-choice,spatial-relational,2|3,7,2/3,230514,2
3,3,23,515,1,802,1,9,4,4,5,single-choice,spatial-relational,4|5,7,4/5,230515,4
3,3,23,516,0,772,1,7,3,4,4,single-choice,spatial-relational,3|4,7,3/4,230516,3
3,3,23,517,1,620,1,3,1,1,2,single-choice,spatial-relational,1|2,7,1/2,230517,1
3,3,23,518,1,943,1,5,2,2,3,single-choice,spatial-relational,2|3,7,2/3,230518,2
3,3,23,519,1,792,1,11,5,5,6,single-choice,spatial-relational,5|6,7,5/6,230519,5
3,3,23,520,1,604,1,7,3,3,4,single-choice,spatial-relational,3|4,7,3/4,230520,3
3,3,23,521,1,676,1,5,2,2,3,single-choice,spatial-relational,2|3,7,2/3,230521,2
3,3,23,522,1,620,1,13,6,6,7,single-choice,spatial-relational,6|7,7,6/7,230522,6
3,3,23,523,1,638,1,7,3,3,4,single-choice,spatial-relational,3|4,7,3/4,230523,3
3,3,23,524,0,652,1,9,4,5,5,single-choice,spatial-relational,4|5,7,4/5,230524,4
3,3,23,525,0,627,1,3,1,2,2,single-choice,spatial-relational,1|2,7,1/2,230525,1
3,3,23,526,1,731,1,13,6,6,7,single-choice,spatial-relational,6|7,7,6/7,230526,6
3,3,23,527,0,690,1,9,4,5,5,single-choice,spatial-relational,4|5,7,4/5,230527,4
3,3,23,528,1,690,1,11,5,5,6,single-choice,spatial-relational,5|6,7,5/6,230528,5
3,3,23,529,1,553,1,3,1,1,2,single-choice,spatial-relational,1|2,7,1/2,230529,1
3,3,23,530,0,603,1,13,6,7,7,single-choice,spatial-relational,6|7,7,6/7,230530,6
3,3,23,531,1,506,1,13,6,6,7,single-choice,spatial-relational,6|7,7,6/7,230531,6
3,3,23,532,1,881,1,11,5,5,6,single-choice,spatial-relational,5|6,7,5/6,230532,5
3,3,23,533,0,701,1,9,4,5,5,single-choice,spatial-relational,4|5,7,4/5,230533,4
3,3,23,534,1,535,1,5,2,2,3,single-choice,spatial-relational,2|3,7,2/3,230534,2
3,3,23,535,1,662,1,3,1,1,2,single-choice,spatial-relational,1|2,7,1/2,230535,1
3,3,23,536,0,708,1,7,3,4,4,single-choice,spatial-relational,3|4,7,3/4,230536,3
3,3,23,537,1,588,1,5,2,2,3,single-choice,spatial-relational,2|3,7,2/3,230537,2
3,3,23,538,0,625,1,9,4,5,5,single-choice,spatial-relational,4|5,7,4/5,230538,4
3,3,23,539,1,681,1,7,3,3,4,single-choice,spatial-relational,3|4,7,3/4,230539,3
3,3,23,540,1,658,1,11,5,5,6,single-choice,spatial-relational,5|6,7,5/6,230540,5
3,3,23,541,1,591,1,13,6,6,7,single-choice,spatial-relational,6|7,7,6/7,230541,6
3,3,23,542,0,488,1,3,1,2,2,single-choice,spatial-relational,1|2,7,1/2,230542,1
3,3,23,543,0,553,1,9,4,5,5,single-choice,spatial-relational,4|5,7,4/5,230543,4
3,3,23,544,1,611,1,7,3,3,4,single-choice,spatial-relational,3|4,7,3/4,230544,3
3,3,23,545,1,621,1,9,4,4,5,single-choice,spatial-relational,4|5,7,4/5,230545,4
3,3,23,546,0,871,1,11,5,6,6,single-choice,spatial-relational,5|6,7,5/6,230546,5
3,3,23,547,0,674,1,3,1,2,2,single-choice,spatial-relational,1|2,7,1/2,230547,1
3,3,23,548,1,717,1,5,2,2,3,single-choice,spatial-relational,2|3,7,2/3,230548,2
3,3,23,549,1,576,1,11,5,5,6,single-choice,spatial-relational,5|6,7,5/6,230549,5
3,3,23,550,0,562,1,5,2,3,3,single-choice,spatial-relational,2|3,7,2/3,230550,2
3,3,23,551,1,590,1,13,6,6,7,single-choice,spatial-relational,6|7,7,6/7,230551,6
3,3,23,552,1,716,1,7,3,3,4,single-choice,spatial-relational,3|4,7,3/4,230552,3
3,3,23,553,1,631,1,11,5,5,6,single-choice,spatial-relational,5|6,7,5/6,230553,5
3,3,23,554,1,517,1,3,1,1,2,single-choice,spatial-relational,1|2,7,1/2,230554,1
3,3,23,555,1,599,1,7,3,3,4,single-choice,spatial-relational,3|4,7,3/4,230555,3
3,3,23,556,1,677,1,13,6,6,7,single-choice,spatial-relational,6|7,7,6/7,230556,6
3,3,23,557,0,533,1,9,4,5,5,single-choice,spatial-relational,4|5,7,4/5,230557,4
3,3,23,558,1,550,1,5,2,2,3,single-choice,spatial-relational,2|3,7,2/3,230558,2
3,3,23,559,1,627,1,7,3,3,4,single-choice,spatial-relational,3|4,7,3/4,230559,3
3,3,23,560,0,554,1,3,1,2,2,single-choice,spatial-relational,1|2,7,1/2,230560,1
3,3,23,561,1,563,1,9,4,4,5,single-choice,spatial-relational,4|5,7,4/5,230561,4
3,3,23,562,1,950,1,11,5,5,6,single-choice,spatial-relational,5|6,7,5/6,230562,5
3,3,23,563,0,772,1,13,6,7,7,single-choice,spatial-relational,6|7,7,6/7,230563,6
3,3,23,564,1,636,1,5,2,2,3,single-choice,spatial-relational,2|3,7,2/3,230564,2
3,3,23,565,0,818,1,9,4,5,5,single-choice,spatial-relational,4|5,7,4/5,230565,4
3,3,23,566,0,597,1,3,1,2,2,single-choice,spatial-relational,1|2,7,1/2,230566,1
3,3,23,567,1,504,1,11,5,5,6,single-choice,spatial-relational,5|6,7,5/6,230567,5
3,3,23,568,0,695,1,11,5,6,6,single-choice,spatial-relational,5|6,7,5/6,230568,5
3,3,23,569,0,639,1,3,1,2,2,single-choice,spatial-relational,1|2,7,1/2,230569,1
3,3,23,570,0,173,1,5,2,3,3,single-choice,spatial-relational,2|3,7,2/3,230570,2
3,3,23,571,1,591,1,5,2,2,3,single-choice,spatial-relational,2|3,7,2/3,230571,2
3,3,23,572,1,702,1,7,3,3,4,single-choice,spatial-relational,3|4,7,3/4,230572,3
3,3,23,573,1,509,1,13,6,6,7,single-choice,spatial-relational,6|7,7,6/7,230573,6
3,3,23,574,1,630,1,7,3,3,4,single-choice,spatial-relational,3|4,7,3/4,230574,3
3,3,23,575,0,521,1,9,4,5,5,single-choice,spatial-relational,4|5,7,4/5,230575,4
3,3,23,576,1,633,1,13,6,6,7,single-choice,spatial-relational,6|7,7,6/7,230576,6
3,3,23,577,1,783,1,7,3,3,4,single-choice,spatial-relational,3|4,7,3/4,230577,3
3,3,23,578,1,623,1,13,6,6,7,single-choice,spatial-relational,6|7,7,6/7,230578,6
3,3,23,579,0,609,1,5,2,3,3,single-choice,spatial-relational,2|3,7,2/3,230579,2
3,3,23,580,1,171,1,5,2,2,3,single-choice,spatial-relational,2|3,7,2/3,230580,2
3,3,23,581,1,662,1,11,5,5,6,single-choice,spatial-relational,5|6,7,5/6,230581,5
3,3,23,582,0,746,1,3,1,2,2,single-choice,spatial-relational,1|2,7,1/2,230582,1
3,3,23,583,0,480,1,9,4,5,5,single-choice,spatial-relational,4|5,7,4/5,230583,4
3,3,23,584,0,605,1,9,4,5,5,single-choice,spatial-relational,4|5,7,4/5,230584,4
3,3,23,585,1,674,1,13,6,6,7,single-choice,spatial-relational,6|7,7,6/7,230585,6
3,3,23,586,1,623,1,3,1,1,2,single-choice,spatial-relational,1|2,7,1/2,230586,1
3,3,23,587,1,618,1,7,3,3,4,single-choice,spatial-relational,3|4,7,3/4,230587,3
3,3,23,588,1,707,1,11,5,5,6,single-choice,spatial-relational,5|6,7,5/6,230588,5
3,3,23,589,0,618,1,5,2,3,3,single-choice,spatial-relational,2|3,7,2/3,230589,2
3,3,23,590,1,556,1,3,1,1,2,single-choice,spatial-relational,1|2,7,1/2,230590,1
3,3,23,591,1,802,1,11,5,5,6,single-choice,spatial-relational,5|6,7,5/6,230591,5
3,3,23,592,1,725,1,11,5,5,6,single-choice,spatial-relational,5|6,7,5/6,230592,5
3,3,23,593,1,725,1,13,6,6,7,single-choice,spatial-relational,6|7,7,6/7,230593,6
3,3,23,594,1,625,1,7,3,3,4,single-choice,spatial-relational,3|4,7,3/4,230594,3
3,3,23,595,1,685,1,7,3,3,4,single-choice,spatial-relational,3|4,7,3/4,230595,3
3,3,23,596,0,627,1,9,4,5,5,single-choice,spatial-relational,4|5,7,4/5,230596,4
3,3,23,597,1,842,1,13,6,6,7,single-choice,spatial-relational,6|7,7,6/7,230597,6
3,3,23,598,0,697,1,9,4,5,5,single-choice,spatial-relational,4|5,7,4/5,230598,4
3,3,23,599,0,561,1,3,1,2,2,single-choice,spatial-relational,1|2,7,1/2,230599,1
3,3,23,600,1,529,1,5,2,2,3,single-choice,spatial-relational,2|3,7,2/3,230600,2
4,3,23,1,0,878,1,11,5,6,6,single-choice,spatial-relational,5|6,7,5/6,230001,5
4,3,23,2,0,576,1,13,6,7,7,single-choice,spatial-relational,6|7,7,6/7,230002,6
4,3,23,3,1,637,1,7,3,3,4,single-choice,spatial-relational,3|4,7,3/4,230003,3
4,3,23,4,0,479,1,9,4,5,5,single-choice,spatial-relational,4|5,7,4/5,230004,4
4,3,23,5,1,598,1,11,5,5,6,single-choice,spatial-relational,5|6,7,5/6,230005,5
4,3,23,6,1,1413,1,7,3,3,4,single-choice,spatial-relational,3|4,7,3/4,230006,3
4,3,23,7,1,487,1,13,6,6,7,single-choice,spatial-relational,6|7,7,6/7,230007,6
4,3,23,8,0,508,1,5,2,3,3,single-choice,spatial-relational,2|3,7,2/3,230008,2
4,3,23,9,0,1068,1,3,1,2,2,single-choice,spatial-relational,1|2,7,1/2,230009,1
4,3,23,10,0,591,1,5,2,3,3,single-choice,spatial-relational,2|3,7,2/3,230010,2
4,3,23,11,1,644,1,9,4,4,5,single-choice,spatial-relational,4|5,7,4/5,230011,4
4,3,23,12,0,541,1,3,1,2,2,single-choice,spatial-relational,1|2,7,1/2,230012,1
4,3,23,13,0,544,1,9,4,5,5,single-choice,spatial-relational,4|5,7,4/5,230013,4
4,3,23,14,1,454,1,3,1,1,2,single-choice,spatial-relational,1|2,7,1/2,230014,1
4,3,23,15,1,548,1,13,6,6,7,single-choice,spatial-relational,6|7,7,6/7,230015,6
4,3,23,16,1,485,1,5,2,2,3,single-choice,spatial-relational,2|3,7,2/3,230016,2
4,3,23,17,1,482,1,13,6,6,7,single-choice,spatial-relational,6|7,7,6/7,230017,6
4,3,23,18,0,534,1,11,5,6,6,single-choice,spatial-relational,5|6,7,5/6,230018,5
4,3,23,19,1,618,1,7,3,3,4,single-choice,spatial-relational,3|4,7,3/4,230019,3
4,3,23,20,1,553,1,7,3,3,4,single-choice,spatial-relational,3|4,7,3/4,230020,3
4,3,23,21,1,610,1,5,2,2,3,single-choice,spatial-relational,2|3,7,2/3,230021,2
4,3,23,22,0,461,1,9,4,5,5,single-choice,spatial-relational,4|5,7,4/5,230022,4
4,3,23,23,0,474,1,11,5,6,6,single-choice,spatial-relational,5|6,7,5/6,230023,5
4,3,23,24,0,496,1,3,1,2,2,single-choice,spatial-relational,1|2,7,1/2,230024,1
4,3,23,25,1,569,1,5,2,2,3,single-choice,spatial-relational,2|3,7,2/3,230025,2
4,3,23,26,1,540,1,13,6,6,7,single-choice,spatial-relational,6|7,7,6/7,230026,6
4,3,23,27,0,536,1,11,5,6,6,single-choice,spatial-relational,5|6,7,5/6,230027,5
4,3,23,28,1,525,1,13,6,6,7,single-choice,spatial-relational,6|7,7,6/7,230028,6
4,3,23,29,0,545,1,5,2,3,3,single-choice,spatial-relational,2|3,7,2/3,230029,2
4,3,23,30,0,454,1,9,4,5,5,single-choice,spatial-relational,4|5,7,4/5,230030,4
4,3,23,31,1,572,1,9,4,4,5,single-choice,spatial-relational,4|5,7,4/5,230031,4
4,3,23,32,1,603,1,7,3,3,4,single-choice,spatial-relational,3|4,7,3/4,230032,3
4,3,23,33,0,552,1,3,1,2,2,single-choice,spatial-relational,1|2,7,1/2,230033,1
4,3,23,34,1,525,1,7,3,3,4,single-choice,spatial-relational,3|4,7,3/4,230034,3
4,3,23,35,1,595,1,11,5,5,6,single-choice,spatial-relational,5|6,7,5/6,230035,5
4,3,23,36,1,721,1,3,1,1,2,single-choice,spatial-relational,1|2,7,1/2,230036,1
4,3,23,37,1,571,1,13,6,6,7,single-choice,spatial-relational,6|7,7,6/7,230037,6
4,3,23,38,1,560,1,7,3,3,4,single-choice,spatial-relational,3|4,7,3/4,230038,3
4,3,23,39,0,604,1,3,1,2,2,single-choice,spatial-relational,1|2,7,1/2,230039,1
4,3,23,40,1,612,1,9,4,4,5,single-choice,spatial-relational,4|5,7,4/5,230040,4
4,3,23,41,1,498,1,13,6,6,7,single-choice,spatial-relational,6|7,7,6/7,230041,6
4,3,23,42,0,603,1,9,4,5,5,single-choice,spatial-relational,4|5,7,4/5,230042,4
4,3,23,43,1,588,1,7,3,3,4,single-choice,spatial-relational,3|4,7,3/4,230043,3
4,3,23,44,1,563,1,3,1,1,2,single-choice,spatial-relational,1|2,7,1/2,230044,1
4,3,23,45,1,552,1,5,2,2,3,single-choice,spatial-relational,2|3,7,2/3,230045,2
4,3,23,46,1,644,1,11,5,5,6,single-choice,spatial-relational,5|6,7,5/6,230046,5
4,3,23,47,1,539,1,5,2,2,3,single-choice,spatial-relational,2|3,7,2/3,230047,2
4,3,23,48,1,540,1,11,5,5,6,single-choice,spatial-relational,5|6,7,5/6,230048,5
4,3,23,49,1,556,1,11,5,5,6,single-choice,spatial-relational,5|6,7,5/6,230049,5
4,3,23,50,1,587,1,13,6,6,7,single-choice,spatial-relational,6|7,7,6/7,230050,6
4,3,23,51,1,552,1,5,2,2,3,single-choice,spatial-relational,2|3,7,2/3,230051,2
4,3,23,52,1,548,1,13,6,6,7,single-choice,spatial-relational,6|7,7,6/7,230052,6
4,3,23,53,1,525,1,3,1,1,2,single-choice,spatial-relational,1|2,7,1/2,230053,1
4,3,23,54,0,623,1,5,2,3,3,single-choice,spatial-relational,2|3,7,2/3,230054,2
4,3,23,55,1,619,1,11,5,5,6,single-choice,spatial-relational,5|6,7,5/6,230055,5
4,3,23,56,0,567,1,7,3,4,4,single-choice,spatial-relational,3|4,7,3/4,230056,3
4,3,23,57,0,513,1,9,4,5,5,single-choice,spatial-relational,4|5,7,4/5,230057,4
4,3,23,58,0,601,1,3,1,2,2,single-choice,spatial-relational,1|2,7,1/2,230058,1
4,3,23,59,1,528,1,7,3,3,4,single-choice,spatial-relational,3|4,7,3/4,230059,3
4,3,23,60,1,588,1,9,4,4,5,single-choice,spatial-relational,4|5,7,4/5,230060,4
4,3,23,61,1,576,1,13,6,6,7,single-choice,spatial-relational,6|7,7,6/7,230061,6
4,3,23,62,0,552,1,7,3,4,4,single-choice,spatial-relational,3|4,7,3/4,230062,3
4,3,23,63,1,553,1,5,2,2,3,single-choice,spatial-relational,2|3,7,2/3,230063,2
4,3,23,64,1,1331,1,7,3,3,4,single-choice,spatial-relational,3|4,7,3/4,230064,3
4,3,23,65,1,561,1,11,5,5,6,single-choice,spatial-relational,5|6,7,5/6,230065,5
4,3,23,66,0,585,1,13,6,7,7,single-choice,spatial-relational,6|7,7,6/7,230066,6
4,3,23,67,1,654,1,5,2,2,3,single-choice,spatial-relational,2|3,7,2/3,230067,2
4,3,23,68,0,556,1,9,4,5,5,single-choice,spatial-relational,4|5,7,4/5,230068,4
4,3,23,69,1,677,1,11,5,5,6,single-choice,spatial-relational,5|6,7,5/6,230069,5
4,3,23,70,1,557,1,3,1,1,2,single-choice,spatial-relational,1|2,7,1/2,230070,1
4,3,23,71,1,615,1,3,1,1,2,single-choice,spatial-relational,1|2,7,1/2,230071,1
4,3,23,72,0,546,1,9,4,5,5,single-choice,spatial-relational,4|5,7,4/5,230072,4
4,3,23,73,1,457,1,7,3,3,4,single-choice,spatial-relational,3|4,7,3/4,230073,3
4,3,23,74,1,635,1,11,5,5,6,single-choice,spatial-relational,5|6,7,5/6,230074,5
4,3,23,75,1,557,1,7,3,3,4,single-choice,spatial-relational,3|4,7,3/4,230075,3
4,3,23,76,0,532,1,9,4,5,5,single-choice,spatial-relational,4|5,7,4/5,230076,4
4,3,23,77,1,643,1,13,6,6,7,single-choice,spatial-relational,6|7,7,6/7,230077,6
4,3,23,78,1,552,1,3,1,1,2,single-choice,spatial-relational,1|2,7,1/2,230078,1
4,3,23,79,1,553,1,5,2,2,3,single-choice,spatial-relational,2|3,7,2/3,230079,2
4,3,23,80,1,513,1,5,2,2,3,single-choice,spatial-relational,2|3,7,2/3,230080,2
4,3,23,81,0,527,1,3,1,2,2,single-choice,spatial-relational,1|2,7,1/2,230081,1
4,3,23,82,1,724,1,13,6,6,7,single-choice,spatial-relational,6|7,7,6/7,230082,6
4,3,23,83,1,665,1,9,4,4,5,single-choice,spatial-relational,4|5,7,4/5,230083,4
4,3,23,84,1,685,1,11,5,5,6,single-choice,spatial-relational,5|6,7,5/6,230084,5
4,3,23,85,0,681,1,11,5,6,6,single-choice,spatial-relational,5|6,7,5/6,230085,5
4,3,23,86,1,656,1,5,2,2,3,single-choice,spatial-relational,2|3,7,2/3,230086,2
4,3,23,87,1,608,1,13,6,6,7,single-choice,spatial-relational,6|7,7,6/7,230087,6
4,3,23,88,1,1099,1,7,3,3,4,single-choice,spatial-relational,3|4,7,3/4,230088,3
4,3,23,89,1,697,1,13,6,6,7,single-choice,spatial-relational,6|7,7,6/7,230089,6
4,3,23,90,1,656,1,9,4,4,5,single-choice,spatial-relational,4|5,7,4/5,230090,4
4,3,23,91,1,597,1,7,3,3,4,single-choice,spatial-relational,3|4,7,3/4,230091,3
4,3,23,92,1,552,1,3,1,1,2,single-choice,spatial-relational,1|2,7,1/2,230092,1
4,3,23,93,1,754,1,3,1,1,2,single-choice,spatial-relational,1|2,7,1/2,230093,1
4,3,23,94,1,564,1,5,2,2,3,single-choice,spatial-relational,2|3,7,2/3,230094,2
4,3,23,95,0,564,1,9,4,5,5,single-choice,spatial-relational,4|5,7,4/5,230095,4
4,3,23,96,1,534,1,11,5,5,6,single-choice,spatial-relational,5|6,7,5/6,230096,5
4,3,23,97,0,518,1,3,1,2,2,single-choice,spatial-relational,1|2,7,1/2,230097,1
4,3,23,98,0,801,1,7,3,4,4,single-choice,spatial-relational,3|4,7,3/4,230098,3
4,3,23,99,1,579,1,13,6,6,7,single-choice,spatial-relational,6|7,7,6/7,230099,6
4,3,23,100,1,595,1,11,5,5,6,single-choice,spatial-relational,5|6,7,5/6,230100,5
4,3,23,101,1,592,1,7,3,3,4,single-choice,spatial-relational,3|4,7,3/4,230101,3
4,3,23,102,1,595,1,13,6,6,7,single-choice,spatial-relational,6|7,7,6/7,230102,6
4,3,23,103,1,631,1,5,2,2,3,single-choice,spatial-relational,2|3,7,2/3,230103,2
4,3,23,104,1,652,1,9,4,4,5,single-choice,spatial-relational,4|5,7,4/5,230104,4
4,3,23,105,1,592,1,3,1,1,2,single-choice,spatial-relational,1|2,7,1/2,230105,1
4,3,23,106,1,538,1,11,5,5,6,single-choice,spatial-relational,5|6,7,5/6,230106,5
4,3,23,107,0,631,1,9,4,5,5,single-choice,spatial-relational,4|5,7,4/5,230107,4
4,3,23,108,0,650,1,5,2,3,3,single-choice,spatial-relational,2|3,7,2/3,230108,2
4,3,23,109,1,610,1,11,5,5,6,single-choice,spatial-relational,5|6,7,5/6,230109,5
4,3,23,110,1,541,1,3,1,1,2,single-choice,spatial-relational,1|2,7,1/2,230110,1
4,3,23,111,1,544,1,13,6,6,7,single-choice,spatial-relational,6|7,7,6/7,230111,6
4,3,23,112,0,1318,1,7,3,4,4,single-choice,spatial-relational,3|4,7,3/4,230112,3
4,3,23,113,1,834,1,7,3,3,4,single-choice,spatial-relational,3|4,7,3/4,230113,3
4,3,23,114,1,618,1,3,1,1,2,single-choice,spatial-relational,1|2,7,1/2,230114,1
4,3,23,115,1,584,1,13,6,6,7,single-choice,spatial-relational,6|7,7,6/7,230115,6
4,3,23,116,0,712,1,5,2,3,3,single-choice,spatial-relational,2|3,7,2/3,230116,2
4,3,23,117,1,616,1,9,4,4,5,single-choice,spatial-relational,4|5,7,4/5,230117,4
4,3,23,118,1,677,1,11,5,5,6,single-choice,spatial-relational,5|6,7,5/6,230118,5
4,3,23,119,0,525,1,9,4,5,5,single-choice,spatial-relational,4|5,7,4/5,230119,4
4,3,23,120,1,561,1,5,2,2,3,single-choice,spatial-relational,2|3,7,2/3,230120,2
4,3,23,121,1,655,1,3,1,1,2,single-choice,spatial-relational,1|2,7,1/2,230121,1
4,3,23,122,1,644,1,13,6,6,7,single-choice,spatial-relational,6|7,7,6/7,230122,6
4,3,23,123,1,632,1,5,2,2,3,single-choice,spatial-relational,2|3,7,2/3,230123,2
4,3,23,124,0,643,1,3,1,2,2,single-choice,spatial-relational,1|2,7,1/2,230124,1
4,3,23,125,1,596,1,11,5,5,6,single-choice,spatial-relational,5|6,7,5/6,230125,5
4,3,23,126,0,616,1,9,4,5,5,single-choice,spatial-relational,4|5,7,4/5,230126,4
4,3,23,127,1,684,1,9,4,4,5,single-choice,spatial-relational,4|5,7,4/5,230127,4
4,3,23,128,1,669,1,11,5,5,6,single-choice,spatial-relational,5|6,7,5/6,230128,5
4,3,23,129,1,598,1,13,6,6,7,single-choice,spatial-relational,6|7,7,6/7,230129,6
4,3,23,130,1,799,1,7,3,3,4,single-choice,spatial-relational,3|4,7,3/4,230130,3
4,3,23,131,1,576,1,7,3,3,4,single-choice,spatial-relational,3|4,7,3/4,230131,3
4,3,23,132,1,564,1,5,2,2,3,single-choice,spatial-relational,2|3,7,2/3,230132,2
4,3,23,133,1,611,1,5,2,2,3,single-choice,spatial-relational,2|3,7,2/3,230133,2
4,3,23,134,1,923,1,11,5,5,6,single-choice,spatial-relational,5|6,7,5/6,230134,5
4,3,23,135,1,584,1,11,5,5,6,single-choice,spatial-relational,5|6,7,5/6,230135,5
4,3,23,136,1,608,1,3,1,1,2,single-choice,spatial-relational,1|2,7,1/2,230136,1
4,3,23,137,1,596,1,13,6,6,7,single-choice,spatial-relational,6|7,7,6/7,230137,6
4,3,23,138,0,650,1,9,4,5,5,single-choice,spatial-relational,4|5,7,4/5,230138,4
4,3,23,139,0,508,1,9,4,5,5,single-choice,spatial-relational,4|5,7,4/5,230139,4
4,3,23,140,1,671,1,13,6,6,7,single-choice,spatial-relational,6|7,7,6/7,230140,6
4,3,23,141,1,779,1,5,2,2,3,single-choice,spatial-relational,2|3,7,2/3,230141,2
4,3,23,142,1,573,1,7,3,3,4,single-choice,spatial-relational,3|4,7,3/4,230142,3
4,3,23,143,1,780,1,7,3,3,4,single-choice,spatial-relational,3|4,7,3/4,230143,3
4,3,23,144,0,1978,1,3,1,2,2,single-choice,spatial-relational,1|2,7,1/2,230144,1
4,3,23,145,1,580,1,5,2,2,3,single-choice,spatial-relational,2|3,7,2/3,230145,2
4,3,23,146,1,713,1,7,3,3,4,single-choice,spatial-relational,3|4,7,3/4,230146,3
4,3,23,147,1,709,1,9,4,4,5,single-choice,spatial-relational,4|5,7,4/5,230147,4
4,3,23,148,0,947,1,11,5,6,6,single-choice,spatial-relational,5|6,7,5/6,230148,5
4,3,23,149,0,587,1,3,1,2,2,single-choice,spatial-relational,1|2,7,1/2,230149,1
4,3,23,150,1,636,1,7,3,3,4,single-choice,spatial-relational,3|4,7,3/4,230150,3
4,3,23,151,1,545,1,5,2,2,3,single-choice,spatial-relational,2|3,7,2/3,230151,2
4,3,23,152,1,548,1,13,6,6,7,single-choice,spatial-relational,6|7,7,6/7,230152,6
4,3,23,153,1,576,1,13,6,6,7,single-choice,spatial-relational,6|7,7,6/7,230153,6
4,3,23,154,1,561,1,3,1,1,2,single-choice,spatial-relational,1|2,7,1/2,230154,1
4,3,23,155,1,583,1,11,5,5,6,single-choice,spatial-relational,5|6,7,5/6,230155,5
4,3,23,156,1,1002,1,9,4,4,5,single-choice,spatial-relational,4|5,7,4/5,230156,4
4,3,23,157,1,11323,1,7,3,3,4,single-choice,spatial-relational,3|4,7,3/4,230157,3
4,3,23,158,0,532,1,11,5,6,6,single-choice,spatial-relational,5|6,7,5/6,230158,5
4,3,23,159,1,639,1,3,1,1,2,single-choice,spatial-relational,1|2,7,1/2,230159,1
4,3,23,160,0,476,1,11,5,6,6,single-choice,spatial-relational,5|6,7,5/6,230160,5
4,3,23,161,1,612,1,5,2,2,3,single-choice,spatial-relational,2|3,7,2/3,230161,2
4,3,23,162,0,607,1,9,4,5,5,single-choice,spatial-relational,4|5,7,4/5,230162,4
4,3,23,163,1,530,1,5,2,2,3,single-choice,spatial-relational,2|3,7,2/3,230163,2
4,3,23,164,1,604,1,7,3,3,4,single-choice,spatial-relational,3|4,7,3/4,230164,3
4,3,23,165,1,553,1,13,6,6,7,single-choice,spatial-relational,6|7,7,6/7,230165,6
4,3,23,166,0,584,1,3,1,2,2,single-choice,spatial-relational,1|2,7,1/2,230166,1
4,3,23,167,0,562,1,9,4,5,5,single-choice,spatial-relational,4|5,7,4/5,230167,4
4,3,23,168,0,628,1,13,6,7,7,single-choice,spatial-relational,6|7,7,6/7,230168,6
4,3,23,169,1,596,1,11,5,5,6,single-choice,spatial-relational,5|6,7,5/6,230169,5
4,3,23,170,1,595,1,5,2,2,3,single-choice,spatial-relational,2|3,7,2/3,230170,2
4,3,23,171,1,612,1,7,3,3,4,single-choice,spatial-relational,3|4,7,3/4,230171,3
4,3,23,172,0,732,1,9,4,5,5,single-choice,spatial-relational,4|5,7,4/5,230172,4
4,3,23,173,1,568,1,5,2,2,3,single-choice,spatial-relational,2|3,7,2/3,230173,2
4,3,23,174,1,582,1,3,1,1,2,single-choice,spatial-relational,1|2,7,1/2,230174,1
4,3,23,175,1,541,1,13,6,6,7,single-choice,spatial-relational,6|7,7,6/7,230175,6
4,3,23,176,0,599,1,9,4,5,5,single-choice,spatial-relational,4|5,7,4/5,230176,4
4,3,23,177,1,602,1,13,6,6,7,single-choice,spatial-relational,6|7,7,6/7,230177,6
4,3,23,178,1,646,1,7,3,3,4,single-choice,spatial-relational,3|4,7,3/4,230178,3
4,3,23,179,1,561,1,3,1,1,2,single-choice,spatial-relational,1|2,7,1/2,230179,1
4,3,23,180,1,565,1,11,5,5,6,single-choice,spatial-relational,5|6,7,5/6,230180,5
4,3,23,181,1,694,1,7,3,3,4,single-choice,spatial-relational,3|4,7,3/4,230181,3
4,3,23,182,1,920,1,9,4,4,5,single-choice,spatial-relational,4|5,7,4/5,230182,4
4,3,23,183,1,583,1,7,3,3,4,single-choice,spatial-relational,3|4,7,3/4,230183,3
4,3,23,184,1,525,1,13,6,6,7,single-choice,spatial-relational,6|7,7,6/7,230184,6
4,3,23,185,1,595,1,3,1,1,2,single-choice,spatial-relational,1|2,7,1/2,230185,1
4,3,23,186,1,583,1,11,5,5,6,single-choice,spatial-relational,5|6,7,5/6,230186,5
4,3,23,187,1,603,1,13,6,6,7,single-choice,spatial-relational,6|7,7,6/7,230187,6
4,3,23,188,1,610,1,5,2,2,3,single-choice,spatial-relational,2|3,7,2/3,230188,2
4,3,23,189,1,804,1,9,4,4,5,single-choice,spatial-relational,4|5,7,4/5,230189,4
4,3,23,190,1,577,1,11,5,5,6,single-choice,spatial-relational,5|6,7,5/6,230190,5
4,3,23,191,0,4345,1,3,1,2,2,single-choice,spatial-relational,1|2,7,1/2,230191,1
4,3,23,192,1,556,1,5,2,2,3,single-choice,spatial-relational,2|3,7,2/3,230192,2
4,3,23,193,1,506,1,13,6,6,7,single-choice,spatial-relational,6|7,7,6/7,230193,6
4,3,23,194,0,745,1,11,5,6,6,single-choice,spatial-relational,5|6,7,5/6,230194,5
4,3,23,195,1,603,1,11,5,5,6,single-choice,spatial-relational,5|6,7,5/6,230195,5
4,3,23,196,1,560,1,7,3,3,4,single-choice,spatial-relational,3|4,7,3/4,230196,3
4,3,23,197,0,592,1,9,4,5,5,single-choice,spatial-relational,4|5,7,4/5,230197,4
4,3,23,198,0,630,1,3,1,2,2,single-choice,spatial-relational,1|2,7,1/2,230198,1
4,3,23,199,1,593,1,13,6,6,7,single-choice,spatial-relational,6|7,7,6/7,230199,6
4,3,23,200,1,588,1,5,2,2,3,single-choice,spatial-relational,2|3,7,2/3,230200,2
4,3,23,201,0,624,1,9,4,5,5,single-choice,spatial-relational,4|5,7,4/5,230201,4
4,3,23,202,1,641,1,5,2,2,3,single-choice,spatial-relational,2|3,7,2/3,230202,2
4,3,23,203,1,644,1,7,3,3,4,single-choice,spatial-relational,3|4,7,3/4,230203,3
4,3,23,204,0,677,1,3,1,2,2,single-choice,spatial-relational,1|2,7,1/2,230204,1
4,3,23,205,1,600,1,5,2,2,3,single-choice,spatial-relational,2|3,7,2/3,230205,2
4,3,23,206,1,631,1,11,5,5,6,single-choice,spatial-relational,5|6,7,5/6,230206,5
4,3,23,207,1,603,1,13,6,6,7,single-choice,spatial-relational,6|7,7,6/7,230207,6
4,3,23,208,1,531,1,13,6,6,7,single-choice,spatial-relational,6|7,7,6/7,230208,6
4,3,23,209,0,603,1,3,1,2,2,single-choice,spatial-relational,1|2,7,1/2,230209,1
4,3,23,210,0,573,1,9,4,5,5,single-choice,spatial-relational,4|5,7,4/5,230210,4
4,3,23,211,1,586,1,11,5,5,6,single-choice,spatial-relational,5|6,7,5/6,230211,5
4,3,23,212,1,482,1,7,3,3,4,single-choice,spatial-relational,3|4,7,3/4,230212,3
4,3,23,213,0,469,1,9,4,5,5,single-choice,spatial-relational,4|5,7,4/5,230213,4
4,3,23,214,0,4153,1,3,1,2,2,single-choice,spatial-relational,1|2,7,1/2,230214,1
4,3,23,215,1,1080,1,5,2,2,3,single-choice,spatial-relational,2|3,7,2/3,230215,2
4,3,23,216,0,689,1,7,3,4,4,single-choice,spatial-relational,3|4,7,3/4,230216,3
4,3,23,217,1,725,1,13,6,6,7,single-choice,spatial-relational,6|7,7,6/7,230217,6
4,3,23,218,1,567,1,13,6,6,7,single-choice,spatial-relational,6|7,7,6/7,230218,6
4,3,23,219,1,623,1,5,2,2,3,single-choice,spatial-relational,2|3,7,2/3,230219,2
4,3,23,220,0,615,1,3,1,2,2,single-choice,spatial-relational,1|2,7,1/2,230220,1
4,3,23,221,0,591,1,9,4,5,5,single-choice,spatial-relational,4|5,7,4/5,230221,4
4,3,23,222,1,828,1,11,5,5,6,single-choice,spatial-relational,5|6,7,5/6,230222,5
4,3,23,223,1,552,1,7,3,3,4,single-choice,spatial-relational,3|4,7,3/4,230223,3
4,3,23,224,0,600,1,3,1,2,2,single-choice,spatial-relational,1|2,7,1/2,230224,1
4,3,23,225,0,1304,1,9,4,5,5,single-choice,spatial-relational,4|5,7,4/5,230225,4
4,3,23,226,0,689,1,7,3,4,4,single-choice,spatial-relational,3|4,7,3/4,230226,3
4,3,23,227,1,637,1,5,2,2,3,single-choice,spatial-relational,2|3,7,2/3,230227,2
4,3,23,228,1,594,1,11,5,5,6,single-choice,spatial-relational,5|6,7,5/6,230228,5
4,3,23,229,1,611,1,13,6,6,7,single-choice,spatial-relational,6|7,7,6/7,230229,6
4,3,23,230,1,629,1,13,6,6,7,single-choice,spatial-relational,6|7,7,6/7,230230,6
4,3,23,231,1,723,1,5,2,2,3,single-choice,spatial-relational,2|3,7,2/3,230231,2
4,3,23,232,1,572,1,5,2,2,3,single-choice,spatial-relational,2|3,7,2/3,230232,2
4,3,23,233,1,632,1,7,3,3,4,single-choice,spatial-relational,3|4,7,3/4,230233,3
4,3,23,234,1,587,1,11,5,5,6,single-choice,spatial-relational,5|6,7,5/6,230234,5
4,3,23,235,0,674,1,7,3,4,4,single-choice,spatial-relational,3|4,7,3/4,230235,3
4,3,23,236,1,756,1,9,4,4,5,single-choice,spatial-relational,4|5,7,4/5,230236,4
4,3,23,237,0,514,1,9,4,5,5,single-choice,spatial-relational,4|5,7,4/5,230237,4
4,3,23,238,1,595,1,3,1,1,2,single-choice,spatial-relational,1|2,7,1/2,230238,1
4,3,23,239,1,635,1,3,1,1,2,single-choice,spatial-relational,1|2,7,1/2,230239,1
4,3,23,240,1,587,1,11,5,5,6,single-choice,spatial-relational,5|6,7,5/6,230240,5
4,3,23,241,1,614,1,5,2,2,3,single-choice,spatial-relational,2|3,7,2/3,230241,2
4,3,23,242,1,608,1,5,2,2,3,single-choice,spatial-relational,2|3,7,2/3,230242,2
4,3,23,243,0,840,1,11,5,6,6,single-choice,spatial-relational,5|6,7,5/6,230243,5
4,3,23,244,0,580,1,3,1,2,2,single-choice,spatial-relational,1|2,7,1/2,230244,1
4,3,23,245,0,948,1,13,6,7,7,single-choice,spatial-relational,6|7,7,6/7,230245,6
4,3,23,246,1,676,1,7,3,3,4,single-choice,spatial-relational,3|4,7,3/4,230246,3
4,3,23,247,1,564,1,13,6,6,7,single-choice,spatial-relational,6|7,7,6/7,230247,6
4,3,23,248,0,885,1,9,4,5,5,single-choice,spatial-relational,4|5,7,4/5,230248,4
4,3,23,249,1,564,1,11,5,5,6,single-choice,spatial-relational,5|6,7,5/6,230249,5
4,3,23,250,0,583,1,9,4,5,5,single-choice,spatial-relational,4|5,7,4/5,230250,4
4,3,23,251,0,918,1,7,3,4,4,single-choice,spatial-relational,3|4,7,3/4,230251,3
4,3,23,252,0,696,1,3,1,2,2,single-choice,spatial-relational,1|2,7,1/2,230252,1
4,3,23,253,1,760,1,13,6,6,7,single-choice,spatial-relational,6|7,7,6/7,230253,6
4,3,23,254,0,1576,1,5,2,3,3,single-choice,spatial-relational,2|3,7,2/3,230254,2
4,3,23,255,1,585,1,7,3,3,4,single-choice,spatial-relational,3|4,7,3/4,230255,3
4,3,23,256,1,677,1,7,3,3,4,single-choice,spatial-relational,3|4,7,3/4,230256,3
4,3,23,257,1,803,1,5,2,2,3,single-choice,spatial-relational,2|3,7,2/3,230257,2
4,3,23,258,1,693,1,11,5,5,6,single-choice,spatial-relational,5|6,7,5/6,230258,5
4,3,23,259,1,744,1,3,1,1,2,single-choice,spatial-relational,1|2,7,1/2,230259,1
4,3,23,260,1,579,1,3,1,1,2,single-choice,spatial-relational,1|2,7,1/2,230260,1
4,3,23,261,1,546,1,13,6,6,7,single-choice,spatial-relational,6|7,7,6/7,230261,6
4,3,23,262,0,666,1,9,4,5,5,single-choice,spatial-relational,4|5,7,4/5,230262,4
4,3,23,263,0,694,1,9,4,5,5,single-choice,spatial-relational,4|5,7,4/5,230263,4
4,3,23,264,1,538,1,11,5,5,6,single-choice,spatial-relational,5|6,7,5/6,230264,5
4,3,23,265,1,698,1,13,6,6,7,single-choice,spatial-relational,6|7,7,6/7,230265,6
4,3,23,266,0,545,1,9,4,5,5,single-choice,spatial-relational,4|5,7,4/5,230266,4
4,3,23,267,1,567,1,5,2,2,3,single-choice,spatial-relational,2|3,7,2/3,230267,2
4,3,23,268,1,596,1,5,2,2,3,single-choice,spatial-relational,2|3,7,2/3,230268,2
4,3,23,269,0,604,1,3,1,2,2,single-choice,spatial-relational,1|2,7,1/2,230269,1
4,3,23,270,0,630,1,7,3,4,4,single-choice,spatial-relational,3|4,7,3/4,230270,3
4,3,23,271,0,648,1,13,6,7,7,single-choice,spatial-relational,6|7,7,6/7,230271,6
4,3,23,272,1,750,1,9,4,4,5,single-choice,spatial-relational,4|5,7,4/5,230272,4
4,3,23,273,1,583,1,3,1,1,2,single-choice,spatial-relational,1|2,7,1/2,230273,1
4,3,23,274,1,717,1,7,3,3,4,single-choice,spatial-relational,3|4,7,3/4,230274,3
4,3,23,275,1,637,1,11,5,5,6,single-choice,spatial-relational,5|6,7,5/6,230275,5
4,3,23,276,1,923,1,11,5,5,6,single-choice,spatial-relational,5|6,7,5/6,230276,5
4,3,23,277,0,572,1,7,3,4,4,single-choice,spatial-relational,3|4,7,3/4,230277,3
4,3,23,278,1,763,1,9,4,4,5,single-choice,spatial-relational,4|5,7,4/5,230278,4
4,3,23,279,0,771,1,9,4,5,5,single-choice,spatial-relational,4|5,7,4/5,230279,4
4,3,23,280,1,602,1,13,6,6,7,single-choice,spatial-relational,6|7,7,6/7,230280,6
4,3,23,281,1,592,1,3,1,1,2,single-choice,spatial-relational,1|2,7,1/2,230281,1
4,3,23,282,1,615,1,11,5,5,6,single-choice,spatial-relational,5|6,7,5/6,230282,5
4,3,23,283,1,548,1,5,2,2,3,single-choice,spatial-relational,2|3,7,2/3,230283,2
4,3,23,284,1,655,1,11,5,5,6,single-choice,spatial-relational,5|6,7,5/6,230284,5
4,3,23,285,1,564,1,13,6,6,7,single-choice,spatial-relational,6|7,7,6/7,230285,6
4,3,23,286,0,572,1,3,1,2,2,single-choice,spatial-relational,1|2,7,1/2,230286,1
4,3,23,287,1,778,1,7,3,3,4,single-choice,spatial-relational,3|4,7,3/4,230287,3
4,3,23,288,1,602,1,5,2,2,3,single-choice,spatial-relational,2|3,7,2/3,230288,2
4,3,23,289,1,615,1,5,2,2,3,single-choice,spatial-relational,2|3,7,2/3,230289,2
4,3,23,290,1,629,1,3,1,1,2,single-choice,spatial-relational,1|2,7,1/2,230290,1
4,3,23,291,0,642,1,9,4,5,5,single-choice,spatial-relational,4|5,7,4/5,230291,4
4,3,23,292,0,701,1,9,4,5,5,single-choice,spatial-relational,4|5,7,4/5,230292,4
4,3,23,293,0,734,1,7,3,4,4,single-choice,spatial-relational,3|4,7,3/4,230293,3
4,3,23,294,1,597,1,5,2,2,3,single-choice,spatial-relational,2|3,7,2/3,230294,2
4,3,23,295,1,533,1,13,6,6,7,single-choice,spatial-relational,6|7,7,6/7,230295,6
4,3,23,296,1,783,1,11,5,5,6,single-choice,spatial-relational,5|6,7,5/6,230296,5
4,3,23,297,1,635,1,13,6,6,7,single-choice,spatial-relational,6|7,7,6/7,230297,6
4,3,23,298,1,660,1,11,5,5,6,single-choice,spatial-relational,5|6,7,5/6,230298,5
4,3,23,299,0,1233,1,7,3,4,4,single-choice,spatial-relational,3|4,7,3/4,230299,3
4,3,23,300,0,607,1,3,1,2,2,single-choice,spatial-relational,1|2,7,1/2,230300,1
4,3,23,301,1,532,1,11,5,5,6,single-choice,spatial-relational,5|6,7,5/6,230301,5
4,3,23,302,1,575,1,3,1,1,2,single-choice,spatial-relational,1|2,7,1/2,230302,1
4,3,23,303,1,647,1,7,3,3,4,single-choice,spatial-relational,3|4,7,3/4,230303,3
4,3,23,304,1,757,1,9,4,4,5,single-choice,spatial-relational,4|5,7,4/5,230304,4
4,3,23,305,1,705,1,7,3,3,4,single-choice,spatial-relational,3|4,7,3/4,230305,3
4,3,23,306,1,615,1,5,2,2,3,single-choice,spatial-relational,2|3,7,2/3,230306,2
4,3,23,307,1,720,1,5,2,2,3,single-choice,spatial-relational,2|3,7,2/3,230307,2
4,3,23,308,0,563,1,3,1,2,2,single-choice,spatial-relational,1|2,7,1/2,230308,1
4,3,23,309,0,553,1,9,4,5,5,single-choice,spatial-relational,4|5,7,4/5,230309,4
4,3,23,310,1,596,1,13,6,6,7,single-choice,spatial-relational,6|7,7,6/7,230310,6
4,3,23,311,1,650,1,11,5,5,6,single-choice,spatial-relational,5|6,7,5/6,230311,5
4,3,23,312,1,634,1,13,6,6,7,single-choice,spatial-relational,6|7,7,6/7,230312,6
4,3,23,313,1,625,1,13,6,6,7,single-choice,spatial-relational,6|7,7,6/7,230313,6
4,3,23,314,0,673,1,3,1,2,2,single-choice,spatial-relational,1|2,7,1/2,230314,1
4,3,23,315,1,582,1,7,3,3,4,single-choice,spatial-relational,3|4,7,3/4,230315,3
4,3,23,316,1,569,1,13,6,6,7,single-choice,spatial-relational,6|7,7,6/7,230316,6
4,3,23,317,1,923,1,5,2,2,3,single-choice,spatial-relational,2|3,7,2/3,230317,2
4,3,23,318,1,553,1,5,2,2,3,single-choice,spatial-relational,2|3,7,2/3,230318,2
4,3,23,319,0,779,1,7,3,4,4,single-choice,spatial-relational,3|4,7,3/4,230319,3
4,3,23,320,1,633,1,11,5,5,6,single-choice,spatial-relational,5|6,7,5/6,230320,5
4,3,23,321,0,634,1,9,4,5,5,single-choice,spatial-relational,4|5,7,4/5,230321,4
4,3,23,322,1,638,1,3,1,1,2,single-choice,spatial-relational,1|2,7,1/2,230322,1
4,3,23,323,0,655,1,9,4,5,5,single-choice,spatial-relational,4|5,7,4/5,230323,4
4,3,23,324,1,48,1,11,5,5,6,single-choice,spatial-relational,5|6,7,5/6,230324,5
4,3,23,325,1,745,1,9,4,4,5,single-choice,spatial-relational,4|5,7,4/5,230325,4
4,3,23,326,1,658,1,3,1,1,2,single-choice,spatial-relational,1|2,7,1/2,230326,1
4,3,23,327,1,665,1,5,2,2,3,single-choice,spatial-relational,2|3,7,2/3,230327,2
4,3,23,328,1,989,1,3,1,1,2,single-choice,spatial-relational,1|2,7,1/2,230328,1
4,3,23,329,0,595,1,9,4,5,5,single-choice,spatial-relational,4|5,7,4/5,230329,4
4,3,23,330,1,562,1,13,6,6,7,single-choice,spatial-relational,6|7,7,6/7,230330,6
4,3,23,331,0,587,1,5,2,3,3,single-choice,spatial-relational,2|3,7,2/3,230331,2
4,3,23,332,1,686,1,11,5,5,6,single-choice,spatial-relational,5|6,7,5/6,230332,5
4,3,23,333,1,607,1,7,3,3,4,single-choice,spatial-relational,3|4,7,3/4,230333,3
4,3,23,334,1,713,1,13,6,6,7,single-choice,spatial-relational,6|7,7,6/7,230334,6
4,3,23,335,1,662,1,11,5,5,6,single-choice,spatial-relational,5|6,7,5/6,230335,5
4,3,23,336,1,765,1,7,3,3,4,single-choice,spatial-relational,3|4,7,3/4,230336,3
4,3,23,337,0,552,1,3,1,2,2,single-choice,spatial-relational,1|2,7,1/2,230337,1
4,3,23,338,0,651,1,7,3,4,4,single-choice,spatial-relational,3|4,7,3/4,230338,3
4,3,23,339,1,721,1,7,3,3,4,single-choice,spatial-relational,3|4,7,3/4,230339,3
4,3,23,340,1,698,1,5,2,2,3,single-choice,spatial-relational,2|3,7,2/3,230340,2
4,3,23,341,1,645,1,9,4,4,5,single-choice,spatial-relational,4|5,7,4/5,230341,4
4,3,23,342,1,797,1,11,5,5,6,single-choice,spatial-relational,5|6,7,5/6,230342,5
4,3,23,343,1,576,1,13,6,6,7,single-choice,spatial-relational,6|7,7,6/7,230343,6
4,3,23,344,0,875,1,9,4,5,5,single-choice,spatial-relational,4|5,7,4/5,230344,4
4,3,23,345,1,587,1,3,1,1,2,single-choice,spatial-relational,1|2,7,1/2,230345,1
4,3,23,346,1,614,1,11,5,5,6,single-choice,spatial-relational,5|6,7,5/6,230346,5
4,3,23,347,1,619,1,13,6,6,7,single-choice,spatial-relational,6|7,7,6/7,230347,6
4,3,23,348,1,725,1,5,2,2,3,single-choice,spatial-relational,2|3,7,2/3,230348,2
4,3,23,349,0,2341,1,9,4,5,5,single-choice,spatial-relational,4|5,7,4/5,230349,4
4,3,23,350,1,669,1,9,4,4,5,single-choice,spatial-relational,4|5,7,4/5,230350,4
4,3,23,351,0,599,1,3,1,2,2,single-choice,spatial-relational,1|2,7,1/2,230351,1
4,3,23,352,1,604,1,7,3,3,4,single-choice,spatial-relational,3|4,7,3/4,230352,3
4,3,23,353,1,544,1,13,6,6,7,single-choice,spatial-relational,6|7,7,6/7,230353,6
4,3,23,354,1,800,1,11,5,5,6,single-choice,spatial-relational,5|6,7,5/6,230354,5
4,3,23,355,1,638,1,13,6,6,7,single-choice,spatial-relational,6|7,7,6/7,230355,6
4,3,23,356,1,3862,1,7,3,3,4,single-choice,spatial-relational,3|4,7,3/4,230356,3
4,3,23,357,1,1158,1,5,2,2,3,single-choice,spatial-relational,2|3,7,2/3,230357,2
4,3,23,358,1,665,1,11,5,5,6,single-choice,spatial-relational,5|6,7,5/6,230358,5
4,3,23,359,1,664,1,3,1,1,2,single-choice,spatial-relational,1|2,7,1/2,230359,1
4,3,23,360,1,704,1,5,2,2,3,single-choice,spatial-relational,2|3,7,2/3,230360,2
4,3,23,361,1,654,1,9,4,4,5,single-choice,spatial-relational,4|5,7,4/5,230361,4
4,3,23,362,1,662,1,13,6,6,7,single-choice,spatial-relational,6|7,7,6/7,230362,6
4,3,23,363,1,611,1,5,2,2,3,single-choice,spatial-relational,2|3,7,2/3,230363,2
4,3,23,364,1,611,1,3,1,1,2,single-choice,spatial-relational,1|2,7,1/2,230364,1
4,3,23,365,1,526,1,13,6,6,7,single-choice,spatial-relational,6|7,7,6/7,230365,6
4,3,23,366,0,611,1,7,3,4,4,single-choice,spatial-relational,3|4,7,3/4,230366,3
4,3,23,367,0,507,1,9,4,5,5,single-choice,spatial-relational,4|5,7,4/5,230367,4
4,3,23,368,1,544,1,3,1,1,2,single-choice,spatial-relational,1|2,7,1/2,230368,1
4,3,23,369,1,605,1,11,5,5,6,single-choice,spatial-relational,5|6,7,5/6,230369,5
4,3,23,370,1,772,1,11,5,5,6,single-choice,spatial-relational,5|6,7,5/6,230370,5
4,3,23,371,1,619,1,5,2,2,3,single-choice,spatial-relational,2|3,7,2/3,230371,2
4,3,23,372,1,639,1,7,3,3,4,single-choice,spatial-relational,3|4,7,3/4,230372,3
4,3,23,373,0,573,1,9,4,5,5,single-choice,spatial-relational,4|5,7,4/5,230373,4
4,3,23,374,1,614,1,5,2,2,3,single-choice,spatial-relational,2|3,7,2/3,230374,2
4,3,23,375,1,556,1,5,2,2,3,single-choice,spatial-relational,2|3,7,2/3,230375,2
4,3,23,376,1,720,1,7,3,3,4,single-choice,spatial-relational,3|4,7,3/4,230376,3
4,3,23,377,1,610,1,11,5,5,6,single-choice,spatial-relational,5|6,7,5/6,230377,5
4,3,23,378,1,693,1,11,5,5,6,single-choice,spatial-relational,5|6,7,5/6,230378,5
4,3,23,379,1,561,1,3,1,1,2,single-choice,spatial-relational,1|2,7,1/2,230379,1
4,3,23,380,1,613,1,7,3,3,4,single-choice,spatial-relational,3|4,7,3/4,230380,3
4,3,23,381,1,676,1,3,1,1,2,single-choice,spatial-relational,1|2,7,1/2,230381,1
4,3,23,382,0,486,1,13,6,7,7,single-choice,spatial-relational,6|7,7,6/7,230382,6
4,3,23,383,1,577,1,13,6,6,7,single-choice,spatial-relational,6|7,7,6/7,230383,6
4,3,23,384,1,673,1,9,4,4,5,single-choice,spatial-relational,4|5,7,4/5,230384,4
4,3,23,385,1,693,1,5,2,2,3,single-choice,spatial-relational,2|3,7,2/3,230385,2
4,3,23,386,1,596,1,7,3,3,4,single-choice,spatial-relational,3|4,7,3/4,230386,3
4,3,23,387,1,637,1,5,2,2,3,single-choice,spatial-relational,2|3,7,2/3,230387,2
4,3,23,388,1,709,1,7,3,3,4,single-choice,spatial-relational,3|4,7,3/4,230388,3
4,3,23,389,1,800,1,9,4,4,5,single-choice,spatial-relational,4|5,7,4/5,230389,4
4,3,23,390,0,829,1,9,4,5,5,single-choice,spatial-relational,4|5,7,4/5,230390,4
4,3,23,391,1,637,1,13,6,6,7,single-choice,spatial-relational,6|7,7,6/7,230391,6
4,3,23,392,1,607,1,13,6,6,7,single-choice,spatial-relational,6|7,7,6/7,230392,6
4,3,23,393,1,744,1,11,5,5,6,single-choice,spatial-relational,5|6,7,5/6,230393,5
4,3,23,394,1,628,1,11,5,5,6,single-choice,spatial-relational,5|6,7,5/6,230394,5
4,3,23,395,1,630,1,3,1,1,2,single-choice,spatial-relational,1|2,7,1/2,230395,1
4,3,23,396,1,698,1,3,1,1,2,single-choice,spatial-relational,1|2,7,1/2,230396,1
4,3,23,397,1,623,1,3,1,1,2,single-choice,spatial-relational,1|2,7,1/2,230397,1
4,3,23,398,1,685,1,7,3,3,4,single-choice,spatial-relational,3|4,7,3/4,230398,3
4,3,23,399,1,599,1,11,5,5,6,single-choice,spatial-relational,5|6,7,5/6,230399,5
4,3,23,400,0,1139,1,11,5,6,6,single-choice,spatial-relational,5|6,7,5/6,230400,5
4,3,23,401,1,677,1,9,4,4,5,single-choice,spatial-relational,4|5,7,4/5,230401,4
4,3,23,402,1,740,1,13,6,6,7,single-choice,spatial-relational,6|7,7,6/7,230402,6
4,3,23,403,1,622,1,13,6,6,7,single-choice,spatial-relational,6|7,7,6/7,230403,6
4,3,23,404,1,675,1,5,2,2,3,single-choice,spatial-relational,2|3,7,2/3,230404,2
4,3,23,405,1,806,1,7,3,3,4,single-choice,spatial-relational,3|4,7,3/4,230405,3
4,3,23,406,0,584,1,3,1,2,2,single-choice,spatial-relational,1|2,7,1/2,230406,1
4,3,23,407,1,795,1,5,2,2,3,single-choice,spatial-relational,2|3,7,2/3,230407,2
4,3,23,408,0,587,1,9,4,5,5,single-choice,spatial-relational,4|5,7,4/5,230408,4
4,3,23,409,1,604,1,11,5,5,6,single-choice,spatial-relational,5|6,7,5/6,230409,5
4,3,23,410,1,634,1,9,4,4,5,single-choice,spatial-relational,4|5,7,4/5,230410,4
4,3,23,411,1,642,1,5,2,2,3,single-choice,spatial-relational,2|3,7,2/3,230411,2
4,3,23,412,1,611,1,7,3,3,4,single-choice,spatial-relational,3|4,7,3/4,230412,3
4,3,23,413,1,595,1,5,2,2,3,single-choice,spatial-relational,2|3,7,2/3,230413,2
4,3,23,414,1,692,1,11,5,5,6,single-choice,spatial-relational,5|6,7,5/6,230414,5
4,3,23,415,0,541,1,3,1,2,2,single-choice,spatial-relational,1|2,7,1/2,230415,1
4,3,23,416,0,475,1,9,4,5,5,single-choice,spatial-relational,4|5,7,4/5,230416,4
4,3,23,417,1,795,1,7,3,3,4,single-choice,spatial-relational,3|4,7,3/4,230417,3
4,3,23,418,0,705,1,13,6,7,7,single-choice,spatial-relational,6|7,7,6/7,230418,6
4,3,23,419,1,670,1,3,1,1,2,single-choice,spatial-relational,1|2,7,1/2,230419,1
4,3,23,420,1,622,1,13,6,6,7,single-choice,spatial-relational,6|7,7,6/7,230420,6
4,3,23,421,1,895,1,9,4,4,5,single-choice,spatial-relational,4|5,7,4/5,230421,4
4,3,23,422,1,511,1,13,6,6,7,single-choice,spatial-relational,6|7,7,6/7,230422,6
4,3,23,423,1,626,1,5,2,2,3,single-choice,spatial-relational,2|3,7,2/3,230423,2
4,3,23,424,0,758,1,3,1,2,2,single-choice,spatial-relational,1|2,7,1/2,230424,1
4,3,23,425,1,649,1,11,5,5,6,single-choice,spatial-relational,5|6,7,5/6,230425,5
4,3,23,426,1,662,1,13,6,6,7,single-choice,spatial-relational,6|7,7,6/7,230426,6
4,3,23,427,1,849,1,7,3,3,4,single-choice,spatial-relational,3|4,7,3/4,230427,3
4,3,23,428,1,720,1,11,5,5,6,single-choice,spatial-relational,5|6,7,5/6,230428,5
4,3,23,429,0,560,1,3,1,2,2,single-choice,spatial-relational,1|2,7,1/2,230429,1
4,3,23,430,1,462,1,5,2,2,3,single-choice,spatial-relational,2|3,7,2/3,230430,2
4,3,23,431,0,619,1,9,4,5,5,single-choice,spatial-relational,4|5,7,4/5,230431,4
4,3,23,432,0,762,1,7,3,4,4,single-choice,spatial-relational,3|4,7,3/4,230432,3
4,3,23,433,1,1123,1,3,1,1,2,single-choice,spatial-relational,1|2,7,1/2,230433,1
4,3,23,434,0,720,1,3,1,2,2,single-choice,spatial-relational,1|2,7,1/2,230434,1
4,3,23,435,1,667,1,7,3,3,4,single-choice,spatial-relational,3|4,7,3/4,230435,3
4,3,23,436,0,665,1,9,4,5,5,single-choice,spatial-relational,4|5,7,4/5,230436,4
4,3,23,437,1,779,1,9,4,4,5,single-choice,spatial-relational,4|5,7,4/5,230437,4
4,3,23,438,1,639,1,13,6,6,7,single-choice,spatial-relational,6|7,7,6/7,230438,6
4,3,23,439,1,560,1,7,3,3,4,single-choice,spatial-relational,3|4,7,3/4,230439,3
4,3,23,440,1,702,1,11,5,5,6,single-choice,spatial-relational,5|6,7,5/6,230440,5
4,3,23,441,1,772,1,5,2,2,3,single-choice,spatial-relational,2|3,7,2/3,230441,2
4,3,23,442,1,780,1,11,5,5,6,single-choice,spatial-relational,5|6,7,5/6,230442,5
4,3,23,443,1,580,1,5,2,2,3,single-choice,spatial-relational,2|3,7,2/3,230443,2
4,3,23,444,1,646,1,13,6,6,7,single-choice,spatial-relational,6|7,7,6/7,230444,6
4,3,23,445,0,622,1,9,4,5,5,single-choice,spatial-relational,4|5,7,4/5,230445,4
4,3,23,446,1,626,1,13,6,6,7,single-choice,spatial-relational,6|7,7,6/7,230446,6
4,3,23,447,0,615,1,11,5,6,6,single-choice,spatial-relational,5|6,7,5/6,230447,5
4,3,23,448,0,49,1,9,4,5,5,single-choice,spatial-relational,4|5,7,4/5,230448,4
4,3,23,449,1,638,1,5,2,2,3,single-choice,spatial-relational,2|3,7,2/3,230449,2
4,3,23,450,1,595,1,5,2,2,3,single-choice,spatial-relational,2|3,7,2/3,230450,2
4,3,23,451,0,623,1,3,1,2,2,single-choice,spatial-relational,1|2,7,1/2,230451,1
4,3,23,452,1,548,1,3,1,1,2,single-choice,spatial-relational,1|2,7,1/2,230452,1
4,3,23,453,1,607,1,7,3,3,4,single-choice,spatial-relational,3|4,7,3/4,230453,3
4,3,23,454,1,732,1,11,5,5,6,single-choice,spatial-relational,5|6,7,5/6,230454,5
4,3,23,455,1,625,1,7,3,3,4,single-choice,spatial-relational,3|4,7,3/4,230455,3
4,3,23,456,1,623,1,13,6,6,7,single-choice,spatial-relational,6|7,7,6/7,230456,6
4,3,23,457,0,638,1,3,1,2,2,single-choice,spatial-relational,1|2,7,1/2,230457,1
4,3,23,458,1,743,1,7,3,3,4,single-choice,spatial-relational,3|4,7,3/4,230458,3
4,3,23,459,1,728,1,9,4,4,5,single-choice,spatial-relational,4|5,7,4/5,230459,4
4,3,23,460,0,1151,1,3,1,2,2,single-choice,spatial-relational,1|2,7,1/2,230460,1
4,3,23,461,1,610,1,13,6,6,7,single-choice,spatial-relational,6|7,7,6/7,230461,6
4,3,23,462,1,666,1,11,5,5,6,single-choice,spatial-relational,5|6,7,5/6,230462,5
4,3,23,463,1,619,1,11,5,5,6,single-choice,spatial-relational,5|6,7,5/6,230463,5
4,3,23,464,1,736,1,5,2,2,3,single-choice,spatial-relational,2|3,7,2/3,230464,2
4,3,23,465,1,708,1,7,3,3,4,single-choice,spatial-relational,3|4,7,3/4,230465,3
4,3,23,466,0,764,1,9,4,5,5,single-choice,spatial-relational,4|5,7,4/5,230466,4
4,3,23,467,1,529,1,13,6,6,7,single-choice,spatial-relational,6|7,7,6/7,230467,6
4,3,23,468,1,622,1,5,2,2,3,single-choice,spatial-relational,2|3,7,2/3,230468,2
4,3,23,469,1,644,1,13,6,6,7,single-choice,spatial-relational,6|7,7,6/7,230469,6
4,3,23,470,1,590,1,5,2,2,3,single-choice,spatial-relational,2|3,7,2/3,230470,2
4,3,23,471,1,740,1,11,5,5,6,single-choice,spatial-relational,5|6,7,5/6,230471,5
4,3,23,472,0,592,1,3,1,2,2,single-choice,spatial-relational,1|2,7,1/2,230472,1
4,3,23,473,1,590,1,3,1,1,2,single-choice,spatial-relational,1|2,7,1/2,230473,1
4,3,23,474,1,739,1,7,3,3,4,single-choice,spatial-relational,3|4,7,3/4,230474,3
4,3,23,475,1,623,1,5,2,2,3,single-choice,spatial-relational,2|3,7,2/3,230475,2
4,3,23,476,1,568,1,13,6,6,7,single-choice,spatial-relational,6|7,7,6/7,230476,6
4,3,23,477,0,630,1,9,4,5,5,single-choice,spatial-relational,4|5,7,4/5,230477,4
4,3,23,478,0,585,1,11,5,6,6,single-choice,spatial-relational,5|6,7,5/6,230478,5
4,3,23,479,1,703,1,7,3,3,4,single-choice,spatial-relational,3|4,7,3/4,230479,3
4,3,23,480,0,619,1,9,4,5,5,single-choice,spatial-relational,4|5,7,4/5,230480,4
4,3,23,481,1,643,1,7,3,3,4,single-choice,spatial-relational,3|4,7,3/4,230481,3
4,3,23,482,1,667,1,9,4,4,5,single-choice,spatial-relational,4|5,7,4/5,230482,4
4,3,23,483,1,747,1,5,2,2,3,single-choice,spatial-relational,2|3,7,2/3,230483,2
4,3,23,484,1,658,1,5,2,2,3,single-choice,spatial-relational,2|3,7,2/3,230484,2
4,3,23,485,1,651,1,11,5,5,6,single-choice,spatial-relational,5|6,7,5/6,230485,5
4,3,23,486,1,657,1,3,1,1,2,single-choice,spatial-relational,1|2,7,1/2,230486,1
4,3,23,487,1,565,1,13,6,6,7,single-choice,spatial-relational,6|7,7,6/7,230487,6
4,3,23,488,0,584,1,11,5,6,6,single-choice,spatial-relational,5|6,7,5/6,230488,5
4,3,23,489,1,686,1,13,6,6,7,single-choice,spatial-relational,6|7,7,6/7,230489,6
4,3,23,490,0,763,1,9,4,5,5,single-choice,spatial-relational,4|5,7,4/5,230490,4
4,3,23,491,1,588,1,7,3,3,4,single-choice,spatial-relational,3|4,7,3/4,230491,3
4,3,23,492,0,580,1,3,1,2,2,single-choice,spatial-relational,1|2,7,1/2,230492,1
4,3,23,493,1,697,1,9,4,4,5,single-choice,spatial-relational,4|5,7,4/5,230493,4
4,3,23,494,1,925,1,11,5,5,6,single-choice,spatial-relational,5|6,7,5/6,230494,5
4,3,23,495,1,634,1,13,6,6,7,single-choice,spatial-relational,6|7,7,6/7,230495,6
4,3,23,496,1,615,1,7,3,3,4,single-choice,spatial-relational,3|4,7,3/4,230496,3
4,3,23,497,1,654,1,3,1,1,2,single-choice,spatial-relational,1|2,7,1/2,230497,1
4,3,23,498,1,584,1,5,2,2,3,single-choice,spatial-relational,2|3,7,2/3,230498,2
4,3,23,499,0,605,1,11,5,6,6,single-choice,spatial-relational,5|6,7,5/6,230499,5
4,3,23,500,0,654,1,7,3,4,4,single-choice,spatial-relational,3|4,7,3/4,230500,3
4,3,23,501,1,535,1,5,2,2,3,single-choice,spatial-relational,2|3,7,2/3,230501,2
4,3,23,502,0,558,1,9,4,5,5,single-choice,spatial-relational,4|5,7,4/5,230502,4
4,3,23,503,1,621,1,3,1,1,2,single-choice,spatial-relational,1|2,7,1/2,230503,1
4,3,23,504,1,517,1,13,6,6,7,single-choice,spatial-relational,6|7,7,6/7,230504,6
4,3,23,505,1,553,1,3,1,1,2,single-choice,spatial-relational,1|2,7,1/2,230505,1
4,3,23,506,1,844,1,13,6,6,7,single-choice,spatial-relational,6|7,7,6/7,230506,6
4,3,23,507,1,654,1,11,5,5,6,single-choice,spatial-relational,5|6,7,5/6,230507,5
4,3,23,508,0,983,1,9,4,5,5,single-choice,spatial-relational,4|5,7,4/5,230508,4
4,3,23,509,1,573,1,5,2,2,3,single-choice,spatial-relational,2|3,7,2/3,230509,2
4,3,23,510,1,612,1,13,6,6,7,single-choice,spatial-relational,6|7,7,6/7,230510,6
4,3,23,511,1,779,1,5,2,2,3,single-choice,spatial-relational,2|3,7,2/3,230511,2
4,3,23,512,0,584,1,3,1,2,2,single-choice,spatial-relational,1|2,7,1/2,230512,1
4,3,23,513,1,738,1,7,3,3,4,single-choice,spatial-relational,3|4,7,3/4,230513,3
4,3,23,514,1,783,1,7,3,3,4,single-choice,spatial-relational,3|4,7,3/4,230514,3
4,3,23,515,1,696,1,11,5,5,6,single-choice,spatial-relational,5|6,7,5/6,230515,5
4,3,23,516,0,647,1,9,4,5,5,single-choice,spatial-relational,4|5,7,4/5,230516,4
4,3,23,517,0,493,1,9,4,5,5,single-choice,spatial-relational,4|5,7,4/5,230517,4
4,3,23,518,1,538,1,13,6,6,7,single-choice,spatial-relational,6|7,7,6/7,230518,6
4,3,23,519,1,873,1,5,2,2,3,single-choice,spatial-relational,2|3,7,2/3,230519,2
4,3,23,520,1,611,1,3,1,1,2,single-choice,spatial-relational,1|2,7,1/2,230520,1
4,3,23,521,1,619,1,9,4,4,5,single-choice,spatial-relational,4|5,7,4/5,230521,4
4,3,23,522,1,674,1,13,6,6,7,single-choice,spatial-relational,6|7,7,6/7,230522,6
4,3,23,523,1,759,1,7,3,3,4,single-choice,spatial-relational,3|4,7,3/4,230523,3
4,3,23,524,1,705,1,11,5,5,6,single-choice,spatial-relational,5|6,7,5/6,230524,5
4,3,23,525,0,811,1,3,1,2,2,single-choice,spatial-relational,1|2,7,1/2,230525,1
4,3,23,526,1,634,1,5,2,2,3,single-choice,spatial-relational,2|3,7,2/3,230526,2
4,3,23,527,1,628,1,11,5,5,6,single-choice,spatial-relational,5|6,7,5/6,230527,5
4,3,23,528,1,597,1,7,3,3,4,single-choice,spatial-relational,3|4,7,3/4,230528,3
4,3,23,529,1,742,1,3,1,1,2,single-choice,spatial-relational,1|2,7,1/2,230529,1
4,3,23,530,1,631,1,11,5,5,6,single-choice,spatial-relational,5|6,7,5/6,230530,5
4,3,23,531,1,793,1,7,3,3,4,single-choice,spatial-relational,3|4,7,3/4,230531,3
4,3,23,532,1,701,1,13,6,6,7,single-choice,spatial-relational,6|7,7,6/7,230532,6
4,3,23,533,1,802,1,11,5,5,6,single-choice,spatial-relational,5|6,7,5/6,230533,5
4,3,23,534,0,635,1,9,4,5,5,single-choice,spatial-relational,4|5,7,4/5,230534,4
4,3,23,535,0,615,1,3,1,2,2,single-choice,spatial-relational,1|2,7,1/2,230535,1
4,3,23,536,1,646,1,5,2,2,3,single-choice,spatial-relational,2|3,7,2/3,230536,2
4,3,23,537,1,809,1,7,3,3,4,single-choice,spatial-relational,3|4,7,3/4,230537,3
4,3,23,538,1,669,1,13,6,6,7,single-choice,spatial-relational,6|7,7,6/7,230538,6
4,3,23,539,0,1057,1,9,4,5,5,single-choice,spatial-relational,4|5,7,4/5,230539,4
4,3,23,540,1,607,1,5,2,2,3,single-choice,spatial-relational,2|3,7,2/3,230540,2
4,3,23,541,1,725,1,7,3,3,4,single-choice,spatial-relational,3|4,7,3/4,230541,3
4,3,23,542,1,733,1,5,2,2,3,single-choice,spatial-relational,2|3,7,2/3,230542,2
4,3,23,543,1,701,1,11,5,5,6,single-choice,spatial-relational,5|6,7,5/6,230543,5
4,3,23,544,0,994,1,9,4,5,5,single-choice,spatial-relational,4|5,7,4/5,230544,4
4,3,23,545,1,192,1,13,6,6,7,single-choice,spatial-relational,6|7,7,6/7,230545,6
4,3,23,546,1,644,1,13,6,6,7,single-choice,spatial-relational,6|7,7,6/7,230546,6
4,3,23,547,1,753,1,5,2,2,3,single-choice,spatial-relational,2|3,7,2/3,230547,2
4,3,23,548,1,679,1,3,1,1,2,single-choice,spatial-relational,1|2,7,1/2,230548,1
4,3,23,549,0,676,1,7,3,4,4,single-choice,spatial-relational,3|4,7,3/4,230549,3
4,3,23,550,1,852,1,9,4,4,5,single-choice,spatial-relational,4|5,7,4/5,230550,4
4,3,23,551,0,612,1,3,1,2,2,single-choice,spatial-relational,1|2,7,1/2,230551,1
4,3,23,552,1,567,1,11,5,5,6,single-choice,spatial-relational,5|6,7,5/6,230552,5
4,3,23,553,1,870,1,7,3,3,4,single-choice,spatial-relational,3|4,7,3/4,230553,3
4,3,23,554,1,721,1,11,5,5,6,single-choice,spatial-relational,5|6,7,5/6,230554,5
4,3,23,555,1,756,1,3,1,1,2,single-choice,spatial-relational,1|2,7,1/2,230555,1
4,3,23,556,0,634,1,13,6,7,7,single-choice,spatial-relational,6|7,7,6/7,230556,6
4,3,23,557,0,607,1,3,1,2,2,single-choice,spatial-relational,1|2,7,1/2,230557,1
4,3,23,558,1,649,1,13,6,6,7,single-choice,spatial-relational,6|7,7,6/7,230558,6
4,3,23,559,0,897,1,9,4,5,5,single-choice,spatial-relational,4|5,7,4/5,230559,4
4,3,23,560,1,1071,1,11,5,5,6,single-choice,spatial-relational,5|6,7,5/6,230560,5
4,3,23,561,0,701,1,5,2,3,3,single-choice,spatial-relational,2|3,7,2/3,230561,2
4,3,23,562,1,776,1,9,4,4,5,single-choice,spatial-relational,4|5,7,4/5,230562,4
4,3,23,563,1,677,1,5,2,2,3,single-choice,spatial-relational,2|3,7,2/3,230563,2
4,3,23,564,1,747,1,7,3,3,4,single-choice,spatial-relational,3|4,7,3/4,230564,3
4,3,23,565,0,556,1,5,2,3,3,single-choice,spatial-relational,2|3,7,2/3,230565,2
4,3,23,566,1,635,1,13,6,6,7,single-choice,spatial-relational,6|7,7,6/7,230566,6
4,3,23,567,1,654,1,5,2,2,3,single-choice,spatial-relational,2|3,7,2/3,230567,2
4,3,23,568,1,680,1,11,5,5,6,single-choice,spatial-relational,5|6,7,5/6,230568,5
4,3,23,569,1,733,1,9,4,4,5,single-choice,spatial-relational,4|5,7,4/5,230569,4
4,3,23,570,1,652,1,7,3,3,4,single-choice,spatial-relational,3|4,7,3/4,230570,3
4,3,23,571,1,635,1,3,1,1,2,single-choice,spatial-relational,1|2,7,1/2,230571,1
4,3,23,572,1,1163,1,7,3,3,4,single-choice,spatial-relational,3|4,7,3/4,230572,3
4,3,23,573,1,575,1,13,6,6,7,single-choice,spatial-relational,6|7,7,6/7,230573,6
4,3,23,574,1,933,1,9,4,4,5,single-choice,spatial-relational,4|5,7,4/5,230574,4
4,3,23,575,1,732,1,3,1,1,2,single-choice,spatial-relational,1|2,7,1/2,230575,1
4,3,23,576,1,788,1,11,5,5,6,single-choice,spatial-relational,5|6,7,5/6,230576,5
4,3,23,577,1,796,1,7,3,3,4,single-choice,spatial-relational,3|4,7,3/4,230577,3
4,3,23,578,1,642,1,13,6,6,7,single-choice,spatial-relational,6|7,7,6/7,230578,6
4,3,23,579,1,760,1,11,5,5,6,single-choice,spatial-relational,5|6,7,5/6,230579,5
4,3,23,580,1,654,1,13,6,6,7,single-choice,spatial-relational,6|7,7,6/7,230580,6
4,3,23,581,1,771,1,11,5,5,6,single-choice,spatial-relational,5|6,7,5/6,230581,5
4,3,23,582,1,681,1,3,1,1,2,single-choice,spatial-relational,1|2,7,1/2,230582,1
4,3,23,583,1,595,1,3,1,1,2,single-choice,spatial-relational,1|2,7,1/2,230583,1
4,3,23,584,1,670,1,5,2,2,3,single-choice,spatial-relational,2|3,7,2/3,230584,2
4,3,23,585,0,654,1,9,4,5,5,single-choice,spatial-relational,4|5,7,4/5,230585,4
4,3,23,586,1,594,1,5,2,2,3,single-choice,spatial-relational,2|3,7,2/3,230586,2
4,3,23,587,1,623,1,9,4,4,5,single-choice,spatial-relational,4|5,7,4/5,230587,4
4,3,23,588,1,642,1,7,3,3,4,single-choice,spatial-relational,3|4,7,3/4,230588,3
4,3,23,589,1,774,1,11,5,5,6,single-choice,spatial-relational,5|6,7,5/6,230589,5
4,3,23,590,1,633,1,13,6,6,7,single-choice,spatial-relational,6|7,7,6/7,230590,6
4,3,23,591,0,685,1,9,4,5,5,single-choice,spatial-relational,4|5,7,4/5,230591,4
4,3,23,592,0,648,1,3,1,2,2,single-choice,spatial-relational,1|2,7,1/2,230592,1
4,3,23,593,1,552,1,13,6,6,7,single-choice,spatial-relational,6|7,7,6/7,230593,6
4,3,23,594,0,1183,1,11,5,6,6,single-choice,spatial-relational,5|6,7,5/6,230594,5
4,3,23,595,1,604,1,3,1,1,2,single-choice,spatial-relational,1|2,7,1/2,230595,1
4,3,23,596,0,760,1,9,4,5,5,single-choice,spatial-relational,4|5,7,4/5,230596,4
4,3,23,597,1,556,1,5,2,2,3,single-choice,spatial-relational,2|3,7,2/3,230597,2
4,3,23,598,0,775,1,7,3,4,4,single-choice,spatial-relational,3|4,7,3/4,230598,3
4,3,23,599,1,628,1,7,3,3,4,single-choice,spatial-relational,3|4,7,3/4,230599,3
4,3,23,600,1,584,1,5,2,2,3,single-choice,spatial-relational,2|3,7,2/3,230600,2
5,3,23,1,1,811,1,3,1,1,2,single-choice,spatial-relational,1|2,7,1/2,230001,1
5,3,23,2,1,1211,1,5,2,2,3,single-choice,spatial-relational,2|3,7,2/3,230002,2
5,3,23,3,0,778,1,9,4,5,5,single-choice,spatial-relational,4|5,7,4/5,230003,4
5,3,23,4,0,566,1,11,5,6,6,single-choice,spatial-relational,5|6,7,5/6,230004,5
5,3,23,5,0,530,1,3,1,2,2,single-choice,spatial-relational,1|2,7,1/2,230005,1
5,3,23,6,1,602,1,7,3,3,4,single-choice,spatial-relational,3|4,7,3/4,230006,3
5,3,23,7,1,757,1,13,6,6,7,single-choice,spatial-relational,6|7,7,6/7,230007,6
5,3,23,8,0,658,1,9,4,5,5,single-choice,spatial-relational,4|5,7,4/5,230008,4
5,3,23,9,1,575,1,13,6,6,7,single-choice,spatial-relational,6|7,7,6/7,230009,6
5,3,23,10,1,484,1,7,3,3,4,single-choice,spatial-relational,3|4,7,3/4,230010,3
5,3,23,11,1,678,1,11,5,5,6,single-choice,spatial-relational,5|6,7,5/6,230011,5
5,3,23,12,0,521,1,5,2,3,3,single-choice,spatial-relational,2|3,7,2/3,230012,2
5,3,23,13,1,598,1,9,4,4,5,single-choice,spatial-relational,4|5,7,4/5,230013,4
5,3,23,14,1,582,1,7,3,3,4,single-choice,spatial-relational,3|4,7,3/4,230014,3
5,3,23,15,0,572,1,9,4,5,5,single-choice,spatial-relational,4|5,7,4/5,230015,4
5,3,23,16,1,600,1,11,5,5,6,single-choice,spatial-relational,5|6,7,5/6,230016,5
5,3,23,17,1,564,1,5,2,2,3,single-choice,spatial-relational,2|3,7,2/3,230017,2
5,3,23,18,1,509,1,13,6,6,7,single-choice,spatial-relational,6|7,7,6/7,230018,6
5,3,23,19,1,801,1,13,6,6,7,single-choice,spatial-relational,6|7,7,6/7,230019,6
5,3,23,20,1,501,1,7,3,3,4,single-choice,spatial-relational,3|4,7,3/4,230020,3
5,3,23,21,1,647,1,3,1,1,2,single-choice,spatial-relational,1|2,7,1/2,230021,1
5,3,23,22,1,529,1,3,1,1,2,single-choice,spatial-relational,1|2,7,1/2,230022,1
5,3,23,23,0,549,1,5,2,3,3,single-choice,spatial-relational,2|3,7,2/3,230023,2
5,3,23,24,0,598,1,11,5,6,6,single-choice,spatial-relational,5|6,7,5/6,230024,5
5,3,23,25,1,554,1,13,6,6,7,single-choice,spatial-relational,6|7,7,6/7,230025,6
5,3,23,26,0,627,1,5,2,3,3,single-choice,spatial-relational,2|3,7,2/3,230026,2
5,3,23,27,1,541,1,11,5,5,6,single-choice,spatial-relational,5|6,7,5/6,230027,5
5,3,23,28,0,592,1,9,4,5,5,single-choice,spatial-relational,4|5,7,4/5,230028,4
5,3,23,29,1,491,1,3,1,1,2,single-choice,spatial-relational,1|2,7,1/2,230029,1
5,3,23,30,0,534,1,3,1,2,2,single-choice,spatial-relational,1|2,7,1/2,230030,1
5,3,23,31,1,567,1,11,5,5,6,single-choice,spatial-relational,5|6,7,5/6,230031,5
5,3,23,32,0,524,1,9,4,5,5,single-choice,spatial-relational,4|5,7,4/5,230032,4
5,3,23,33,1,530,1,5,2,2,3,single-choice,spatial-relational,2|3,7,2/3,230033,2
5,3,23,34,0,572,1,13,6,7,7,single-choice,spatial-relational,6|7,7,6/7,230034,6
5,3,23,35,1,562,1,7,3,3,4,single-choice,spatial-relational,3|4,7,3/4,230035,3
5,3,23,36,1,592,1,7,3,3,4,single-choice,spatial-relational,3|4,7,3/4,230036,3
5,3,23,37,1,646,1,9,4,4,5,single-choice,spatial-relational,4|5,7,4/5,230037,4
5,3,23,38,1,583,1,5,2,2,3,single-choice,spatial-relational,2|3,7,2/3,230038,2
5,3,23,39,1,633,1,11,5,5,6,single-choice,spatial-relational,5|6,7,5/6,230039,5
5,3,23,40,1,654,1,7,3,3,4,single-choice,spatial-relational,3|4,7,3/4,230040,3
5,3,23,41,0,600,1,3,1,2,2,single-choice,spatial-relational,1|2,7,1/2,230041,1
5,3,23,42,0,457,1,9,4,5,5,single-choice,spatial-relational,4|5,7,4/5,230042,4
5,3,23,43,0,475,1,3,1,2,2,single-choice,spatial-relational,1|2,7,1/2,230043,1
5,3,23,44,1,592,1,5,2,2,3,single-choice,spatial-relational,2|3,7,2/3,230044,2
5,3,23,45,1,545,1,13,6,6,7,single-choice,spatial-relational,6|7,7,6/7,230045,6
5,3,23,46,1,543,1,11,5,5,6,single-choice,spatial-relational,5|6,7,5/6,230046,5
5,3,23,47,1,574,1,13,6,6,7,single-choice,spatial-relational,6|7,7,6/7,230047,6
5,3,23,48,1,579,1,7,3,3,4,single-choice,spatial-relational,3|4,7,3/4,230048,3
5,3,23,49,0,523,1,11,5,6,6,single-choice,spatial-relational,5|6,7,5/6,230049,5
5,3,23,50,1,589,1,9,4,4,5,single-choice,spatial-relational,4|5,7,4/5,230050,4
5,3,23,51,1,557,1,5,2,2,3,single-choice,spatial-relational,2|3,7,2/3,230051,2
5,3,23,52,1,544,1,13,6,6,7,single-choice,spatial-relational,6|7,7,6/7,230052,6
5,3,23,53,0,484,1,3,1,2,2,single-choice,spatial-relational,1|2,7,1/2,230053,1
5,3,23,54,1,624,1,7,3,3,4,single-choice,spatial-relational,3|4,7,3/4,230054,3
5,3,23,55,0,455,1,9,4,5,5,single-choice,spatial-relational,4|5,7,4/5,230055,4
5,3,23,56,0,658,1,3,1,2,2,single-choice,spatial-relational,1|2,7,1/2,230056,1
5,3,23,57,1,743,1,7,3,3,4,single-choice,spatial-relational,3|4,7,3/4,230057,3
5,3,23,58,1,691,1,5,2,2,3,single-choice,spatial-relational,2|3,7,2/3,230058,2
5,3,23,59,1,525,1,13,6,6,7,single-choice,spatial-relational,6|7,7,6/7,230059,6
5,3,23,60,1,654,1,11,5,5,6,single-choice,spatial-relational,5|6,7,5/6,230060,5
5,3,23,61,0,529,1,5,2,3,3,single-choice,spatial-relational,2|3,7,2/3,230061,2
5,3,23,62,0,592,1,7,3,4,4,single-choice,spatial-relational,3|4,7,3/4,230062,3
5,3,23,63,0,533,1,11,5,6,6,single-choice,spatial-relational,5|6,7,5/6,230063,5
5,3,23,64,1,586,1,5,2,2,3,single-choice,spatial-relational,2|3,7,2/3,230064,2
5,3,23,65,1,494,1,11,5,5,6,single-choice,spatial-relational,5|6,7,5/6,230065,5
5,3,23,66,0,573,1,13,6,7,7,single-choice,spatial-relational,6|7,7,6/7,230066,6
5,3,23,67,0,645,1,3,1,2,2,single-choice,spatial-relational,1|2,7,1/2,230067,1
5,3,23,68,1,467,1,7,3,3,4,single-choice,spatial-relational,3|4,7,3/4,230068,3
5,3,23,69,0,467,1,3,1,2,2,single-choice,spatial-relational,1|2,7,1/2,230069,1
5,3,23,70,1,555,1,13,6,6,7,single-choice,spatial-relational,6|7,7,6/7,230070,6
5,3,23,71,0,424,1,9,4,5,5,single-choice,spatial-relational,4|5,7,4/5,230071,4
5,3,23,72,1,619,1,9,4,4,5,single-choice,spatial-relational,4|5,7,4/5,230072,4
5,3,23,73,1,591,1,9,4,4,5,single-choice,spatial-relational,4|5,7,4/5,230073,4
5,3,23,74,1,705,1,5,2,2,3,single-choice,spatial-relational,2|3,7,2/3,230074,2
5,3,23,75,1,561,1,11,5,5,6,single-choice,spatial-relational,5|6,7,5/6,230075,5
5,3,23,76,0,924,1,7,3,4,4,single-choice,spatial-relational,3|4,7,3/4,230076,3
5,3,23,77,0,601,1,5,2,3,3,single-choice,spatial-relational,2|3,7,2/3,230077,2
5,3,23,78,1,522,1,13,6,6,7,single-choice,spatial-relational,6|7,7,6/7,230078,6
5,3,23,79,0,544,1,3,1,2,2,single-choice,spatial-relational,1|2,7,1/2,230079,1
5,3,23,80,1,603,1,11,5,5,6,single-choice,spatial-relational,5|6,7,5/6,230080,5
5,3,23,81,1,577,1,13,6,6,7,single-choice,spatial-relational,6|7,7,6/7,230081,6
5,3,23,82,0,496,1,9,4,5,5,single-choice,spatial-relational,4|5,7,4/5,230082,4
5,3,23,83,1,527,1,3,1,1,2,single-choice,spatial-relational,1|2,7,1/2,230083,1
5,3,23,84,0,642,1,7,3,4,4,single-choice,spatial-relational,3|4,7,3/4,230084,3
5,3,23,85,1,655,1,5,2,2,3,single-choice,spatial-relational,2|3,7,2/3,230085,2
5,3,23,86,0,558,1,7,3,4,4,single-choice,spatial-relational,3|4,7,3/4,230086,3
5,3,23,87,1,614,1,11,5,5,6,single-choice,spatial-relational,5|6,7,5/6,230087,5
5,3,23,88,1,596,1,5,2,2,3,single-choice,spatial-relational,2|3,7,2/3,230088,2
5,3,23,89,0,572,1,3,1,2,2,single-choice,spatial-relational,1|2,7,1/2,230089,1
5,3,23,90,1,500,1,13,6,6,7,single-choice,spatial-relational,6|7,7,6/7,230090,6
5,3,23,91,1,604,1,13,6,6,7,single-choice,spatial-relational,6|7,7,6/7,230091,6
5,3,23,92,0,545,1,11,5,6,6,single-choice,spatial-relational,5|6,7,5/6,230092,5
5,3,23,93,1,611,1,9,4,4,5,single-choice,spatial-relational,4|5,7,4/5,230093,4
5,3,23,94,1,736,1,7,3,3,4,single-choice,spatial-relational,3|4,7,3/4,230094,3
5,3,23,95,1,782,1,9,4,4,5,single-choice,spatial-relational,4|5,7,4/5,230095,4
5,3,23,96,1,730,1,3,1,1,2,single-choice,spatial-relational,1|2,7,1/2,230096,1
5,3,23,97,0,515,1,3,1,2,2,single-choice,spatial-relational,1|2,7,1/2,230097,1
5,3,23,98,1,579,1,7,3,3,4,single-choice,spatial-relational,3|4,7,3/4,230098,3
5,3,23,99,1,573,1,11,5,5,6,single-choice,spatial-relational,5|6,7,5/6,230099,5
5,3,23,100,1,630,1,7,3,3,4,single-choice,spatial-relational,3|4,7,3/4,230100,3
5,3,23,101,0,537,1,3,1,2,2,single-choice,spatial-relational,1|2,7,1/2,230101,1
5,3,23,102,1,531,1,5,2,2,3,single-choice,spatial-relational,2|3,7,2/3,230102,2
5,3,23,103,1,652,1,9,4,4,5,single-choice,spatial-relational,4|5,7,4/5,230103,4
5,3,23,104,1,743,1,13,6,6,7,single-choice,spatial-relational,6|7,7,6/7,230104,6
5,3,23,105,1,763,1,11,5,5,6,single-choice,spatial-relational,5|6,7,5/6,230105,5
5,3,23,106,1,660,1,13,6,6,7,single-choice,spatial-relational,6|7,7,6/7,230106,6
5,3,23,107,1,723,1,5,2,2,3,single-choice,spatial-relational,2|3,7,2/3,230107,2
5,3,23,108,0,651,1,9,4,5,5,single-choice,spatial-relational,4|5,7,4/5,230108,4
5,3,23,109,1,591,1,5,2,2,3,single-choice,spatial-relational,2|3,7,2/3,230109,2
5,3,23,110,1,572,1,13,6,6,7,single-choice,spatial-relational,6|7,7,6/7,230110,6
5,3,23,111,1,595,1,11,5,5,6,single-choice,spatial-relational,5|6,7,5/6,230111,5
5,3,23,112,1,739,1,3,1,1,2,single-choice,spatial-relational,1|2,7,1/2,230112,1
5,3,23,113,1,634,1,7,3,3,4,single-choice,spatial-relational,3|4,7,3/4,230113,3
5,3,23,114,1,604,1,3,1,1,2,single-choice,spatial-relational,1|2,7,1/2,230114,1
5,3,23,115,1,802,1,9,4,4,5,single-choice,spatial-relational,4|5,7,4/5,230115,4
5,3,23,116,1,688,1,13,6,6,7,single-choice,spatial-relational,6|7,7,6/7,230116,6
5,3,23,117,0,789,1,9,4,5,5,single-choice,spatial-relational,4|5,7,4/5,230117,4
5,3,23,118,1,686,1,7,3,3,4,single-choice,spatial-relational,3|4,7,3/4,230118,3
5,3,23,119,1,612,1,5,2,2,3,single-choice,spatial-relational,2|3,7,2/3,230119,2
5,3,23,120,0,595,1,11,5,6,6,single-choice,spatial-relational,5|6,7,5/6,230120,5
5,3,23,121,0,580,1,3,1,2,2,single-choice,spatial-relational,1|2,7,1/2,230121,1
5,3,23,122,0,621,1,3,1,2,2,single-choice,spatial-relational,1|2,7,1/2,230122,1
5,3,23,123,1,603,1,11,5,5,6,single-choice,spatial-relational,5|6,7,5/6,230123,5
5,3,23,124,1,576,1,13,6,6,7,single-choice,spatial-relational,6|7,7,6/7,230124,6
5,3,23,125,1,763,1,5,2,2,3,single-choice,spatial-relational,2|3,7,2/3,230125,2
5,3,23,126,1,607,1,7,3,3,4,single-choice,spatial-relational,3|4,7,3/4,230126,3
5,3,23,127,1,630,1,13,6,6,7,single-choice,spatial-relational,6|7,7,6/7,230127,6
5,3,23,128,0,584,1,9,4,5,5,single-choice,spatial-relational,4|5,7,4/5,230128,4
5,3,23,129,1,736,1,11,5,5,6,single-choice,spatial-relational,5|6,7,5/6,230129,5
5,3,23,130,1,824,1,7,3,3,4,single-choice,spatial-relational,3|4,7,3/4,230130,3
5,3,23,131,1,541,1,5,2,2,3,single-choice,spatial-relational,2|3,7,2/3,230131,2
5,3,23,132,1,684,1,9,4,4,5,single-choice,spatial-relational,4|5,7,4/5,230132,4
5,3,23,133,1,732,1,5,2,2,3,single-choice,spatial-relational,2|3,7,2/3,230133,2
5,3,23,134,0,552,1,3,1,2,2,single-choice,spatial-relational,1|2,7,1/2,230134,1
5,3,23,135,1,602,1,11,5,5,6,single-choice,spatial-relational,5|6,7,5/6,230135,5
5,3,23,136,0,541,1,9,4,5,5,single-choice,spatial-relational,4|5,7,4/5,230136,4
5,3,23,137,1,576,1,5,2,2,3,single-choice,spatial-relational,2|3,7,2/3,230137,2
5,3,23,138,1,646,1,7,3,3,4,single-choice,spatial-relational,3|4,7,3/4,230138,3
5,3,23,139,0,764,1,9,4,5,5,single-choice,spatial-relational,4|5,7,4/5,230139,4
5,3,23,140,1,604,1,13,6,6,7,single-choice,spatial-relational,6|7,7,6/7,230140,6
5,3,23,141,1,729,1,7,3,3,4,single-choice,spatial-relational,3|4,7,3/4,230141,3
5,3,23,142,1,532,1,13,6,6,7,single-choice,spatial-relational,6|7,7,6/7,230142,6
5,3,23,143,0,571,1,11,5,6,6,single-choice,spatial-relational,5|6,7,5/6,230143,5
5,3,23,144,1,688,1,3,1,1,2,single-choice,spatial-relational,1|2,7,1/2,230144,1
5,3,23,145,1,591,1,11,5,5,6,single-choice,spatial-relational,5|6,7,5/6,230145,5
5,3,23,146,0,490,1,3,1,2,2,single-choice,spatial-relational,1|2,7,1/2,230146,1
5,3,23,147,1,678,1,5,2,2,3,single-choice,spatial-relational,2|3,7,2/3,230147,2
5,3,23,148,1,580,1,13,6,6,7,single-choice,spatial-relational,6|7,7,6/7,230148,6
5,3,23,149,1,626,1,3,1,1,2,single-choice,spatial-relational,1|2,7,1/2,230149,1
5,3,23,150,0,863,1,9,4,5,5,single-choice,spatial-relational,4|5,7,4/5,230150,4
5,3,23,151,1,693,1,11,5,5,6,single-choice,spatial-relational,5|6,7,5/6,230151,5
5,3,23,152,1,553,1,13,6,6,7,single-choice,spatial-relational,6|7,7,6/7,230152,6
5,3,23,153,1,635,1,7,3,3,4,single-choice,spatial-relational,3|4,7,3/4,230153,3
5,3,23,154,0,713,1,9,4,5,5,single-choice,spatial-relational,4|5,7,4/5,230154,4
5,3,23,155,0,68,1,5,2,3,3,single-choice,spatial-relational,2|3,7,2/3,230155,2
5,3,23,156,0,632,1,7,3,4,4,single-choice,spatial-relational,3|4,7,3/4,230156,3
5,3,23,157,0,782,1,5,2,3,3,single-choice,spatial-relational,2|3,7,2/3,230157,2
5,3,23,158,1,656,1,13,6,6,7,single-choice,spatial-relational,6|7,7,6/7,230158,6
5,3,23,159,0,830,1,3,1,2,2,single-choice,spatial-relational,1|2,7,1/2,230159,1
5,3,23,160,1,558,1,5,2,2,3,single-choice,spatial-relational,2|3,7,2/3,230160,2
5,3,23,161,0,525,1,9,4,5,5,single-choice,spatial-relational,4|5,7,4/5,230161,4
5,3,23,162,1,619,1,11,5,5,6,single-choice,spatial-relational,5|6,7,5/6,230162,5
5,3,23,163,1,1096,1,11,5,5,6,single-choice,spatial-relational,5|6,7,5/6,230163,5
5,3,23,164,0,552,1,3,1,2,2,single-choice,spatial-relational,1|2,7,1/2,230164,1
5,3,23,165,1,759,1,7,3,3,4,single-choice,spatial-relational,3|4,7,3/4,230165,3
5,3,23,166,0,574,1,9,4,5,5,single-choice,spatial-relational,4|5,7,4/5,230166,4
5,3,23,167,0,606,1,7,3,4,4,single-choice,spatial-relational,3|4,7,3/4,230167,3
5,3,23,168,1,599,1,13,6,6,7,single-choice,spatial-relational,6|7,7,6/7,230168,6
5,3,23,169,1,514,1,13,6,6,7,single-choice,spatial-relational,6|7,7,6/7,230169,6
5,3,23,170,1,566,1,3,1,1,2,single-choice,spatial-relational,1|2,7,1/2,230170,1
5,3,23,171,1,660,1,7,3,3,4,single-choice,spatial-relational,3|4,7,3/4,230171,3
5,3,23,172,0,690,1,5,2,3,3,single-choice,spatial-relational,2|3,7,2/3,230172,2
5,3,23,173,1,585,1,11,5,5,6,single-choice,spatial-relational,5|6,7,5/6,230173,5
5,3,23,174,1,736,1,5,2,2,3,single-choice,spatial-relational,2|3,7,2/3,230174,2
5,3,23,175,1,705,1,7,3,3,4,single-choice,spatial-relational,3|4,7,3/4,230175,3
5,3,23,176,0,556,1,3,1,2,2,single-choice,spatial-relational,1|2,7,1/2,230176,1
5,3,23,177,1,600,1,11,5,5,6,single-choice,spatial-relational,5|6,7,5/6,230177,5
5,3,23,178,1,607,1,13,6,6,7,single-choice,spatial-relational,6|7,7,6/7,230178,6
5,3,23,179,0,794,1,9,4,5,5,single-choice,spatial-relational,4|5,7,4/5,230179,4
5,3,23,180,1,864,1,9,4,4,5,single-choice,spatial-relational,4|5,7,4/5,230180,4
5,3,23,181,0,704,1,3,1,2,2,single-choice,spatial-relational,1|2,7,1/2,230181,1
5,3,23,182,1,811,1,11,5,5,6,single-choice,spatial-relational,5|6,7,5/6,230182,5
5,3,23,183,1,592,1,13,6,6,7,single-choice,spatial-relational,6|7,7,6/7,230183,6
5,3,23,184,1,783,1,3,1,1,2,single-choice,spatial-relational,1|2,7,1/2,230184,1
5,3,23,185,1,661,1,7,3,3,4,single-choice,spatial-relational,3|4,7,3/4,230185,3
5,3,23,186,1,579,1,7,3,3,4,single-choice,spatial-relational,3|4,7,3/4,230186,3
5,3,23,187,1,955,1,9,4,4,5,single-choice,spatial-relational,4|5,7,4/5,230187,4
5,3,23,188,1,742,1,9,4,4,5,single-choice,spatial-relational,4|5,7,4/5,230188,4
5,3,23,189,1,721,1,13,6,6,7,single-choice,spatial-relational,6|7,7,6/7,230189,6
5,3,23,190,0,662,1,11,5,6,6,single-choice,spatial-relational,5|6,7,5/6,230190,5
5,3,23,191,1,618,1,5,2,2,3,single-choice,spatial-relational,2|3,7,2/3,230191,2
5,3,23,192,1,760,1,5,2,2,3,single-choice,spatial-relational,2|3,7,2/3,230192,2
5,3,23,193,1,588,1,13,6,6,7,single-choice,spatial-relational,6|7,7,6/7,230193,6
5,3,23,194,1,572,1,3,1,1,2,single-choice,spatial-relational,1|2,7,1/2,230194,1
5,3,23,195,1,658,1,5,2,2,3,single-choice,spatial-relational,2|3,7,2/3,230195,2
5,3,23,196,0,557,1,3,1,2,2,single-choice,spatial-relational,1|2,7,1/2,230196,1
5,3,23,197,1,612,1,7,3,3,4,single-choice,spatial-relational,3|4,7,3/4,230197,3
5,3,23,198,1,815,1,5,2,2,3,single-choice,spatial-relational,2|3,7,2/3,230198,2
5,3,23,199,0,1178,1,9,4,5,5,single-choice,spatial-relational,4|5,7,4/5,230199,4
5,3,23,200,1,558,1,13,6,6,7,single-choice,spatial-relational,6|7,7,6/7,230200,6
5,3,23,201,1,826,1,9,4,4,5,single-choice,spatial-relational,4|5,7,4/5,230201,4
5,3,23,202,0,1252,1,7,3,4,4,single-choice,spatial-relational,3|4,7,3/4,230202,3
5,3,23,203,1,826,1,11,5,5,6,single-choice,spatial-relational,5|6,7,5/6,230203,5
5,3,23,204,1,967,1,11,5,5,6,single-choice,spatial-relational,5|6,7,5/6,230204,5
5,3,23,205,1,641,1,13,6,6,7,single-choice,spatial-relational,6|7,7,6/7,230205,6
5,3,23,206,1,870,1,9,4,4,5,single-choice,spatial-relational,4|5,7,4/5,230206,4
5,3,23,207,0,550,1,3,1,2,2,single-choice,spatial-relational,1|2,7,1/2,230207,1
5,3,23,208,1,732,1,7,3,3,4,single-choice,spatial-relational,3|4,7,3/4,230208,3
5,3,23,209,1,695,1,9,4,4,5,single-choice,spatial-relational,4|5,7,4/5,230209,4
5,3,23,210,1,833,1,11,5,5,6,single-choice,spatial-relational,5|6,7,5/6,230210,5
5,3,23,211,0,596,1,7,3,4,4,single-choice,spatial-relational,3|4,7,3/4,230211,3
5,3,23,212,1,731,1,5,2,2,3,single-choice,spatial-relational,2|3,7,2/3,230212,2
5,3,23,213,1,634,1,13,6,6,7,single-choice,spatial-relational,6|7,7,6/7,230213,6
5,3,23,214,1,711,1,11,5,5,6,single-choice,spatial-relational,5|6,7,5/6,230214,5
5,3,23,215,0,774,1,3,1,2,2,single-choice,spatial-relational,1|2,7,1/2,230215,1
5,3,23,216,1,647,1,5,2,2,3,single-choice,spatial-relational,2|3,7,2/3,230216,2
5,3,23,217,1,818,1,9,4,4,5,single-choice,spatial-relational,4|5,7,4/5,230217,4
5,3,23,218,1,737,1,9,4,4,5,single-choice,spatial-relational,4|5,7,4/5,230218,4
5,3,23,219,1,713,1,11,5,5,6,single-choice,spatial-relational,5|6,7,5/6,230219,5
5,3,23,220,1,601,1,11,5,5,6,single-choice,spatial-relational,5|6,7,5/6,230220,5
5,3,23,221,0,743,1,3,1,2,2,single-choice,spatial-relational,1|2,7,1/2,230221,1
5,3,23,222,1,720,1,7,3,3,4,single-choice,spatial-relational,3|4,7,3/4,230222,3
5,3,23,223,0,736,1,5,2,3,3,single-choice,spatial-relational,2|3,7,2/3,230223,2
5,3,23,224,1,613,1,13,6,6,7,single-choice,spatial-relational,6|7,7,6/7,230224,6
5,3,23,225,1,604,1,13,6,6,7,single-choice,spatial-relational,6|7,7,6/7,230225,6
5,3,23,226,1,564,1,3,1,1,2,single-choice,spatial-relational,1|2,7,1/2,230226,1
5,3,23,227,1,887,1,7,3,3,4,single-choice,spatial-relational,3|4,7,3/4,230227,3
5,3,23,228,1,655,1,5,2,2,3,single-choice,spatial-relational,2|3,7,2/3,230228,2
5,3,23,229,0,706,1,7,3,4,4,single-choice,spatial-relational,3|4,7,3/4,230229,3
5,3,23,230,1,763,1,9,4,4,5,single-choice,spatial-relational,4|5,7,4/5,230230,4
5,3,23,231,1,577,1,5,2,2,3,single-choice,spatial-relational,2|3,7,2/3,230231,2
5,3,23,232,1,604,1,7,3,3,4,single-choice,spatial-relational,3|4,7,3/4,230232,3
5,3,23,233,1,2326,1,3,1,1,2,single-choice,spatial-relational,1|2,7,1/2,230233,1
5,3,23,234,1,548,1,13,6,6,7,single-choice,spatial-relational,6|7,7,6/7,230234,6
5,3,23,235,1,618,1,13,6,6,7,single-choice,spatial-relational,6|7,7,6/7,230235,6
5,3,23,236,1,702,1,11,5,5,6,single-choice,spatial-relational,5|6,7,5/6,230236,5
5,3,23,237,1,521,1,3,1,1,2,single-choice,spatial-relational,1|2,7,1/2,230237,1
5,3,23,238,1,572,1,11,5,5,6,single-choice,spatial-relational,5|6,7,5/6,230238,5
5,3,23,239,1,822,1,9,4,4,5,single-choice,spatial-relational,4|5,7,4/5,230239,4
5,3,23,240,1,633,1,5,2,2,3,single-choice,spatial-relational,2|3,7,2/3,230240,2
5,3,23,241,1,783,1,3,1,1,2,single-choice,spatial-relational,1|2,7,1/2,230241,1
5,3,23,242,1,607,1,3,1,1,2,single-choice,spatial-relational,1|2,7,1/2,230242,1
5,3,23,243,1,633,1,5,2,2,3,single-choice,spatial-relational,2|3,7,2/3,230243,2
5,3,23,244,0,717,1,9,4,5,5,single-choice,spatial-relational,4|5,7,4/5,230244,4
5,3,23,245,1,684,1,7,3,3,4,single-choice,spatial-relational,3|4,7,3/4,230245,3
5,3,23,246,0,602,1,5,2,3,3,single-choice,spatial-relational,2|3,7,2/3,230246,2
5,3,23,247,1,759,1,9,4,4,5,single-choice,spatial-relational,4|5,7,4/5,230247,4
5,3,23,248,1,592,1,13,6,6,7,single-choice,spatial-relational,6|7,7,6/7,230248,6
5,3,23,249,1,592,1,11,5,5,6,single-choice,spatial-relational,5|6,7,5/6,230249,5
5,3,23,250,1,855,1,7,3,3,4,single-choice,spatial-relational,3|4,7,3/4,230250,3
5,3,23,251,1,583,1,13,6,6,7,single-choice,spatial-relational,6|7,7,6/7,230251,6
5,3,23,252,0,531,1,11,5,6,6,single-choice,spatial-relational,5|6,7,5/6,230252,5
5,3,23,253,0,576,1,9,4,5,5,single-choice,spatial-relational,4|5,7,4/5,230253,4
5,3,23,254,1,625,1,11,5,5,6,single-choice,spatial-relational,5|6,7,5/6,230254,5
5,3,23,255,1,690,1,7,3,3,4,single-choice,spatial-relational,3|4,7,3/4,230255,3
5,3,23,256,1,590,1,11,5,5,6,single-choice,spatial-relational,5|6,7,5/6,230256,5
5,3,23,257,1,611,1,5,2,2,3,single-choice,spatial-relational,2|3,7,2/3,230257,2
5,3,23,258,1,580,1,5,2,2,3,single-choice,spatial-relational,2|3,7,2/3,230258,2
5,3,23,259,0,924,1,7,3,4,4,single-choice,spatial-relational,3|4,7,3/4,230259,3
5,3,23,260,1,630,1,13,6,6,7,single-choice,spatial-relational,6|7,7,6/7,230260,6
5,3,23,261,1,587,1,3,1,1,2,single-choice,spatial-relational,1|2,7,1/2,230261,1
5,3,23,262,1,3036,1,3,1,1,2,single-choice,spatial-relational,1|2,7,1/2,230262,1
5,3,23,263,0,693,1,9,4,5,5,single-choice,spatial-relational,4|5,7,4/5,230263,4
5,3,23,264,1,620,1,13,6,6,7,single-choice,spatial-relational,6|7,7,6/7,230264,6
5,3,23,265,1,656,1,11,5,5,6,single-choice,spatial-relational,5|6,7,5/6,230265,5
5,3,23,266,0,1009,1,9,4,5,5,single-choice,spatial-relational,4|5,7,4/5,230266,4
5,3,23,267,1,612,1,13,6,6,7,single-choice,spatial-relational,6|7,7,6/7,230267,6
5,3,23,268,1,658,1,7,3,3,4,single-choice,spatial-relational,3|4,7,3/4,230268,3
5,3,23,269,1,672,1,11,5,5,6,single-choice,spatial-relational,5|6,7,5/6,230269,5
5,3,23,270,1,564,1,3,1,1,2,single-choice,spatial-relational,1|2,7,1/2,230270,1
5,3,23,271,1,595,1,5,2,2,3,single-choice,spatial-relational,2|3,7,2/3,230271,2
5,3,23,272,1,791,1,7,3,3,4,single-choice,spatial-relational,3|4,7,3/4,230272,3
5,3,23,273,1,857,1,3,1,1,2,single-choice,spatial-relational,1|2,7,1/2,230273,1
5,3,23,274,1,670,1,13,6,6,7,single-choice,spatial-relational,6|7,7,6/7,230274,6
5,3,23,275,0,635,1,9,4,5,5,single-choice,spatial-relational,4|5,7,4/5,230275,4
5,3,23,276,1,568,1,5,2,2,3,single-choice,spatial-relational,2|3,7,2/3,230276,2
5,3,23,277,0,1156,1,9,4,5,5,single-choice,spatial-relational,4|5,7,4/5,230277,4
5,3,23,278,1,654,1,11,5,5,6,single-choice,spatial-relational,5|6,7,5/6,230278,5
5,3,23,279,1,541,1,11,5,5,6,single-choice,spatial-relational,5|6,7,5/6,230279,5
5,3,23,280,1,607,1,13,6,6,7,single-choice,spatial-relational,6|7,7,6/7,230280,6
5,3,23,281,1,642,1,5,2,2,3,single-choice,spatial-relational,2|3,7,2/3,230281,2
5,3,23,282,1,693,1,3,1,1,2,single-choice,spatial-relational,1|2,7,1/2,230282,1
5,3,23,283,1,591,1,3,1,1,2,single-choice,spatial-relational,1|2,7,1/2,230283,1
5,3,23,284,1,604,1,5,2,2,3,single-choice,spatial-relational,2|3,7,2/3,230284,2
5,3,23,285,1,674,1,7,3,3,4,single-choice,spatial-relational,3|4,7,3/4,230285,3
5,3,23,286,1,665,1,13,6,6,7,single-choice,spatial-relational,6|7,7,6/7,230286,6
5,3,23,287,0,603,1,9,4,5,5,single-choice,spatial-relational,4|5,7,4/5,230287,4
5,3,23,288,1,602,1,7,3,3,4,single-choice,spatial-relational,3|4,7,3/4,230288,3
5,3,23,289,0,994,1,3,1,2,2,single-choice,spatial-relational,1|2,7,1/2,230289,1
5,3,23,290,1,646,1,11,5,5,6,single-choice,spatial-relational,5|6,7,5/6,230290,5
5,3,23,291,0,525,1,9,4,5,5,single-choice,spatial-relational,4|5,7,4/5,230291,4
5,3,23,292,1,515,1,5,2,2,3,single-choice,spatial-relational,2|3,7,2/3,230292,2
5,3,23,293,1,596,1,5,2,2,3,single-choice,spatial-relational,2|3,7,2/3,230293,2
5,3,23,294,1,626,1,7,3,3,4,single-choice,spatial-relational,3|4,7,3/4,230294,3
5,3,23,295,1,732,1,3,1,1,2,single-choice,spatial-relational,1|2,7,1/2,230295,1
5,3,23,296,0,908,1,11,5,6,6,single-choice,spatial-relational,5|6,7,5/6,230296,5
5,3,23,297,1,680,1,9,4,4,5,single-choice,spatial-relational,4|5,7,4/5,230297,4
5,3,23,298,1,741,1,7,3,3,4,single-choice,spatial-relational,3|4,7,3/4,230298,3
5,3,23,299,1,608,1,13,6,6,7,single-choice,spatial-relational,6|7,7,6/7,230299,6
5,3,23,300,1,593,1,13,6,6,7,single-choice,spatial-relational,6|7,7,6/7,230300,6
5,3,23,301,1,615,1,13,6,6,7,single-choice,spatial-relational,6|7,7,6/7,230301,6
5,3,23,302,1,834,1,9,4,4,5,single-choice,spatial-relational,4|5,7,4/5,230302,4
5,3,23,303,1,623,1,3,1,1,2,single-choice,spatial-relational,1|2,7,1/2,230303,1
5,3,23,304,0,615,1,9,4,5,5,single-choice,spatial-relational,4|5,7,4/5,230304,4
5,3,23,305,1,732,1,7,3,3,4,single-choice,spatial-relational,3|4,7,3/4,230305,3
5,3,23,306,1,861,1,3,1,1,2,single-choice,spatial-relational,1|2,7,1/2,230306,1
5,3,23,307,1,551,1,11,5,5,6,single-choice,spatial-relational,5|6,7,5/6,230307,5
5,3,23,308,1,643,1,13,6,6,7,single-choice,spatial-relational,6|7,7,6/7,230308,6
5,3,23,309,1,564,1,11,5,5,6,single-choice,spatial-relational,5|6,7,5/6,230309,5
5,3,23,310,0,568,1,5,2,3,3,single-choice,spatial-relational,2|3,7,2/3,230310,2
5,3,23,311,1,1157,1,7,3,3,4,single-choice,spatial-relational,3|4,7,3/4,230311,3
5,3,23,312,1,553,1,5,2,2,3,single-choice,spatial-relational,2|3,7,2/3,230312,2
5,3,23,313,0,814,1,9,4,5,5,single-choice,spatial-relational,4|5,7,4/5,230313,4
5,3,23,314,1,709,1,9,4,4,5,single-choice,spatial-relational,4|5,7,4/5,230314,4
5,3,23,315,1,592,1,5,2,2,3,single-choice,spatial-relational,2|3,7,2/3,230315,2
5,3,23,316,1,880,1,11,5,5,6,single-choice,spatial-relational,5|6,7,5/6,230316,5
5,3,23,317,0,548,1,5,2,3,3,single-choice,spatial-relational,2|3,7,2/3,230317,2
5,3,23,318,1,588,1,11,5,5,6,single-choice,spatial-relational,5|6,7,5/6,230318,5
5,3,23,319,1,634,1,7,3,3,4,single-choice,spatial-relational,3|4,7,3/4,230319,3
5,3,23,320,1,865,1,7,3,3,4,single-choice,spatial-relational,3|4,7,3/4,230320,3
5,3,23,321,1,565,1,3,1,1,2,single-choice,spatial-relational,1|2,7,1/2,230321,1
5,3,23,322,1,818,1,13,6,6,7,single-choice,spatial-relational,6|7,7,6/7,230322,6
5,3,23,323,1,642,1,13,6,6,7,single-choice,spatial-relational,6|7,7,6/7,230323,6
5,3,23,324,0,682,1,3,1,2,2,single-choice,spatial-relational,1|2,7,1/2,230324,1
5,3,23,325,1,808,1,9,4,4,5,single-choice,spatial-relational,4|5,7,4/5,230325,4
5,3,23,326,1,650,1,3,1,1,2,single-choice,spatial-relational,1|2,7,1/2,230326,1
5,3,23,327,1,681,1,11,5,5,6,single-choice,spatial-relational,5|6,7,5/6,230327,5
5,3,23,328,1,909,1,11,5,5,6,single-choice,spatial-relational,5|6,7,5/6,230328,5
5,3,23,329,0,615,1,7,3,4,4,single-choice,spatial-relational,3|4,7,3/4,230329,3
5,3,23,330,1,662,1,13,6,6,7,single-choice,spatial-relational,6|7,7,6/7,230330,6
5,3,23,331,1,760,1,5,2,2,3,single-choice,spatial-relational,2|3,7,2/3,230331,2
5,3,23,332,1,615,1,7,3,3,4,single-choice,spatial-relational,3|4,7,3/4,230332,3
5,3,23,333,1,577,1,13,6,6,7,single-choice,spatial-relational,6|7,7,6/7,230333,6
5,3,23,334,0,575,1,3,1,2,2,single-choice,spatial-relational,1|2,7,1/2,230334,1
5,3,23,335,1,823,1,9,4,4,5,single-choice,spatial-relational,4|5,7,4/5,230335,4
5,3,23,336,1,639,1,5,2,2,3,single-choice,spatial-relational,2|3,7,2/3,230336,2
5,3,23,337,0,740,1,9,4,5,5,single-choice,spatial-relational,4|5,7,4/5,230337,4
5,3,23,338,1,705,1,3,1,1,2,single-choice,spatial-relational,1|2,7,1/2,230338,1
5,3,23,339,0,580,1,9,4,5,5,single-choice,spatial-relational,4|5,7,4/5,230339,4
5,3,23,340,1,60,1,13,6,6,7,single-choice,spatial-relational,6|7,7,6/7,230340,6
5,3,23,341,1,582,1,13,6,6,7,single-choice,spatial-relational,6|7,7,6/7,230341,6
5,3,23,342,0,653,1,11,5,6,6,single-choice,spatial-relational,5|6,7,5/6,230342,5
5,3,23,343,1,529,1,5,2,2,3,single-choice,spatial-relational,2|3,7,2/3,230343,2
5,3,23,344,1,615,1,3,1,1,2,single-choice,spatial-relational,1|2,7,1/2,230344,1
5,3,23,345,1,580,1,5,2,2,3,single-choice,spatial-relational,2|3,7,2/3,230345,2
5,3,23,346,1,611,1,7,3,3,4,single-choice,spatial-relational,3|4,7,3/4,230346,3
5,3,23,347,1,704,1,7,3,3,4,single-choice,spatial-relational,3|4,7,3/4,230347,3
5,3,23,348,1,661,1,11,5,5,6,single-choice,spatial-relational,5|6,7,5/6,230348,5
5,3,23,349,0,593,1,5,2,3,3,single-choice,spatial-relational,2|3,7,2/3,230349,2
5,3,23,350,1,828,1,7,3,3,4,single-choice,spatial-relational,3|4,7,3/4,230350,3
5,3,23,351,1,783,1,9,4,4,5,single-choice,spatial-relational,4|5,7,4/5,230351,4
5,3,23,352,1,796,1,3,1,1,2,single-choice,spatial-relational,1|2,7,1/2,230352,1
5,3,23,353,1,572,1,7,3,3,4,single-choice,spatial-relational,3|4,7,3/4,230353,3
5,3,23,354,1,611,1,13,6,6,7,single-choice,spatial-relational,6|7,7,6/7,230354,6
5,3,23,355,0,826,1,11,5,6,6,single-choice,spatial-relational,5|6,7,5/6,230355,5
5,3,23,356,1,540,1,13,6,6,7,single-choice,spatial-relational,6|7,7,6/7,230356,6
5,3,23,357,1,571,1,5,2,2,3,single-choice,spatial-relational,2|3,7,2/3,230357,2
5,3,23,358,1,608,1,3,1,1,2,single-choice,spatial-relational,1|2,7,1/2,230358,1
5,3,23,359,0,970,1,11,5,6,6,single-choice,spatial-relational,5|6,7,5/6,230359,5
5,3,23,360,1,873,1,9,4,4,5,single-choice,spatial-relational,4|5,7,4/5,230360,4
5,3,23,361,1,620,1,11,5,5,6,single-choice,spatial-relational,5|6,7,5/6,230361,5
5,3,23,362,1,712,1,13,6,6,7,single-choice,spatial-relational,6|7,7,6/7,230362,6
5,3,23,363,0,615,1,5,2,3,3,single-choice,spatial-relational,2|3,7,2/3,230363,2
5,3,23,364,1,634,1,13,6,6,7,single-choice,spatial-relational,6|7,7,6/7,230364,6
5,3,23,365,1,545,1,5,2,2,3,single-choice,spatial-relational,2|3,7,2/3,230365,2
5,3,23,366,1,654,1,7,3,3,4,single-choice,spatial-relational,3|4,7,3/4,230366,3
5,3,23,367,0,701,1,9,4,5,5,single-choice,spatial-relational,4|5,7,4/5,230367,4
5,3,23,368,1,672,1,9,4,4,5,single-choice,spatial-relational,4|5,7,4/5,230368,4
5,3,23,369,1,650,1,3,1,1,2,single-choice,spatial-relational,1|2,7,1/2,230369,1
5,3,23,370,0,624,1,3,1,2,2,single-choice,spatial-relational,1|2,7,1/2,230370,1
5,3,23,371,1,812,1,11,5,5,6,single-choice,spatial-relational,5|6,7,5/6,230371,5
5,3,23,372,0,598,1,7,3,4,4,single-choice,spatial-relational,3|4,7,3/4,230372,3
5,3,23,373,1,719,1,7,3,3,4,single-choice,spatial-relational,3|4,7,3/4,230373,3
5,3,23,374,1,569,1,13,6,6,7,single-choice,spatial-relational,6|7,7,6/7,230374,6
5,3,23,375,1,822,1,5,2,2,3,single-choice,spatial-relational,2|3,7,2/3,230375,2
5,3,23,376,0,902,1,5,2,3,3,single-choice,spatial-relational,2|3,7,2/3,230376,2
5,3,23,377,1,592,1,13,6,6,7,single-choice,spatial-relational,6|7,7,6/7,230377,6
5,3,23,378,0,619,1,3,1,2,2,single-choice,spatial-relational,1|2,7,1/2,230378,1
5,3,23,379,1,779,1,11,5,5,6,single-choice,spatial-relational,5|6,7,5/6,230379,5
5,3,23,380,0,678,1,9,4,5,5,single-choice,spatial-relational,4|5,7,4/5,230380,4
5,3,23,381,1,646,1,11,5,5,6,single-choice,spatial-relational,5|6,7,5/6,230381,5
5,3,23,382,1,583,1,3,1,1,2,single-choice,spatial-relational,1|2,7,1/2,230382,1
5,3,23,383,0,574,1,9,4,5,5,single-choice,spatial-relational,4|5,7,4/5,230383,4
5,3,23,384,1,854,1,7,3,3,4,single-choice,spatial-relational,3|4,7,3/4,230384,3
5,3,23,385,0,785,1,9,4,5,5,single-choice,spatial-relational,4|5,7,4/5,230385,4
5,3,23,386,1,617,1,9,4,4,5,single-choice,spatial-relational,4|5,7,4/5,230386,4
5,3,23,387,1,615,1,5,2,2,3,single-choice,spatial-relational,2|3,7,2/3,230387,2
5,3,23,388,1,583,1,11,5,5,6,single-choice,spatial-relational,5|6,7,5/6,230388,5
5,3,23,389,0,630,1,13,6,7,7,single-choice,spatial-relational,6|7,7,6/7,230389,6
5,3,23,390,0,672,1,5,2,3,3,single-choice,spatial-relational,2|3,7,2/3,230390,2
5,3,23,391,1,639,1,7,3,3,4,single-choice,spatial-relational,3|4,7,3/4,230391,3
5,3,23,392,1,678,1,13,6,6,7,single-choice,spatial-relational,6|7,7,6/7,230392,6
5,3,23,393,0,611,1,3,1,2,2,single-choice,spatial-relational,1|2,7,1/2,230393,1
5,3,23,394,1,648,1,3,1,1,2,single-choice,spatial-relational,1|2,7,1/2,230394,1
5,3,23,395,1,680,1,7,3,3,4,single-choice,spatial-relational,3|4,7,3/4,230395,3
5,3,23,396,1,583,1,11,5,5,6,single-choice,spatial-relational,5|6,7,5/6,230396,5
5,3,23,397,1,557,1,13,6,6,7,single-choice,spatial-relational,6|7,7,6/7,230397,6
5,3,23,398,1,681,1,11,5,5,6,single-choice,spatial-relational,5|6,7,5/6,230398,5
5,3,23,399,0,1005,1,9,4,5,5,single-choice,spatial-relational,4|5,7,4/5,230399,4
5,3,23,400,1,761,1,7,3,3,4,single-choice,spatial-relational,3|4,7,3/4,230400,3
5,3,23,401,1,654,1,7,3,3,4,single-choice,spatial-relational,3|4,7,3/4,230401,3
5,3,23,402,1,591,1,3,1,1,2,single-choice,spatial-relational,1|2,7,1/2,230402,1
5,3,23,403,1,576,1,5,2,2,3,single-choice,spatial-relational,2|3,7,2/3,230403,2
5,3,23,404,1,580,1,13,6,6,7,single-choice,spatial-relational,6|7,7,6/7,230404,6
5,3,23,405,1,718,1,5,2,2,3,single-choice,spatial-relational,2|3,7,2/3,230405,2
5,3,23,406,0,680,1,3,1,2,2,single-choice,spatial-relational,1|2,7,1/2,230406,1
5,3,23,407,1,556,1,11,5,5,6,single-choice,spatial-relational,5|6,7,5/6,230407,5
5,3,23,408,0,821,1,9,4,5,5,single-choice,spatial-relational,4|5,7,4/5,230408,4
5,3,23,409,0,783,1,3,1,2,2,single-choice,spatial-relational,1|2,7,1/2,230409,1
5,3,23,410,1,615,1,7,3,3,4,single-choice,spatial-relational,3|4,7,3/4,230410,3
5,3,23,411,0,580,1,11,5,6,6,single-choice,spatial-relational,5|6,7,5/6,230411,5
5,3,23,412,1,634,1,13,6,6,7,single-choice,spatial-relational,6|7,7,6/7,230412,6
5,3,23,413,0,681,1,3,1,2,2,single-choice,spatial-relational,1|2,7,1/2,230413,1
5,3,23,414,0,660,1,9,4,5,5,single-choice,spatial-relational,4|5,7,4/5,230414,4
5,3,23,415,1,661,1,13,6,6,7,single-choice,spatial-relational,6|7,7,6/7,230415,6
5,3,23,416,0,850,1,11,5,6,6,single-choice,spatial-relational,5|6,7,5/6,230416,5
5,3,23,417,1,630,1,5,2,2,3,single-choice,spatial-relational,2|3,7,2/3,230417,2
5,3,23,418,1,686,1,5,2,2,3,single-choice,spatial-relational,2|3,7,2/3,230418,2
5,3,23,419,1,682,1,7,3,3,4,single-choice,spatial-relational,3|4,7,3/4,230419,3
5,3,23,420,0,641,1,9,4,5,5,single-choice,spatial-relational,4|5,7,4/5,230420,4
5,3,23,421,1,676,1,3,1,1,2,single-choice,spatial-relational,1|2,7,1/2,230421,1
5,3,23,422,0,1180,1,11,5,6,6,single-choice,spatial-relational,5|6,7,5/6,230422,5
5,3,23,423,0,533,1,9,4,5,5,single-choice,spatial-relational,4|5,7,4/5,230423,4
5,3,23,424,0,1069,1,9,4,5,5,single-choice,spatial-relational,4|5,7,4/5,230424,4
5,3,23,425,1,592,1,11,5,5,6,single-choice,spatial-relational,5|6,7,5/6,230425,5
5,3,23,426,1,586,1,3,1,1,2,single-choice,spatial-relational,1|2,7,1/2,230426,1
5,3,23,427,1,743,1,7,3,3,4,single-choice,spatial-relational,3|4,7,3/4,230427,3
5,3,23,428,1,580,1,5,2,2,3,single-choice,spatial-relational,2|3,7,2/3,230428,2
5,3,23,429,1,523,1,13,6,6,7,single-choice,spatial-relational,6|7,7,6/7,230429,6
5,3,23,430,1,578,1,7,3,3,4,single-choice,spatial-relational,3|4,7,3/4,230430,3
5,3,23,431,1,627,1,13,6,6,7,single-choice,spatial-relational,6|7,7,6/7,230431,6
5,3,23,432,1,813,1,5,2,2,3,single-choice,spatial-relational,2|3,7,2/3,230432,2
5,3,23,433,0,751,1,11,5,6,6,single-choice,spatial-relational,5|6,7,5/6,230433,5
5,3,23,434,0,483,1,9,4,5,5,single-choice,spatial-relational,4|5,7,4/5,230434,4
5,3,23,435,1,713,1,5,2,2,3,single-choice,spatial-relational,2|3,7,2/3,230435,2
5,3,23,436,0,733,1,3,1,2,2,single-choice,spatial-relational,1|2,7,1/2,230436,1
5,3,23,437,0,623,1,3,1,2,2,single-choice,spatial-relational,1|2,7,1/2,230437,1
5,3,23,438,0,707,1,5,2,3,3,single-choice,spatial-relational,2|3,7,2/3,230438,2
5,3,23,439,1,854,1,7,3,3,4,single-choice,spatial-relational,3|4,7,3/4,230439,3
5,3,23,440,1,634,1,13,6,6,7,single-choice,spatial-relational,6|7,7,6/7,230440,6
5,3,23,441,1,685,1,7,3,3,4,single-choice,spatial-relational,3|4,7,3/4,230441,3
5,3,23,442,0,537,1,11,5,6,6,single-choice,spatial-relational,5|6,7,5/6,230442,5
5,3,23,443,1,527,1,13,6,6,7,single-choice,spatial-relational,6|7,7,6/7,230443,6
5,3,23,444,0,666,1,9,4,5,5,single-choice,spatial-relational,4|5,7,4/5,230444,4
5,3,23,445,1,568,1,13,6,6,7,single-choice,spatial-relational,6|7,7,6/7,230445,6
5,3,23,446,1,794,1,7,3,3,4,single-choice,spatial-relational,3|4,7,3/4,230446,3
5,3,23,447,1,592,1,5,2,2,3,single-choice,spatial-relational,2|3,7,2/3,230447,2
5,3,23,448,0,616,1,11,5,6,6,single-choice,spatial-relational,5|6,7,5/6,230448,5
5,3,23,449,0,697,1,9,4,5,5,single-choice,spatial-relational,4|5,7,4/5,230449,4
5,3,23,450,1,673,1,5,2,2,3,single-choice,spatial-relational,2|3,7,2/3,230450,2
5,3,23,451,0,624,1,3,1,2,2,single-choice,spatial-relational,1|2,7,1/2,230451,1
5,3,23,452,1,742,1,7,3,3,4,single-choice,spatial-relational,3|4,7,3/4,230452,3
5,3,23,453,1,595,1,13,6,6,7,single-choice,spatial-relational,6|7,7,6/7,230453,6
5,3,23,454,1,717,1,3,1,1,2,single-choice,spatial-relational,1|2,7,1/2,230454,1
5,3,23,455,0,659,1,9,4,5,5,single-choice,spatial-relational,4|5,7,4/5,230455,4
5,3,23,456,1,650,1,11,5,5,6,single-choice,spatial-relational,5|6,7,5/6,230456,5
5,3,23,457,1,814,1,11,5,5,6,single-choice,spatial-relational,5|6,7,5/6,230457,5
5,3,23,458,0,596,1,9,4,5,5,single-choice,spatial-relational,4|5,7,4/5,230458,4
5,3,23,459,0,585,1,3,1,2,2,single-choice,spatial-relational,1|2,7,1/2,230459,1
5,3,23,460,1,591,1,11,5,5,6,single-choice,spatial-relational,5|6,7,5/6,230460,5
5,3,23,461,1,596,1,7,3,3,4,single-choice,spatial-relational,3|4,7,3/4,230461,3
5,3,23,462,1,545,1,13,6,6,7,single-choice,spatial-relational,6|7,7,6/7,230462,6
5,3,23,463,0,662,1,9,4,5,5,single-choice,spatial-relational,4|5,7,4/5,230463,4
5,3,23,464,0,708,1,3,1,2,2,single-choice,spatial-relational,1|2,7,1/2,230464,1
5,3,23,465,1,709,1,13,6,6,7,single-choice,spatial-relational,6|7,7,6/7,230465,6
5,3,23,466,0,584,1,5,2,3,3,single-choice,spatial-relational,2|3,7,2/3,230466,2
5,3,23,467,1,643,1,7,3,3,4,single-choice,spatial-relational,3|4,7,3/4,230467,3
5,3,23,468,1,623,1,5,2,2,3,single-choice,spatial-relational,2|3,7,2/3,230468,2
5,3,23,469,1,668,1,7,3,3,4,single-choice,spatial-relational,3|4,7,3/4,230469,3
5,3,23,470,0,703,1,9,4,5,5,single-choice,spatial-relational,4|5,7,4/5,230470,4
5,3,23,471,0,673,1,11,5,6,6,single-choice,spatial-relational,5|6,7,5/6,230471,5
5,3,23,472,1,612,1,13,6,6,7,single-choice,spatial-relational,6|7,7,6/7,230472,6
5,3,23,473,1,627,1,5,2,2,3,single-choice,spatial-relational,2|3,7,2/3,230473,2
5,3,23,474,1,603,1,5,2,2,3,single-choice,spatial-relational,2|3,7,2/3,230474,2
5,3,23,475,0,811,1,9,4,5,5,single-choice,spatial-relational,4|5,7,4/5,230475,4
5,3,23,476,1,596,1,13,6,6,7,single-choice,spatial-relational,6|7,7,6/7,230476,6
5,3,23,477,1,658,1,3,1,1,2,single-choice,spatial-relational,1|2,7,1/2,230477,1
5,3,23,478,1,537,1,7,3,3,4,single-choice,spatial-relational,3|4,7,3/4,230478,3
5,3,23,479,1,571,1,11,5,5,6,single-choice,spatial-relational,5|6,7,5/6,230479,5
5,3,23,480,1,529,1,3,1,1,2,single-choice,spatial-relational,1|2,7,1/2,230480,1
5,3,23,481,0,615,1,7,3,4,4,single-choice,spatial-relational,3|4,7,3/4,230481,3
5,3,23,482,1,593,1,13,6,6,7,single-choice,spatial-relational,6|7,7,6/7,230482,6
5,3,23,483,0,1458,1,9,4,5,5,single-choice,spatial-relational,4|5,7,4/5,230483,4
5,3,23,484,0,839,1,11,5,6,6,single-choice,spatial-relational,5|6,7,5/6,230484,5
5,3,23,485,0,467,1,9,4,5,5,single-choice,spatial-relational,4|5,7,4/5,230485,4
5,3,23,486,1,603,1,13,6,6,7,single-choice,spatial-relational,6|7,7,6/7,230486,6
5,3,23,487,0,606,1,3,1,2,2,single-choice,spatial-relational,1|2,7,1/2,230487,1
5,3,23,488,1,560,1,5,2,2,3,single-choice,spatial-relational,2|3,7,2/3,230488,2
5,3,23,489,1,587,1,7,3,3,4,single-choice,spatial-relational,3|4,7,3/4,230489,3
5,3,23,490,0,612,1,3,1,2,2,single-choice,spatial-relational,1|2,7,1/2,230490,1
5,3,23,491,1,576,1,11,5,5,6,single-choice,spatial-relational,5|6,7,5/6,230491,5
5,3,23,492,1,599,1,5,2,2,3,single-choice,spatial-relational,2|3,7,2/3,230492,2
5,3,23,493,1,578,1,3,1,1,2,single-choice,spatial-relational,1|2,7,1/2,230493,1
5,3,23,494,0,502,1,11,5,6,6,single-choice,spatial-relational,5|6,7,5/6,230494,5
5,3,23,495,0,904,1,7,3,4,4,single-choice,spatial-relational,3|4,7,3/4,230495,3
5,3,23,496,0,744,1,7,3,4,4,single-choice,spatial-relational,3|4,7,3/4,230496,3
5,3,23,497,1,576,1,13,6,6,7,single-choice,spatial-relational,6|7,7,6/7,230497,6
5,3,23,498,1,1207,1,5,2,2,3,single-choice,spatial-relational,2|3,7,2/3,230498,2
5,3,23,499,1,631,1,13,6,6,7,single-choice,spatial-relational,6|7,7,6/7,230499,6
5,3,23,500,1,525,1,5,2,2,3,single-choice,spatial-relational,2|3,7,2/3,230500,2
5,3,23,501,1,615,1,3,1,1,2,single-choice,spatial-relational,1|2,7,1/2,230501,1
5,3,23,502,0,549,1,9,4,5,5,single-choice,spatial-relational,4|5,7,4/5,230502,4
5,3,23,503,1,576,1,11,5,5,6,single-choice,spatial-relational,5|6,7,5/6,230503,5
5,3,23,504,0,568,1,9,4,5,5,single-choice,spatial-relational,4|5,7,4/5,230504,4
5,3,23,505,1,803,1,5,2,2,3,single-choice,spatial-relational,2|3,7,2/3,230505,2
5,3,23,506,1,666,1,7,3,3,4,single-choice,spatial-relational,3|4,7,3/4,230506,3
5,3,23,507,1,603,1,13,6,6,7,single-choice,spatial-relational,6|7,7,6/7,230507,6
5,3,23,508,1,630,1,3,1,1,2,single-choice,spatial-relational,1|2,7,1/2,230508,1
5,3,23,509,0,591,1,5,2,3,3,single-choice,spatial-relational,2|3,7,2/3,230509,2
5,3,23,510,1,584,1,13,6,6,7,single-choice,spatial-relational,6|7,7,6/7,230510,6
5,3,23,511,1,1270,1,3,1,1,2,single-choice,spatial-relational,1|2,7,1/2,230511,1
5,3,23,512,1,654,1,7,3,3,4,single-choice,spatial-relational,3|4,7,3/4,230512,3
5,3,23,513,0,583,1,9,4,5,5,single-choice,spatial-relational,4|5,7,4/5,230513,4
5,3,23,514,1,737,1,9,4,4,5,single-choice,spatial-relational,4|5,7,4/5,230514,4
5,3,23,515,1,654,1,11,5,5,6,single-choice,spatial-relational,5|6,7,5/6,230515,5
5,3,23,516,1,787,1,11,5,5,6,single-choice,spatial-relational,5|6,7,5/6,230516,5
5,3,23,517,0,531,1,5,2,3,3,single-choice,spatial-relational,2|3,7,2/3,230517,2
5,3,23,518,1,656,1,11,5,5,6,single-choice,spatial-relational,5|6,7,5/6,230518,5
5,3,23,519,1,609,1,13,6,6,7,single-choice,spatial-relational,6|7,7,6/7,230519,6
5,3,23,520,0,568,1,9,4,5,5,single-choice,spatial-relational,4|5,7,4/5,230520,4
5,3,23,521,1,662,1,9,4,4,5,single-choice,spatial-relational,4|5,7,4/5,230521,4
5,3,23,522,1,572,1,5,2,2,3,single-choice,spatial-relational,2|3,7,2/3,230522,2
5,3,23,523,1,637,1,7,3,3,4,single-choice,spatial-relational,3|4,7,3/4,230523,3
5,3,23,524,1,709,1,7,3,3,4,single-choice,spatial-relational,3|4,7,3/4,230524,3
5,3,23,525,0,481,1,11,5,6,6,single-choice,spatial-relational,5|6,7,5/6,230525,5
5,3,23,526,1,523,1,3,1,1,2,single-choice,spatial-relational,1|2,7,1/2,230526,1
5,3,23,527,1,587,1,13,6,6,7,single-choice,spatial-relational,6|7,7,6/7,230527,6
5,3,23,528,0,572,1,3,1,2,2,single-choice,spatial-relational,1|2,7,1/2,230528,1
5,3,23,529,0,644,1,7,3,4,4,single-choice,spatial-relational,3|4,7,3/4,230529,3
5,3,23,530,0,463,1,11,5,6,6,single-choice,spatial-relational,5|6,7,5/6,230530,5
5,3,23,531,1,525,1,9,4,4,5,single-choice,spatial-relational,4|5,7,4/5,230531,4
5,3,23,532,1,541,1,7,3,3,4,single-choice,spatial-relational,3|4,7,3/4,230532,3
5,3,23,533,0,535,1,9,4,5,5,single-choice,spatial-relational,4|5,7,4/5,230533,4
5,3,23,534,1,584,1,13,6,6,7,single-choice,spatial-relational,6|7,7,6/7,230534,6
5,3,23,535,1,557,1,13,6,6,7,single-choice,spatial-relational,6|7,7,6/7,230535,6
5,3,23,536,1,575,1,3,1,1,2,single-choice,spatial-relational,1|2,7,1/2,230536,1
5,3,23,537,1,981,1,5,2,2,3,single-choice,spatial-relational,2|3,7,2/3,230537,2
5,3,23,538,0,372,1,3,1,2,2,single-choice,spatial-relational,1|2,7,1/2,230538,1
5,3,23,539,1,634,1,11,5,5,6,single-choice,spatial-relational,5|6,7,5/6,230539,5
5,3,23,540,0,851,1,5,2,3,3,single-choice,spatial-relational,2|3,7,2/3,230540,2
5,3,23,541,0,4064,1,3,1,2,2,single-choice,spatial-relational,1|2,7,1/2,230541,1
5,3,23,542,1,707,1,9,4,4,5,single-choice,spatial-relational,4|5,7,4/5,230542,4
5,3,23,543,0,609,1,9,4,5,5,single-choice,spatial-relational,4|5,7,4/5,230543,4
5,3,23,544,1,603,1,5,2,2,3,single-choice,spatial-relational,2|3,7,2/3,230544,2
5,3,23,545,0,614,1,11,5,6,6,single-choice,spatial-relational,5|6,7,5/6,230545,5
5,3,23,546,1,926,1,11,5,5,6,single-choice,spatial-relational,5|6,7,5/6,230546,5
5,3,23,547,1,611,1,13,6,6,7,single-choice,spatial-relational,6|7,7,6/7,230547,6
5,3,23,548,1,752,1,7,3,3,4,single-choice,spatial-relational,3|4,7,3/4,230548,3
5,3,23,549,1,630,1,13,6,6,7,single-choice,spatial-relational,6|7,7,6/7,230549,6
5,3,23,550,0,545,1,5,2,3,3,single-choice,spatial-relational,2|3,7,2/3,230550,2
5,3,23,551,1,604,1,7,3,3,4,single-choice,spatial-relational,3|4,7,3/4,230551,3
5,3,23,552,1,626,1,3,1,1,2,single-choice,spatial-relational,1|2,7,1/2,230552,1
5,3,23,553,1,726,1,9,4,4,5,single-choice,spatial-relational,4|5,7,4/5,230553,4
5,3,23,554,0,522,1,11,5,6,6,single-choice,spatial-relational,5|6,7,5/6,230554,5
5,3,23,555,0,505,1,3,1,2,2,single-choice,spatial-relational,1|2,7,1/2,230555,1
5,3,23,556,1,616,1,13,6,6,7,single-choice,spatial-relational,6|7,7,6/7,230556,6
5,3,23,557,0,432,1,5,2,3,3,single-choice,spatial-relational,2|3,7,2/3,230557,2
5,3,23,558,1,451,1,3,1,1,2,single-choice,spatial-relational,1|2,7,1/2,230558,1
5,3,23,559,1,648,1,5,2,2,3,single-choice,spatial-relational,2|3,7,2/3,230559,2
5,3,23,560,0,534,1,11,5,6,6,single-choice,spatial-relational,5|6,7,5/6,230560,5
5,3,23,561,1,486,1,13,6,6,7,single-choice,spatial-relational,6|7,7,6/7,230561,6
5,3,23,562,1,564,1,9,4,4,5,single-choice,spatial-relational,4|5,7,4/5,230562,4
5,3,23,563,1,829,1,7,3,3,4,single-choice,spatial-relational,3|4,7,3/4,230563,3
5,3,23,564,0,1119,1,7,3,4,4,single-choice,spatial-relational,3|4,7,3/4,230564,3
5,3,23,565,0,3101,1,5,2,3,3,single-choice,spatial-relational,2|3,7,2/3,230565,2
5,3,23,566,1,423,1,7,3,3,4,single-choice,spatial-relational,3|4,7,3/4,230566,3
5,3,23,567,0,537,1,3,1,2,2,single-choice,spatial-relational,1|2,7,1/2,230567,1
5,3,23,568,1,522,1,5,2,2,3,single-choice,spatial-relational,2|3,7,2/3,230568,2
5,3,23,569,1,482,1,9,4,4,5,single-choice,spatial-relational,4|5,7,4/5,230569,4
5,3,23,570,0,510,1,11,5,6,6,single-choice,spatial-relational,5|6,7,5/6,230570,5
5,3,23,571,1,594,1,3,1,1,2,single-choice,spatial-relational,1|2,7,1/2,230571,1
5,3,23,572,0,445,1,11,5,6,6,single-choice,spatial-relational,5|6,7,5/6,230572,5
5,3,23,573,1,605,1,9,4,4,5,single-choice,spatial-relational,4|5,7,4/5,230573,4
5,3,23,574,0,563,1,7,3,4,4,single-choice,spatial-relational,3|4,7,3/4,230574,3
5,3,23,575,1,616,1,13,6,6,7,single-choice,spatial-relational,6|7,7,6/7,230575,6
5,3,23,576,1,400,1,13,6,6,7,single-choice,spatial-relational,6|7,7,6/7,230576,6
5,3,23,577,0,417,1,3,1,2,2,single-choice,spatial-relational,1|2,7,1/2,230577,1
5,3,23,578,0,835,1,9,4,5,5,single-choice,spatial-relational,4|5,7,4/5,230578,4
5,3,23,579,1,762,1,9,4,4,5,single-choice,spatial-relational,4|5,7,4/5,230579,4
5,3,23,580,1,572,1,7,3,3,4,single-choice,spatial-relational,3|4,7,3/4,230580,3
5,3,23,581,1,627,1,7,3,3,4,single-choice,spatial-relational,3|4,7,3/4,230581,3
5,3,23,582,1,732,1,5,2,2,3,single-choice,spatial-relational,2|3,7,2/3,230582,2
5,3,23,583,1,595,1,13,6,6,7,single-choice,spatial-relational,6|7,7,6/7,230583,6
5,3,23,584,1,580,1,5,2,2,3,single-choice,spatial-relational,2|3,7,2/3,230584,2
5,3,23,585,1,710,1,11,5,5,6,single-choice,spatial-relational,5|6,7,5/6,230585,5
5,3,23,586,1,573,1,11,5,5,6,single-choice,spatial-relational,5|6,7,5/6,230586,5
5,3,23,587,0,603,1,3,1,2,2,single-choice,spatial-relational,1|2,7,1/2,230587,1
5,3,23,588,1,592,1,13,6,6,7,single-choice,spatial-relational,6|7,7,6/7,230588,6
5,3,23,589,1,583,1,3,1,1,2,single-choice,spatial-relational,1|2,7,1/2,230589,1
5,3,23,590,0,690,1,11,5,6,6,single-choice,spatial-relational,5|6,7,5/6,230590,5
5,3,23,591,1,554,1,7,3,3,4,single-choice,spatial-relational,3|4,7,3/4,230591,3
5,3,23,592,0,792,1,9,4,5,5,single-choice,spatial-relational,4|5,7,4/5,230592,4
5,3,23,593,1,498,1,13,6,6,7,single-choice,spatial-relational,6|7,7,6/7,230593,6
5,3,23,594,1,607,1,7,3,3,4,single-choice,spatial-relational,3|4,7,3/4,230594,3
5,3,23,595,0,446,1,9,4,5,5,single-choice,spatial-relational,4|5,7,4/5,230595,4
5,3,23,596,1,635,1,13,6,6,7,single-choice,spatial-relational,6|7,7,6/7,230596,6
5,3,23,597,1,504,1,5,2,2,3,single-choice,spatial-relational,2|3,7,2/3,230597,2
5,3,23,598,0,505,1,5,2,3,3,single-choice,spatial-relational,2|3,7,2/3,230598,2
5,3,23,599,1,735,1,11,5,5,6,single-choice,spatial-relational,5|6,7,5/6,230599,5
5,3,23,600,1,541,1,3,1,1,2,single-choice,spatial-relational,1|2,7,1/2,230600,1
6,3,23,1,0,1039,1,7,3,4,4,single-choice,spatial-relational,3|4,7,3/4,230001,3
6,3,23,2,0,589,1,5,2,3,3,single-choice,spatial-relational,2|3,7,2/3,230002,2
6,3,23,3,1,522,1,9,4,4,5,single-choice,spatial-relational,4|5,7,4/5,230003,4
6,3,23,4,0,598,1,9,4,5,5,single-choice,spatial-relational,4|5,7,4/5,230004,4
6,3,23,5,0,523,1,3,1,2,2,single-choice,spatial-relational,1|2,7,1/2,230005,1
6,3,23,6,1,793,1,13,6,6,7,single-choice,spatial-relational,6|7,7,6/7,230006,6
6,3,23,7,1,572,1,5,2,2,3,single-choice,spatial-relational,2|3,7,2/3,230007,2
6,3,23,8,0,596,1,13,6,7,7,single-choice,spatial-relational,6|7,7,6/7,230008,6
6,3,23,9,0,478,1,11,5,6,6,single-choice,spatial-relational,5|6,7,5/6,230009,5
6,3,23,10,1,735,1,3,1,1,2,single-choice,spatial-relational,1|2,7,1/2,230010,1
6,3,23,11,1,576,1,11,5,5,6,single-choice,spatial-relational,5|6,7,5/6,230011,5
6,3,23,12,0,650,1,7,3,4,4,single-choice,spatial-relational,3|4,7,3/4,230012,3
6,3,23,13,1,704,1,11,5,5,6,single-choice,spatial-relational,5|6,7,5/6,230013,5
6,3,23,14,1,662,1,7,3,3,4,single-choice,spatial-relational,3|4,7,3/4,230014,3
6,3,23,15,0,494,1,9,4,5,5,single-choice,spatial-relational,4|5,7,4/5,230015,4
6,3,23,16,1,1130,1,13,6,6,7,single-choice,spatial-relational,6|7,7,6/7,230016,6
6,3,23,17,0,513,1,11,5,6,6,single-choice,spatial-relational,5|6,7,5/6,230017,5
6,3,23,18,1,736,1,9,4,4,5,single-choice,spatial-relational,4|5,7,4/5,230018,4
6,3,23,19,1,741,1,3,1,1,2,single-choice,spatial-relational,1|2,7,1/2,230019,1
6,3,23,20,1,690,1,7,3,3,4,single-choice,spatial-relational,3|4,7,3/4,230020,3
6,3,23,21,1,603,1,5,2,2,3,single-choice,spatial-relational,2|3,7,2/3,230021,2
6,3,23,22,1,590,1,13,6,6,7,single-choice,spatial-relational,6|7,7,6/7,230022,6
6,3,23,23,0,576,1,5,2,3,3,single-choice,spatial-relational,2|3,7,2/3,230023,2
6,3,23,24,0,614,1,3,1,2,2,single-choice,spatial-relational,1|2,7,1/2,230024,1
6,3,23,25,1,656,1,11,5,5,6,single-choice,spatial-relational,5|6,7,5/6,230025,5
6,3,23,26,0,685,1,3,1,2,2,single-choice,spatial-relational,1|2,7,1/2,230026,1
6,3,23,27,0,530,1,9,4,5,5,single-choice,spatial-relational,4|5,7,4/5,230027,4
6,3,23,28,1,586,1,13,6,6,7,single-choice,spatial-relational,6|7,7,6/7,230028,6
6,3,23,29,1,548,1,13,6,6,7,single-choice,spatial-relational,6|7,7,6/7,230029,6
6,3,23,30,0,613,1,5,2,3,3,single-choice,spatial-relational,2|3,7,2/3,230030,2
6,3,23,31,1,671,1,11,5,5,6,single-choice,spatial-relational,5|6,7,5/6,230031,5
6,3,23,32,1,536,1,5,2,2,3,single-choice,spatial-relational,2|3,7,2/3,230032,2
6,3,23,33,0,598,1,3,1,2,2,single-choice,spatial-relational,1|2,7,1/2,230033,1
6,3,23,34,1,710,1,9,4,4,5,single-choice,spatial-relational,4|5,7,4/5,230034,4
6,3,23,35,1,595,1,7,3,3,4,single-choice,spatial-relational,3|4,7,3/4,230035,3
6,3,23,36,1,692,1,7,3,3,4,single-choice,spatial-relational,3|4,7,3/4,230036,3
6,3,23,37,1,622,1,7,3,3,4,single-choice,spatial-relational,3|4,7,3/4,230037,3
6,3,23,38,1,646,1,9,4,4,5,single-choice,spatial-relational,4|5,7,4/5,230038,4
6,3,23,39,1,593,1,5,2,2,3,single-choice,spatial-relational,2|3,7,2/3,230039,2
6,3,23,40,1,604,1,13,6,6,7,single-choice,spatial-relational,6|7,7,6/7,230040,6
6,3,23,41,0,576,1,3,1,2,2,single-choice,spatial-relational,1|2,7,1/2,230041,1
6,3,23,42,0,572,1,9,4,5,5,single-choice,spatial-relational,4|5,7,4/5,230042,4
6,3,23,43,1,567,1,5,2,2,3,single-choice,spatial-relational,2|3,7,2/3,230043,2
6,3,23,44,1,583,1,11,5,5,6,single-choice,spatial-relational,5|6,7,5/6,230044,5
6,3,23,45,1,553,1,3,1,1,2,single-choice,spatial-relational,1|2,7,1/2,230045,1
6,3,23,46,0,670,1,13,6,7,7,single-choice,spatial-relational,6|7,7,6/7,230046,6
6,3,23,47,0,654,1,11,5,6,6,single-choice,spatial-relational,5|6,7,5/6,230047,5
6,3,23,48,1,756,1,7,3,3,4,single-choice,spatial-relational,3|4,7,3/4,230048,3
6,3,23,49,1,584,1,7,3,3,4,single-choice,spatial-relational,3|4,7,3/4,230049,3
6,3,23,50,0,686,1,5,2,3,3,single-choice,spatial-relational,2|3,7,2/3,230050,2
6,3,23,51,0,604,1,9,4,5,5,single-choice,spatial-relational,4|5,7,4/5,230051,4
6,3,23,52,1,644,1,11,5,5,6,single-choice,spatial-relational,5|6,7,5/6,230052,5
6,3,23,53,1,552,1,13,6,6,7,single-choice,spatial-relational,6|7,7,6/7,230053,6
6,3,23,54,1,1174,1,7,3,3,4,single-choice,spatial-relational,3|4,7,3/4,230054,3
6,3,23,55,0,693,1,9,4,5,5,single-choice,spatial-relational,4|5,7,4/5,230055,4
6,3,23,56,1,693,1,13,6,6,7,single-choice,spatial-relational,6|7,7,6/7,230056,6
6,3,23,57,1,1010,1,11,5,5,6,single-choice,spatial-relational,5|6,7,5/6,230057,5
6,3,23,58,1,566,1,3,1,1,2,single-choice,spatial-relational,1|2,7,1/2,230058,1
6,3,23,59,1,612,1,3,1,1,2,single-choice,spatial-relational,1|2,7,1/2,230059,1
6,3,23,60,1,794,1,5,2,2,3,single-choice,spatial-relational,2|3,7,2/3,230060,2
6,3,23,61,1,801,1,9,4,4,5,single-choice,spatial-relational,4|5,7,4/5,230061,4
6,3,23,62,0,665,1,11,5,6,6,single-choice,spatial-relational,5|6,7,5/6,230062,5
6,3,23,63,1,808,1,9,4,4,5,single-choice,spatial-relational,4|5,7,4/5,230063,4
6,3,23,64,1,648,1,5,2,2,3,single-choice,spatial-relational,2|3,7,2/3,230064,2
6,3,23,65,1,611,1,13,6,6,7,single-choice,spatial-relational,6|7,7,6/7,230065,6
6,3,23,66,1,731,1,7,3,3,4,single-choice,spatial-relational,3|4,7,3/4,230066,3
6,3,23,67,1,616,1,5,2,2,3,single-choice,spatial-relational,2|3,7,2/3,230067,2
6,3,23,68,0,596,1,3,1,2,2,single-choice,spatial-relational,1|2,7,1/2,230068,1
6,3,23,69,1,652,1,11,5,5,6,single-choice,spatial-relational,5|6,7,5/6,230069,5
6,3,23,70,1,564,1,13,6,6,7,single-choice,spatial-relational,6|7,7,6/7,230070,6
6,3,23,71,1,689,1,3,1,1,2,single-choice,spatial-relational,1|2,7,1/2,230071,1
6,3,23,72,1,600,1,7,3,3,4,single-choice,spatial-relational,3|4,7,3/4,230072,3
6,3,23,73,1,946,1,9,4,4,5,single-choice,spatial-relational,4|5,7,4/5,230073,4
6,3,23,74,1,674,1,3,1,1,2,single-choice,spatial-relational,1|2,7,1/2,230074,1
6,3,23,75,1,594,1,13,6,6,7,single-choice,spatial-relational,6|7,7,6/7,230075,6
6,3,23,76,0,841,1,3,1,2,2,single-choice,spatial-relational,1|2,7,1/2,230076,1
6,3,23,77,1,685,1,7,3,3,4,single-choice,spatial-relational,3|4,7,3/4,230077,3
6,3,23,78,1,718,1,5,2,2,3,single-choice,spatial-relational,2|3,7,2/3,230078,2
6,3,23,79,1,593,1,11,5,5,6,single-choice,spatial-relational,5|6,7,5/6,230079,5
6,3,23,80,1,641,1,11,5,5,6,single-choice,spatial-relational,5|6,7,5/6,230080,5
6,3,23,81,1,773,1,9,4,4,5,single-choice,spatial-relational,4|5,7,4/5,230081,4
6,3,23,82,1,606,1,5,2,2,3,single-choice,spatial-relational,2|3,7,2/3,230082,2
6,3,23,83,0,724,1,7,3,4,4,single-choice,spatial-relational,3|4,7,3/4,230083,3
6,3,23,84,1,592,1,13,6,6,7,single-choice,spatial-relational,6|7,7,6/7,230084,6
6,3,23,85,0,618,1,3,1,2,2,single-choice,spatial-relational,1|2,7,1/2,230085,1
6,3,23,86,1,715,1,7,3,3,4,single-choice,spatial-relational,3|4,7,3/4,230086,3
6,3,23,87,1,603,1,5,2,2,3,single-choice,spatial-relational,2|3,7,2/3,230087,2
6,3,23,88,1,682,1,13,6,6,7,single-choice,spatial-relational,6|7,7,6/7,230088,6
6,3,23,89,1,626,1,3,1,1,2,single-choice,spatial-relational,1|2,7,1/2,230089,1
6,3,23,90,1,658,1,5,2,2,3,single-choice,spatial-relational,2|3,7,2/3,230090,2
6,3,23,91,1,965,1,9,4,4,5,single-choice,spatial-relational,4|5,7,4/5,230091,4
6,3,23,92,1,683,1,11,5,5,6,single-choice,spatial-relational,5|6,7,5/6,230092,5
6,3,23,93,1,853,1,11,5,5,6,single-choice,spatial-relational,5|6,7,5/6,230093,5
6,3,23,94,1,579,1,7,3,3,4,single-choice,spatial-relational,3|4,7,3/4,230094,3
6,3,23,95,1,621,1,13,6,6,7,single-choice,spatial-relational,6|7,7,6/7,230095,6
6,3,23,96,0,619,1,9,4,5,5,single-choice,spatial-relational,4|5,7,4/5,230096,4
6,3,23,97,0,678,1,9,4,5,5,single-choice,spatial-relational,4|5,7,4/5,230097,4
6,3,23,98,1,744,1,11,5,5,6,single-choice,spatial-relational,5|6,7,5/6,230098,5
6,3,23,99,1,827,1,7,3,3,4,single-choice,spatial-relational,3|4,7,3/4,230099,3
6,3,23,100,0,676,1,9,4,5,5,single-choice,spatial-relational,4|5,7,4/5,230100,4
6,3,23,101,1,654,1,3,1,1,2,single-choice,spatial-relational,1|2,7,1/2,230101,1
6,3,23,102,1,611,1,11,5,5,6,single-choice,spatial-relational,5|6,7,5/6,230102,5
6,3,23,103,1,7871,1,13,6,6,7,single-choice,spatial-relational,6|7,7,6/7,230103,6
6,3,23,104,0,621,1,5,2,3,3,single-choice,spatial-relational,2|3,7,2/3,230104,2
6,3,23,105,0,687,1,5,2,3,3,single-choice,spatial-relational,2|3,7,2/3,230105,2
6,3,23,106,0,615,1,3,1,2,2,single-choice,spatial-relational,1|2,7,1/2,230106,1
6,3,23,107,1,619,1,13,6,6,7,single-choice,spatial-relational,6|7,7,6/7,230107,6
6,3,23,108,1,656,1,7,3,3,4,single-choice,spatial-relational,3|4,7,3/4,230108,3
6,3,23,109,1,853,1,7,3,3,4,single-choice,spatial-relational,3|4,7,3/4,230109,3
6,3,23,110,1,590,1,11,5,5,6,single-choice,spatial-relational,5|6,7,5/6,230110,5
6,3,23,111,1,1013,1,5,2,2,3,single-choice,spatial-relational,2|3,7,2/3,230111,2
6,3,23,112,1,598,1,13,6,6,7,single-choice,spatial-relational,6|7,7,6/7,230112,6
6,3,23,113,0,581,1,3,1,2,2,single-choice,spatial-relational,1|2,7,1/2,230113,1
6,3,23,114,1,623,1,3,1,1,2,single-choice,spatial-relational,1|2,7,1/2,230114,1
6,3,23,115,0,677,1,5,2,3,3,single-choice,spatial-relational,2|3,7,2/3,230115,2
6,3,23,116,1,854,1,7,3,3,4,single-choice,spatial-relational,3|4,7,3/4,230116,3
6,3,23,117,1,615,1,11,5,5,6,single-choice,spatial-relational,5|6,7,5/6,230117,5
6,3,23,118,0,572,1,9,4,5,5,single-choice,spatial-relational,4|5,7,4/5,230118,4
6,3,23,119,1,583,1,13,6,6,7,single-choice,spatial-relational,6|7,7,6/7,230119,6
6,3,23,120,1,1037,1,9,4,4,5,single-choice,spatial-relational,4|5,7,4/5,230120,4
6,3,23,121,1,599,1,3,1,1,2,single-choice,spatial-relational,1|2,7,1/2,230121,1
6,3,23,122,1,607,1,7,3,3,4,single-choice,spatial-relational,3|4,7,3/4,230122,3
6,3,23,123,1,514,1,13,6,6,7,single-choice,spatial-relational,6|7,7,6/7,230123,6
6,3,23,124,1,830,1,9,4,4,5,single-choice,spatial-relational,4|5,7,4/5,230124,4
6,3,23,125,1,606,1,13,6,6,7,single-choice,spatial-relational,6|7,7,6/7,230125,6
6,3,23,126,1,807,1,7,3,3,4,single-choice,spatial-relational,3|4,7,3/4,230126,3
6,3,23,127,0,533,1,3,1,2,2,single-choice,spatial-relational,1|2,7,1/2,230127,1
6,3,23,128,1,709,1,9,4,4,5,single-choice,spatial-relational,4|5,7,4/5,230128,4
6,3,23,129,1,603,1,11,5,5,6,single-choice,spatial-relational,5|6,7,5/6,230129,5
6,3,23,130,1,841,1,5,2,2,3,single-choice,spatial-relational,2|3,7,2/3,230130,2
6,3,23,131,1,580,1,5,2,2,3,single-choice,spatial-relational,2|3,7,2/3,230131,2
6,3,23,132,1,683,1,11,5,5,6,single-choice,spatial-relational,5|6,7,5/6,230132,5
6,3,23,133,0,554,1,3,1,2,2,single-choice,spatial-relational,1|2,7,1/2,230133,1
6,3,23,134,1,595,1,13,6,6,7,single-choice,spatial-relational,6|7,7,6/7,230134,6
6,3,23,135,1,583,1,5,2,2,3,single-choice,spatial-relational,2|3,7,2/3,230135,2
6,3,23,136,1,890,1,7,3,3,4,single-choice,spatial-relational,3|4,7,3/4,230136,3
6,3,23,137,1,557,1,7,3,3,4,single-choice,spatial-relational,3|4,7,3/4,230137,3
6,3,23,138,1,846,1,11,5,5,6,single-choice,spatial-relational,5|6,7,5/6,230138,5
6,3,23,139,0,771,1,9,4,5,5,single-choice,spatial-relational,4|5,7,4/5,230139,4
6,3,23,140,1,681,1,9,4,4,5,single-choice,spatial-relational,4|5,7,4/5,230140,4
6,3,23,141,1,675,1,11,5,5,6,single-choice,spatial-relational,5|6,7,5/6,230141,5
6,3,23,142,1,614,1,13,6,6,7,single-choice,spatial-relational,6|7,7,6/7,230142,6
6,3,23,143,1,744,1,3,1,1,2,single-choice,spatial-relational,1|2,7,1/2,230143,1
6,3,23,144,1,732,1,5,2,2,3,single-choice,spatial-relational,2|3,7,2/3,230144,2
6,3,23,145,0,546,1,5,2,3,3,single-choice,spatial-relational,2|3,7,2/3,230145,2
6,3,23,146,0,568,1,3,1,2,2,single-choice,spatial-relational,1|2,7,1/2,230146,1
6,3,23,147,1,643,1,11,5,5,6,single-choice,spatial-relational,5|6,7,5/6,230147,5
6,3,23,148,1,588,1,13,6,6,7,single-choice,spatial-relational,6|7,7,6/7,230148,6
6,3,23,149,1,566,1,5,2,2,3,single-choice,spatial-relational,2|3,7,2/3,230149,2
6,3,23,150,1,742,1,13,6,6,7,single-choice,spatial-relational,6|7,7,6/7,230150,6
6,3,23,151,1,822,1,9,4,4,5,single-choice,spatial-relational,4|5,7,4/5,230151,4
6,3,23,152,0,658,1,9,4,5,5,single-choice,spatial-relational,4|5,7,4/5,230152,4
6,3,23,153,1,860,1,7,3,3,4,single-choice,spatial-relational,3|4,7,3/4,230153,3
6,3,23,154,1,521,1,3,1,1,2,single-choice,spatial-relational,1|2,7,1/2,230154,1
6,3,23,155,1,572,1,7,3,3,4,single-choice,spatial-relational,3|4,7,3/4,230155,3
6,3,23,156,0,499,1,11,5,6,6,single-choice,spatial-relational,5|6,7,5/6,230156,5
6,3,23,157,0,587,1,11,5,6,6,single-choice,spatial-relational,5|6,7,5/6,230157,5
6,3,23,158,1,685,1,7,3,3,4,single-choice,spatial-relational,3|4,7,3/4,230158,3
6,3,23,159,0,818,1,9,4,5,5,single-choice,spatial-relational,4|5,7,4/5,230159,4
6,3,23,160,1,638,1,7,3,3,4,single-choice,spatial-relational,3|4,7,3/4,230160,3
6,3,23,161,1,892,1,9,4,4,5,single-choice,spatial-relational,4|5,7,4/5,230161,4
6,3,23,162,1,585,1,13,6,6,7,single-choice,spatial-relational,6|7,7,6/7,230162,6
6,3,23,163,1,950,1,5,2,2,3,single-choice,spatial-relational,2|3,7,2/3,230163,2
6,3,23,164,1,568,1,3,1,1,2,single-choice,spatial-relational,1|2,7,1/2,230164,1
6,3,23,165,1,626,1,11,5,5,6,single-choice,spatial-relational,5|6,7,5/6,230165,5
6,3,23,166,1,611,1,13,6,6,7,single-choice,spatial-relational,6|7,7,6/7,230166,6
6,3,23,167,0,585,1,3,1,2,2,single-choice,spatial-relational,1|2,7,1/2,230167,1
6,3,23,168,1,615,1,5,2,2,3,single-choice,spatial-relational,2|3,7,2/3,230168,2
6,3,23,169,0,713,1,5,2,3,3,single-choice,spatial-relational,2|3,7,2/3,230169,2
6,3,23,170,0,721,1,7,3,4,4,single-choice,spatial-relational,3|4,7,3/4,230170,3
6,3,23,171,1,556,1,13,6,6,7,single-choice,spatial-relational,6|7,7,6/7,230171,6
6,3,23,172,1,588,1,7,3,3,4,single-choice,spatial-relational,3|4,7,3/4,230172,3
6,3,23,173,1,1385,1,3,1,1,2,single-choice,spatial-relational,1|2,7,1/2,230173,1
6,3,23,174,1,572,1,11,5,5,6,single-choice,spatial-relational,5|6,7,5/6,230174,5
6,3,23,175,1,626,1,11,5,5,6,single-choice,spatial-relational,5|6,7,5/6,230175,5
6,3,23,176,1,529,1,3,1,1,2,single-choice,spatial-relational,1|2,7,1/2,230176,1
6,3,23,177,0,889,1,5,2,3,3,single-choice,spatial-relational,2|3,7,2/3,230177,2
6,3,23,178,0,855,1,9,4,5,5,single-choice,spatial-relational,4|5,7,4/5,230178,4
6,3,23,179,1,930,1,9,4,4,5,single-choice,spatial-relational,4|5,7,4/5,230179,4
6,3,23,180,1,615,1,13,6,6,7,single-choice,spatial-relational,6|7,7,6/7,230180,6
6,3,23,181,1,583,1,3,1,1,2,single-choice,spatial-relational,1|2,7,1/2,230181,1
6,3,23,182,0,622,1,3,1,2,2,single-choice,spatial-relational,1|2,7,1/2,230182,1
6,3,23,183,1,635,1,7,3,3,4,single-choice,spatial-relational,3|4,7,3/4,230183,3
6,3,23,184,0,706,1,9,4,5,5,single-choice,spatial-relational,4|5,7,4/5,230184,4
6,3,23,185,1,670,1,13,6,6,7,single-choice,spatial-relational,6|7,7,6/7,230185,6
6,3,23,186,1,671,1,11,5,5,6,single-choice,spatial-relational,5|6,7,5/6,230186,5
6,3,23,187,1,896,1,9,4,4,5,single-choice,spatial-relational,4|5,7,4/5,230187,4
6,3,23,188,0,571,1,11,5,6,6,single-choice,spatial-relational,5|6,7,5/6,230188,5
6,3,23,189,1,680,1,7,3,3,4,single-choice,spatial-relational,3|4,7,3/4,230189,3
6,3,23,190,1,552,1,5,2,2,3,single-choice,spatial-relational,2|3,7,2/3,230190,2
6,3,23,191,1,705,1,5,2,2,3,single-choice,spatial-relational,2|3,7,2/3,230191,2
6,3,23,192,1,619,1,13,6,6,7,single-choice,spatial-relational,6|7,7,6/7,230192,6
6,3,23,193,1,611,1,13,6,6,7,single-choice,spatial-relational,6|7,7,6/7,230193,6
6,3,23,194,1,584,1,7,3,3,4,single-choice,spatial-relational,3|4,7,3/4,230194,3
6,3,23,195,1,972,1,7,3,3,4,single-choice,spatial-relational,3|4,7,3/4,230195,3
6,3,23,196,1,525,1,3,1,1,2,single-choice,spatial-relational,1|2,7,1/2,230196,1
6,3,23,197,0,579,1,9,4,5,5,single-choice,spatial-relational,4|5,7,4/5,230197,4
6,3,23,198,1,625,1,5,2,2,3,single-choice,spatial-relational,2|3,7,2/3,230198,2
6,3,23,199,1,545,1,5,2,2,3,single-choice,spatial-relational,2|3,7,2/3,230199,2
6,3,23,200,1,865,1,9,4,4,5,single-choice,spatial-relational,4|5,7,4/5,230200,4
6,3,23,201,1,575,1,13,6,6,7,single-choice,spatial-relational,6|7,7,6/7,230201,6
6,3,23,202,0,536,1,3,1,2,2,single-choice,spatial-relational,1|2,7,1/2,230202,1
6,3,23,203,1,955,1,11,5,5,6,single-choice,spatial-relational,5|6,7,5/6,230203,5
6,3,23,204,1,873,1,11,5,5,6,single-choice,spatial-relational,5|6,7,5/6,230204,5
6,3,23,205,1,826,1,11,5,5,6,single-choice,spatial-relational,5|6,7,5/6,230205,5
6,3,23,206,0,681,1,11,5,6,6,single-choice,spatial-relational,5|6,7,5/6,230206,5
6,3,23,207,1,590,1,7,3,3,4,single-choice,spatial-relational,3|4,7,3/4,230207,3
6,3,23,208,0,594,1,3,1,2,2,single-choice,spatial-relational,1|2,7,1/2,230208,1
6,3,23,209,1,956,1,13,6,6,7,single-choice,spatial-relational,6|7,7,6/7,230209,6
6,3,23,210,1,1159,1,7,3,3,4,single-choice,spatial-relational,3|4,7,3/4,230210,3
6,3,23,211,1,570,1,3,1,1,2,single-choice,spatial-relational,1|2,7,1/2,230211,1
6,3,23,212,1,572,1,5,2,2,3,single-choice,spatial-relational,2|3,7,2/3,230212,2
6,3,23,213,1,685,1,5,2,2,3,single-choice,spatial-relational,2|3,7,2/3,230213,2
6,3,23,214,0,721,1,9,4,5,5,single-choice,spatial-relational,4|5,7,4/5,230214,4
6,3,23,215,1,597,1,13,6,6,7,single-choice,spatial-relational,6|7,7,6/7,230215,6
6,3,23,216,0,709,1,9,4,5,5,single-choice,spatial-relational,4|5,7,4/5,230216,4
6,3,23,217,0,704,1,9,4,5,5,single-choice,spatial-relational,4|5,7,4/5,230217,4
6,3,23,218,1,676,1,13,6,6,7,single-choice,spatial-relational,6|7,7,6/7,230218,6
6,3,23,219,1,728,1,3,1,1,2,single-choice,spatial-relational,1|2,7,1/2,230219,1
6,3,23,220,1,689,1,11,5,5,6,single-choice,spatial-relational,5|6,7,5/6,230220,5
6,3,23,221,0,1799,1,5,2,3,3,single-choice,spatial-relational,2|3,7,2/3,230221,2
6,3,23,222,1,705,1,11,5,5,6,single-choice,spatial-relational,5|6,7,5/6,230222,5
6,3,23,223,0,561,1,3,1,2,2,single-choice,spatial-relational,1|2,7,1/2,230223,1
6,3,23,224,1,712,1,7,3,3,4,single-choice,spatial-relational,3|4,7,3/4,230224,3
6,3,23,225,1,674,1,5,2,2,3,single-choice,spatial-relational,2|3,7,2/3,230225,2
6,3,23,226,1,608,1,7,3,3,4,single-choice,spatial-relational,3|4,7,3/4,230226,3
6,3,23,227,1,525,1,13,6,6,7,single-choice,spatial-relational,6|7,7,6/7,230227,6
6,3,23,228,1,865,1,9,4,4,5,single-choice,spatial-relational,4|5,7,4/5,230228,4
6,3,23,229,1,624,1,13,6,6,7,single-choice,spatial-relational,6|7,7,6/7,230229,6
6,3,23,230,0,978,1,9,4,5,5,single-choice,spatial-relational,4|5,7,4/5,230230,4
6,3,23,231,1,594,1,5,2,2,3,single-choice,spatial-relational,2|3,7,2/3,230231,2
6,3,23,232,1,681,1,11,5,5,6,single-choice,spatial-relational,5|6,7,5/6,230232,5
6,3,23,233,1,561,1,3,1,1,2,single-choice,spatial-relational,1|2,7,1/2,230233,1
6,3,23,234,1,1185,1,3,1,1,2,single-choice,spatial-relational,1|2,7,1/2,230234,1
6,3,23,235,1,601,1,13,6,6,7,single-choice,spatial-relational,6|7,7,6/7,230235,6
6,3,23,236,0,831,1,7,3,4,4,single-choice,spatial-relational,3|4,7,3/4,230236,3
6,3,23,237,1,778,1,11,5,5,6,single-choice,spatial-relational,5|6,7,5/6,230237,5
6,3,23,238,1,661,1,5,2,2,3,single-choice,spatial-relational,2|3,7,2/3,230238,2
6,3,23,239,1,615,1,7,3,3,4,single-choice,spatial-relational,3|4,7,3/4,230239,3
6,3,23,240,1,1076,1,9,4,4,5,single-choice,spatial-relational,4|5,7,4/5,230240,4
6,3,23,241,1,646,1,11,5,5,6,single-choice,spatial-relational,5|6,7,5/6,230241,5
6,3,23,242,1,712,1,9,4,4,5,single-choice,spatial-relational,4|5,7,4/5,230242,4
6,3,23,243,1,662,1,13,6,6,7,single-choice,spatial-relational,6|7,7,6/7,230243,6
6,3,23,244,1,788,1,7,3,3,4,single-choice,spatial-relational,3|4,7,3/4,230244,3
6,3,23,245,0,615,1,5,2,3,3,single-choice,spatial-relational,2|3,7,2/3,230245,2
6,3,23,246,1,603,1,13,6,6,7,single-choice,spatial-relational,6|7,7,6/7,230246,6
6,3,23,247,1,615,1,3,1,1,2,single-choice,spatial-relational,1|2,7,1/2,230247,1
6,3,23,248,1,690,1,7,3,3,4,single-choice,spatial-relational,3|4,7,3/4,230248,3
6,3,23,249,0,778,1,5,2,3,3,single-choice,spatial-relational,2|3,7,2/3,230249,2
6,3,23,250,0,635,1,3,1,2,2,single-choice,spatial-relational,1|2,7,1/2,230250,1
6,3,23,251,0,675,1,9,4,5,5,single-choice,spatial-relational,4|5,7,4/5,230251,4
6,3,23,252,1,725,1,11,5,5,6,single-choice,spatial-relational,5|6,7,5/6,230252,5
6,3,23,253,0,689,1,9,4,5,5,single-choice,spatial-relational,4|5,7,4/5,230253,4
6,3,23,254,0,653,1,7,3,4,4,single-choice,spatial-relational,3|4,7,3/4,230254,3
6,3,23,255,1,646,1,3,1,1,2,single-choice,spatial-relational,1|2,7,1/2,230255,1
6,3,23,256,1,693,1,7,3,3,4,single-choice,spatial-relational,3|4,7,3/4,230256,3
6,3,23,257,1,803,1,3,1,1,2,single-choice,spatial-relational,1|2,7,1/2,230257,1
6,3,23,258,0,812,1,9,4,5,5,single-choice,spatial-relational,4|5,7,4/5,230258,4
6,3,23,259,1,939,1,13,6,6,7,single-choice,spatial-relational,6|7,7,6/7,230259,6
6,3,23,260,1,722,1,13,6,6,7,single-choice,spatial-relational,6|7,7,6/7,230260,6
6,3,23,261,0,645,1,5,2,3,3,single-choice,spatial-relational,2|3,7,2/3,230261,2
6,3,23,262,1,679,1,5,2,2,3,single-choice,spatial-relational,2|3,7,2/3,230262,2
6,3,23,263,0,521,1,11,5,6,6,single-choice,spatial-relational,5|6,7,5/6,230263,5
6,3,23,264,0,677,1,11,5,6,6,single-choice,spatial-relational,5|6,7,5/6,230264,5
6,3,23,265,1,678,1,3,1,1,2,single-choice,spatial-relational,1|2,7,1/2,230265,1
6,3,23,266,0,567,1,7,3,4,4,single-choice,spatial-relational,3|4,7,3/4,230266,3
6,3,23,267,0,752,1,5,2,3,3,single-choice,spatial-relational,2|3,7,2/3,230267,2
6,3,23,268,1,630,1,3,1,1,2,single-choice,spatial-relational,1|2,7,1/2,230268,1
6,3,23,269,1,650,1,11,5,5,6,single-choice,spatial-relational,5|6,7,5/6,230269,5
6,3,23,270,0,592,1,7,3,4,4,single-choice,spatial-relational,3|4,7,3/4,230270,3
6,3,23,271,1,576,1,13,6,6,7,single-choice,spatial-relational,6|7,7,6/7,230271,6
6,3,23,272,0,561,1,5,2,3,3,single-choice,spatial-relational,2|3,7,2/3,230272,2
6,3,23,273,0,681,1,9,4,5,5,single-choice,spatial-relational,4|5,7,4/5,230273,4
6,3,23,274,0,100,1,13,6,7,7,single-choice,spatial-relational,6|7,7,6/7,230274,6
6,3,23,275,1,771,1,9,4,4,5,single-choice,spatial-relational,4|5,7,4/5,230275,4
6,3,23,276,1,633,1,11,5,5,6,single-choice,spatial-relational,5|6,7,5/6,230276,5
6,3,23,277,1,681,1,11,5,5,6,single-choice,spatial-relational,5|6,7,5/6,230277,5
6,3,23,278,1,835,1,7,3,3,4,single-choice,spatial-relational,3|4,7,3/4,230278,3
6,3,23,279,1,658,1,5,2,2,3,single-choice,spatial-relational,2|3,7,2/3,230279,2
6,3,23,280,1,802,1,13,6,6,7,single-choice,spatial-relational,6|7,7,6/7,230280,6
6,3,23,281,1,713,1,7,3,3,4,single-choice,spatial-relational,3|4,7,3/4,230281,3
6,3,23,282,1,697,1,5,2,2,3,single-choice,spatial-relational,2|3,7,2/3,230282,2
6,3,23,283,1,839,1,9,4,4,5,single-choice,spatial-relational,4|5,7,4/5,230283,4
6,3,23,284,1,744,1,11,5,5,6,single-choice,spatial-relational,5|6,7,5/6,230284,5
6,3,23,285,1,617,1,13,6,6,7,single-choice,spatial-relational,6|7,7,6/7,230285,6
6,3,23,286,1,742,1,3,1,1,2,single-choice,spatial-relational,1|2,7,1/2,230286,1
6,3,23,287,1,1431,1,3,1,1,2,single-choice,spatial-relational,1|2,7,1/2,230287,1
6,3,23,288,1,635,1,9,4,4,5,single-choice,spatial-relational,4|5,7,4/5,230288,4
6,3,23,289,0,795,1,9,4,5,5,single-choice,spatial-relational,4|5,7,4/5,230289,4
6,3,23,290,1,682,1,7,3,3,4,single-choice,spatial-relational,3|4,7,3/4,230290,3
6,3,23,291,1,611,1,11,5,5,6,single-choice,spatial-relational,5|6,7,5/6,230291,5
6,3,23,292,1,621,1,13,6,6,7,single-choice,spatial-relational,6|7,7,6/7,230292,6
6,3,23,293,0,799,1,5,2,3,3,single-choice,spatial-relational,2|3,7,2/3,230293,2
6,3,23,294,1,522,1,13,6,6,7,single-choice,spatial-relational,6|7,7,6/7,230294,6
6,3,23,295,1,1121,1,3,1,1,2,single-choice,spatial-relational,1|2,7,1/2,230295,1
6,3,23,296,0,666,1,5,2,3,3,single-choice,spatial-relational,2|3,7,2/3,230296,2
6,3,23,297,1,720,1,9,4,4,5,single-choice,spatial-relational,4|5,7,4/5,230297,4
6,3,23,298,0,486,1,11,5,6,6,single-choice,spatial-relational,5|6,7,5/6,230298,5
6,3,23,299,1,609,1,3,1,1,2,single-choice,spatial-relational,1|2,7,1/2,230299,1
6,3,23,300,1,623,1,7,3,3,4,single-choice,spatial-relational,3|4,7,3/4,230300,3
6,3,23,301,1,630,1,7,3,3,4,single-choice,spatial-relational,3|4,7,3/4,230301,3
6,3,23,302,0,478,1,9,4,5,5,single-choice,spatial-relational,4|5,7,4/5,230302,4
6,3,23,303,1,84,1,11,5,5,6,single-choice,spatial-relational,5|6,7,5/6,230303,5
6,3,23,304,0,604,1,7,3,4,4,single-choice,spatial-relational,3|4,7,3/4,230304,3
6,3,23,305,0,544,1,3,1,2,2,single-choice,spatial-relational,1|2,7,1/2,230305,1
6,3,23,306,0,549,1,5,2,3,3,single-choice,spatial-relational,2|3,7,2/3,230306,2
6,3,23,307,1,650,1,11,5,5,6,single-choice,spatial-relational,5|6,7,5/6,230307,5
6,3,23,308,0,682,1,9,4,5,5,single-choice,spatial-relational,4|5,7,4/5,230308,4
6,3,23,309,1,638,1,3,1,1,2,single-choice,spatial-relational,1|2,7,1/2,230309,1
6,3,23,310,1,620,1,5,2,2,3,single-choice,spatial-relational,2|3,7,2/3,230310,2
6,3,23,311,1,513,1,13,6,6,7,single-choice,spatial-relational,6|7,7,6/7,230311,6
6,3,23,312,1,598,1,13,6,6,7,single-choice,spatial-relational,6|7,7,6/7,230312,6
6,3,23,313,1,884,1,7,3,3,4,single-choice,spatial-relational,3|4,7,3/4,230313,3
6,3,23,314,1,580,1,13,6,6,7,single-choice,spatial-relational,6|7,7,6/7,230314,6
6,3,23,315,1,953,1,9,4,4,5,single-choice,spatial-relational,4|5,7,4/5,230315,4
6,3,23,316,1,622,1,7,3,3,4,single-choice,spatial-relational,3|4,7,3/4,230316,3
6,3,23,317,1,710,1,3,1,1,2,single-choice,spatial-relational,1|2,7,1/2,230317,1
6,3,23,318,1,603,1,13,6,6,7,single-choice,spatial-relational,6|7,7,6/7,230318,6
6,3,23,319,0,647,1,3,1,2,2,single-choice,spatial-relational,1|2,7,1/2,230319,1
6,3,23,320,0,694,1,9,4,5,5,single-choice,spatial-relational,4|5,7,4/5,230320,4
6,3,23,321,0,818,1,11,5,6,6,single-choice,spatial-relational,5|6,7,5/6,230321,5
6,3,23,322,1,594,1,5,2,2,3,single-choice,spatial-relational,2|3,7,2/3,230322,2
6,3,23,323,1,595,1,11,5,5,6,single-choice,spatial-relational,5|6,7,5/6,230323,5
6,3,23,324,0,554,1,5,2,3,3,single-choice,spatial-relational,2|3,7,2/3,230324,2
6,3,23,325,1,776,1,11,5,5,6,single-choice,spatial-relational,5|6,7,5/6,230325,5
6,3,23,326,0,716,1,9,4,5,5,single-choice,spatial-relational,4|5,7,4/5,230326,4
6,3,23,327,1,907,1,7,3,3,4,single-choice,spatial-relational,3|4,7,3/4,230327,3
6,3,23,328,1,1312,1,3,1,1,2,single-choice,spatial-relational,1|2,7,1/2,230328,1
6,3,23,329,1,814,1,13,6,6,7,single-choice,spatial-relational,6|7,7,6/7,230329,6
6,3,23,330,0,526,1,5,2,3,3,single-choice,spatial-relational,2|3,7,2/3,230330,2
6,3,23,331,1,520,1,5,2,2,3,single-choice,spatial-relational,2|3,7,2/3,230331,2
6,3,23,332,0,653,1,3,1,2,2,single-choice,spatial-relational,1|2,7,1/2,230332,1
6,3,23,333,1,497,1,7,3,3,4,single-choice,spatial-relational,3|4,7,3/4,230333,3
6,3,23,334,1,502,1,13,6,6,7,single-choice,spatial-relational,6|7,7,6/7,230334,6
6,3,23,335,1,1340,1,9,4,4,5,single-choice,spatial-relational,4|5,7,4/5,230335,4
6,3,23,336,0,482,1,11,5,6,6,single-choice,spatial-relational,5|6,7,5/6,230336,5
6,3,23,337,0,1481,1,11,5,6,6,single-choice,spatial-relational,5|6,7,5/6,230337,5
6,3,23,338,1,599,1,13,6,6,7,single-choice,spatial-relational,6|7,7,6/7,230338,6
6,3,23,339,0,1322,1,9,4,5,5,single-choice,spatial-relational,4|5,7,4/5,230339,4
6,3,23,340,1,666,1,13,6,6,7,single-choice,spatial-relational,6|7,7,6/7,230340,6
6,3,23,341,1,1235,1,3,1,1,2,single-choice,spatial-relational,1|2,7,1/2,230341,1
6,3,23,342,0,1459,1,3,1,2,2,single-choice,spatial-relational,1|2,7,1/2,230342,1
6,3,23,343,1,666,1,7,3,3,4,single-choice,spatial-relational,3|4,7,3/4,230343,3
6,3,23,344,1,281,1,5,2,2,3,single-choice,spatial-relational,2|3,7,2/3,230344,2
6,3,23,345,0,483,1,5,2,3,3,single-choice,spatial-relational,2|3,7,2/3,230345,2
6,3,23,346,0,449,1,11,5,6,6,single-choice,spatial-relational,5|6,7,5/6,230346,5
6,3,23,347,1,631,1,7,3,3,4,single-choice,spatial-relational,3|4,7,3/4,230347,3
6,3,23,348,0,501,1,9,4,5,5,single-choice,spatial-relational,4|5,7,4/5,230348,4
6,3,23,349,1,701,1,13,6,6,7,single-choice,spatial-relational,6|7,7,6/7,230349,6
6,3,23,350,0,685,1,5,2,3,3,single-choice,spatial-relational,2|3,7,2/3,230350,2
6,3,23,351,1,587,1,13,6,6,7,single-choice,spatial-relational,6|7,7,6/7,230351,6
6,3,23,352,1,1001,1,5,2,2,3,single-choice,spatial-relational,2|3,7,2/3,230352,2
6,3,23,353,0,615,1,3,1,2,2,single-choice,spatial-relational,1|2,7,1/2,230353,1
6,3,23,354,0,130184,1,9,4,5,5,single-choice,spatial-relational,4|5,7,4/5,230354,4
6,3,23,355,1,553,1,7,3,3,4,single-choice,spatial-relational,3|4,7,3/4,230355,3
6,3,23,356,1,636,1,11,5,5,6,single-choice,spatial-relational,5|6,7,5/6,230356,5
6,3,23,357,0,64,1,3,1,2,2,single-choice,spatial-relational,1|2,7,1/2,230357,1
6,3,23,358,1,653,1,9,4,4,5,single-choice,spatial-relational,4|5,7,4/5,230358,4
6,3,23,359,0,522,1,11,5,6,6,single-choice,spatial-relational,5|6,7,5/6,230359,5
6,3,23,360,1,682,1,7,3,3,4,single-choice,spatial-relational,3|4,7,3/4,230360,3
6,3,23,361,1,574,1,5,2,2,3,single-choice,spatial-relational,2|3,7,2/3,230361,2
6,3,23,362,1,649,1,9,4,4,5,single-choice,spatial-relational,4|5,7,4/5,230362,4
6,3,23,363,1,803,1,7,3,3,4,single-choice,spatial-relational,3|4,7,3/4,230363,3
6,3,23,364,1,453,1,3,1,1,2,single-choice,spatial-relational,1|2,7,1/2,230364,1
6,3,23,365,1,409,1,7,3,3,4,single-choice,spatial-relational,3|4,7,3/4,230365,3
6,3,23,366,0,53,1,13,6,7,7,single-choice,spatial-relational,6|7,7,6/7,230366,6
6,3,23,367,0,865,1,3,1,2,2,single-choice,spatial-relational,1|2,7,1/2,230367,1
6,3,23,368,0,460,1,11,5,6,6,single-choice,spatial-relational,5|6,7,5/6,230368,5
6,3,23,369,1,594,1,13,6,6,7,single-choice,spatial-relational,6|7,7,6/7,230369,6
6,3,23,370,1,908,1,9,4,4,5,single-choice,spatial-relational,4|5,7,4/5,230370,4
6,3,23,371,0,111,1,5,2,3,3,single-choice,spatial-relational,2|3,7,2/3,230371,2
6,3,23,372,1,635,1,11,5,5,6,single-choice,spatial-relational,5|6,7,5/6,230372,5
6,3,23,373,0,137,1,13,6,7,7,single-choice,spatial-relational,6|7,7,6/7,230373,6
6,3,23,374,1,602,1,13,6,6,7,single-choice,spatial-relational,6|7,7,6/7,230374,6
6,3,23,375,0,1398,1,9,4,5,5,single-choice,spatial-relational,4|5,7,4/5,230375,4
6,3,23,376,0,486,1,9,4,5,5,single-choice,spatial-relational,4|5,7,4/5,230376,4
6,3,23,377,0,1233,1,7,3,4,4,single-choice,spatial-relational,3|4,7,3/4,230377,3
6,3,23,378,1,540,1,3,1,1,2,single-choice,spatial-relational,1|2,7,1/2,230378,1
6,3,23,379,1,472,1,5,2,2,3,single-choice,spatial-relational,2|3,7,2/3,230379,2
6,3,23,380,0,486,1,7,3,4,4,single-choice,spatial-relational,3|4,7,3/4,230380,3
6,3,23,381,1,579,1,3,1,1,2,single-choice,spatial-relational,1|2,7,1/2,230381,1
6,3,23,382,1,771,1,11,5,5,6,single-choice,spatial-relational,5|6,7,5/6,230382,5
6,3,23,383,0,64,1,5,2,3,3,single-choice,spatial-relational,2|3,7,2/3,230383,2
6,3,23,384,1,65518,1,11,5,5,6,single-choice,spatial-relational,5|6,7,5/6,230384,5
6,3,23,385,1,1146,1,13,6,6,7,single-choice,spatial-relational,6|7,7,6/7,230385,6
6,3,23,386,0,1356,1,5,2,3,3,single-choice,spatial-relational,2|3,7,2/3,230386,2
6,3,23,387,0,485,1,3,1,2,2,single-choice,spatial-relational,1|2,7,1/2,230387,1
6,3,23,388,1,472,1,7,3,3,4,single-choice,spatial-relational,3|4,7,3/4,230388,3
6,3,23,389,0,1877,1,11,5,6,6,single-choice,spatial-relational,5|6,7,5/6,230389,5
6,3,23,390,0,830,1,9,4,5,5,single-choice,spatial-relational,4|5,7,4/5,230390,4
6,3,23,391,1,664,1,11,5,5,6,single-choice,spatial-relational,5|6,7,5/6,230391,5
6,3,23,392,1,533,1,3,1,1,2,single-choice,spatial-relational,1|2,7,1/2,230392,1
6,3,23,393,1,793,1,9,4,4,5,single-choice,spatial-relational,4|5,7,4/5,230393,4
6,3,23,394,0,744,1,5,2,3,3,single-choice,spatial-relational,2|3,7,2/3,230394,2
6,3,23,395,1,603,1,7,3,3,4,single-choice,spatial-relational,3|4,7,3/4,230395,3
6,3,23,396,1,1057,1,13,6,6,7,single-choice,spatial-relational,6|7,7,6/7,230396,6
6,3,23,397,0,56,1,9,4,5,5,single-choice,spatial-relational,4|5,7,4/5,230397,4
6,3,23,398,0,707,1,5,2,3,3,single-choice,spatial-relational,2|3,7,2/3,230398,2
6,3,23,399,0,653,1,3,1,2,2,single-choice,spatial-relational,1|2,7,1/2,230399,1
6,3,23,400,1,802,1,13,6,6,7,single-choice,spatial-relational,6|7,7,6/7,230400,6
6,3,23,401,0,56,1,11,5,6,6,single-choice,spatial-relational,5|6,7,5/6,230401,5
6,3,23,402,1,978,1,7,3,3,4,single-choice,spatial-relational,3|4,7,3/4,230402,3
6,3,23,403,1,48,1,5,2,2,3,single-choice,spatial-relational,2|3,7,2/3,230403,2
6,3,23,404,1,841,1,3,1,1,2,single-choice,spatial-relational,1|2,7,1/2,230404,1
6,3,23,405,1,670,1,11,5,5,6,single-choice,spatial-relational,5|6,7,5/6,230405,5
6,3,23,406,1,2092,1,9,4,4,5,single-choice,spatial-relational,4|5,7,4/5,230406,4
6,3,23,407,0,1049,1,7,3,4,4,single-choice,spatial-relational,3|4,7,3/4,230407,3
6,3,23,408,0,1396,1,13,6,7,7,single-choice,spatial-relational,6|7,7,6/7,230408,6
6,3,23,409,0,1004,1,7,3,4,4,single-choice,spatial-relational,3|4,7,3/4,230409,3
6,3,23,410,0,858,1,13,6,7,7,single-choice,spatial-relational,6|7,7,6/7,230410,6
6,3,23,411,1,576,1,11,5,5,6,single-choice,spatial-relational,5|6,7,5/6,230411,5
6,3,23,412,0,72,1,5,2,3,3,single-choice,spatial-relational,2|3,7,2/3,230412,2
6,3,23,413,1,681,1,13,6,6,7,single-choice,spatial-relational,6|7,7,6/7,230413,6
6,3,23,414,1,656,1,7,3,3,4,single-choice,spatial-relational,3|4,7,3/4,230414,3
6,3,23,415,1,49001,1,9,4,4,5,single-choice,spatial-relational,4|5,7,4/5,230415,4
6,3,23,416,0,1233,1,11,5,6,6,single-choice,spatial-relational,5|6,7,5/6,230416,5
6,3,23,417,0,685,1,3,1,2,2,single-choice,spatial-relational,1|2,7,1/2,230417,1
6,3,23,418,0,2096,1,9,4,5,5,single-choice,spatial-relational,4|5,7,4/5,230418,4
6,3,23,419,1,1083,1,3,1,1,2,single-choice,spatial-relational,1|2,7,1/2,230419,1
6,3,23,420,1,3093,1,5,2,2,3,single-choice,spatial-relational,2|3,7,2/3,230420,2
6,3,23,421,0,654,1,13,6,7,7,single-choice,spatial-relational,6|7,7,6/7,230421,6
6,3,23,422,0,51812,1,3,1,2,2,single-choice,spatial-relational,1|2,7,1/2,230422,1
6,3,23,423,1,684,1,11,5,5,6,single-choice,spatial-relational,5|6,7,5/6,230423,5
6,3,23,424,0,540,1,5,2,3,3,single-choice,spatial-relational,2|3,7,2/3,230424,2
6,3,23,425,0,984,1,7,3,4,4,single-choice,spatial-relational,3|4,7,3/4,230425,3
6,3,23,426,1,656,1,9,4,4,5,single-choice,spatial-relational,4|5,7,4/5,230426,4
6,3,23,427,1,677,1,5,2,2,3,single-choice,spatial-relational,2|3,7,2/3,230427,2
6,3,23,428,0,864,1,9,4,5,5,single-choice,spatial-relational,4|5,7,4/5,230428,4
6,3,23,429,1,484,1,3,1,1,2,single-choice,spatial-relational,1|2,7,1/2,230429,1
6,3,23,430,0,427,1,11,5,6,6,single-choice,spatial-relational,5|6,7,5/6,230430,5
6,3,23,431,1,1867,1,7,3,3,4,single-choice,spatial-relational,3|4,7,3/4,230431,3
6,3,23,432,1,564,1,13,6,6,7,single-choice,spatial-relational,6|7,7,6/7,230432,6
6,3,23,433,0,580,1,3,1,2,2,single-choice,spatial-relational,1|2,7,1/2,230433,1
6,3,23,434,1,603,1,13,6,6,7,single-choice,spatial-relational,6|7,7,6/7,230434,6
6,3,23,435,0,419,1,11,5,6,6,single-choice,spatial-relational,5|6,7,5/6,230435,5
6,3,23,436,1,650,1,9,4,4,5,single-choice,spatial-relational,4|5,7,4/5,230436,4
6,3,23,437,1,587,1,5,2,2,3,single-choice,spatial-relational,2|3,7,2/3,230437,2
6,3,23,438,1,58723,1,7,3,3,4,single-choice,spatial-relational,3|4,7,3/4,230438,3
6,3,23,439,0,510,1,7,3,4,4,single-choice,spatial-relational,3|4,7,3/4,230439,3
6,3,23,440,0,694,1,9,4,5,5,single-choice,spatial-relational,4|5,7,4/5,230440,4
6,3,23,441,1,836,1,13,6,6,7,single-choice,spatial-relational,6|7,7,6/7,230441,6
6,3,23,442,1,830,1,11,5,5,6,single-choice,spatial-relational,5|6,7,5/6,230442,5
6,3,23,443,0,636,1,5,2,3,3,single-choice,spatial-relational,2|3,7,2/3,230443,2
6,3,23,444,0,673,1,3,1,2,2,single-choice,spatial-relational,1|2,7,1/2,230444,1
6,3,23,445,1,648,1,7,3,3,4,single-choice,spatial-relational,3|4,7,3/4,230445,3
6,3,23,446,1,640,1,3,1,1,2,single-choice,spatial-relational,1|2,7,1/2,230446,1
6,3,23,447,1,662,1,5,2,2,3,single-choice,spatial-relational,2|3,7,2/3,230447,2
6,3,23,448,1,634,1,11,5,5,6,single-choice,spatial-relational,5|6,7,5/6,230448,5
6,3,23,449,0,580,1,9,4,5,5,single-choice,spatial-relational,4|5,7,4/5,230449,4
6,3,23,450,0,752,1,5,2,3,3,single-choice,spatial-relational,2|3,7,2/3,230450,2
6,3,23,451,1,661,1,3,1,1,2,single-choice,spatial-relational,1|2,7,1/2,230451,1
6,3,23,452,1,619,1,13,6,6,7,single-choice,spatial-relational,6|7,7,6/7,230452,6
6,3,23,453,0,654,1,13,6,7,7,single-choice,spatial-relational,6|7,7,6/7,230453,6
6,3,23,454,0,854,1,9,4,5,5,single-choice,spatial-relational,4|5,7,4/5,230454,4
6,3,23,455,1,724,1,11,5,5,6,single-choice,spatial-relational,5|6,7,5/6,230455,5
6,3,23,456,1,545,1,7,3,3,4,single-choice,spatial-relational,3|4,7,3/4,230456,3
6,3,23,457,1,869,1,5,2,2,3,single-choice,spatial-relational,2|3,7,2/3,230457,2
6,3,23,458,1,601,1,5,2,2,3,single-choice,spatial-relational,2|3,7,2/3,230458,2
6,3,23,459,1,630,1,13,6,6,7,single-choice,spatial-relational,6|7,7,6/7,230459,6
6,3,23,460,0,541,1,9,4,5,5,single-choice,spatial-relational,4|5,7,4/5,230460,4
6,3,23,461,0,670,1,11,5,6,6,single-choice,spatial-relational,5|6,7,5/6,230461,5
6,3,23,462,1,658,1,3,1,1,2,single-choice,spatial-relational,1|2,7,1/2,230462,1
6,3,23,463,1,566,1,7,3,3,4,single-choice,spatial-relational,3|4,7,3/4,230463,3
6,3,23,464,1,818,1,13,6,6,7,single-choice,spatial-relational,6|7,7,6/7,230464,6
6,3,23,465,1,878,1,11,5,5,6,single-choice,spatial-relational,5|6,7,5/6,230465,5
6,3,23,466,1,619,1,3,1,1,2,single-choice,spatial-relational,1|2,7,1/2,230466,1
6,3,23,467,1,712,1,9,4,4,5,single-choice,spatial-relational,4|5,7,4/5,230467,4
6,3,23,468,1,942,1,7,3,3,4,single-choice,spatial-relational,3|4,7,3/4,230468,3
6,3,23,469,0,582,1,3,1,2,2,single-choice,spatial-relational,1|2,7,1/2,230469,1
6,3,23,470,1,559,1,11,5,5,6,single-choice,spatial-relational,5|6,7,5/6,230470,5
6,3,23,471,0,1056,1,9,4,5,5,single-choice,spatial-relational,4|5,7,4/5,230471,4
6,3,23,472,1,471,1,7,3,3,4,single-choice,spatial-relational,3|4,7,3/4,230472,3
6,3,23,473,1,624,1,13,6,6,7,single-choice,spatial-relational,6|7,7,6/7,230473,6
6,3,23,474,1,826,1,5,2,2,3,single-choice,spatial-relational,2|3,7,2/3,230474,2
6,3,23,475,1,1079,1,11,5,5,6,single-choice,spatial-relational,5|6,7,5/6,230475,5
6,3,23,476,0,612,1,3,1,2,2,single-choice,spatial-relational,1|2,7,1/2,230476,1
6,3,23,477,1,592,1,13,6,6,7,single-choice,spatial-relational,6|7,7,6/7,230477,6
6,3,23,478,1,658,1,5,2,2,3,single-choice,spatial-relational,2|3,7,2/3,230478,2
6,3,23,479,1,635,1,7,3,3,4,single-choice,spatial-relational,3|4,7,3/4,230479,3
6,3,23,480,1,842,1,9,4,4,5,single-choice,spatial-relational,4|5,7,4/5,230480,4
6,3,23,481,1,662,1,3,1,1,2,single-choice,spatial-relational,1|2,7,1/2,230481,1
6,3,23,482,1,622,1,13,6,6,7,single-choice,spatial-relational,6|7,7,6/7,230482,6
6,3,23,483,1,741,1,11,5,5,6,single-choice,spatial-relational,5|6,7,5/6,230483,5
6,3,23,484,1,772,1,7,3,3,4,single-choice,spatial-relational,3|4,7,3/4,230484,3
6,3,23,485,0,967,1,9,4,5,5,single-choice,spatial-relational,4|5,7,4/5,230485,4
6,3,23,486,1,548,1,5,2,2,3,single-choice,spatial-relational,2|3,7,2/3,230486,2
6,3,23,487,1,800,1,11,5,5,6,single-choice,spatial-relational,5|6,7,5/6,230487,5
6,3,23,488,1,553,1,3,1,1,2,single-choice,spatial-relational,1|2,7,1/2,230488,1
6,3,23,489,1,628,1,5,2,2,3,single-choice,spatial-relational,2|3,7,2/3,230489,2
6,3,23,490,1,605,1,7,3,3,4,single-choice,spatial-relational,3|4,7,3/4,230490,3
6,3,23,491,1,682,1,9,4,4,5,single-choice,spatial-relational,4|5,7,4/5,230491,4
6,3,23,492,1,599,1,13,6,6,7,single-choice,spatial-relational,6|7,7,6/7,230492,6
6,3,23,493,1,542,1,3,1,1,2,single-choice,spatial-relational,1|2,7,1/2,230493,1
6,3,23,494,1,598,1,13,6,6,7,single-choice,spatial-relational,6|7,7,6/7,230494,6
6,3,23,495,1,614,1,7,3,3,4,single-choice,spatial-relational,3|4,7,3/4,230495,3
6,3,23,496,1,562,1,11,5,5,6,single-choice,spatial-relational,5|6,7,5/6,230496,5
6,3,23,497,1,587,1,13,6,6,7,single-choice,spatial-relational,6|7,7,6/7,230497,6
6,3,23,498,1,600,1,7,3,3,4,single-choice,spatial-relational,3|4,7,3/4,230498,3
6,3,23,499,1,761,1,9,4,4,5,single-choice,spatial-relational,4|5,7,4/5,230499,4
6,3,23,500,1,633,1,5,2,2,3,single-choice,spatial-relational,2|3,7,2/3,230500,2
6,3,23,501,1,744,1,9,4,4,5,single-choice,spatial-relational,4|5,7,4/5,230501,4
6,3,23,502,0,874,1,5,2,3,3,single-choice,spatial-relational,2|3,7,2/3,230502,2
6,3,23,503,1,1026,1,11,5,5,6,single-choice,spatial-relational,5|6,7,5/6,230503,5
6,3,23,504,0,595,1,3,1,2,2,single-choice,spatial-relational,1|2,7,1/2,230504,1
6,3,23,505,1,658,1,9,4,4,5,single-choice,spatial-relational,4|5,7,4/5,230505,4
6,3,23,506,1,612,1,3,1,1,2,single-choice,spatial-relational,1|2,7,1/2,230506,1
6,3,23,507,1,673,1,7,3,3,4,single-choice,spatial-relational,3|4,7,3/4,230507,3
6,3,23,508,1,560,1,13,6,6,7,single-choice,spatial-relational,6|7,7,6/7,230508,6
6,3,23,509,0,619,1,5,2,3,3,single-choice,spatial-relational,2|3,7,2/3,230509,2
6,3,23,510,0,513,1,11,5,6,6,single-choice,spatial-relational,5|6,7,5/6,230510,5
6,3,23,511,0,562,1,9,4,5,5,single-choice,spatial-relational,4|5,7,4/5,230511,4
6,3,23,512,1,544,1,11,5,5,6,single-choice,spatial-relational,5|6,7,5/6,230512,5
6,3,23,513,0,790,1,13,6,7,7,single-choice,spatial-relational,6|7,7,6/7,230513,6
6,3,23,514,1,646,1,5,2,2,3,single-choice,spatial-relational,2|3,7,2/3,230514,2
6,3,23,515,1,744,1,3,1,1,2,single-choice,spatial-relational,1|2,7,1/2,230515,1
6,3,23,516,1,639,1,7,3,3,4,single-choice,spatial-relational,3|4,7,3/4,230516,3
6,3,23,517,0,996,1,9,4,5,5,single-choice,spatial-relational,4|5,7,4/5,230517,4
6,3,23,518,1,661,1,7,3,3,4,single-choice,spatial-relational,3|4,7,3/4,230518,3
6,3,23,519,1,580,1,7,3,3,4,single-choice,spatial-relational,3|4,7,3/4,230519,3
6,3,23,520,1,546,1,13,6,6,7,single-choice,spatial-relational,6|7,7,6/7,230520,6
6,3,23,521,1,589,1,5,2,2,3,single-choice,spatial-relational,2|3,7,2/3,230521,2
6,3,23,522,1,693,1,11,5,5,6,single-choice,spatial-relational,5|6,7,5/6,230522,5
6,3,23,523,1,767,1,5,2,2,3,single-choice,spatial-relational,2|3,7,2/3,230523,2
6,3,23,524,0,36,1,3,1,2,2,single-choice,spatial-relational,1|2,7,1/2,230524,1
6,3,23,525,1,748,1,9,4,4,5,single-choice,spatial-relational,4|5,7,4/5,230525,4
6,3,23,526,1,694,1,3,1,1,2,single-choice,spatial-relational,1|2,7,1/2,230526,1
6,3,23,527,0,603,1,11,5,6,6,single-choice,spatial-relational,5|6,7,5/6,230527,5
6,3,23,528,1,705,1,13,6,6,7,single-choice,spatial-relational,6|7,7,6/7,230528,6
6,3,23,529,0,693,1,9,4,5,5,single-choice,spatial-relational,4|5,7,4/5,230529,4
6,3,23,530,1,699,1,3,1,1,2,single-choice,spatial-relational,1|2,7,1/2,230530,1
6,3,23,531,0,702,1,5,2,3,3,single-choice,spatial-relational,2|3,7,2/3,230531,2
6,3,23,532,1,599,1,7,3,3,4,single-choice,spatial-relational,3|4,7,3/4,230532,3
6,3,23,533,1,689,1,5,2,2,3,single-choice,spatial-relational,2|3,7,2/3,230533,2
6,3,23,534,1,576,1,13,6,6,7,single-choice,spatial-relational,6|7,7,6/7,230534,6
6,3,23,535,1,616,1,13,6,6,7,single-choice,spatial-relational,6|7,7,6/7,230535,6
6,3,23,536,1,619,1,11,5,5,6,single-choice,spatial-relational,5|6,7,5/6,230536,5
6,3,23,537,1,1281,1,3,1,1,2,single-choice,spatial-relational,1|2,7,1/2,230537,1
6,3,23,538,1,623,1,11,5,5,6,single-choice,spatial-relational,5|6,7,5/6,230538,5
6,3,23,539,1,698,1,7,3,3,4,single-choice,spatial-relational,3|4,7,3/4,230539,3
6,3,23,540,0,848,1,9,4,5,5,single-choice,spatial-relational,4|5,7,4/5,230540,4
6,3,23,541,1,780,1,7,3,3,4,single-choice,spatial-relational,3|4,7,3/4,230541,3
6,3,23,542,1,722,1,11,5,5,6,single-choice,spatial-relational,5|6,7,5/6,230542,5
6,3,23,543,1,635,1,13,6,6,7,single-choice,spatial-relational,6|7,7,6/7,230543,6
6,3,23,544,1,707,1,7,3,3,4,single-choice,spatial-relational,3|4,7,3/4,230544,3
6,3,23,545,0,895,1,9,4,5,5,single-choice,spatial-relational,4|5,7,4/5,230545,4
6,3,23,546,0,643,1,5,2,3,3,single-choice,spatial-relational,2|3,7,2/3,230546,2
6,3,23,547,1,610,1,3,1,1,2,single-choice,spatial-relational,1|2,7,1/2,230547,1
6,3,23,548,0,455,1,11,5,6,6,single-choice,spatial-relational,5|6,7,5/6,230548,5
6,3,23,549,1,578,1,9,4,4,5,single-choice,spatial-relational,4|5,7,4/5,230549,4
6,3,23,550,1,740,1,5,2,2,3,single-choice,spatial-relational,2|3,7,2/3,230550,2
6,3,23,551,1,620,1,13,6,6,7,single-choice,spatial-relational,6|7,7,6/7,230551,6
6,3,23,552,1,841,1,3,1,1,2,single-choice,spatial-relational,1|2,7,1/2,230552,1
6,3,23,553,1,587,1,11,5,5,6,single-choice,spatial-relational,5|6,7,5/6,230553,5
6,3,23,554,1,663,1,11,5,5,6,single-choice,spatial-relational,5|6,7,5/6,230554,5
6,3,23,555,1,806,1,9,4,4,5,single-choice,spatial-relational,4|5,7,4/5,230555,4
6,3,23,556,0,686,1,5,2,3,3,single-choice,spatial-relational,2|3,7,2/3,230556,2
6,3,23,557,1,709,1,7,3,3,4,single-choice,spatial-relational,3|4,7,3/4,230557,3
6,3,23,558,1,52,1,13,6,6,7,single-choice,spatial-relational,6|7,7,6/7,230558,6
6,3,23,559,1,650,1,13,6,6,7,single-choice,spatial-relational,6|7,7,6/7,230559,6
6,3,23,560,1,779,1,9,4,4,5,single-choice,spatial-relational,4|5,7,4/5,230560,4
6,3,23,561,1,17092,1,3,1,1,2,single-choice,spatial-relational,1|2,7,1/2,230561,1
6,3,23,562,0,599,1,3,1,2,2,single-choice,spatial-relational,1|2,7,1/2,230562,1
6,3,23,563,0,572,1,5,2,3,3,single-choice,spatial-relational,2|3,7,2/3,230563,2
6,3,23,564,1,591,1,7,3,3,4,single-choice,spatial-relational,3|4,7,3/4,230564,3
6,3,23,565,1,642,1,3,1,1,2,single-choice,spatial-relational,1|2,7,1/2,230565,1
6,3,23,566,0,660,1,9,4,5,5,single-choice,spatial-relational,4|5,7,4/5,230566,4
6,3,23,567,0,659,1,7,3,4,4,single-choice,spatial-relational,3|4,7,3/4,230567,3
6,3,23,568,1,932,1,7,3,3,4,single-choice,spatial-relational,3|4,7,3/4,230568,3
6,3,23,569,1,624,1,5,2,2,3,single-choice,spatial-relational,2|3,7,2/3,230569,2
6,3,23,570,1,614,1,13,6,6,7,single-choice,spatial-relational,6|7,7,6/7,230570,6
6,3,23,571,0,550,1,3,1,2,2,single-choice,spatial-relational,1|2,7,1/2,230571,1
6,3,23,572,0,1155,1,9,4,5,5,single-choice,spatial-relational,4|5,7,4/5,230572,4
6,3,23,573,0,642,1,11,5,6,6,single-choice,spatial-relational,5|6,7,5/6,230573,5
6,3,23,574,1,618,1,13,6,6,7,single-choice,spatial-relational,6|7,7,6/7,230574,6
6,3,23,575,0,685,1,5,2,3,3,single-choice,spatial-relational,2|3,7,2/3,230575,2
6,3,23,576,1,544,1,11,5,5,6,single-choice,spatial-relational,5|6,7,5/6,230576,5
6,3,23,577,1,978,1,3,1,1,2,single-choice,spatial-relational,1|2,7,1/2,230577,1
6,3,23,578,1,573,1,5,2,2,3,single-choice,spatial-relational,2|3,7,2/3,230578,2
6,3,23,579,1,763,1,9,4,4,5,single-choice,spatial-relational,4|5,7,4/5,230579,4
6,3,23,580,0,474,1,11,5,6,6,single-choice,spatial-relational,5|6,7,5/6,230580,5
6,3,23,581,1,728,1,9,4,4,5,single-choice,spatial-relational,4|5,7,4/5,230581,4
6,3,23,582,1,624,1,13,6,6,7,single-choice,spatial-relational,6|7,7,6/7,230582,6
6,3,23,583,1,805,1,11,5,5,6,single-choice,spatial-relational,5|6,7,5/6,230583,5
6,3,23,584,1,690,1,13,6,6,7,single-choice,spatial-relational,6|7,7,6/7,230584,6
6,3,23,585,1,529,1,5,2,2,3,single-choice,spatial-relational,2|3,7,2/3,230585,2
6,3,23,586,1,650,1,7,3,3,4,single-choice,spatial-relational,3|4,7,3/4,230586,3
6,3,23,587,1,793,1,3,1,1,2,single-choice,spatial-relational,1|2,7,1/2,230587,1
6,3,23,588,0,744,1,7,3,4,4,single-choice,spatial-relational,3|4,7,3/4,230588,3
6,3,23,589,1,48059,1,7,3,3,4,single-choice,spatial-relational,3|4,7,3/4,230589,3
6,3,23,590,1,636,1,3,1,1,2,single-choice,spatial-relational,1|2,7,1/2,230590,1
6,3,23,591,1,638,1,11,5,5,6,single-choice,spatial-relational,5|6,7,5/6,230591,5
6,3,23,592,0,783,1,5,2,3,3,single-choice,spatial-relational,2|3,7,2/3,230592,2
6,3,23,593,1,677,1,11,5,5,6,single-choice,spatial-relational,5|6,7,5/6,230593,5
6,3,23,594,1,573,1,5,2,2,3,single-choice,spatial-relational,2|3,7,2/3,230594,2
6,3,23,595,1,616,1,7,3,3,4,single-choice,spatial-relational,3|4,7,3/4,230595,3
6,3,23,596,1,865,1,3,1,1,2,single-choice,spatial-relational,1|2,7,1/2,230596,1
6,3,23,597,1,650,1,9,4,4,5,single-choice,spatial-relational,4|5,7,4/5,230597,4
6,3,23,598,1,745,1,9,4,4,5,single-choice,spatial-relational,4|5,7,4/5,230598,4
6,3,23,599,1,544,1,13,6,6,7,single-choice,spatial-relational,6|7,7,6/7,230599,6
6,3,23,600,1,599,1,13,6,6,7,single-choice,spatial-relational,6|7,7,6/7,230600,6
7,3,23,1,1,746,1,9,4,4,5,single-choice,spatial-relational,4|5,7,4/5,230001,4
7,3,23,2,1,818,1,5,2,2,3,single-choice,spatial-relational,2|3,7,2/3,230002,2
7,3,23,3,1,550,1,5,2,2,3,single-choice,spatial-relational,2|3,7,2/3,230003,2
7,3,23,4,1,60,1,7,3,3,4,single-choice,spatial-relational,3|4,7,3/4,230004,3
7,3,23,5,1,762,1,13,6,6,7,single-choice,spatial-relational,6|7,7,6/7,230005,6
7,3,23,6,0,638,1,9,4,5,5,single-choice,spatial-relational,4|5,7,4/5,230006,4
7,3,23,7,0,6794,1,11,5,6,6,single-choice,spatial-relational,5|6,7,5/6,230007,5
7,3,23,8,0,662,1,3,1,2,2,single-choice,spatial-relational,1|2,7,1/2,230008,1
7,3,23,9,1,717,1,13,6,6,7,single-choice,spatial-relational,6|7,7,6/7,230009,6
7,3,23,10,0,639,1,7,3,4,4,single-choice,spatial-relational,3|4,7,3/4,230010,3
7,3,23,11,1,613,1,11,5,5,6,single-choice,spatial-relational,5|6,7,5/6,230011,5
7,3,23,12,1,52,1,3,1,1,2,single-choice,spatial-relational,1|2,7,1/2,230012,1
7,3,23,13,1,509,1,9,4,4,5,single-choice,spatial-relational,4|5,7,4/5,230013,4
7,3,23,14,1,1149,1,9,4,4,5,single-choice,spatial-relational,4|5,7,4/5,230014,4
7,3,23,15,1,52,1,11,5,5,6,single-choice,spatial-relational,5|6,7,5/6,230015,5
7,3,23,16,1,598,1,3,1,1,2,single-choice,spatial-relational,1|2,7,1/2,230016,1
7,3,23,17,1,630,1,5,2,2,3,single-choice,spatial-relational,2|3,7,2/3,230017,2
7,3,23,18,1,53,1,7,3,3,4,single-choice,spatial-relational,3|4,7,3/4,230018,3
7,3,23,19,0,48,1,3,1,2,2,single-choice,spatial-relational,1|2,7,1/2,230019,1
7,3,23,20,1,834,1,13,6,6,7,single-choice,spatial-relational,6|7,7,6/7,230020,6
7,3,23,21,1,53,1,13,6,6,7,single-choice,spatial-relational,6|7,7,6/7,230021,6
7,3,23,22,1,815,1,11,5,5,6,single-choice,spatial-relational,5|6,7,5/6,230022,5
7,3,23,23,0,450,1,5,2,3,3,single-choice,spatial-relational,2|3,7,2/3,230023,2
7,3,23,24,0,472,1,7,3,4,4,single-choice,spatial-relational,3|4,7,3/4,230024,3
7,3,23,25,1,488,1,7,3,3,4,single-choice,spatial-relational,3|4,7,3/4,230025,3
7,3,23,26,0,584,1,7,3,4,4,single-choice,spatial-relational,3|4,7,3/4,230026,3
7,3,23,27,0,646,1,11,5,6,6,single-choice,spatial-relational,5|6,7,5/6,230027,5
7,3,23,28,1,476,1,11,5,5,6,single-choice,spatial-relational,5|6,7,5/6,230028,5
7,3,23,29,1,2105,1,9,4,4,5,single-choice,spatial-relational,4|5,7,4/5,230029,4
7,3,23,30,0,545,1,9,4,5,5,single-choice,spatial-relational,4|5,7,4/5,230030,4
7,3,23,31,0,757,1,5,2,3,3,single-choice,spatial-relational,2|3,7,2/3,230031,2
7,3,23,32,1,531,1,13,6,6,7,single-choice,spatial-relational,6|7,7,6/7,230032,6
7,3,23,33,1,642,1,5,2,2,3,single-choice,spatial-relational,2|3,7,2/3,230033,2
7,3,23,34,1,580,1,13,6,6,7,single-choice,spatial-relational,6|7,7,6/7,230034,6
7,3,23,35,0,676,1,3,1,2,2,single-choice,spatial-relational,1|2,7,1/2,230035,1
7,3,23,36,1,533,1,3,1,1,2,single-choice,spatial-relational,1|2,7,1/2,230036,1
7,3,23,37,1,760,1,3,1,1,2,single-choice,spatial-relational,1|2,7,1/2,230037,1
7,3,23,38,0,763,1,9,4,5,5,single-choice,spatial-relational,4|5,7,4/5,230038,4
7,3,23,39,1,111140,1,5,2,2,3,single-choice,spatial-relational,2|3,7,2/3,230039,2
7,3,23,40,0,647,1,13,6,7,7,single-choice,spatial-relational,6|7,7,6/7,230040,6
7,3,23,41,1,654,1,7,3,3,4,single-choice,spatial-relational,3|4,7,3/4,230041,3
7,3,23,42,0,752,1,9,4,5,5,single-choice,spatial-relational,4|5,7,4/5,230042,4
7,3,23,43,1,655,1,5,2,2,3,single-choice,spatial-relational,2|3,7,2/3,230043,2
7,3,23,44,1,525,1,11,5,5,6,single-choice,spatial-relational,5|6,7,5/6,230044,5
7,3,23,45,1,530,1,11,5,5,6,single-choice,spatial-relational,5|6,7,5/6,230045,5
7,3,23,46,1,759,1,7,3,3,4,single-choice,spatial-relational,3|4,7,3/4,230046,3
7,3,23,47,1,564,1,13,6,6,7,single-choice,spatial-relational,6|7,7,6/7,230047,6
7,3,23,48,1,814,1,3,1,1,2,single-choice,spatial-relational,1|2,7,1/2,230048,1
7,3,23,49,1,730,1,9,4,4,5,single-choice,spatial-relational,4|5,7,4/5,230049,4
7,3,23,50,1,601,1,11,5,5,6,single-choice,spatial-relational,5|6,7,5/6,230050,5
7,3,23,51,1,604,1,7,3,3,4,single-choice,spatial-relational,3|4,7,3/4,230051,3
7,3,23,52,1,674,1,11,5,5,6,single-choice,spatial-relational,5|6,7,5/6,230052,5
7,3,23,53,0,793,1,9,4,5,5,single-choice,spatial-relational,4|5,7,4/5,230053,4
7,3,23,54,1,535,1,5,2,2,3,single-choice,spatial-relational,2|3,7,2/3,230054,2
7,3,23,55,1,584,1,13,6,6,7,single-choice,spatial-relational,6|7,7,6/7,230055,6
7,3,23,56,1,871,1,13,6,6,7,single-choice,spatial-relational,6|7,7,6/7,230056,6
7,3,23,57,1,681,1,5,2,2,3,single-choice,spatial-relational,2|3,7,2/3,230057,2
7,3,23,58,1,783,1,3,1,1,2,single-choice,spatial-relational,1|2,7,1/2,230058,1
7,3,23,59,1,614,1,3,1,1,2,single-choice,spatial-relational,1|2,7,1/2,230059,1
7,3,23,60,1,713,1,7,3,3,4,single-choice,spatial-relational,3|4,7,3/4,230060,3
7,3,23,61,1,665,1,11,5,5,6,single-choice,spatial-relational,5|6,7,5/6,230061,5
7,3,23,62,0,1208,1,3,1,2,2,single-choice,spatial-relational,1|2,7,1/2,230062,1
7,3,23,63,0,553,1,9,4,5,5,single-choice,spatial-relational,4|5,7,4/5,230063,4
7,3,23,64,0,620,1,3,1,2,2,single-choice,spatial-relational,1|2,7,1/2,230064,1
7,3,23,65,1,616,1,5,2,2,3,single-choice,spatial-relational,2|3,7,2/3,230065,2
7,3,23,66,1,608,1,13,6,6,7,single-choice,spatial-relational,6|7,7,6/7,230066,6
7,3,23,67,1,711,1,7,3,3,4,single-choice,spatial-relational,3|4,7,3/4,230067,3
7,3,23,68,0,670,1,5,2,3,3,single-choice,spatial-relational,2|3,7,2/3,230068,2
7,3,23,69,0,516,1,11,5,6,6,single-choice,spatial-relational,5|6,7,5/6,230069,5
7,3,23,70,1,661,1,13,6,6,7,single-choice,spatial-relational,6|7,7,6/7,230070,6
7,3,23,71,1,703,1,7,3,3,4,single-choice,spatial-relational,3|4,7,3/4,230071,3
7,3,23,72,1,724,1,9,4,4,5,single-choice,spatial-relational,4|5,7,4/5,230072,4
7,3,23,73,1,644,1,7,3,3,4,single-choice,spatial-relational,3|4,7,3/4,230073,3
7,3,23,74,1,816,1,7,3,3,4,single-choice,spatial-relational,3|4,7,3/4,230074,3
7,3,23,75,1,631,1,11,5,5,6,single-choice,spatial-relational,5|6,7,5/6,230075,5
7,3,23,76,1,783,1,3,1,1,2,single-choice,spatial-relational,1|2,7,1/2,230076,1
7,3,23,77,1,713,1,9,4,4,5,single-choice,spatial-relational,4|5,7,4/5,230077,4
7,3,23,78,1,695,1,5,2,2,3,single-choice,spatial-relational,2|3,7,2/3,230078,2
7,3,23,79,1,1050,1,5,2,2,3,single-choice,spatial-relational,2|3,7,2/3,230079,2
7,3,23,80,1,623,1,3,1,1,2,single-choice,spatial-relational,1|2,7,1/2,230080,1
7,3,23,81,1,761,1,9,4,4,5,single-choice,spatial-relational,4|5,7,4/5,230081,4
7,3,23,82,1,523,1,13,6,6,7,single-choice,spatial-relational,6|7,7,6/7,230082,6
7,3,23,83,1,632,1,11,5,5,6,single-choice,spatial-relational,5|6,7,5/6,230083,5
7,3,23,84,1,577,1,13,6,6,7,single-choice,spatial-relational,6|7,7,6/7,230084,6
7,3,23,85,1,861,1,7,3,3,4,single-choice,spatial-relational,3|4,7,3/4,230085,3
7,3,23,86,0,612,1,11,5,6,6,single-choice,spatial-relational,5|6,7,5/6,230086,5
7,3,23,87,1,574,1,13,6,6,7,single-choice,spatial-relational,6|7,7,6/7,230087,6
7,3,23,88,1,862,1,11,5,5,6,single-choice,spatial-relational,5|6,7,5/6,230088,5
7,3,23,89,1,873,1,5,2,2,3,single-choice,spatial-relational,2|3,7,2/3,230089,2
7,3,23,90,1,750,1,9,4,4,5,single-choice,spatial-relational,4|5,7,4/5,230090,4
7,3,23,91,0,62486,1,3,1,2,2,single-choice,spatial-relational,1|2,7,1/2,230091,1
7,3,23,92,1,701,1,3,1,1,2,single-choice,spatial-relational,1|2,7,1/2,230092,1
7,3,23,93,1,546,1,13,6,6,7,single-choice,spatial-relational,6|7,7,6/7,230093,6
7,3,23,94,0,807,1,9,4,5,5,single-choice,spatial-relational,4|5,7,4/5,230094,4
7,3,23,95,1,620,1,7,3,3,4,single-choice,spatial-relational,3|4,7,3/4,230095,3
7,3,23,96,1,693,1,5,2,2,3,single-choice,spatial-relational,2|3,7,2/3,230096,2
7,3,23,97,1,768,1,9,4,4,5,single-choice,spatial-relational,4|5,7,4/5,230097,4
7,3,23,98,0,625,1,9,4,5,5,single-choice,spatial-relational,4|5,7,4/5,230098,4
7,3,23,99,1,583,1,7,3,3,4,single-choice,spatial-relational,3|4,7,3/4,230099,3
7,3,23,100,1,587,1,13,6,6,7,single-choice,spatial-relational,6|7,7,6/7,230100,6
7,3,23,101,1,533,1,13,6,6,7,single-choice,spatial-relational,6|7,7,6/7,230101,6
7,3,23,102,1,928,1,7,3,3,4,single-choice,spatial-relational,3|4,7,3/4,230102,3
7,3,23,103,0,523,1,11,5,6,6,single-choice,spatial-relational,5|6,7,5/6,230103,5
7,3,23,104,1,693,1,3,1,1,2,single-choice,spatial-relational,1|2,7,1/2,230104,1
7,3,23,105,1,564,1,3,1,1,2,single-choice,spatial-relational,1|2,7,1/2,230105,1
7,3,23,106,1,541,1,11,5,5,6,single-choice,spatial-relational,5|6,7,5/6,230106,5
7,3,23,107,1,549,1,5,2,2,3,single-choice,spatial-relational,2|3,7,2/3,230107,2
7,3,23,108,1,643,1,5,2,2,3,single-choice,spatial-relational,2|3,7,2/3,230108,2
7,3,23,109,0,609,1,3,1,2,2,single-choice,spatial-relational,1|2,7,1/2,230109,1
7,3,23,110,1,545,1,5,2,2,3,single-choice,spatial-relational,2|3,7,2/3,230110,2
7,3,23,111,1,586,1,11,5,5,6,single-choice,spatial-relational,5|6,7,5/6,230111,5
7,3,23,112,1,825,1,7,3,3,4,single-choice,spatial-relational,3|4,7,3/4,230112,3
7,3,23,113,1,774,1,11,5,5,6,single-choice,spatial-relational,5|6,7,5/6,230113,5
7,3,23,114,0,888,1,9,4,5,5,single-choice,spatial-relational,4|5,7,4/5,230114,4
7,3,23,115,1,604,1,5,2,2,3,single-choice,spatial-relational,2|3,7,2/3,230115,2
7,3,23,116,1,506,1,13,6,6,7,single-choice,spatial-relational,6|7,7,6/7,230116,6
7,3,23,117,1,617,1,13,6,6,7,single-choice,spatial-relational,6|7,7,6/7,230117,6
7,3,23,118,0,694,1,3,1,2,2,single-choice,spatial-relational,1|2,7,1/2,230118,1
7,3,23,119,1,593,1,7,3,3,4,single-choice,spatial-relational,3|4,7,3/4,230119,3
7,3,23,120,0,804,1,9,4,5,5,single-choice,spatial-relational,4|5,7,4/5,230120,4
7,3,23,121,1,526,1,13,6,6,7,single-choice,spatial-relational,6|7,7,6/7,230121,6
7,3,23,122,1,603,1,3,1,1,2,single-choice,spatial-relational,1|2,7,1/2,230122,1
7,3,23,123,1,689,1,7,3,3,4,single-choice,spatial-relational,3|4,7,3/4,230123,3
7,3,23,124,1,581,1,7,3,3,4,single-choice,spatial-relational,3|4,7,3/4,230124,3
7,3,23,125,0,752,1,9,4,5,5,single-choice,spatial-relational,4|5,7,4/5,230125,4
7,3,23,126,1,544,1,5,2,2,3,single-choice,spatial-relational,2|3,7,2/3,230126,2
7,3,23,127,1,647,1,5,2,2,3,single-choice,spatial-relational,2|3,7,2/3,230127,2
7,3,23,128,1,624,1,3,1,1,2,single-choice,spatial-relational,1|2,7,1/2,230128,1
7,3,23,129,1,646,1,13,6,6,7,single-choice,spatial-relational,6|7,7,6/7,230129,6
7,3,23,130,1,756,1,9,4,4,5,single-choice,spatial-relational,4|5,7,4/5,230130,4
7,3,23,131,1,591,1,11,5,5,6,single-choice,spatial-relational,5|6,7,5/6,230131,5
7,3,23,132,1,786,1,11,5,5,6,single-choice,spatial-relational,5|6,7,5/6,230132,5
7,3,23,133,1,832,1,7,3,3,4,single-choice,spatial-relational,3|4,7,3/4,230133,3
7,3,23,134,1,674,1,13,6,6,7,single-choice,spatial-relational,6|7,7,6/7,230134,6
7,3,23,135,0,595,1,3,1,2,2,single-choice,spatial-relational,1|2,7,1/2,230135,1
7,3,23,136,0,592,1,3,1,2,2,single-choice,spatial-relational,1|2,7,1/2,230136,1
7,3,23,137,1,562,1,11,5,5,6,single-choice,spatial-relational,5|6,7,5/6,230137,5
7,3,23,138,1,584,1,13,6,6,7,single-choice,spatial-relational,6|7,7,6/7,230138,6
7,3,23,139,1,660,1,9,4,4,5,single-choice,spatial-relational,4|5,7,4/5,230139,4
7,3,23,140,1,728,1,9,4,4,5,single-choice,spatial-relational,4|5,7,4/5,230140,4
7,3,23,141,1,631,1,5,2,2,3,single-choice,spatial-relational,2|3,7,2/3,230141,2
7,3,23,142,1,611,1,7,3,3,4,single-choice,spatial-relational,3|4,7,3/4,230142,3
7,3,23,143,0,524,1,11,5,6,6,single-choice,spatial-relational,5|6,7,5/6,230143,5
7,3,23,144,1,568,1,5,2,2,3,single-choice,spatial-relational,2|3,7,2/3,230144,2
7,3,23,145,1,571,1,7,3,3,4,single-choice,spatial-relational,3|4,7,3/4,230145,3
7,3,23,146,1,514,1,13,6,6,7,single-choice,spatial-relational,6|7,7,6/7,230146,6
7,3,23,147,1,660,1,7,3,3,4,single-choice,spatial-relational,3|4,7,3/4,230147,3
7,3,23,148,1,759,1,9,4,4,5,single-choice,spatial-relational,4|5,7,4/5,230148,4
7,3,23,149,1,596,1,13,6,6,7,single-choice,spatial-relational,6|7,7,6/7,230149,6
7,3,23,150,1,582,1,3,1,1,2,single-choice,spatial-relational,1|2,7,1/2,230150,1
7,3,23,151,0,693,1,11,5,6,6,single-choice,spatial-relational,5|6,7,5/6,230151,5
7,3,23,152,0,437,1,11,5,6,6,single-choice,spatial-relational,5|6,7,5/6,230152,5
7,3,23,153,1,765,1,9,4,4,5,single-choice,spatial-relational,4|5,7,4/5,230153,4
7,3,23,154,0,674,1,3,1,2,2,single-choice,spatial-relational,1|2,7,1/2,230154,1
7,3,23,155,0,616,1,5,2,3,3,single-choice,spatial-relational,2|3,7,2/3,230155,2
7,3,23,156,1,535,1,5,2,2,3,single-choice,spatial-relational,2|3,7,2/3,230156,2
7,3,23,157,1,510,1,13,6,6,7,single-choice,spatial-relational,6|7,7,6/7,230157,6
7,3,23,158,1,632,1,9,4,4,5,single-choice,spatial-relational,4|5,7,4/5,230158,4
7,3,23,159,1,625,1,3,1,1,2,single-choice,spatial-relational,1|2,7,1/2,230159,1
7,3,23,160,1,601,1,7,3,3,4,single-choice,spatial-relational,3|4,7,3/4,230160,3
7,3,23,161,0,444,1,11,5,6,6,single-choice,spatial-relational,5|6,7,5/6,230161,5
7,3,23,162,0,604,1,5,2,3,3,single-choice,spatial-relational,2|3,7,2/3,230162,2
7,3,23,163,1,568,1,11,5,5,6,single-choice,spatial-relational,5|6,7,5/6,230163,5
7,3,23,164,1,618,1,13,6,6,7,single-choice,spatial-relational,6|7,7,6/7,230164,6
7,3,23,165,0,762,1,9,4,5,5,single-choice,spatial-relational,4|5,7,4/5,230165,4
7,3,23,166,1,641,1,7,3,3,4,single-choice,spatial-relational,3|4,7,3/4,230166,3
7,3,23,167,0,603,1,3,1,2,2,single-choice,spatial-relational,1|2,7,1/2,230167,1
7,3,23,168,1,510,1,5,2,2,3,single-choice,spatial-relational,2|3,7,2/3,230168,2
7,3,23,169,0,740,1,9,4,5,5,single-choice,spatial-relational,4|5,7,4/5,230169,4
7,3,23,170,0,526,1,11,5,6,6,single-choice,spatial-relational,5|6,7,5/6,230170,5
7,3,23,171,0,581,1,3,1,2,2,single-choice,spatial-relational,1|2,7,1/2,230171,1
7,3,23,172,1,587,1,5,2,2,3,single-choice,spatial-relational,2|3,7,2/3,230172,2
7,3,23,173,1,611,1,7,3,3,4,single-choice,spatial-relational,3|4,7,3/4,230173,3
7,3,23,174,0,672,1,9,4,5,5,single-choice,spatial-relational,4|5,7,4/5,230174,4
7,3,23,175,1,576,1,13,6,6,7,single-choice,spatial-relational,6|7,7,6/7,230175,6
7,3,23,176,1,675,1,5,2,2,3,single-choice,spatial-relational,2|3,7,2/3,230176,2
7,3,23,177,0,661,1,11,5,6,6,single-choice,spatial-relational,5|6,7,5/6,230177,5
7,3,23,178,0,485,1,3,1,2,2,single-choice,spatial-relational,1|2,7,1/2,230178,1
7,3,23,179,1,557,1,13,6,6,7,single-choice,spatial-relational,6|7,7,6/7,230179,6
7,3,23,180,1,728,1,7,3,3,4,single-choice,spatial-relational,3|4,7,3/4,230180,3
7,3,23,181,1,1246,1,5,2,2,3,single-choice,spatial-relational,2|3,7,2/3,230181,2
7,3,23,182,0,542,1,11,5,6,6,single-choice,spatial-relational,5|6,7,5/6,230182,5
7,3,23,183,1,597,1,3,1,1,2,single-choice,spatial-relational,1|2,7,1/2,230183,1
7,3,23,184,1,733,1,11,5,5,6,single-choice,spatial-relational,5|6,7,5/6,230184,5
7,3,23,185,1,654,1,13,6,6,7,single-choice,spatial-relational,6|7,7,6/7,230185,6
7,3,23,186,0,562,1,3,1,2,2,single-choice,spatial-relational,1|2,7,1/2,230186,1
7,3,23,187,0,701,1,9,4,5,5,single-choice,spatial-relational,4|5,7,4/5,230187,4
7,3,23,188,1,658,1,7,3,3,4,single-choice,spatial-relational,3|4,7,3/4,230188,3
7,3,23,189,0,533,1,5,2,3,3,single-choice,spatial-relational,2|3,7,2/3,230189,2
7,3,23,190,1,597,1,7,3,3,4,single-choice,spatial-relational,3|4,7,3/4,230190,3
7,3,23,191,1,618,1,13,6,6,7,single-choice,spatial-relational,6|7,7,6/7,230191,6
7,3,23,192,1,540,1,9,4,4,5,single-choice,spatial-relational,4|5,7,4/5,230192,4
7,3,23,193,0,754,1,5,2,3,3,single-choice,spatial-relational,2|3,7,2/3,230193,2
7,3,23,194,0,5477,1,3,1,2,2,single-choice,spatial-relational,1|2,7,1/2,230194,1
7,3,23,195,1,496,1,13,6,6,7,single-choice,spatial-relational,6|7,7,6/7,230195,6
7,3,23,196,1,653,1,7,3,3,4,single-choice,spatial-relational,3|4,7,3/4,230196,3
7,3,23,197,0,478,1,11,5,6,6,single-choice,spatial-relational,5|6,7,5/6,230197,5
7,3,23,198,1,559,1,7,3,3,4,single-choice,spatial-relational,3|4,7,3/4,230198,3
7,3,23,199,0,577,1,3,1,2,2,single-choice,spatial-relational,1|2,7,1/2,230199,1
7,3,23,200,0,467,1,13,6,7,7,single-choice,spatial-relational,6|7,7,6/7,230200,6
7,3,23,201,1,529,1,11,5,5,6,single-choice,spatial-relational,5|6,7,5/6,230201,5
7,3,23,202,1,693,1,9,4,4,5,single-choice,spatial-relational,4|5,7,4/5,230202,4
7,3,23,203,0,888,1,9,4,5,5,single-choice,spatial-relational,4|5,7,4/5,230203,4
7,3,23,204,1,579,1,5,2,2,3,single-choice,spatial-relational,2|3,7,2/3,230204,2
7,3,23,205,1,626,1,3,1,1,2,single-choice,spatial-relational,1|2,7,1/2,230205,1
7,3,23,206,0,507,1,11,5,6,6,single-choice,spatial-relational,5|6,7,5/6,230206,5
7,3,23,207,1,516,1,11,5,5,6,single-choice,spatial-relational,5|6,7,5/6,230207,5
7,3,23,208,1,745,1,9,4,4,5,single-choice,spatial-relational,4|5,7,4/5,230208,4
7,3,23,209,0,544,1,5,2,3,3,single-choice,spatial-relational,2|3,7,2/3,230209,2
7,3,23,210,1,729,1,7,3,3,4,single-choice,spatial-relational,3|4,7,3/4,230210,3
7,3,23,211,1,619,1,3,1,1,2,single-choice,spatial-relational,1|2,7,1/2,230211,1
7,3,23,212,0,662,1,9,4,5,5,single-choice,spatial-relational,4|5,7,4/5,230212,4
7,3,23,213,1,653,1,13,6,6,7,single-choice,spatial-relational,6|7,7,6/7,230213,6
7,3,23,214,0,713,1,7,3,4,4,single-choice,spatial-relational,3|4,7,3/4,230214,3
7,3,23,215,1,573,1,13,6,6,7,single-choice,spatial-relational,6|7,7,6/7,230215,6
7,3,23,216,1,681,1,5,2,2,3,single-choice,spatial-relational,2|3,7,2/3,230216,2
7,3,23,217,0,670,1,9,4,5,5,single-choice,spatial-relational,4|5,7,4/5,230217,4
7,3,23,218,1,568,1,13,6,6,7,single-choice,spatial-relational,6|7,7,6/7,230218,6
7,3,23,219,1,810,1,3,1,1,2,single-choice,spatial-relational,1|2,7,1/2,230219,1
7,3,23,220,0,1123,1,11,5,6,6,single-choice,spatial-relational,5|6,7,5/6,230220,5
7,3,23,221,1,412,1,5,2,2,3,single-choice,spatial-relational,2|3,7,2/3,230221,2
7,3,23,222,1,480,1,9,4,4,5,single-choice,spatial-relational,4|5,7,4/5,230222,4
7,3,23,223,1,679,1,11,5,5,6,single-choice,spatial-relational,5|6,7,5/6,230223,5
7,3,23,224,1,567,1,13,6,6,7,single-choice,spatial-relational,6|7,7,6/7,230224,6
7,3,23,225,0,534,1,5,2,3,3,single-choice,spatial-relational,2|3,7,2/3,230225,2
7,3,23,226,0,669,1,7,3,4,4,single-choice,spatial-relational,3|4,7,3/4,230226,3
7,3,23,227,1,449,1,3,1,1,2,single-choice,spatial-relational,1|2,7,1/2,230227,1
7,3,23,228,0,415,1,7,3,4,4,single-choice,spatial-relational,3|4,7,3/4,230228,3
7,3,23,229,0,437,1,11,5,6,6,single-choice,spatial-relational,5|6,7,5/6,230229,5
7,3,23,230,1,415,1,9,4,4,5,single-choice,spatial-relational,4|5,7,4/5,230230,4
7,3,23,231,1,518,1,3,1,1,2,single-choice,spatial-relational,1|2,7,1/2,230231,1
7,3,23,232,0,738,1,7,3,4,4,single-choice,spatial-relational,3|4,7,3/4,230232,3
7,3,23,233,1,543,1,13,6,6,7,single-choice,spatial-relational,6|7,7,6/7,230233,6
7,3,23,234,0,576,1,5,2,3,3,single-choice,spatial-relational,2|3,7,2/3,230234,2
7,3,23,235,1,639,1,13,6,6,7,single-choice,spatial-relational,6|7,7,6/7,230235,6
7,3,23,236,0,56,1,9,4,5,5,single-choice,spatial-relational,4|5,7,4/5,230236,4
7,3,23,237,0,1046,1,3,1,2,2,single-choice,spatial-relational,1|2,7,1/2,230237,1
7,3,23,238,1,576,1,11,5,5,6,single-choice,spatial-relational,5|6,7,5/6,230238,5
7,3,23,239,1,753,1,5,2,2,3,single-choice,spatial-relational,2|3,7,2/3,230239,2
7,3,23,240,1,743,1,7,3,3,4,single-choice,spatial-relational,3|4,7,3/4,230240,3
7,3,23,241,0,45650,1,5,2,3,3,single-choice,spatial-relational,2|3,7,2/3,230241,2
7,3,23,242,1,427,1,3,1,1,2,single-choice,spatial-relational,1|2,7,1/2,230242,1
7,3,23,243,0,416,1,3,1,2,2,single-choice,spatial-relational,1|2,7,1/2,230243,1
7,3,23,244,1,508,1,5,2,2,3,single-choice,spatial-relational,2|3,7,2/3,230244,2
7,3,23,245,0,455,1,7,3,4,4,single-choice,spatial-relational,3|4,7,3/4,230245,3
1,3,24,1,0,2023,4,8,2,6,6,single-choice,spatial-relational,2|6,7,2/6,240001,2
1,3,24,2,1,585,1,11,5,5,6,single-choice,spatial-relational,5|6,7,5/6,240002,5
1,3,24,3,0,648,1,9,4,5,5,single-choice,spatial-relational,4|5,7,4/5,240003,4
1,3,24,4,0,23,1,3,1,2,2,single-choice,spatial-relational,1|2,7,1/2,240004,1
1,3,24,5,1,731,3,5,1,1,4,single-choice,spatial-relational,1|4,7,1/4,240005,1
1,3,24,6,1,524,3,9,3,3,6,single-choice,spatial-relational,3|6,7,3/6,240006,3
1,3,24,7,0,705,2,4,1,3,3,single-choice,spatial-relational,1|3,7,1/3,240007,1
1,3,24,8,0,541,2,6,2,4,4,single-choice,spatial-relational,2|4,7,2/4,240008,2
1,3,24,9,0,550,5,9,2,7,7,single-choice,spatial-relational,2|7,7,2/7,240009,2
1,3,24,10,1,579,1,9,4,4,5,single-choice,spatial-relational,4|5,7,4/5,240010,4
1,3,24,11,1,1060,5,7,1,1,6,single-choice,spatial-relational,1|6,7,1/6,240011,1
1,3,24,12,1,616,1,7,3,3,4,single-choice,spatial-relational,3|4,7,3/4,240012,3
1,3,24,13,1,462,1,3,1,1,2,single-choice,spatial-relational,1|2,7,1/2,240013,1
1,3,24,14,0,395,1,11,5,6,6,single-choice,spatial-relational,5|6,7,5/6,240014,5
1,3,24,15,1,540,4,10,3,3,7,single-choice,spatial-relational,3|7,7,3/7,240015,3
1,3,24,16,0,469,4,6,1,5,5,single-choice,spatial-relational,1|5,7,1/5,240016,1
1,3,24,17,0,438,3,11,4,7,7,single-choice,spatial-relational,4|7,7,4/7,240017,4
1,3,24,18,0,475,6,8,1,7,7,single-choice,spatial-relational,1|7,7,1/7,240018,1
1,3,24,19,1,575,1,13,6,6,7,single-choice,spatial-relational,6|7,7,6/7,240019,6
1,3,24,20,1,567,1,13,6,6,7,single-choice,spatial-relational,6|7,7,6/7,240020,6
1,3,24,21,1,598,1,7,3,3,4,single-choice,spatial-relational,3|4,7,3/4,240021,3
1,3,24,22,0,556,2,4,1,3,3,single-choice,spatial-relational,1|3,7,1/3,240022,1
1,3,24,23,1,606,3,11,4,4,7,single-choice,spatial-relational,4|7,7,4/7,240023,4
1,3,24,24,1,713,3,7,2,2,5,single-choice,spatial-relational,2|5,7,2/5,240024,2
1,3,24,25,0,594,4,8,2,6,6,single-choice,spatial-relational,2|6,7,2/6,240025,2
1,3,24,26,1,644,1,5,2,2,3,single-choice,spatial-relational,2|3,7,2/3,240026,2
1,3,24,27,1,809,2,8,3,3,5,single-choice,spatial-relational,3|5,7,3/5,240027,3
1,3,24,28,1,716,2,6,2,2,4,single-choice,spatial-relational,2|4,7,2/4,240028,2
1,3,24,29,1,693,6,8,1,1,7,single-choice,spatial-relational,1|7,7,1/7,240029,1
1,3,24,30,0,577,3,7,2,5,5,single-choice,spatial-relational,2|5,7,2/5,240030,2
1,3,24,31,0,643,3,5,1,4,4,single-choice,spatial-relational,1|4,7,1/4,240031,1
1,3,24,32,1,777,3,9,3,3,6,single-choice,spatial-relational,3|6,7,3/6,240032,3
1,3,24,33,0,626,2,8,3,5,5,single-choice,spatial-relational,3|5,7,3/5,240033,3
1,3,24,34,1,718,2,12,5,5,7,single-choice,spatial-relational,5|7,7,5/7,240034,5
1,3,24,35,1,658,4,10,3,3,7,single-choice,spatial-relational,3|7,7,3/7,240035,3
1,3,24,36,0,545,2,12,5,7,7,single-choice,spatial-relational,5|7,7,5/7,240036,5
1,3,24,37,1,563,5,7,1,1,6,single-choice,spatial-relational,1|6,7,1/6,240037,1
1,3,24,38,1,687,5,9,2,2,7,single-choice,spatial-relational,2|7,7,2/7,240038,2
1,3,24,39,0,739,2,10,4,6,6,single-choice,spatial-relational,4|6,7,4/6,240039,4
1,3,24,40,0,616,1,5,2,3,3,single-choice,spatial-relational,2|3,7,2/3,240040,2
1,3,24,41,1,498,2,10,4,4,6,single-choice,spatial-relational,4|6,7,4/6,240041,4
1,3,24,42,1,704,4,6,1,1,5,single-choice,spatial-relational,1|5,7,1/5,240042,1
1,3,24,43,0,828,3,11,4,7,7,single-choice,spatial-relational,4|7,7,4/7,240043,4
1,3,24,44,1,532,1,11,5,5,6,single-choice,spatial-relational,5|6,7,5/6,240044,5
1,3,24,45,1,1014,3,5,1,1,4,single-choice,spatial-relational,1|4,7,1/4,240045,1
1,3,24,46,1,655,2,12,5,5,7,single-choice,spatial-relational,5|7,7,5/7,240046,5
1,3,24,47,1,605,1,13,6,6,7,single-choice,spatial-relational,6|7,7,6/7,240047,6
1,3,24,48,1,762,4,6,1,1,5,single-choice,spatial-relational,1|5,7,1/5,240048,1
1,3,24,49,0,415,4,8,2,6,6,single-choice,spatial-relational,2|6,7,2/6,240049,2
1,3,24,50,1,638,3,9,3,3,6,single-choice,spatial-relational,3|6,7,3/6,240050,3
1,3,24,51,0,1003,5,9,2,7,7,single-choice,spatial-relational,2|7,7,2/7,240051,2
1,3,24,52,0,922,4,10,3,7,7,single-choice,spatial-relational,3|7,7,3/7,240052,3
1,3,24,53,1,530,4,8,2,2,6,single-choice,spatial-relational,2|6,7,2/6,240053,2
1,3,24,54,1,547,4,6,1,1,5,single-choice,spatial-relational,1|5,7,1/5,240054,1
1,3,24,55,0,15615,1,5,2,3,3,single-choice,spatial-relational,2|3,7,2/3,240055,2
1,3,24,56,1,524,2,10,4,4,6,single-choice,spatial-relational,4|6,7,4/6,240056,4
1,3,24,57,1,586,2,4,1,1,3,single-choice,spatial-relational,1|3,7,1/3,240057,1
1,3,24,58,1,678,3,7,2,2,5,single-choice,spatial-relational,2|5,7,2/5,240058,2
1,3,24,59,1,512,2,8,3,3,5,single-choice,spatial-relational,3|5,7,3/5,240059,3
1,3,24,60,1,816,5,9,2,2,7,single-choice,spatial-relational,2|7,7,2/7,240060,2
1,3,24,61,1,805,2,12,5,5,7,single-choice,spatial-relational,5|7,7,5/7,240061,5
1,3,24,62,1,59,1,7,3,3,4,single-choice,spatial-relational,3|4,7,3/4,240062,3
1,3,24,63,1,713,2,6,2,2,4,single-choice,spatial-relational,2|4,7,2/4,240063,2
1,3,24,64,1,720,3,7,2,2,5,single-choice,spatial-relational,2|5,7,2/5,240064,2
1,3,24,65,0,666,1,3,1,2,2,single-choice,spatial-relational,1|2,7,1/2,240065,1
1,3,24,66,1,574,1,13,6,6,7,single-choice,spatial-relational,6|7,7,6/7,240066,6
1,3,24,67,1,635,2,8,3,3,5,single-choice,spatial-relational,3|5,7,3/5,240067,3
1,3,24,68,1,647,1,9,4,4,5,single-choice,spatial-relational,4|5,7,4/5,240068,4
1,3,24,69,1,637,1,5,2,2,3,single-choice,spatial-relational,2|3,7,2/3,240069,2
1,3,24,70,0,523,6,8,1,7,7,single-choice,spatial-relational,1|7,7,1/7,240070,1
1,3,24,71,1,646,5,7,1,1,6,single-choice,spatial-relational,1|6,7,1/6,240071,1
1,3,24,72,1,701,3,5,1,1,4,single-choice,spatial-relational,1|4,7,1/4,240072,1
1,3,24,73,0,673,2,10,4,6,6,single-choice,spatial-relational,4|6,7,4/6,240073,4
1,3,24,74,1,575,3,9,3,3,6,single-choice,spatial-relational,3|6,7,3/6,240074,3
1,3,24,75,1,630,1,3,1,1,2,single-choice,spatial-relational,1|2,7,1/2,240075,1
1,3,24,76,0,673,1,11,5,6,6,single-choice,spatial-relational,5|6,7,5/6,240076,5
1,3,24,77,0,947,2,6,2,4,4,single-choice,spatial-relational,2|4,7,2/4,240077,2
1,3,24,78,1,709,1,7,3,3,4,single-choice,spatial-relational,3|4,7,3/4,240078,3
1,3,24,79,1,685,3,11,4,4,7,single-choice,spatial-relational,4|7,7,4/7,240079,4
1,3,24,80,0,544,5,7,1,6,6,single-choice,spatial-relational,1|6,7,1/6,240080,1
1,3,24,81,1,683,6,8,1,1,7,single-choice,spatial-relational,1|7,7,1/7,240081,1
1,3,24,82,1,756,4,10,3,3,7,single-choice,spatial-relational,3|7,7,3/7,240082,3
1,3,24,83,1,667,2,4,1,1,3,single-choice,spatial-relational,1|3,7,1/3,240083,1
1,3,24,84,1,562,1,9,4,4,5,single-choice,spatial-relational,4|5,7,4/5,240084,4
1,3,24,85,1,666,2,4,1,1,3,single-choice,spatial-relational,1|3,7,1/3,240085,1
1,3,24,86,1,610,3,11,4,4,7,single-choice,spatial-relational,4|7,7,4/7,240086,4
1,3,24,87,0,555,2,6,2,4,4,single-choice,spatial-relational,2|4,7,2/4,240087,2
1,3,24,88,1,662,2,10,4,4,6,single-choice,spatial-relational,4|6,7,4/6,240088,4
1,3,24,89,0,49,1,9,4,5,5,single-choice,spatial-relational,4|5,7,4/5,240089,4
1,3,24,90,1,701,1,13,6,6,7,single-choice,spatial-relational,6|7,7,6/7,240090,6
1,3,24,91,0,745,2,10,4,6,6,single-choice,spatial-relational,4|6,7,4/6,240091,4
1,3,24,92,1,685,1,9,4,4,5,single-choice,spatial-relational,4|5,7,4/5,240092,4
1,3,24,93,0,651,1,3,1,2,2,single-choice,spatial-relational,1|2,7,1/2,240093,1
1,3,24,94,1,616,3,11,4,4,7,single-choice,spatial-relational,4|7,7,4/7,240094,4
1,3,24,95,1,627,1,7,3,3,4,single-choice,spatial-relational,3|4,7,3/4,240095,3
1,3,24,96,0,838,1,11,5,6,6,single-choice,spatial-relational,5|6,7,5/6,240096,5
1,3,24,97,1,619,5,9,2,2,7,single-choice,spatial-relational,2|7,7,2/7,240097,2
1,3,24,98,1,744,5,7,1,1,6,single-choice,spatial-relational,1|6,7,1/6,240098,1
1,3,24,99,1,1110,1,7,3,3,4,single-choice,spatial-relational,3|4,7,3/4,240099,3
1,3,24,100,0,617,1,11,5,6,6,single-choice,spatial-relational,5|6,7,5/6,240100,5
1,3,24,101,0,730,1,5,2,3,3,single-choice,spatial-relational,2|3,7,2/3,240101,2
1,3,24,102,1,693,2,12,5,5,7,single-choice,spatial-relational,5|7,7,5/7,240102,5
1,3,24,103,1,657,5,9,2,2,7,single-choice,spatial-relational,2|7,7,2/7,240103,2
1,3,24,104,1,908,2,12,5,5,7,single-choice,spatial-relational,5|7,7,5/7,240104,5
1,3,24,105,1,788,2,8,3,3,5,single-choice,spatial-relational,3|5,7,3/5,240105,3
1,3,24,106,1,619,5,7,1,1,6,single-choice,spatial-relational,1|6,7,1/6,240106,1
1,3,24,107,1,654,2,6,2,2,4,single-choice,spatial-relational,2|4,7,2/4,240107,2
1,3,24,108,1,510,1,3,1,1,2,single-choice,spatial-relational,1|2,7,1/2,240108,1
1,3,24,109,1,650,2,8,3,3,5,single-choice,spatial-relational,3|5,7,3/5,240109,3
1,3,24,110,0,2438,4,8,2,6,6,single-choice,spatial-relational,2|6,7,2/6,240110,2
1,3,24,111,1,637,4,10,3,3,7,single-choice,spatial-relational,3|7,7,3/7,240111,3
1,3,24,112,0,2649,3,7,2,5,5,single-choice,spatial-relational,2|5,7,2/5,240112,2
1,3,24,113,0,504,6,8,1,7,7,single-choice,spatial-relational,1|7,7,1/7,240113,1
1,3,24,114,1,632,1,13,6,6,7,single-choice,spatial-relational,6|7,7,6/7,240114,6
1,3,24,115,1,621,4,10,3,3,7,single-choice,spatial-relational,3|7,7,3/7,240115,3
1,3,24,116,1,675,4,6,1,1,5,single-choice,spatial-relational,1|5,7,1/5,240116,1
1,3,24,117,1,635,6,8,1,1,7,single-choice,spatial-relational,1|7,7,1/7,240117,1
1,3,24,118,1,613,4,6,1,1,5,single-choice,spatial-relational,1|5,7,1/5,240118,1
1,3,24,119,1,549,3,9,3,3,6,single-choice,spatial-relational,3|6,7,3/6,240119,3
1,3,24,120,0,631,2,4,1,3,3,single-choice,spatial-relational,1|3,7,1/3,240120,1
1,3,24,121,1,730,3,7,2,2,5,single-choice,spatial-relational,2|5,7,2/5,240121,2
1,3,24,122,1,768,3,5,1,1,4,single-choice,spatial-relational,1|4,7,1/4,240122,1
1,3,24,123,1,1018,4,8,2,2,6,single-choice,spatial-relational,2|6,7,2/6,240123,2
1,3,24,124,1,841,3,9,3,3,6,single-choice,spatial-relational,3|6,7,3/6,240124,3
1,3,24,125,0,710,1,5,2,3,3,single-choice,spatial-relational,2|3,7,2/3,240125,2
1,3,24,126,1,493,3,5,1,1,4,single-choice,spatial-relational,1|4,7,1/4,240126,1
1,3,24,127,1,767,1,9,4,4,5,single-choice,spatial-relational,4|5,7,4/5,240127,4
1,3,24,128,0,758,1,5,2,3,3,single-choice,spatial-relational,2|3,7,2/3,240128,2
1,3,24,129,1,779,4,10,3,3,7,single-choice,spatial-relational,3|7,7,3/7,240129,3
1,3,24,130,1,1009,3,7,2,2,5,single-choice,spatial-relational,2|5,7,2/5,240130,2
1,3,24,131,1,709,2,12,5,5,7,single-choice,spatial-relational,5|7,7,5/7,240131,5
1,3,24,132,1,588,1,13,6,6,7,single-choice,spatial-relational,6|7,7,6/7,240132,6
1,3,24,133,1,1083,4,8,2,2,6,single-choice,spatial-relational,2|6,7,2/6,240133,2
1,3,24,134,1,631,5,7,1,1,6,single-choice,spatial-relational,1|6,7,1/6,240134,1
1,3,24,135,1,616,3,11,4,4,7,single-choice,spatial-relational,4|7,7,4/7,240135,4
1,3,24,136,1,663,3,9,3,3,6,single-choice,spatial-relational,3|6,7,3/6,240136,3
1,3,24,137,0,885,1,11,5,6,6,single-choice,spatial-relational,5|6,7,5/6,240137,5
1,3,24,138,1,677,1,5,2,2,3,single-choice,spatial-relational,2|3,7,2/3,240138,2
1,3,24,139,1,602,2,10,4,4,6,single-choice,spatial-relational,4|6,7,4/6,240139,4
1,3,24,140,1,649,4,8,2,2,6,single-choice,spatial-relational,2|6,7,2/6,240140,2
1,3,24,141,1,691,3,5,1,1,4,single-choice,spatial-relational,1|4,7,1/4,240141,1
1,3,24,142,1,519,5,7,1,1,6,single-choice,spatial-relational,1|6,7,1/6,240142,1
1,3,24,143,0,552,1,7,3,4,4,single-choice,spatial-relational,3|4,7,3/4,240143,3
1,3,24,144,1,629,1,7,3,3,4,single-choice,spatial-relational,3|4,7,3/4,240144,3
1,3,24,145,1,703,2,12,5,5,7,single-choice,spatial-relational,5|7,7,5/7,240145,5
1,3,24,146,0,3,3,7,2,5,5,single-choice,spatial-relational,2|5,7,2/5,240146,2
1,3,24,147,1,507,3,9,3,3,6,single-choice,spatial-relational,3|6,7,3/6,240147,3
1,3,24,148,1,547,1,3,1,1,2,single-choice,spatial-relational,1|2,7,1/2,240148,1
1,3,24,149,1,579,4,10,3,3,7,single-choice,spatial-relational,3|7,7,3/7,240149,3
1,3,24,150,1,687,2,8,3,3,5,single-choice,spatial-relational,3|5,7,3/5,240150,3
1,3,24,151,0,677,2,10,4,6,6,single-choice,spatial-relational,4|6,7,4/6,240151,4
1,3,24,152,0,631,4,6,1,5,5,single-choice,spatial-relational,1|5,7,1/5,240152,1
1,3,24,153,0,751,1,9,4,5,5,single-choice,spatial-relational,4|5,7,4/5,240153,4
1,3,24,154,1,880,5,9,2,2,7,single-choice,spatial-relational,2|7,7,2/7,240154,2
1,3,24,155,1,618,5,9,2,2,7,single-choice,spatial-relational,2|7,7,2/7,240155,2
1,3,24,156,0,624,2,6,2,4,4,single-choice,spatial-relational,2|4,7,2/4,240156,2
1,3,24,157,1,733,2,8,3,3,5,single-choice,spatial-relational,3|5,7,3/5,240157,3
1,3,24,158,1,686,6,8,1,1,7,single-choice,spatial-relational,1|7,7,1/7,240158,1
1,3,24,159,1,797,2,6,2,2,4,single-choice,spatial-relational,2|4,7,2/4,240159,2
1,3,24,160,0,593,1,11,5,6,6,single-choice,spatial-relational,5|6,7,5/6,240160,5
1,3,24,161,1,578,4,6,1,1,5,single-choice,spatial-relational,1|5,7,1/5,240161,1
1,3,24,162,1,569,1,13,6,6,7,single-choice,spatial-relational,6|7,7,6/7,240162,6
1,3,24,163,1,615,6,8,1,1,7,single-choice,spatial-relational,1|7,7,1/7,240163,1
1,3,24,164,1,902,3,11,4,4,7,single-choice,spatial-relational,4|7,7,4/7,240164,4
1,3,24,165,0,661,2,4,1,3,3,single-choice,spatial-relational,1|3,7,1/3,240165,1
1,3,24,166,1,656,2,4,1,1,3,single-choice,spatial-relational,1|3,7,1/3,240166,1
1,3,24,167,1,618,1,3,1,1,2,single-choice,spatial-relational,1|2,7,1/2,240167,1
1,3,24,168,1,703,3,5,1,1,4,single-choice,spatial-relational,1|4,7,1/4,240168,1
1,3,24,169,1,668,3,11,4,4,7,single-choice,spatial-relational,4|7,7,4/7,240169,4
1,3,24,170,1,922,6,8,1,1,7,single-choice,spatial-relational,1|7,7,1/7,240170,1
1,3,24,171,1,606,1,5,2,2,3,single-choice,spatial-relational,2|3,7,2/3,240171,2
1,3,24,172,0,453,1,11,5,6,6,single-choice,spatial-relational,5|6,7,5/6,240172,5
1,3,24,173,0,67,1,9,4,5,5,single-choice,spatial-relational,4|5,7,4/5,240173,4
1,3,24,174,0,607,5,7,1,6,6,single-choice,spatial-relational,1|6,7,1/6,240174,1
1,3,24,175,1,729,2,6,2,2,4,single-choice,spatial-relational,2|4,7,2/4,240175,2
1,3,24,176,1,699,4,6,1,1,5,single-choice,spatial-relational,1|5,7,1/5,240176,1
1,3,24,177,1,604,4,6,1,1,5,single-choice,spatial-relational,1|5,7,1/5,240177,1
1,3,24,178,1,665,3,9,3,3,6,single-choice,spatial-relational,3|6,7,3/6,240178,3
1,3,24,179,1,721,2,10,4,4,6,single-choice,spatial-relational,4|6,7,4/6,240179,4
1,3,24,180,0,664,3,7,2,5,5,single-choice,spatial-relational,2|5,7,2/5,240180,2
1,3,24,181,1,636,3,11,4,4,7,single-choice,spatial-relational,4|7,7,4/7,240181,4
1,3,24,182,1,691,2,4,1,1,3,single-choice,spatial-relational,1|3,7,1/3,240182,1
1,3,24,183,1,730,3,9,3,3,6,single-choice,spatial-relational,3|6,7,3/6,240183,3
1,3,24,184,1,1052,1,5,2,2,3,single-choice,spatial-relational,2|3,7,2/3,240184,2
1,3,24,185,1,574,1,3,1,1,2,single-choice,spatial-relational,1|2,7,1/2,240185,1
1,3,24,186,0,516,4,8,2,6,6,single-choice,spatial-relational,2|6,7,2/6,240186,2
1,3,24,187,1,675,4,10,3,3,7,single-choice,spatial-relational,3|7,7,3/7,240187,3
1,3,24,188,1,792,5,7,1,1,6,single-choice,spatial-relational,1|6,7,1/6,240188,1
1,3,24,189,0,655,1,11,5,6,6,single-choice,spatial-relational,5|6,7,5/6,240189,5
1,3,24,190,1,762,2,8,3,3,5,single-choice,spatial-relational,3|5,7,3/5,240190,3
1,3,24,191,1,655,1,3,1,1,2,single-choice,spatial-relational,1|2,7,1/2,240191,1
1,3,24,192,1,665,1,13,6,6,7,single-choice,spatial-relational,6|7,7,6/7,240192,6
1,3,24,193,0,1271,3,5,1,4,4,single-choice,spatial-relational,1|4,7,1/4,240193,1
1,3,24,194,1,678,3,7,2,2,5,single-choice,spatial-relational,2|5,7,2/5,240194,2
1,3,24,195,1,692,3,5,1,1,4,single-choice,spatial-relational,1|4,7,1/4,240195,1
1,3,24,196,1,758,6,8,1,1,7,single-choice,spatial-relational,1|7,7,1/7,240196,1
1,3,24,197,0,684,1,9,4,5,5,single-choice,spatial-relational,4|5,7,4/5,240197,4
1,3,24,198,1,793,1,7,3,3,4,single-choice,spatial-relational,3|4,7,3/4,240198,3
1,3,24,199,1,1079,4,8,2,2,6,single-choice,spatial-relational,2|6,7,2/6,240199,2
1,3,24,200,0,634,2,4,1,3,3,single-choice,spatial-relational,1|3,7,1/3,240200,1
1,3,24,201,1,730,4,10,3,3,7,single-choice,spatial-relational,3|7,7,3/7,240201,3
1,3,24,202,0,798,2,8,3,5,5,single-choice,spatial-relational,3|5,7,3/5,240202,3
1,3,24,203,1,677,1,7,3,3,4,single-choice,spatial-relational,3|4,7,3/4,240203,3
1,3,24,204,0,585,2,6,2,4,4,single-choice,spatial-relational,2|4,7,2/4,240204,2
1,3,24,205,1,664,2,10,4,4,6,single-choice,spatial-relational,4|6,7,4/6,240205,4
1,3,24,206,1,655,1,13,6,6,7,single-choice,spatial-relational,6|7,7,6/7,240206,6
1,3,24,207,0,553,5,9,2,7,7,single-choice,spatial-relational,2|7,7,2/7,240207,2
1,3,24,208,0,1134,2,12,5,7,7,single-choice,spatial-relational,5|7,7,5/7,240208,5
1,3,24,209,1,665,2,12,5,5,7,single-choice,spatial-relational,5|7,7,5/7,240209,5
1,3,24,210,1,757,5,9,2,2,7,single-choice,spatial-relational,2|7,7,2/7,240210,2
1,3,24,211,1,774,3,11,4,4,7,single-choice,spatial-relational,4|7,7,4/7,240211,4
1,3,24,212,0,735,1,11,5,6,6,single-choice,spatial-relational,5|6,7,5/6,240212,5
1,3,24,213,1,872,1,13,6,6,7,single-choice,spatial-relational,6|7,7,6/7,240213,6
1,3,24,214,0,607,5,7,1,6,6,single-choice,spatial-relational,1|6,7,1/6,240214,1
1,3,24,215,1,720,1,7,3,3,4,single-choice,spatial-relational,3|4,7,3/4,240215,3
1,3,24,216,1,595,1,5,2,2,3,single-choice,spatial-relational,2|3,7,2/3,240216,2
1,3,24,217,1,754,5,9,2,2,7,single-choice,spatial-relational,2|7,7,2/7,240217,2
1,3,24,218,1,754,2,10,4,4,6,single-choice,spatial-relational,4|6,7,4/6,240218,4
1,3,24,219,1,662,5,9,2,2,7,single-choice,spatial-relational,2|7,7,2/7,240219,2
1,3,24,220,1,652,3,11,4,4,7,single-choice,spatial-relational,4|7,7,4/7,240220,4
1,3,24,221,0,39,1,7,3,4,4,single-choice,spatial-relational,3|4,7,3/4,240221,3
1,3,24,222,1,706,2,12,5,5,7,single-choice,spatial-relational,5|7,7,5/7,240222,5
1,3,24,223,1,637,6,8,1,1,7,single-choice,spatial-relational,1|7,7,1/7,240223,1
1,3,24,224,1,806,1,3,1,1,2,single-choice,spatial-relational,1|2,7,1/2,240224,1
1,3,24,225,1,655,4,10,3,3,7,single-choice,spatial-relational,3|7,7,3/7,240225,3
1,3,24,226,1,589,4,10,3,3,7,single-choice,spatial-relational,3|7,7,3/7,240226,3
1,3,24,227,1,804,3,7,2,2,5,single-choice,spatial-relational,2|5,7,2/5,240227,2
1,3,24,228,0,659,3,9,3,6,6,single-choice,spatial-relational,3|6,7,3/6,240228,3
1,3,24,229,1,688,2,4,1,1,3,single-choice,spatial-relational,1|3,7,1/3,240229,1
1,3,24,230,1,603,2,8,3,3,5,single-choice,spatial-relational,3|5,7,3/5,240230,3
1,3,24,231,1,701,1,9,4,4,5,single-choice,spatial-relational,4|5,7,4/5,240231,4
1,3,24,232,1,620,1,13,6,6,7,single-choice,spatial-relational,6|7,7,6/7,240232,6
1,3,24,233,1,793,2,4,1,1,3,single-choice,spatial-relational,1|3,7,1/3,240233,1
1,3,24,234,1,683,4,6,1,1,5,single-choice,spatial-relational,1|5,7,1/5,240234,1
1,3,24,235,0,579,3,5,1,4,4,single-choice,spatial-relational,1|4,7,1/4,240235,1
1,3,24,236,1,728,4,6,1,1,5,single-choice,spatial-relational,1|5,7,1/5,240236,1
1,3,24,237,0,606,2,6,2,4,4,single-choice,spatial-relational,2|4,7,2/4,240237,2
1,3,24,238,1,655,2,8,3,3,5,single-choice,spatial-relational,3|5,7,3/5,240238,3
1,3,24,239,1,687,1,5,2,2,3,single-choice,spatial-relational,2|3,7,2/3,240239,2
1,3,24,240,1,647,3,5,1,1,4,single-choice,spatial-relational,1|4,7,1/4,240240,1
1,3,24,241,0,626,3,7,2,5,5,single-choice,spatial-relational,2|5,7,2/5,240241,2
1,3,24,242,1,556,5,7,1,1,6,single-choice,spatial-relational,1|6,7,1/6,240242,1
1,3,24,243,1,638,2,12,5,5,7,single-choice,spatial-relational,5|7,7,5/7,240243,5
1,3,24,244,1,709,3,9,3,3,6,single-choice,spatial-relational,3|6,7,3/6,240244,3
1,3,24,245,1,547,4,8,2,2,6,single-choice,spatial-relational,2|6,7,2/6,240245,2
1,3,24,246,1,752,1,9,4,4,5,single-choice,spatial-relational,4|5,7,4/5,240246,4
1,3,24,247,0,686,1,11,5,6,6,single-choice,spatial-relational,5|6,7,5/6,240247,5
1,3,24,248,0,619,1,3,1,2,2,single-choice,spatial-relational,1|2,7,1/2,240248,1
1,3,24,249,1,786,2,10,4,4,6,single-choice,spatial-relational,4|6,7,4/6,240249,4
1,3,24,250,1,631,2,6,2,2,4,single-choice,spatial-relational,2|4,7,2/4,240250,2
1,3,24,251,1,578,6,8,1,1,7,single-choice,spatial-relational,1|7,7,1/7,240251,1
1,3,24,252,1,699,4,8,2,2,6,single-choice,spatial-relational,2|6,7,2/6,240252,2
1,3,24,253,1,555,1,13,6,6,7,single-choice,spatial-relational,6|7,7,6/7,240253,6
1,3,24,254,1,812,1,7,3,3,4,single-choice,spatial-relational,3|4,7,3/4,240254,3
1,3,24,255,1,6303,6,8,1,1,7,single-choice,spatial-relational,1|7,7,1/7,240255,1
1,3,24,256,1,823,1,9,4,4,5,single-choice,spatial-relational,4|5,7,4/5,240256,4
1,3,24,257,1,660,3,7,2,2,5,single-choice,spatial-relational,2|5,7,2/5,240257,2
1,3,24,258,1,611,1,3,1,1,2,single-choice,spatial-relational,1|2,7,1/2,240258,1
1,3,24,259,1,699,3,9,3,3,6,single-choice,spatial-relational,3|6,7,3/6,240259,3
1,3,24,260,0,632,3,7,2,5,5,single-choice,spatial-relational,2|5,7,2/5,240260,2
1,3,24,261,1,653,2,12,5,5,7,single-choice,spatial-relational,5|7,7,5/7,240261,5
1,3,24,262,1,727,3,9,3,3,6,single-choice,spatial-relational,3|6,7,3/6,240262,3
1,3,24,263,1,649,4,10,3,3,7,single-choice,spatial-relational,3|7,7,3/7,240263,3
1,3,24,264,0,688,1,11,5,6,6,single-choice,spatial-relational,5|6,7,5/6,240264,5
1,3,24,265,1,655,4,10,3,3,7,single-choice,spatial-relational,3|7,7,3/7,240265,3
1,3,24,266,0,708,3,5,1,4,4,single-choice,spatial-relational,1|4,7,1/4,240266,1
1,3,24,267,1,642,3,5,1,1,4,single-choice,spatial-relational,1|4,7,1/4,240267,1
1,3,24,268,1,638,2,6,2,2,4,single-choice,spatial-relational,2|4,7,2/4,240268,2
1,3,24,269,1,521,1,5,2,2,3,single-choice,spatial-relational,2|3,7,2/3,240269,2
1,3,24,270,1,4,4,6,1,1,5,single-choice,spatial-relational,1|5,7,1/5,240270,1
1,3,24,271,0,579,4,8,2,6,6,single-choice,spatial-relational,2|6,7,2/6,240271,2
1,3,24,272,1,684,5,9,2,2,7,single-choice,spatial-relational,2|7,7,2/7,240272,2
1,3,24,273,1,654,2,8,3,3,5,single-choice,spatial-relational,3|5,7,3/5,240273,3
1,3,24,274,1,628,5,7,1,1,6,single-choice,spatial-relational,1|6,7,1/6,240274,1
1,3,24,275,0,4,5,7,1,6,6,single-choice,spatial-relational,1|6,7,1/6,240275,1
1,3,24,276,1,557,3,11,4,4,7,single-choice,spatial-relational,4|7,7,4/7,240276,4
1,3,24,277,1,689,3,11,4,4,7,single-choice,spatial-relational,4|7,7,4/7,240277,4
1,3,24,278,1,646,2,4,1,1,3,single-choice,spatial-relational,1|3,7,1/3,240278,1
1,3,24,279,0,673,4,6,1,5,5,single-choice,spatial-relational,1|5,7,1/5,240279,1
1,3,24,280,0,847,2,10,4,6,6,single-choice,spatial-relational,4|6,7,4/6,240280,4
1,3,24,281,0,583,1,3,1,2,2,single-choice,spatial-relational,1|2,7,1/2,240281,1
1,3,24,282,0,621,2,12,5,7,7,single-choice,spatial-relational,5|7,7,5/7,240282,5
1,3,24,283,1,759,2,6,2,2,4,single-choice,spatial-relational,2|4,7,2/4,240283,2
1,3,24,284,1,191,4,8,2,2,6,single-choice,spatial-relational,2|6,7,2/6,240284,2
1,3,24,285,1,410,1,9,4,4,5,single-choice,spatial-relational,4|5,7,4/5,240285,4
1,3,24,286,1,1696,2,8,3,3,5,single-choice,spatial-relational,3|5,7,3/5,240286,3
1,3,24,287,1,655,1,13,6,6,7,single-choice,spatial-relational,6|7,7,6/7,240287,6
1,3,24,288,0,572,1,5,2,3,3,single-choice,spatial-relational,2|3,7,2/3,240288,2
1,3,24,289,1,543,5,9,2,2,7,single-choice,spatial-relational,2|7,7,2/7,240289,2
1,3,24,290,0,668,2,10,4,6,6,single-choice,spatial-relational,4|6,7,4/6,240290,4
1,3,24,291,1,658,6,8,1,1,7,single-choice,spatial-relational,1|7,7,1/7,240291,1
1,3,24,292,0,726,1,7,3,4,4,single-choice,spatial-relational,3|4,7,3/4,240292,3
1,3,24,293,0,507,2,4,1,3,3,single-choice,spatial-relational,1|3,7,1/3,240293,1
1,3,24,294,1,590,1,11,5,5,6,single-choice,spatial-relational,5|6,7,5/6,240294,5
1,3,24,295,0,563,2,6,2,4,4,single-choice,spatial-relational,2|4,7,2/4,240295,2
1,3,24,296,1,722,5,9,2,2,7,single-choice,spatial-relational,2|7,7,2/7,240296,2
1,3,24,297,0,600,1,11,5,6,6,single-choice,spatial-relational,5|6,7,5/6,240297,5
1,3,24,298,1,602,3,5,1,1,4,single-choice,spatial-relational,1|4,7,1/4,240298,1
1,3,24,299,0,583,1,5,2,3,3,single-choice,spatial-relational,2|3,7,2/3,240299,2
1,3,24,300,0,17571,5,7,1,6,6,single-choice,spatial-relational,1|6,7,1/6,240300,1
1,3,24,301,1,651,4,10,3,3,7,single-choice,spatial-relational,3|7,7,3/7,240301,3
1,3,24,302,0,674,4,6,1,5,5,single-choice,spatial-relational,1|5,7,1/5,240302,1
1,3,24,303,1,706,2,12,5,5,7,single-choice,spatial-relational,5|7,7,5/7,240303,5
1,3,24,304,1,771,1,13,6,6,7,single-choice,spatial-relational,6|7,7,6/7,240304,6
1,3,24,305,0,470,4,8,2,6,6,single-choice,spatial-relational,2|6,7,2/6,240305,2
1,3,24,306,0,761,1,3,1,2,2,single-choice,spatial-relational,1|2,7,1/2,240306,1
1,3,24,307,1,501,1,3,1,1,2,single-choice,spatial-relational,1|2,7,1/2,240307,1
1,3,24,308,0,509,5,9,2,7,7,single-choice,spatial-relational,2|7,7,2/7,240308,2
1,3,24,309,0,677,2,6,2,4,4,single-choice,spatial-relational,2|4,7,2/4,240309,2
1,3,24,310,1,570,1,5,2,2,3,single-choice,spatial-relational,2|3,7,2/3,240310,2
1,3,24,311,0,632,1,9,4,5,5,single-choice,spatial-relational,4|5,7,4/5,240311,4
1,3,24,312,0,628,2,4,1,3,3,single-choice,spatial-relational,1|3,7,1/3,240312,1
1,3,24,313,1,539,3,9,3,3,6,single-choice,spatial-relational,3|6,7,3/6,240313,3
1,3,24,314,0,636,3,11,4,7,7,single-choice,spatial-relational,4|7,7,4/7,240314,4
1,3,24,315,1,585,1,13,6,6,7,single-choice,spatial-relational,6|7,7,6/7,240315,6
1,3,24,316,0,734,3,7,2,5,5,single-choice,spatial-relational,2|5,7,2/5,240316,2
1,3,24,317,1,794,2,4,1,1,3,single-choice,spatial-relational,1|3,7,1/3,240317,1
1,3,24,318,1,494,1,11,5,5,6,single-choice,spatial-relational,5|6,7,5/6,240318,5
1,3,24,319,0,489,6,8,1,7,7,single-choice,spatial-relational,1|7,7,1/7,240319,1
1,3,24,320,1,513,6,8,1,1,7,single-choice,spatial-relational,1|7,7,1/7,240320,1
1,3,24,321,1,506,2,8,3,3,5,single-choice,spatial-relational,3|5,7,3/5,240321,3
1,3,24,322,0,649,3,9,3,6,6,single-choice,spatial-relational,3|6,7,3/6,240322,3
1,3,24,323,1,584,1,7,3,3,4,single-choice,spatial-relational,3|4,7,3/4,240323,3
1,3,24,324,1,520,4,8,2,2,6,single-choice,spatial-relational,2|6,7,2/6,240324,2
1,3,24,325,1,440,4,6,1,1,5,single-choice,spatial-relational,1|5,7,1/5,240325,1
1,3,24,326,1,31,5,7,1,1,6,single-choice,spatial-relational,1|6,7,1/6,240326,1
1,3,24,327,1,608,2,12,5,5,7,single-choice,spatial-relational,5|7,7,5/7,240327,5
1,3,24,328,1,614,3,11,4,4,7,single-choice,spatial-relational,4|7,7,4/7,240328,4
1,3,24,329,1,610,2,8,3,3,5,single-choice,spatial-relational,3|5,7,3/5,240329,3
1,3,24,330,1,584,4,10,3,3,7,single-choice,spatial-relational,3|7,7,3/7,240330,3
1,3,24,331,1,759,3,5,1,1,4,single-choice,spatial-relational,1|4,7,1/4,240331,1
1,3,24,332,1,593,2,10,4,4,6,single-choice,spatial-relational,4|6,7,4/6,240332,4
1,3,24,333,0,539,1,7,3,4,4,single-choice,spatial-relational,3|4,7,3/4,240333,3
1,3,24,334,1,598,1,9,4,4,5,single-choice,spatial-relational,4|5,7,4/5,240334,4
1,3,24,335,0,539,3,7,2,5,5,single-choice,spatial-relational,2|5,7,2/5,240335,2
1,3,24,336,0,703,2,10,4,6,6,single-choice,spatial-relational,4|6,7,4/6,240336,4
1,3,24,337,1,581,3,11,4,4,7,single-choice,spatial-relational,4|7,7,4/7,240337,4
1,3,24,338,0,542,5,9,2,7,7,single-choice,spatial-relational,2|7,7,2/7,240338,2
1,3,24,339,1,639,4,8,2,2,6,single-choice,spatial-relational,2|6,7,2/6,240339,2
1,3,24,340,0,602,2,8,3,5,5,single-choice,spatial-relational,3|5,7,3/5,240340,3
1,3,24,341,0,503,4,10,3,7,7,single-choice,spatial-relational,3|7,7,3/7,240341,3
1,3,24,342,0,564,5,7,1,6,6,single-choice,spatial-relational,1|6,7,1/6,240342,1
1,3,24,343,1,1205,4,6,1,1,5,single-choice,spatial-relational,1|5,7,1/5,240343,1
1,3,24,344,1,472,2,4,1,1,3,single-choice,spatial-relational,1|3,7,1/3,240344,1
1,3,24,345,1,496,1,13,6,6,7,single-choice,spatial-relational,6|7,7,6/7,240345,6
1,3,24,346,0,542,6,8,1,7,7,single-choice,spatial-relational,1|7,7,1/7,240346,1
1,3,24,347,1,987,1,7,3,3,4,single-choice,spatial-relational,3|4,7,3/4,240347,3
1,3,24,348,0,488,3,11,4,7,7,single-choice,spatial-relational,4|7,7,4/7,240348,4
1,3,24,349,1,663,1,13,6,6,7,single-choice,spatial-relational,6|7,7,6/7,240349,6
1,3,24,350,1,1355,1,5,2,2,3,single-choice,spatial-relational,2|3,7,2/3,240350,2
1,3,24,351,1,869,6,8,1,1,7,single-choice,spatial-relational,1|7,7,1/7,240351,1
1,3,24,352,1,983,1,11,5,5,6,single-choice,spatial-relational,5|6,7,5/6,240352,5
1,3,24,353,1,850,1,7,3,3,4,single-choice,spatial-relational,3|4,7,3/4,240353,3
1,3,24,354,0,796,4,6,1,5,5,single-choice,spatial-relational,1|5,7,1/5,240354,1
1,3,24,355,1,534,1,3,1,1,2,single-choice,spatial-relational,1|2,7,1/2,240355,1
1,3,24,356,1,501,1,9,4,4,5,single-choice,spatial-relational,4|5,7,4/5,240356,4
1,3,24,357,0,1104,3,7,2,5,5,single-choice,spatial-relational,2|5,7,2/5,240357,2
1,3,24,358,0,532,2,6,2,4,4,single-choice,spatial-relational,2|4,7,2/4,240358,2
1,3,24,359,1,559,2,6,2,2,4,single-choice,spatial-relational,2|4,7,2/4,240359,2
1,3,24,360,0,531,2,10,4,6,6,single-choice,spatial-relational,4|6,7,4/6,240360,4
1,3,24,361,0,972,2,12,5,7,7,single-choice,spatial-relational,5|7,7,5/7,240361,5
1,3,24,362,1,790,4,10,3,3,7,single-choice,spatial-relational,3|7,7,3/7,240362,3
1,3,24,363,1,541,2,8,3,3,5,single-choice,spatial-relational,3|5,7,3/5,240363,3
1,3,24,364,1,451,3,5,1,1,4,single-choice,spatial-relational,1|4,7,1/4,240364,1
1,3,24,365,0,715,1,9,4,5,5,single-choice,spatial-relational,4|5,7,4/5,240365,4
1,3,24,366,1,533,5,7,1,1,6,single-choice,spatial-relational,1|6,7,1/6,240366,1
1,3,24,367,1,565,4,8,2,2,6,single-choice,spatial-relational,2|6,7,2/6,240367,2
1,3,24,368,1,557,3,9,3,3,6,single-choice,spatial-relational,3|6,7,3/6,240368,3
1,3,24,369,0,488,2,12,5,7,7,single-choice,spatial-relational,5|7,7,5/7,240369,5
1,3,24,370,0,15847,3,7,2,5,5,single-choice,spatial-relational,2|5,7,2/5,240370,2
1,3,24,371,1,424,2,8,3,3,5,single-choice,spatial-relational,3|5,7,3/5,240371,3
1,3,24,372,1,443,5,7,1,1,6,single-choice,spatial-relational,1|6,7,1/6,240372,1
1,3,24,373,1,614,1,13,6,6,7,single-choice,spatial-relational,6|7,7,6/7,240373,6
1,3,24,374,1,591,1,9,4,4,5,single-choice,spatial-relational,4|5,7,4/5,240374,4
1,3,24,375,1,458,4,6,1,1,5,single-choice,spatial-relational,1|5,7,1/5,240375,1
1,3,24,376,1,404,1,9,4,4,5,single-choice,spatial-relational,4|5,7,4/5,240376,4
1,3,24,377,0,550,1,5,2,3,3,single-choice,spatial-relational,2|3,7,2/3,240377,2
1,3,24,378,1,545,2,8,3,3,5,single-choice,spatial-relational,3|5,7,3/5,240378,3
1,3,24,379,1,594,1,7,3,3,4,single-choice,spatial-relational,3|4,7,3/4,240379,3
1,3,24,380,1,570,5,7,1,1,6,single-choice,spatial-relational,1|6,7,1/6,240380,1
1,3,24,381,0,422,3,7,2,5,5,single-choice,spatial-relational,2|5,7,2/5,240381,2
1,3,24,382,0,577,2,10,4,6,6,single-choice,spatial-relational,4|6,7,4/6,240382,4
1,3,24,383,1,463,2,6,2,2,4,single-choice,spatial-relational,2|4,7,2/4,240383,2
1,3,24,384,0,603,1,11,5,6,6,single-choice,spatial-relational,5|6,7,5/6,240384,5
1,3,24,385,1,442,1,13,6,6,7,single-choice,spatial-relational,6|7,7,6/7,240385,6
1,3,24,386,0,514,2,4,1,3,3,single-choice,spatial-relational,1|3,7,1/3,240386,1
1,3,24,387,0,432,2,6,2,4,4,single-choice,spatial-relational,2|4,7,2/4,240387,2
1,3,24,388,1,533,2,12,5,5,7,single-choice,spatial-relational,5|7,7,5/7,240388,5
1,3,24,389,1,510,4,10,3,3,7,single-choice,spatial-relational,3|7,7,3/7,240389,3
1,3,24,390,1,561,3,9,3,3,6,single-choice,spatial-relational,3|6,7,3/6,240390,3
1,3,24,391,0,470,3,9,3,6,6,single-choice,spatial-relational,3|6,7,3/6,240391,3
1,3,24,392,1,602,3,5,1,1,4,single-choice,spatial-relational,1|4,7,1/4,240392,1
1,3,24,393,1,565,6,8,1,1,7,single-choice,spatial-relational,1|7,7,1/7,240393,1
1,3,24,394,0,578,2,12,5,7,7,single-choice,spatial-relational,5|7,7,5/7,240394,5
1,3,24,395,1,525,3,11,4,4,7,single-choice,spatial-relational,4|7,7,4/7,240395,4
1,3,24,396,1,658,5,9,2,2,7,single-choice,spatial-relational,2|7,7,2/7,240396,2
1,3,24,397,1,584,3,11,4,4,7,single-choice,spatial-relational,4|7,7,4/7,240397,4
1,3,24,398,0,628,3,5,1,4,4,single-choice,spatial-relational,1|4,7,1/4,240398,1
1,3,24,399,1,628,4,6,1,1,5,single-choice,spatial-relational,1|5,7,1/5,240399,1
1,3,24,400,1,673,4,8,2,2,6,single-choice,spatial-relational,2|6,7,2/6,240400,2
1,3,24,401,1,615,1,3,1,1,2,single-choice,spatial-relational,1|2,7,1/2,240401,1
1,3,24,402,0,600,4,8,2,6,6,single-choice,spatial-relational,2|6,7,2/6,240402,2
1,3,24,403,1,608,6,8,1,1,7,single-choice,spatial-relational,1|7,7,1/7,240403,1
1,3,24,404,0,537,1,3,1,2,2,single-choice,spatial-relational,1|2,7,1/2,240404,1
1,3,24,405,1,531,4,10,3,3,7,single-choice,spatial-relational,3|7,7,3/7,240405,3
1,3,24,406,0,572,2,4,1,3,3,single-choice,spatial-relational,1|3,7,1/3,240406,1
1,3,24,407,1,564,5,9,2,2,7,single-choice,spatial-relational,2|7,7,2/7,240407,2
1,3,24,408,1,606,1,7,3,3,4,single-choice,spatial-relational,3|4,7,3/4,240408,3
1,3,24,409,0,604,2,10,4,6,6,single-choice,spatial-relational,4|6,7,4/6,240409,4
1,3,24,410,0,733,1,11,5,6,6,single-choice,spatial-relational,5|6,7,5/6,240410,5
1,3,24,411,1,556,3,7,2,2,5,single-choice,spatial-relational,2|5,7,2/5,240411,2
1,3,24,412,0,3354,1,5,2,3,3,single-choice,spatial-relational,2|3,7,2/3,240412,2
1,3,24,413,1,5270,5,9,2,2,7,single-choice,spatial-relational,2|7,7,2/7,240413,2
1,3,24,414,0,463,3,5,1,4,4,single-choice,spatial-relational,1|4,7,1/4,240414,1
1,3,24,415,1,577,4,8,2,2,6,single-choice,spatial-relational,2|6,7,2/6,240415,2
1,3,24,416,1,685,3,11,4,4,7,single-choice,spatial-relational,4|7,7,4/7,240416,4
1,3,24,417,1,601,4,6,1,1,5,single-choice,spatial-relational,1|5,7,1/5,240417,1
1,3,24,418,0,833,2,12,5,7,7,single-choice,spatial-relational,5|7,7,5/7,240418,5
1,3,24,419,0,773,1,13,6,7,7,single-choice,spatial-relational,6|7,7,6/7,240419,6
1,3,24,420,1,563,1,13,6,6,7,single-choice,spatial-relational,6|7,7,6/7,240420,6
1,3,24,421,1,639,3,11,4,4,7,single-choice,spatial-relational,4|7,7,4/7,240421,4
1,3,24,422,1,740,4,8,2,2,6,single-choice,spatial-relational,2|6,7,2/6,240422,2
1,3,24,423,1,721,1,9,4,4,5,single-choice,spatial-relational,4|5,7,4/5,240423,4
1,3,24,424,1,633,3,5,1,1,4,single-choice,spatial-relational,1|4,7,1/4,240424,1
1,3,24,425,1,533,3,7,2,2,5,single-choice,spatial-relational,2|5,7,2/5,240425,2
1,3,24,426,0,11415,2,6,2,4,4,single-choice,spatial-relational,2|4,7,2/4,240426,2
1,3,24,427,0,2490,1,5,2,3,3,single-choice,spatial-relational,2|3,7,2/3,240427,2
1,3,24,428,0,534,2,4,1,3,3,single-choice,spatial-relational,1|3,7,1/3,240428,1
1,3,24,429,1,748,3,9,3,3,6,single-choice,spatial-relational,3|6,7,3/6,240429,3
1,3,24,430,1,666,1,9,4,4,5,single-choice,spatial-relational,4|5,7,4/5,240430,4
1,3,24,431,0,668,1,3,1,2,2,single-choice,spatial-relational,1|2,7,1/2,240431,1
1,3,24,432,1,725,1,3,1,1,2,single-choice,spatial-relational,1|2,7,1/2,240432,1
1,3,24,433,0,591,2,10,4,6,6,single-choice,spatial-relational,4|6,7,4/6,240433,4
1,3,24,434,0,824,2,8,3,5,5,single-choice,spatial-relational,3|5,7,3/5,240434,3
1,3,24,435,1,540,2,8,3,3,5,single-choice,spatial-relational,3|5,7,3/5,240435,3
1,3,24,436,1,802,1,7,3,3,4,single-choice,spatial-relational,3|4,7,3/4,240436,3
1,3,24,437,1,646,6,8,1,1,7,single-choice,spatial-relational,1|7,7,1/7,240437,1
1,3,24,438,1,647,2,10,4,4,6,single-choice,spatial-relational,4|6,7,4/6,240438,4
1,3,24,439,0,732,1,5,2,3,3,single-choice,spatial-relational,2|3,7,2/3,240439,2
1,3,24,440,1,607,6,8,1,1,7,single-choice,spatial-relational,1|7,7,1/7,240440,1
1,3,24,441,1,568,4,10,3,3,7,single-choice,spatial-relational,3|7,7,3/7,240441,3
1,3,24,442,0,970,4,6,1,5,5,single-choice,spatial-relational,1|5,7,1/5,240442,1
1,3,24,443,1,519,4,10,3,3,7,single-choice,spatial-relational,3|7,7,3/7,240443,3
1,3,24,444,1,610,3,9,3,3,6,single-choice,spatial-relational,3|6,7,3/6,240444,3
1,3,24,445,1,712,2,6,2,2,4,single-choice,spatial-relational,2|4,7,2/4,240445,2
1,3,24,446,0,679,2,12,5,7,7,single-choice,spatial-relational,5|7,7,5/7,240446,5
1,3,24,447,1,687,5,9,2,2,7,single-choice,spatial-relational,2|7,7,2/7,240447,2
1,3,24,448,0,584,1,11,5,6,6,single-choice,spatial-relational,5|6,7,5/6,240448,5
1,3,24,449,1,478,5,7,1,1,6,single-choice,spatial-relational,1|6,7,1/6,240449,1
1,3,24,450,1,559,1,7,3,3,4,single-choice,spatial-relational,3|4,7,3/4,240450,3
1,3,24,451,0,762,5,7,1,6,6,single-choice,spatial-relational,1|6,7,1/6,240451,1
1,3,24,452,1,572,3,7,2,2,5,single-choice,spatial-relational,2|5,7,2/5,240452,2
1,3,24,453,1,552,1,11,5,5,6,single-choice,spatial-relational,5|6,7,5/6,240453,5
1,3,24,454,1,711,2,4,1,1,3,single-choice,spatial-relational,1|3,7,1/3,240454,1
1,3,24,455,0,889,3,5,1,4,4,single-choice,spatial-relational,1|4,7,1/4,240455,1
1,3,24,456,0,790,5,9,2,7,7,single-choice,spatial-relational,2|7,7,2/7,240456,2
1,3,24,457,1,814,1,7,3,3,4,single-choice,spatial-relational,3|4,7,3/4,240457,3
1,3,24,458,1,685,2,12,5,5,7,single-choice,spatial-relational,5|7,7,5/7,240458,5
1,3,24,459,1,568,4,10,3,3,7,single-choice,spatial-relational,3|7,7,3/7,240459,3
1,3,24,460,1,686,2,8,3,3,5,single-choice,spatial-relational,3|5,7,3/5,240460,3
1,3,24,461,1,1282,3,9,3,3,6,single-choice,spatial-relational,3|6,7,3/6,240461,3
1,3,24,462,1,708,3,5,1,1,4,single-choice,spatial-relational,1|4,7,1/4,240462,1
1,3,24,463,1,575,5,7,1,1,6,single-choice,spatial-relational,1|6,7,1/6,240463,1
1,3,24,464,0,642,2,8,3,5,5,single-choice,spatial-relational,3|5,7,3/5,240464,3
1,3,24,465,1,568,3,11,4,4,7,single-choice,spatial-relational,4|7,7,4/7,240465,4
1,3,24,466,1,603,2,10,4,4,6,single-choice,spatial-relational,4|6,7,4/6,240466,4
1,3,24,467,1,775,3,9,3,3,6,single-choice,spatial-relational,3|6,7,3/6,240467,3
1,3,24,468,0,1072,1,9,4,5,5,single-choice,spatial-relational,4|5,7,4/5,240468,4
1,3,24,469,1,698,2,6,2,2,4,single-choice,spatial-relational,2|4,7,2/4,240469,2
1,3,24,470,1,629,2,12,5,5,7,single-choice,spatial-relational,5|7,7,5/7,240470,5
1,3,24,471,1,673,6,8,1,1,7,single-choice,spatial-relational,1|7,7,1/7,240471,1
1,3,24,472,1,547,6,8,1,1,7,single-choice,spatial-relational,1|7,7,1/7,240472,1
1,3,24,473,1,684,2,10,4,4,6,single-choice,spatial-relational,4|6,7,4/6,240473,4
1,3,24,474,1,609,3,7,2,2,5,single-choice,spatial-relational,2|5,7,2/5,240474,2
1,3,24,475,1,694,1,13,6,6,7,single-choice,spatial-relational,6|7,7,6/7,240475,6
1,3,24,476,1,714,1,11,5,5,6,single-choice,spatial-relational,5|6,7,5/6,240476,5
1,3,24,477,0,655,1,5,2,3,3,single-choice,spatial-relational,2|3,7,2/3,240477,2
1,3,24,478,1,550,4,6,1,1,5,single-choice,spatial-relational,1|5,7,1/5,240478,1
1,3,24,479,1,737,4,6,1,1,5,single-choice,spatial-relational,1|5,7,1/5,240479,1
1,3,24,480,1,661,5,7,1,1,6,single-choice,spatial-relational,1|6,7,1/6,240480,1
1,3,24,481,1,673,3,11,4,4,7,single-choice,spatial-relational,4|7,7,4/7,240481,4
1,3,24,482,0,620,1,3,1,2,2,single-choice,spatial-relational,1|2,7,1/2,240482,1
1,3,24,483,1,528,1,3,1,1,2,single-choice,spatial-relational,1|2,7,1/2,240483,1
1,3,24,484,1,584,3,7,2,2,5,single-choice,spatial-relational,2|5,7,2/5,240484,2
1,3,24,485,1,632,4,10,3,3,7,single-choice,spatial-relational,3|7,7,3/7,240485,3
1,3,24,486,1,687,4,8,2,2,6,single-choice,spatial-relational,2|6,7,2/6,240486,2
1,3,24,487,1,830,2,4,1,1,3,single-choice,spatial-relational,1|3,7,1/3,240487,1
1,3,24,488,1,612,1,7,3,3,4,single-choice,spatial-relational,3|4,7,3/4,240488,3
1,3,24,489,1,675,1,13,6,6,7,single-choice,spatial-relational,6|7,7,6/7,240489,6
1,3,24,490,1,675,1,9,4,4,5,single-choice,spatial-relational,4|5,7,4/5,240490,4
1,3,24,491,1,623,4,8,2,2,6,single-choice,spatial-relational,2|6,7,2/6,240491,2
1,3,24,492,0,834,1,11,5,6,6,single-choice,spatial-relational,5|6,7,5/6,240492,5
1,3,24,493,1,655,5,9,2,2,7,single-choice,spatial-relational,2|7,7,2/7,240493,2
1,3,24,494,0,593,2,6,2,4,4,single-choice,spatial-relational,2|4,7,2/4,240494,2
1,3,24,495,1,706,2,4,1,1,3,single-choice,spatial-relational,1|3,7,1/3,240495,1
1,3,24,496,1,774,1,5,2,2,3,single-choice,spatial-relational,2|3,7,2/3,240496,2
1,3,24,497,1,792,3,9,3,3,6,single-choice,spatial-relational,3|6,7,3/6,240497,3
1,3,24,498,1,666,4,10,3,3,7,single-choice,spatial-relational,3|7,7,3/7,240498,3
1,3,24,499,1,756,6,8,1,1,7,single-choice,spatial-relational,1|7,7,1/7,240499,1
1,3,24,500,1,649,2,4,1,1,3,single-choice,spatial-relational,1|3,7,1/3,240500,1
1,3,24,501,0,668,1,5,2,3,3,single-choice,spatial-relational,2|3,7,2/3,240501,2
1,3,24,502,1,525,1,13,6,6,7,single-choice,spatial-relational,6|7,7,6/7,240502,6
1,3,24,503,1,599,1,7,3,3,4,single-choice,spatial-relational,3|4,7,3/4,240503,3
1,3,24,504,0,870,3,7,2,5,5,single-choice,spatial-relational,2|5,7,2/5,240504,2
1,3,24,505,0,576,4,8,2,6,6,single-choice,spatial-relational,2|6,7,2/6,240505,2
1,3,24,506,0,707,1,3,1,2,2,single-choice,spatial-relational,1|2,7,1/2,240506,1
1,3,24,507,1,991,3,9,3,3,6,single-choice,spatial-relational,3|6,7,3/6,240507,3
1,3,24,508,1,766,2,6,2,2,4,single-choice,spatial-relational,2|4,7,2/4,240508,2
1,3,24,509,1,705,2,12,5,5,7,single-choice,spatial-relational,5|7,7,5/7,240509,5
1,3,24,510,1,731,4,8,2,2,6,single-choice,spatial-relational,2|6,7,2/6,240510,2
1,3,24,511,1,738,2,10,4,4,6,single-choice,spatial-relational,4|6,7,4/6,240511,4
1,3,24,512,1,694,3,5,1,1,4,single-choice,spatial-relational,1|4,7,1/4,240512,1
1,3,24,513,1,782,2,12,5,5,7,single-choice,spatial-relational,5|7,7,5/7,240513,5
1,3,24,514,1,735,1,11,5,5,6,single-choice,spatial-relational,5|6,7,5/6,240514,5
1,3,24,515,1,670,3,11,4,4,7,single-choice,spatial-relational,4|7,7,4/7,240515,4
1,3,24,516,0,1065,5,9,2,7,7,single-choice,spatial-relational,2|7,7,2/7,240516,2
1,3,24,517,0,685,1,9,4,5,5,single-choice,spatial-relational,4|5,7,4/5,240517,4
1,3,24,518,1,598,6,8,1,1,7,single-choice,spatial-relational,1|7,7,1/7,240518,1
1,3,24,519,1,647,2,8,3,3,5,single-choice,spatial-relational,3|5,7,3/5,240519,3
1,3,24,520,1,646,1,11,5,5,6,single-choice,spatial-relational,5|6,7,5/6,240520,5
1,3,24,521,0,658,1,7,3,4,4,single-choice,spatial-relational,3|4,7,3/4,240521,3
1,3,24,522,1,540,5,7,1,1,6,single-choice,spatial-relational,1|6,7,1/6,240522,1
1,3,24,523,1,644,4,10,3,3,7,single-choice,spatial-relational,3|7,7,3/7,240523,3
1,3,24,524,0,575,3,5,1,4,4,single-choice,spatial-relational,1|4,7,1/4,240524,1
1,3,24,525,1,572,1,13,6,6,7,single-choice,spatial-relational,6|7,7,6/7,240525,6
1,3,24,526,1,436,1,9,4,4,5,single-choice,spatial-relational,4|5,7,4/5,240526,4
1,3,24,527,0,115622,5,9,2,7,7,single-choice,spatial-relational,2|7,7,2/7,240527,2
1,3,24,528,0,703,3,11,4,7,7,single-choice,spatial-relational,4|7,7,4/7,240528,4
1,3,24,529,0,526,1,5,2,3,3,single-choice,spatial-relational,2|3,7,2/3,240529,2
1,3,24,530,0,486,5,7,1,6,6,single-choice,spatial-relational,1|6,7,1/6,240530,1
1,3,24,531,1,623,3,7,2,2,5,single-choice,spatial-relational,2|5,7,2/5,240531,2
1,3,24,532,1,579,2,10,4,4,6,single-choice,spatial-relational,4|6,7,4/6,240532,4
1,3,24,533,1,645,4,6,1,1,5,single-choice,spatial-relational,1|5,7,1/5,240533,1
1,3,24,534,1,605,2,8,3,3,5,single-choice,spatial-relational,3|5,7,3/5,240534,3
1,3,24,535,0,511,2,6,2,4,4,single-choice,spatial-relational,2|4,7,2/4,240535,2
1,3,24,536,1,622,2,4,1,1,3,single-choice,spatial-relational,1|3,7,1/3,240536,1
1,3,24,537,1,594,4,6,1,1,5,single-choice,spatial-relational,1|5,7,1/5,240537,1
1,3,24,538,1,634,1,3,1,1,2,single-choice,spatial-relational,1|2,7,1/2,240538,1
1,3,24,539,1,599,1,7,3,3,4,single-choice,spatial-relational,3|4,7,3/4,240539,3
1,3,24,540,1,2077,3,5,1,1,4,single-choice,spatial-relational,1|4,7,1/4,240540,1
1,3,24,541,0,562,2,10,4,6,6,single-choice,spatial-relational,4|6,7,4/6,240541,4
1,3,24,542,1,553,4,6,1,1,5,single-choice,spatial-relational,1|5,7,1/5,240542,1
1,3,24,543,1,631,3,9,3,3,6,single-choice,spatial-relational,3|6,7,3/6,240543,3
1,3,24,544,1,615,1,11,5,5,6,single-choice,spatial-relational,5|6,7,5/6,240544,5
1,3,24,545,1,654,1,7,3,3,4,single-choice,spatial-relational,3|4,7,3/4,240545,3
1,3,24,546,1,431,2,4,1,1,3,single-choice,spatial-relational,1|3,7,1/3,240546,1
1,3,24,547,1,560,2,12,5,5,7,single-choice,spatial-relational,5|7,7,5/7,240547,5
1,3,24,548,1,632,4,10,3,3,7,single-choice,spatial-relational,3|7,7,3/7,240548,3
1,3,24,549,1,791,1,9,4,4,5,single-choice,spatial-relational,4|5,7,4/5,240549,4
1,3,24,550,0,662,1,3,1,2,2,single-choice,spatial-relational,1|2,7,1/2,240550,1
1,3,24,551,1,1038,5,9,2,2,7,single-choice,spatial-relational,2|7,7,2/7,240551,2
1,3,24,552,1,639,5,7,1,1,6,single-choice,spatial-relational,1|6,7,1/6,240552,1
1,3,24,553,1,940,5,9,2,2,7,single-choice,spatial-relational,2|7,7,2/7,240553,2
1,3,24,554,1,641,1,13,6,6,7,single-choice,spatial-relational,6|7,7,6/7,240554,6
1,3,24,555,1,177275,6,8,1,1,7,single-choice,spatial-relational,1|7,7,1/7,240555,1
1,3,24,556,0,550,2,12,5,7,7,single-choice,spatial-relational,5|7,7,5/7,240556,5
1,3,24,557,1,576,4,10,3,3,7,single-choice,spatial-relational,3|7,7,3/7,240557,3
1,3,24,558,1,622,3,11,4,4,7,single-choice,spatial-relational,4|7,7,4/7,240558,4
1,3,24,559,1,560,3,7,2,2,5,single-choice,spatial-relational,2|5,7,2/5,240559,2
1,3,24,560,0,588,2,10,4,6,6,single-choice,spatial-relational,4|6,7,4/6,240560,4
1,3,24,561,1,585,5,7,1,1,6,single-choice,spatial-relational,1|6,7,1/6,240561,1
1,3,24,562,1,686,2,8,3,3,5,single-choice,spatial-relational,3|5,7,3/5,240562,3
1,3,24,563,1,605,2,8,3,3,5,single-choice,spatial-relational,3|5,7,3/5,240563,3
1,3,24,564,1,768,2,6,2,2,4,single-choice,spatial-relational,2|4,7,2/4,240564,2
1,3,24,565,0,624,3,5,1,4,4,single-choice,spatial-relational,1|4,7,1/4,240565,1
1,3,24,566,0,581,2,4,1,3,3,single-choice,spatial-relational,1|3,7,1/3,240566,1
1,3,24,567,0,783,2,6,2,4,4,single-choice,spatial-relational,2|4,7,2/4,240567,2
1,3,24,568,0,681,4,8,2,6,6,single-choice,spatial-relational,2|6,7,2/6,240568,2
1,3,24,569,1,615,1,5,2,2,3,single-choice,spatial-relational,2|3,7,2/3,240569,2
1,3,24,570,0,527,4,8,2,6,6,single-choice,spatial-relational,2|6,7,2/6,240570,2
1,3,24,571,1,704,1,3,1,1,2,single-choice,spatial-relational,1|2,7,1/2,240571,1
1,3,24,572,0,572,1,5,2,3,3,single-choice,spatial-relational,2|3,7,2/3,240572,2
1,3,24,573,1,541,1,11,5,5,6,single-choice,spatial-relational,5|6,7,5/6,240573,5
1,3,24,574,1,592,3,7,2,2,5,single-choice,spatial-relational,2|5,7,2/5,240574,2
1,3,24,575,1,585,4,6,1,1,5,single-choice,spatial-relational,1|5,7,1/5,240575,1
1,3,24,576,1,529,1,13,6,6,7,single-choice,spatial-relational,6|7,7,6/7,240576,6
1,3,24,577,1,517,3,9,3,3,6,single-choice,spatial-relational,3|6,7,3/6,240577,3
1,3,24,578,1,513,3,11,4,4,7,single-choice,spatial-relational,4|7,7,4/7,240578,4
1,3,24,579,1,660,1,9,4,4,5,single-choice,spatial-relational,4|5,7,4/5,240579,4
1,3,24,580,1,682,6,8,1,1,7,single-choice,spatial-relational,1|7,7,1/7,240580,1
1,3,24,581,1,701,3,9,3,3,6,single-choice,spatial-relational,3|6,7,3/6,240581,3
1,3,24,582,0,638,2,6,2,4,4,single-choice,spatial-relational,2|4,7,2/4,240582,2
1,3,24,583,1,580,2,10,4,4,6,single-choice,spatial-relational,4|6,7,4/6,240583,4
1,3,24,584,1,650,1,3,1,1,2,single-choice,spatial-relational,1|2,7,1/2,240584,1
1,3,24,585,0,1166,2,4,1,3,3,single-choice,spatial-relational,1|3,7,1/3,240585,1
1,3,24,586,0,560,6,8,1,7,7,single-choice,spatial-relational,1|7,7,1/7,240586,1
1,3,24,587,1,645,2,10,4,4,6,single-choice,spatial-relational,4|6,7,4/6,240587,4
1,3,24,588,1,646,6,8,1,1,7,single-choice,spatial-relational,1|7,7,1/7,240588,1
1,3,24,589,1,610,1,13,6,6,7,single-choice,spatial-relational,6|7,7,6/7,240589,6
1,3,24,590,0,31363,4,6,1,5,5,single-choice,spatial-relational,1|5,7,1/5,240590,1
1,3,24,591,0,576,2,4,1,3,3,single-choice,spatial-relational,1|3,7,1/3,240591,1
1,3,24,592,1,524,4,6,1,1,5,single-choice,spatial-relational,1|5,7,1/5,240592,1
1,3,24,593,0,800,1,5,2,3,3,single-choice,spatial-relational,2|3,7,2/3,240593,2
1,3,24,594,0,617,3,7,2,5,5,single-choice,spatial-relational,2|5,7,2/5,240594,2
1,3,24,595,0,1092,1,5,2,3,3,single-choice,spatial-relational,2|3,7,2/3,240595,2
1,3,24,596,1,613,2,6,2,2,4,single-choice,spatial-relational,2|4,7,2/4,240596,2
1,3,24,597,1,322,1,3,1,1,2,single-choice,spatial-relational,1|2,7,1/2,240597,1
1,3,24,598,0,713,1,9,4,5,5,single-choice,spatial-relational,4|5,7,4/5,240598,4
1,3,24,599,1,557,3,11,4,4,7,single-choice,spatial-relational,4|7,7,4/7,240599,4
1,3,24,600,0,604,2,12,5,7,7,single-choice,spatial-relational,5|7,7,5/7,240600,5
1,3,24,601,0,546,3,9,3,6,6,single-choice,spatial-relational,3|6,7,3/6,240601,3
1,3,24,602,0,443,5,7,1,6,6,single-choice,spatial-relational,1|6,7,1/6,240602,1
1,3,24,603,1,517,1,11,5,5,6,single-choice,spatial-relational,5|6,7,5/6,240603,5
1,3,24,604,1,648,5,7,1,1,6,single-choice,spatial-relational,1|6,7,1/6,240604,1
1,3,24,605,1,768,5,9,2,2,7,single-choice,spatial-relational,2|7,7,2/7,240605,2
1,3,24,606,1,576,2,8,3,3,5,single-choice,spatial-relational,3|5,7,3/5,240606,3
1,3,24,607,1,56,1,13,6,6,7,single-choice,spatial-relational,6|7,7,6/7,240607,6
1,3,24,608,1,797,4,8,2,2,6,single-choice,spatial-relational,2|6,7,2/6,240608,2
1,3,24,609,1,541,3,11,4,4,7,single-choice,spatial-relational,4|7,7,4/7,240609,4
1,3,24,610,1,768,1,11,5,5,6,single-choice,spatial-relational,5|6,7,5/6,240610,5
1,3,24,611,1,745,1,7,3,3,4,single-choice,spatial-relational,3|4,7,3/4,240611,3
1,3,24,612,1,616,2,8,3,3,5,single-choice,spatial-relational,3|5,7,3/5,240612,3
1,3,24,613,1,869,2,12,5,5,7,single-choice,spatial-relational,5|7,7,5/7,240613,5
1,3,24,614,1,663,4,8,2,2,6,single-choice,spatial-relational,2|6,7,2/6,240614,2
1,3,24,615,1,650,3,5,1,1,4,single-choice,spatial-relational,1|4,7,1/4,240615,1
1,3,24,616,1,551,5,9,2,2,7,single-choice,spatial-relational,2|7,7,2/7,240616,2
1,3,24,617,1,568,4,10,3,3,7,single-choice,spatial-relational,3|7,7,3/7,240617,3
1,3,24,618,1,618,4,10,3,3,7,single-choice,spatial-relational,3|7,7,3/7,240618,3
1,3,24,619,0,592,1,9,4,5,5,single-choice,spatial-relational,4|5,7,4/5,240619,4
1,3,24,620,0,627,3,7,2,5,5,single-choice,spatial-relational,2|5,7,2/5,240620,2
1,3,24,621,0,790,1,7,3,4,4,single-choice,spatial-relational,3|4,7,3/4,240621,3
1,3,24,622,1,583,3,5,1,1,4,single-choice,spatial-relational,1|4,7,1/4,240622,1
1,3,24,623,1,861,1,3,1,1,2,single-choice,spatial-relational,1|2,7,1/2,240623,1
1,3,24,624,1,636,4,10,3,3,7,single-choice,spatial-relational,3|7,7,3/7,240624,3
1,3,24,625,1,584,5,7,1,1,6,single-choice,spatial-relational,1|6,7,1/6,240625,1
1,3,24,626,1,3295,3,9,3,3,6,single-choice,spatial-relational,3|6,7,3/6,240626,3
1,3,24,627,1,564,1,3,1,1,2,single-choice,spatial-relational,1|2,7,1/2,240627,1
1,3,24,628,1,613,4,8,2,2,6,single-choice,spatial-relational,2|6,7,2/6,240628,2
1,3,24,629,1,505,4,10,3,3,7,single-choice,spatial-relational,3|7,7,3/7,240629,3
1,3,24,630,1,626,1,9,4,4,5,single-choice,spatial-relational,4|5,7,4/5,240630,4
1,3,24,631,1,553,6,8,1,1,7,single-choice,spatial-relational,1|7,7,1/7,240631,1
1,3,24,632,1,661,5,7,1,1,6,single-choice,spatial-relational,1|6,7,1/6,240632,1
1,3,24,633,1,545,3,5,1,1,4,single-choice,spatial-relational,1|4,7,1/4,240633,1
1,3,24,634,1,541,1,5,2,2,3,single-choice,spatial-relational,2|3,7,2/3,240634,2
1,3,24,635,1,775,2,8,3,3,5,single-choice,spatial-relational,3|5,7,3/5,240635,3
1,3,24,636,1,677,2,12,5,5,7,single-choice,spatial-relational,5|7,7,5/7,240636,5
1,3,24,637,1,599,2,6,2,2,4,single-choice,spatial-relational,2|4,7,2/4,240637,2
1,3,24,638,0,603,1,11,5,6,6,single-choice,spatial-relational,5|6,7,5/6,240638,5
1,3,24,639,1,611,2,10,4,4,6,single-choice,spatial-relational,4|6,7,4/6,240639,4
1,3,24,640,1,672,6,8,1,1,7,single-choice,spatial-relational,1|7,7,1/7,240640,1
1,3,24,641,1,676,4,8,2,2,6,single-choice,spatial-relational,2|6,7,2/6,240641,2
1,3,24,642,0,528,1,5,2,3,3,single-choice,spatial-relational,2|3,7,2/3,240642,2
1,3,24,643,1,568,5,9,2,2,7,single-choice,spatial-relational,2|7,7,2/7,240643,2
1,3,24,644,1,553,1,7,3,3,4,single-choice,spatial-relational,3|4,7,3/4,240644,3
1,3,24,645,1,665,5,9,2,2,7,single-choice,spatial-relational,2|7,7,2/7,240645,2
1,3,24,646,1,601,1,7,3,3,4,single-choice,spatial-relational,3|4,7,3/4,240646,3
1,3,24,647,1,1000,2,12,5,5,7,single-choice,spatial-relational,5|7,7,5/7,240647,5
1,3,24,648,1,1052,2,10,4,4,6,single-choice,spatial-relational,4|6,7,4/6,240648,4
1,3,24,649,1,556,2,4,1,1,3,single-choice,spatial-relational,1|3,7,1/3,240649,1
1,3,24,650,1,594,2,8,3,3,5,single-choice,spatial-relational,3|5,7,3/5,240650,3
1,3,24,651,1,660,3,11,4,4,7,single-choice,spatial-relational,4|7,7,4/7,240651,4
1,3,24,652,1,1014,1,9,4,4,5,single-choice,spatial-relational,4|5,7,4/5,240652,4
1,3,24,653,1,518,1,13,6,6,7,single-choice,spatial-relational,6|7,7,6/7,240653,6
1,3,24,654,1,754,1,11,5,5,6,single-choice,spatial-relational,5|6,7,5/6,240654,5
1,3,24,655,1,576,1,13,6,6,7,single-choice,spatial-relational,6|7,7,6/7,240655,6
1,3,24,656,0,545,2,4,1,3,3,single-choice,spatial-relational,1|3,7,1/3,240656,1
1,3,24,657,0,619,2,6,2,4,4,single-choice,spatial-relational,2|4,7,2/4,240657,2
1,3,24,658,1,470,3,7,2,2,5,single-choice,spatial-relational,2|5,7,2/5,240658,2
1,3,24,659,0,42514,4,6,1,5,5,single-choice,spatial-relational,1|5,7,1/5,240659,1
1,3,24,660,0,529,3,5,1,4,4,single-choice,spatial-relational,1|4,7,1/4,240660,1
1,3,24,661,1,502,4,6,1,1,5,single-choice,spatial-relational,1|5,7,1/5,240661,1
1,3,24,662,0,759,3,7,2,5,5,single-choice,spatial-relational,2|5,7,2/5,240662,2
1,3,24,663,1,554,3,9,3,3,6,single-choice,spatial-relational,3|6,7,3/6,240663,3
1,3,24,664,1,584,3,11,4,4,7,single-choice,spatial-relational,4|7,7,4/7,240664,4
1,3,24,665,1,552,3,9,3,3,6,single-choice,spatial-relational,3|6,7,3/6,240665,3
1,3,24,666,1,534,2,8,3,3,5,single-choice,spatial-relational,3|5,7,3/5,240666,3
1,3,24,667,0,569,1,11,5,6,6,single-choice,spatial-relational,5|6,7,5/6,240667,5
1,3,24,668,1,494,6,8,1,1,7,single-choice,spatial-relational,1|7,7,1/7,240668,1
1,3,24,669,1,666,1,7,3,3,4,single-choice,spatial-relational,3|4,7,3/4,240669,3
1,3,24,670,1,604,2,6,2,2,4,single-choice,spatial-relational,2|4,7,2/4,240670,2
1,3,24,671,0,1219,2,4,1,3,3,single-choice,spatial-relational,1|3,7,1/3,240671,1
1,3,24,672,1,553,2,4,1,1,3,single-choice,spatial-relational,1|3,7,1/3,240672,1
1,3,24,673,1,594,2,8,3,3,5,single-choice,spatial-relational,3|5,7,3/5,240673,3
1,3,24,674,0,423,6,8,1,7,7,single-choice,spatial-relational,1|7,7,1/7,240674,1
1,3,24,675,0,486,5,9,2,7,7,single-choice,spatial-relational,2|7,7,2/7,240675,2
1,3,24,676,1,597,4,8,2,2,6,single-choice,spatial-relational,2|6,7,2/6,240676,2
1,3,24,677,1,580,2,12,5,5,7,single-choice,spatial-relational,5|7,7,5/7,240677,5
1,3,24,678,1,616,3,9,3,3,6,single-choice,spatial-relational,3|6,7,3/6,240678,3
1,3,24,679,1,490,1,3,1,1,2,single-choice,spatial-relational,1|2,7,1/2,240679,1
1,3,24,680,0,670,1,9,4,5,5,single-choice,spatial-relational,4|5,7,4/5,240680,4
1,3,24,681,1,752,1,13,6,6,7,single-choice,spatial-relational,6|7,7,6/7,240681,6
1,3,24,682,0,623,3,7,2,5,5,single-choice,spatial-relational,2|5,7,2/5,240682,2
1,3,24,683,1,517,3,5,1,1,4,single-choice,spatial-relational,1|4,7,1/4,240683,1
1,3,24,684,0,623,1,5,2,3,3,single-choice,spatial-relational,2|3,7,2/3,240684,2
1,3,24,685,0,551,2,10,4,6,6,single-choice,spatial-relational,4|6,7,4/6,240685,4
1,3,24,686,1,513,1,11,5,5,6,single-choice,spatial-relational,5|6,7,5/6,240686,5
1,3,24,687,0,484,4,8,2,6,6,single-choice,spatial-relational,2|6,7,2/6,240687,2
1,3,24,688,1,567,5,7,1,1,6,single-choice,spatial-relational,1|6,7,1/6,240688,1
1,3,24,689,1,1434,3,11,4,4,7,single-choice,spatial-relational,4|7,7,4/7,240689,4
1,3,24,690,1,627,1,7,3,3,4,single-choice,spatial-relational,3|4,7,3/4,240690,3
1,3,24,691,1,631,2,10,4,4,6,single-choice,spatial-relational,4|6,7,4/6,240691,4
1,3,24,692,1,510,3,5,1,1,4,single-choice,spatial-relational,1|4,7,1/4,240692,1
1,3,24,693,1,871,4,10,3,3,7,single-choice,spatial-relational,3|7,7,3/7,240693,3
1,3,24,694,0,48,2,6,2,4,4,single-choice,spatial-relational,2|4,7,2/4,240694,2
1,3,24,695,1,541,4,6,1,1,5,single-choice,spatial-relational,1|5,7,1/5,240695,1
1,3,24,696,1,604,4,6,1,1,5,single-choice,spatial-relational,1|5,7,1/5,240696,1
1,3,24,697,1,643,1,5,2,2,3,single-choice,spatial-relational,2|3,7,2/3,240697,2
1,3,24,698,1,648,3,7,2,2,5,single-choice,spatial-relational,2|5,7,2/5,240698,2
1,3,24,699,0,1540,5,9,2,7,7,single-choice,spatial-relational,2|7,7,2/7,240699,2
1,3,24,700,1,464,4,10,3,3,7,single-choice,spatial-relational,3|7,7,3/7,240700,3
1,3,24,701,1,561,3,11,4,4,7,single-choice,spatial-relational,4|7,7,4/7,240701,4
1,3,24,702,1,69656,1,9,4,4,5,single-choice,spatial-relational,4|5,7,4/5,240702,4
1,3,24,703,1,558,1,13,6,6,7,single-choice,spatial-relational,6|7,7,6/7,240703,6
1,3,24,704,0,621,2,12,5,7,7,single-choice,spatial-relational,5|7,7,5/7,240704,5
1,3,24,705,1,563,5,7,1,1,6,single-choice,spatial-relational,1|6,7,1/6,240705,1
1,3,24,706,1,1046,1,3,1,1,2,single-choice,spatial-relational,1|2,7,1/2,240706,1
1,3,24,707,0,556,3,9,3,6,6,single-choice,spatial-relational,3|6,7,3/6,240707,3
1,3,24,708,1,73369,2,8,3,3,5,single-choice,spatial-relational,3|5,7,3/5,240708,3
1,3,24,709,0,630,1,9,4,5,5,single-choice,spatial-relational,4|5,7,4/5,240709,4
1,3,24,710,1,627,2,12,5,5,7,single-choice,spatial-relational,5|7,7,5/7,240710,5
1,3,24,711,0,600,2,4,1,3,3,single-choice,spatial-relational,1|3,7,1/3,240711,1
1,3,24,712,1,682,5,7,1,1,6,single-choice,spatial-relational,1|6,7,1/6,240712,1
1,3,24,713,1,583,6,8,1,1,7,single-choice,spatial-relational,1|7,7,1/7,240713,1
1,3,24,714,1,631,3,7,2,2,5,single-choice,spatial-relational,2|5,7,2/5,240714,2
1,3,24,715,1,589,4,6,1,1,5,single-choice,spatial-relational,1|5,7,1/5,240715,1
1,3,24,716,0,477,2,6,2,4,4,single-choice,spatial-relational,2|4,7,2/4,240716,2
1,3,24,717,0,574,2,6,2,4,4,single-choice,spatial-relational,2|4,7,2/4,240717,2
1,3,24,718,1,653,3,9,3,3,6,single-choice,spatial-relational,3|6,7,3/6,240718,3
1,3,24,719,1,615,3,5,1,1,4,single-choice,spatial-relational,1|4,7,1/4,240719,1
1,3,24,720,1,639,1,9,4,4,5,single-choice,spatial-relational,4|5,7,4/5,240720,4
1,3,24,721,1,737,2,10,4,4,6,single-choice,spatial-relational,4|6,7,4/6,240721,4
2,3,24,1,1,754,4,10,3,3,7,single-choice,spatial-relational,3|7,7,3/7,240001,3
2,3,24,2,0,639,2,12,5,7,7,single-choice,spatial-relational,5|7,7,5/7,240002,5
2,3,24,3,1,484,3,11,4,4,7,single-choice,spatial-relational,4|7,7,4/7,240003,4
2,3,24,4,0,14102,4,6,1,5,5,single-choice,spatial-relational,1|5,7,1/5,240004,1
2,3,24,5,1,576,3,9,3,3,6,single-choice,spatial-relational,3|6,7,3/6,240005,3
2,3,24,6,1,627,1,7,3,3,4,single-choice,spatial-relational,3|4,7,3/4,240006,3
2,3,24,7,1,528,1,11,5,5,6,single-choice,spatial-relational,5|6,7,5/6,240007,5
2,3,24,8,0,524,2,6,2,4,4,single-choice,spatial-relational,2|4,7,2/4,240008,2
2,3,24,9,1,553,2,8,3,3,5,single-choice,spatial-relational,3|5,7,3/5,240009,3
2,3,24,10,1,575,3,5,1,1,4,single-choice,spatial-relational,1|4,7,1/4,240010,1
2,3,24,11,0,575,1,3,1,2,2,single-choice,spatial-relational,1|2,7,1/2,240011,1
2,3,24,12,1,573,1,11,5,5,6,single-choice,spatial-relational,5|6,7,5/6,240012,5
2,3,24,13,1,623,2,12,5,5,7,single-choice,spatial-relational,5|7,7,5/7,240013,5
2,3,24,14,1,513,4,6,1,1,5,single-choice,spatial-relational,1|5,7,1/5,240014,1
2,3,24,15,1,541,5,9,2,2,7,single-choice,spatial-relational,2|7,7,2/7,240015,2
2,3,24,16,1,626,3,9,3,3,6,single-choice,spatial-relational,3|6,7,3/6,240016,3
2,3,24,17,1,871,2,8,3,3,5,single-choice,spatial-relational,3|5,7,3/5,240017,3
2,3,24,18,1,593,1,5,2,2,3,single-choice,spatial-relational,2|3,7,2/3,240018,2
2,3,24,19,1,620,3,7,2,2,5,single-choice,spatial-relational,2|5,7,2/5,240019,2
2,3,24,20,1,623,1,3,1,1,2,single-choice,spatial-relational,1|2,7,1/2,240020,1
2,3,24,21,1,573,2,6,2,2,4,single-choice,spatial-relational,2|4,7,2/4,240021,2
2,3,24,22,1,794,6,8,1,1,7,single-choice,spatial-relational,1|7,7,1/7,240022,1
2,3,24,23,1,561,1,13,6,6,7,single-choice,spatial-relational,6|7,7,6/7,240023,6
2,3,24,24,0,681,2,10,4,6,6,single-choice,spatial-relational,4|6,7,4/6,240024,4
2,3,24,25,1,601,2,10,4,4,6,single-choice,spatial-relational,4|6,7,4/6,240025,4
2,3,24,26,1,580,1,13,6,6,7,single-choice,spatial-relational,6|7,7,6/7,240026,6
2,3,24,27,1,675,1,5,2,2,3,single-choice,spatial-relational,2|3,7,2/3,240027,2
2,3,24,28,1,583,3,5,1,1,4,single-choice,spatial-relational,1|4,7,1/4,240028,1
2,3,24,29,1,705,3,7,2,2,5,single-choice,spatial-relational,2|5,7,2/5,240029,2
2,3,24,30,1,588,2,4,1,1,3,single-choice,spatial-relational,1|3,7,1/3,240030,1
2,3,24,31,1,713,5,9,2,2,7,single-choice,spatial-relational,2|7,7,2/7,240031,2
2,3,24,32,0,521,1,9,4,5,5,single-choice,spatial-relational,4|5,7,4/5,240032,4
2,3,24,33,1,550,2,4,1,1,3,single-choice,spatial-relational,1|3,7,1/3,240033,1
2,3,24,34,0,543,4,8,2,6,6,single-choice,spatial-relational,2|6,7,2/6,240034,2
2,3,24,35,1,511,4,8,2,2,6,single-choice,spatial-relational,2|6,7,2/6,240035,2
2,3,24,36,1,579,3,11,4,4,7,single-choice,spatial-relational,4|7,7,4/7,240036,4
2,3,24,37,1,564,6,8,1,1,7,single-choice,spatial-relational,1|7,7,1/7,240037,1
2,3,24,38,1,541,5,7,1,1,6,single-choice,spatial-relational,1|6,7,1/6,240038,1
2,3,24,39,1,663,1,9,4,4,5,single-choice,spatial-relational,4|5,7,4/5,240039,4
2,3,24,40,1,681,1,7,3,3,4,single-choice,spatial-relational,3|4,7,3/4,240040,3
2,3,24,41,0,665,4,10,3,7,7,single-choice,spatial-relational,3|7,7,3/7,240041,3
2,3,24,42,1,559,5,7,1,1,6,single-choice,spatial-relational,1|6,7,1/6,240042,1
2,3,24,43,1,623,6,8,1,1,7,single-choice,spatial-relational,1|7,7,1/7,240043,1
2,3,24,44,0,588,2,12,5,7,7,single-choice,spatial-relational,5|7,7,5/7,240044,5
2,3,24,45,1,536,3,9,3,3,6,single-choice,spatial-relational,3|6,7,3/6,240045,3
2,3,24,46,1,826,3,9,3,3,6,single-choice,spatial-relational,3|6,7,3/6,240046,3
2,3,24,47,1,654,1,7,3,3,4,single-choice,spatial-relational,3|4,7,3/4,240047,3
2,3,24,48,1,550,3,11,4,4,7,single-choice,spatial-relational,4|7,7,4/7,240048,4
2,3,24,49,1,581,1,13,6,6,7,single-choice,spatial-relational,6|7,7,6/7,240049,6
2,3,24,50,1,594,1,11,5,5,6,single-choice,spatial-relational,5|6,7,5/6,240050,5
2,3,24,51,1,684,2,6,2,2,4,single-choice,spatial-relational,2|4,7,2/4,240051,2
2,3,24,52,1,627,4,6,1,1,5,single-choice,spatial-relational,1|5,7,1/5,240052,1
2,3,24,53,1,603,2,6,2,2,4,single-choice,spatial-relational,2|4,7,2/4,240053,2
2,3,24,54,1,562,1,7,3,3,4,single-choice,spatial-relational,3|4,7,3/4,240054,3
2,3,24,55,1,721,5,9,2,2,7,single-choice,spatial-relational,2|7,7,2/7,240055,2
2,3,24,56,0,612,1,13,6,7,7,single-choice,spatial-relational,6|7,7,6/7,240056,6
2,3,24,57,1,561,1,3,1,1,2,single-choice,spatial-relational,1|2,7,1/2,240057,1
2,3,24,58,1,530,2,10,4,4,6,single-choice,spatial-relational,4|6,7,4/6,240058,4
2,3,24,59,1,643,4,8,2,2,6,single-choice,spatial-relational,2|6,7,2/6,240059,2
2,3,24,60,1,546,2,4,1,1,3,single-choice,spatial-relational,1|3,7,1/3,240060,1
2,3,24,61,1,669,2,4,1,1,3,single-choice,spatial-relational,1|3,7,1/3,240061,1
2,3,24,62,1,615,2,8,3,3,5,single-choice,spatial-relational,3|5,7,3/5,240062,3
2,3,24,63,1,592,2,8,3,3,5,single-choice,spatial-relational,3|5,7,3/5,240063,3
2,3,24,64,0,655,1,11,5,6,6,single-choice,spatial-relational,5|6,7,5/6,240064,5
2,3,24,65,1,561,2,10,4,4,6,single-choice,spatial-relational,4|6,7,4/6,240065,4
2,3,24,66,0,510,4,6,1,5,5,single-choice,spatial-relational,1|5,7,1/5,240066,1
2,3,24,67,1,552,3,11,4,4,7,single-choice,spatial-relational,4|7,7,4/7,240067,4
2,3,24,68,1,517,1,5,2,2,3,single-choice,spatial-relational,2|3,7,2/3,240068,2
2,3,24,69,1,564,5,9,2,2,7,single-choice,spatial-relational,2|7,7,2/7,240069,2
2,3,24,70,1,595,1,3,1,1,2,single-choice,spatial-relational,1|2,7,1/2,240070,1
2,3,24,71,1,539,6,8,1,1,7,single-choice,spatial-relational,1|7,7,1/7,240071,1
2,3,24,72,1,591,2,12,5,5,7,single-choice,spatial-relational,5|7,7,5/7,240072,5
2,3,24,73,1,643,3,7,2,2,5,single-choice,spatial-relational,2|5,7,2/5,240073,2
2,3,24,74,1,853,3,7,2,2,5,single-choice,spatial-relational,2|5,7,2/5,240074,2
2,3,24,75,1,590,3,5,1,1,4,single-choice,spatial-relational,1|4,7,1/4,240075,1
2,3,24,76,1,573,4,10,3,3,7,single-choice,spatial-relational,3|7,7,3/7,240076,3
2,3,24,77,1,547,4,10,3,3,7,single-choice,spatial-relational,3|7,7,3/7,240077,3
2,3,24,78,0,515,5,7,1,6,6,single-choice,spatial-relational,1|6,7,1/6,240078,1
2,3,24,79,1,709,1,5,2,2,3,single-choice,spatial-relational,2|3,7,2/3,240079,2
2,3,24,80,1,676,3,5,1,1,4,single-choice,spatial-relational,1|4,7,1/4,240080,1
2,3,24,81,1,650,1,9,4,4,5,single-choice,spatial-relational,4|5,7,4/5,240081,4
2,3,24,82,0,556,1,9,4,5,5,single-choice,spatial-relational,4|5,7,4/5,240082,4
2,3,24,83,1,595,4,8,2,2,6,single-choice,spatial-relational,2|6,7,2/6,240083,2
2,3,24,84,1,490,5,7,1,1,6,single-choice,spatial-relational,1|6,7,1/6,240084,1
2,3,24,85,1,530,3,5,1,1,4,single-choice,spatial-relational,1|4,7,1/4,240085,1
2,3,24,86,1,561,3,11,4,4,7,single-choice,spatial-relational,4|7,7,4/7,240086,4
2,3,24,87,1,635,3,9,3,3,6,single-choice,spatial-relational,3|6,7,3/6,240087,3
2,3,24,88,1,548,1,3,1,1,2,single-choice,spatial-relational,1|2,7,1/2,240088,1
2,3,24,89,1,533,1,7,3,3,4,single-choice,spatial-relational,3|4,7,3/4,240089,3
2,3,24,90,1,668,6,8,1,1,7,single-choice,spatial-relational,1|7,7,1/7,240090,1
2,3,24,91,1,588,3,11,4,4,7,single-choice,spatial-relational,4|7,7,4/7,240091,4
2,3,24,92,0,674,1,11,5,6,6,single-choice,spatial-relational,5|6,7,5/6,240092,5
2,3,24,93,1,620,1,9,4,4,5,single-choice,spatial-relational,4|5,7,4/5,240093,4
2,3,24,94,1,525,2,4,1,1,3,single-choice,spatial-relational,1|3,7,1/3,240094,1
2,3,24,95,1,599,4,10,3,3,7,single-choice,spatial-relational,3|7,7,3/7,240095,3
2,3,24,96,1,642,5,9,2,2,7,single-choice,spatial-relational,2|7,7,2/7,240096,2
2,3,24,97,0,544,2,4,1,3,3,single-choice,spatial-relational,1|3,7,1/3,240097,1
2,3,24,98,1,546,2,12,5,5,7,single-choice,spatial-relational,5|7,7,5/7,240098,5
2,3,24,99,0,592,2,10,4,6,6,single-choice,spatial-relational,4|6,7,4/6,240099,4
2,3,24,100,1,572,1,3,1,1,2,single-choice,spatial-relational,1|2,7,1/2,240100,1
2,3,24,101,1,604,6,8,1,1,7,single-choice,spatial-relational,1|7,7,1/7,240101,1
2,3,24,102,1,670,5,7,1,1,6,single-choice,spatial-relational,1|6,7,1/6,240102,1
2,3,24,103,1,742,2,10,4,4,6,single-choice,spatial-relational,4|6,7,4/6,240103,4
2,3,24,104,0,572,1,5,2,3,3,single-choice,spatial-relational,2|3,7,2/3,240104,2
2,3,24,105,1,578,4,6,1,1,5,single-choice,spatial-relational,1|5,7,1/5,240105,1
2,3,24,106,1,529,4,8,2,2,6,single-choice,spatial-relational,2|6,7,2/6,240106,2
2,3,24,107,1,722,1,7,3,3,4,single-choice,spatial-relational,3|4,7,3/4,240107,3
2,3,24,108,1,806,3,5,1,1,4,single-choice,spatial-relational,1|4,7,1/4,240108,1
2,3,24,109,1,757,5,9,2,2,7,single-choice,spatial-relational,2|7,7,2/7,240109,2
2,3,24,110,1,791,4,8,2,2,6,single-choice,spatial-relational,2|6,7,2/6,240110,2
2,3,24,111,1,597,1,13,6,6,7,single-choice,spatial-relational,6|7,7,6/7,240111,6
2,3,24,112,1,694,1,9,4,4,5,single-choice,spatial-relational,4|5,7,4/5,240112,4
2,3,24,113,1,676,3,7,2,2,5,single-choice,spatial-relational,2|5,7,2/5,240113,2
2,3,24,114,1,782,4,6,1,1,5,single-choice,spatial-relational,1|5,7,1/5,240114,1
2,3,24,115,1,697,1,11,5,5,6,single-choice,spatial-relational,5|6,7,5/6,240115,5
2,3,24,116,1,668,2,6,2,2,4,single-choice,spatial-relational,2|4,7,2/4,240116,2
2,3,24,117,1,755,4,10,3,3,7,single-choice,spatial-relational,3|7,7,3/7,240117,3
2,3,24,118,0,711,3,7,2,5,5,single-choice,spatial-relational,2|5,7,2/5,240118,2
2,3,24,119,0,921,2,8,3,5,5,single-choice,spatial-relational,3|5,7,3/5,240119,3
2,3,24,120,1,712,2,6,2,2,4,single-choice,spatial-relational,2|4,7,2/4,240120,2
2,3,24,121,1,631,2,8,3,3,5,single-choice,spatial-relational,3|5,7,3/5,240121,3
2,3,24,122,1,600,3,9,3,3,6,single-choice,spatial-relational,3|6,7,3/6,240122,3
2,3,24,123,1,643,2,12,5,5,7,single-choice,spatial-relational,5|7,7,5/7,240123,5
2,3,24,124,1,513,1,13,6,6,7,single-choice,spatial-relational,6|7,7,6/7,240124,6
2,3,24,125,1,623,5,7,1,1,6,single-choice,spatial-relational,1|6,7,1/6,240125,1
2,3,24,126,0,585,1,5,2,3,3,single-choice,spatial-relational,2|3,7,2/3,240126,2
2,3,24,127,1,592,2,6,2,2,4,single-choice,spatial-relational,2|4,7,2/4,240127,2
2,3,24,128,1,682,3,5,1,1,4,single-choice,spatial-relational,1|4,7,1/4,240128,1
2,3,24,129,1,545,4,10,3,3,7,single-choice,spatial-relational,3|7,7,3/7,240129,3
2,3,24,130,1,626,2,12,5,5,7,single-choice,spatial-relational,5|7,7,5/7,240130,5
2,3,24,131,1,857,2,8,3,3,5,single-choice,spatial-relational,3|5,7,3/5,240131,3
2,3,24,132,1,588,4,10,3,3,7,single-choice,spatial-relational,3|7,7,3/7,240132,3
2,3,24,133,1,652,1,3,1,1,2,single-choice,spatial-relational,1|2,7,1/2,240133,1
2,3,24,134,1,841,4,8,2,2,6,single-choice,spatial-relational,2|6,7,2/6,240134,2
2,3,24,135,1,641,5,7,1,1,6,single-choice,spatial-relational,1|6,7,1/6,240135,1
2,3,24,136,1,832,2,12,5,5,7,single-choice,spatial-relational,5|7,7,5/7,240136,5
2,3,24,137,0,607,1,11,5,6,6,single-choice,spatial-relational,5|6,7,5/6,240137,5
2,3,24,138,0,550,2,4,1,3,3,single-choice,spatial-relational,1|3,7,1/3,240138,1
2,3,24,139,0,778,1,7,3,4,4,single-choice,spatial-relational,3|4,7,3/4,240139,3
2,3,24,140,1,695,3,9,3,3,6,single-choice,spatial-relational,3|6,7,3/6,240140,3
2,3,24,141,1,1181,1,3,1,1,2,single-choice,spatial-relational,1|2,7,1/2,240141,1
2,3,24,142,1,498,1,13,6,6,7,single-choice,spatial-relational,6|7,7,6/7,240142,6
2,3,24,143,1,818,2,4,1,1,3,single-choice,spatial-relational,1|3,7,1/3,240143,1
2,3,24,144,1,620,3,9,3,3,6,single-choice,spatial-relational,3|6,7,3/6,240144,3
2,3,24,145,1,694,5,9,2,2,7,single-choice,spatial-relational,2|7,7,2/7,240145,2
2,3,24,146,0,560,3,7,2,5,5,single-choice,spatial-relational,2|5,7,2/5,240146,2
2,3,24,147,0,556,4,8,2,6,6,single-choice,spatial-relational,2|6,7,2/6,240147,2
2,3,24,148,1,584,1,13,6,6,7,single-choice,spatial-relational,6|7,7,6/7,240148,6
2,3,24,149,1,681,2,8,3,3,5,single-choice,spatial-relational,3|5,7,3/5,240149,3
2,3,24,150,1,624,5,9,2,2,7,single-choice,spatial-relational,2|7,7,2/7,240150,2
2,3,24,151,1,1380,1,9,4,4,5,single-choice,spatial-relational,4|5,7,4/5,240151,4
2,3,24,152,1,760,1,5,2,2,3,single-choice,spatial-relational,2|3,7,2/3,240152,2
2,3,24,153,1,693,4,6,1,1,5,single-choice,spatial-relational,1|5,7,1/5,240153,1
2,3,24,154,1,663,2,10,4,4,6,single-choice,spatial-relational,4|6,7,4/6,240154,4
2,3,24,155,0,598,1,5,2,3,3,single-choice,spatial-relational,2|3,7,2/3,240155,2
2,3,24,156,1,598,6,8,1,1,7,single-choice,spatial-relational,1|7,7,1/7,240156,1
2,3,24,157,0,565,3,5,1,4,4,single-choice,spatial-relational,1|4,7,1/4,240157,1
2,3,24,158,1,641,2,6,2,2,4,single-choice,spatial-relational,2|4,7,2/4,240158,2
2,3,24,159,1,611,2,10,4,4,6,single-choice,spatial-relational,4|6,7,4/6,240159,4
2,3,24,160,0,706,1,7,3,4,4,single-choice,spatial-relational,3|4,7,3/4,240160,3
2,3,24,161,1,478,4,6,1,1,5,single-choice,spatial-relational,1|5,7,1/5,240161,1
2,3,24,162,1,620,6,8,1,1,7,single-choice,spatial-relational,1|7,7,1/7,240162,1
2,3,24,163,1,769,3,11,4,4,7,single-choice,spatial-relational,4|7,7,4/7,240163,4
2,3,24,164,1,646,1,9,4,4,5,single-choice,spatial-relational,4|5,7,4/5,240164,4
2,3,24,165,1,581,3,11,4,4,7,single-choice,spatial-relational,4|7,7,4/7,240165,4
2,3,24,166,0,653,1,11,5,6,6,single-choice,spatial-relational,5|6,7,5/6,240166,5
2,3,24,167,1,603,3,7,2,2,5,single-choice,spatial-relational,2|5,7,2/5,240167,2
2,3,24,168,1,599,5,7,1,1,6,single-choice,spatial-relational,1|6,7,1/6,240168,1
2,3,24,169,0,642,1,11,5,6,6,single-choice,spatial-relational,5|6,7,5/6,240169,5
2,3,24,170,0,44,1,3,1,2,2,single-choice,spatial-relational,1|2,7,1/2,240170,1
2,3,24,171,1,4465,1,3,1,1,2,single-choice,spatial-relational,1|2,7,1/2,240171,1
2,3,24,172,1,594,4,8,2,2,6,single-choice,spatial-relational,2|6,7,2/6,240172,2
2,3,24,173,1,611,4,10,3,3,7,single-choice,spatial-relational,3|7,7,3/7,240173,3
2,3,24,174,1,668,1,5,2,2,3,single-choice,spatial-relational,2|3,7,2/3,240174,2
2,3,24,175,1,719,2,12,5,5,7,single-choice,spatial-relational,5|7,7,5/7,240175,5
2,3,24,176,1,621,3,9,3,3,6,single-choice,spatial-relational,3|6,7,3/6,240176,3
2,3,24,177,0,784,2,6,2,4,4,single-choice,spatial-relational,2|4,7,2/4,240177,2
2,3,24,178,1,514,2,4,1,1,3,single-choice,spatial-relational,1|3,7,1/3,240178,1
2,3,24,179,1,759,1,9,4,4,5,single-choice,spatial-relational,4|5,7,4/5,240179,4
2,3,24,180,1,638,5,7,1,1,6,single-choice,spatial-relational,1|6,7,1/6,240180,1
2,3,24,181,1,740,4,8,2,2,6,single-choice,spatial-relational,2|6,7,2/6,240181,2
2,3,24,182,1,702,1,13,6,6,7,single-choice,spatial-relational,6|7,7,6/7,240182,6
2,3,24,183,1,603,1,11,5,5,6,single-choice,spatial-relational,5|6,7,5/6,240183,5
2,3,24,184,1,638,3,11,4,4,7,single-choice,spatial-relational,4|7,7,4/7,240184,4
2,3,24,185,1,685,3,7,2,2,5,single-choice,spatial-relational,2|5,7,2/5,240185,2
2,3,24,186,1,752,2,4,1,1,3,single-choice,spatial-relational,1|3,7,1/3,240186,1
2,3,24,187,0,644,1,5,2,3,3,single-choice,spatial-relational,2|3,7,2/3,240187,2
2,3,24,188,1,615,5,7,1,1,6,single-choice,spatial-relational,1|6,7,1/6,240188,1
2,3,24,189,1,634,6,8,1,1,7,single-choice,spatial-relational,1|7,7,1/7,240189,1
2,3,24,190,1,709,3,5,1,1,4,single-choice,spatial-relational,1|4,7,1/4,240190,1
2,3,24,191,1,732,3,9,3,3,6,single-choice,spatial-relational,3|6,7,3/6,240191,3
2,3,24,192,1,692,1,9,4,4,5,single-choice,spatial-relational,4|5,7,4/5,240192,4
2,3,24,193,1,896,1,7,3,3,4,single-choice,spatial-relational,3|4,7,3/4,240193,3
2,3,24,194,1,650,2,12,5,5,7,single-choice,spatial-relational,5|7,7,5/7,240194,5
2,3,24,195,0,799,2,10,4,6,6,single-choice,spatial-relational,4|6,7,4/6,240195,4
2,3,24,196,1,671,4,6,1,1,5,single-choice,spatial-relational,1|5,7,1/5,240196,1
2,3,24,197,1,602,2,6,2,2,4,single-choice,spatial-relational,2|4,7,2/4,240197,2
2,3,24,198,1,603,1,13,6,6,7,single-choice,spatial-relational,6|7,7,6/7,240198,6
2,3,24,199,1,576,1,7,3,3,4,single-choice,spatial-relational,3|4,7,3/4,240199,3
2,3,24,200,1,693,5,9,2,2,7,single-choice,spatial-relational,2|7,7,2/7,240200,2
2,3,24,201,1,533,3,7,2,2,5,single-choice,spatial-relational,2|5,7,2/5,240201,2
2,3,24,202,1,563,2,8,3,3,5,single-choice,spatial-relational,3|5,7,3/5,240202,3
2,3,24,203,1,619,6,8,1,1,7,single-choice,spatial-relational,1|7,7,1/7,240203,1
2,3,24,204,1,557,4,6,1,1,5,single-choice,spatial-relational,1|5,7,1/5,240204,1
2,3,24,205,1,697,2,8,3,3,5,single-choice,spatial-relational,3|5,7,3/5,240205,3
2,3,24,206,1,600,5,9,2,2,7,single-choice,spatial-relational,2|7,7,2/7,240206,2
2,3,24,207,1,642,3,11,4,4,7,single-choice,spatial-relational,4|7,7,4/7,240207,4
2,3,24,208,1,576,3,5,1,1,4,single-choice,spatial-relational,1|4,7,1/4,240208,1
2,3,24,209,1,655,2,10,4,4,6,single-choice,spatial-relational,4|6,7,4/6,240209,4
2,3,24,210,1,630,4,10,3,3,7,single-choice,spatial-relational,3|7,7,3/7,240210,3
2,3,24,211,1,587,4,10,3,3,7,single-choice,spatial-relational,3|7,7,3/7,240211,3
2,3,24,212,1,791,2,12,5,5,7,single-choice,spatial-relational,5|7,7,5/7,240212,5
2,3,24,213,0,810,2,4,1,3,3,single-choice,spatial-relational,1|3,7,1/3,240213,1
2,3,24,214,1,644,2,10,4,4,6,single-choice,spatial-relational,4|6,7,4/6,240214,4
2,3,24,215,0,550,1,5,2,3,3,single-choice,spatial-relational,2|3,7,2/3,240215,2
2,3,24,216,0,598,3,9,3,6,6,single-choice,spatial-relational,3|6,7,3/6,240216,3
2,3,24,217,1,562,5,9,2,2,7,single-choice,spatial-relational,2|7,7,2/7,240217,2
2,3,24,218,1,614,1,11,5,5,6,single-choice,spatial-relational,5|6,7,5/6,240218,5
2,3,24,219,0,912,2,12,5,7,7,single-choice,spatial-relational,5|7,7,5/7,240219,5
2,3,24,220,1,685,4,8,2,2,6,single-choice,spatial-relational,2|6,7,2/6,240220,2
2,3,24,221,1,584,3,7,2,2,5,single-choice,spatial-relational,2|5,7,2/5,240221,2
2,3,24,222,1,584,4,6,1,1,5,single-choice,spatial-relational,1|5,7,1/5,240222,1
2,3,24,223,1,584,1,7,3,3,4,single-choice,spatial-relational,3|4,7,3/4,240223,3
2,3,24,224,1,620,2,4,1,1,3,single-choice,spatial-relational,1|3,7,1/3,240224,1
2,3,24,225,1,673,5,9,2,2,7,single-choice,spatial-relational,2|7,7,2/7,240225,2
2,3,24,226,1,605,5,7,1,1,6,single-choice,spatial-relational,1|6,7,1/6,240226,1
2,3,24,227,1,615,3,11,4,4,7,single-choice,spatial-relational,4|7,7,4/7,240227,4
2,3,24,228,1,632,1,3,1,1,2,single-choice,spatial-relational,1|2,7,1/2,240228,1
2,3,24,229,1,619,3,5,1,1,4,single-choice,spatial-relational,1|4,7,1/4,240229,1
2,3,24,230,1,574,3,5,1,1,4,single-choice,spatial-relational,1|4,7,1/4,240230,1
2,3,24,231,1,572,2,10,4,4,6,single-choice,spatial-relational,4|6,7,4/6,240231,4
2,3,24,232,1,676,3,9,3,3,6,single-choice,spatial-relational,3|6,7,3/6,240232,3
2,3,24,233,1,648,1,13,6,6,7,single-choice,spatial-relational,6|7,7,6/7,240233,6
2,3,24,234,1,729,5,7,1,1,6,single-choice,spatial-relational,1|6,7,1/6,240234,1
2,3,24,235,1,635,4,10,3,3,7,single-choice,spatial-relational,3|7,7,3/7,240235,3
2,3,24,236,0,684,2,8,3,5,5,single-choice,spatial-relational,3|5,7,3/5,240236,3
2,3,24,237,1,553,2,6,2,2,4,single-choice,spatial-relational,2|4,7,2/4,240237,2
2,3,24,238,1,611,6,8,1,1,7,single-choice,spatial-relational,1|7,7,1/7,240238,1
2,3,24,239,1,591,4,8,2,2,6,single-choice,spatial-relational,2|6,7,2/6,240239,2
2,3,24,240,1,628,1,11,5,5,6,single-choice,spatial-relational,5|6,7,5/6,240240,5
2,3,24,241,1,581,4,6,1,1,5,single-choice,spatial-relational,1|5,7,1/5,240241,1
2,3,24,242,1,642,1,13,6,6,7,single-choice,spatial-relational,6|7,7,6/7,240242,6
2,3,24,243,1,693,1,3,1,1,2,single-choice,spatial-relational,1|2,7,1/2,240243,1
2,3,24,244,1,648,2,8,3,3,5,single-choice,spatial-relational,3|5,7,3/5,240244,3
2,3,24,245,1,1386,2,6,2,2,4,single-choice,spatial-relational,2|4,7,2/4,240245,2
2,3,24,246,1,612,6,8,1,1,7,single-choice,spatial-relational,1|7,7,1/7,240246,1
2,3,24,247,0,680,1,7,3,4,4,single-choice,spatial-relational,3|4,7,3/4,240247,3
2,3,24,248,1,592,3,11,4,4,7,single-choice,spatial-relational,4|7,7,4/7,240248,4
2,3,24,249,1,536,1,5,2,2,3,single-choice,spatial-relational,2|3,7,2/3,240249,2
2,3,24,250,0,672,1,9,4,5,5,single-choice,spatial-relational,4|5,7,4/5,240250,4
2,3,24,251,1,558,3,7,2,2,5,single-choice,spatial-relational,2|5,7,2/5,240251,2
2,3,24,252,1,648,1,9,4,4,5,single-choice,spatial-relational,4|5,7,4/5,240252,4
2,3,24,253,1,557,4,6,1,1,5,single-choice,spatial-relational,1|5,7,1/5,240253,1
2,3,24,254,0,639,2,8,3,5,5,single-choice,spatial-relational,3|5,7,3/5,240254,3
2,3,24,255,0,592,1,3,1,2,2,single-choice,spatial-relational,1|2,7,1/2,240255,1
2,3,24,256,0,60,5,7,1,6,6,single-choice,spatial-relational,1|6,7,1/6,240256,1
2,3,24,257,1,745,1,13,6,6,7,single-choice,spatial-relational,6|7,7,6/7,240257,6
2,3,24,258,0,636,1,11,5,6,6,single-choice,spatial-relational,5|6,7,5/6,240258,5
2,3,24,259,1,694,3,11,4,4,7,single-choice,spatial-relational,4|7,7,4/7,240259,4
2,3,24,260,0,970,3,7,2,5,5,single-choice,spatial-relational,2|5,7,2/5,240260,2
2,3,24,261,1,40,4,8,2,2,6,single-choice,spatial-relational,2|6,7,2/6,240261,2
2,3,24,262,1,616,5,7,1,1,6,single-choice,spatial-relational,1|6,7,1/6,240262,1
2,3,24,263,1,556,1,5,2,2,3,single-choice,spatial-relational,2|3,7,2/3,240263,2
2,3,24,264,1,680,2,10,4,4,6,single-choice,spatial-relational,4|6,7,4/6,240264,4
2,3,24,265,1,602,4,10,3,3,7,single-choice,spatial-relational,3|7,7,3/7,240265,3
2,3,24,266,0,620,2,10,4,6,6,single-choice,spatial-relational,4|6,7,4/6,240266,4
2,3,24,267,1,599,1,7,3,3,4,single-choice,spatial-relational,3|4,7,3/4,240267,3
2,3,24,268,0,798,2,12,5,7,7,single-choice,spatial-relational,5|7,7,5/7,240268,5
2,3,24,269,1,583,4,10,3,3,7,single-choice,spatial-relational,3|7,7,3/7,240269,3
2,3,24,270,1,596,1,9,4,4,5,single-choice,spatial-relational,4|5,7,4/5,240270,4
2,3,24,271,1,697,3,5,1,1,4,single-choice,spatial-relational,1|4,7,1/4,240271,1
2,3,24,272,1,591,3,11,4,4,7,single-choice,spatial-relational,4|7,7,4/7,240272,4
2,3,24,273,1,580,6,8,1,1,7,single-choice,spatial-relational,1|7,7,1/7,240273,1
2,3,24,274,1,698,3,7,2,2,5,single-choice,spatial-relational,2|5,7,2/5,240274,2
2,3,24,275,1,693,3,9,3,3,6,single-choice,spatial-relational,3|6,7,3/6,240275,3
2,3,24,276,1,643,2,6,2,2,4,single-choice,spatial-relational,2|4,7,2/4,240276,2
2,3,24,277,1,545,1,13,6,6,7,single-choice,spatial-relational,6|7,7,6/7,240277,6
2,3,24,278,1,611,1,7,3,3,4,single-choice,spatial-relational,3|4,7,3/4,240278,3
2,3,24,279,1,912,3,9,3,3,6,single-choice,spatial-relational,3|6,7,3/6,240279,3
2,3,24,280,1,714,4,6,1,1,5,single-choice,spatial-relational,1|5,7,1/5,240280,1
2,3,24,281,1,701,1,9,4,4,5,single-choice,spatial-relational,4|5,7,4/5,240281,4
2,3,24,282,1,634,2,4,1,1,3,single-choice,spatial-relational,1|3,7,1/3,240282,1
2,3,24,283,0,687,2,6,2,4,4,single-choice,spatial-relational,2|4,7,2/4,240283,2
2,3,24,284,1,536,6,8,1,1,7,single-choice,spatial-relational,1|7,7,1/7,240284,1
2,3,24,285,1,697,3,5,1,1,4,single-choice,spatial-relational,1|4,7,1/4,240285,1
2,3,24,286,1,572,1,11,5,5,6,single-choice,spatial-relational,5|6,7,5/6,240286,5
2,3,24,287,1,706,2,12,5,5,7,single-choice,spatial-relational,5|7,7,5/7,240287,5
2,3,24,288,1,741,1,5,2,2,3,single-choice,spatial-relational,2|3,7,2/3,240288,2
2,3,24,289,1,560,1,3,1,1,2,single-choice,spatial-relational,1|2,7,1/2,240289,1
2,3,24,290,0,1038,2,4,1,3,3,single-choice,spatial-relational,1|3,7,1/3,240290,1
2,3,24,291,1,571,2,8,3,3,5,single-choice,spatial-relational,3|5,7,3/5,240291,3
2,3,24,292,1,703,4,8,2,2,6,single-choice,spatial-relational,2|6,7,2/6,240292,2
2,3,24,293,0,869,5,9,2,7,7,single-choice,spatial-relational,2|7,7,2/7,240293,2
2,3,24,294,1,572,5,9,2,2,7,single-choice,spatial-relational,2|7,7,2/7,240294,2
2,3,24,295,1,567,6,8,1,1,7,single-choice,spatial-relational,1|7,7,1/7,240295,1
2,3,24,296,1,634,2,6,2,2,4,single-choice,spatial-relational,2|4,7,2/4,240296,2
2,3,24,297,0,554,1,11,5,6,6,single-choice,spatial-relational,5|6,7,5/6,240297,5
2,3,24,298,1,629,1,11,5,5,6,single-choice,spatial-relational,5|6,7,5/6,240298,5
2,3,24,299,1,525,2,10,4,4,6,single-choice,spatial-relational,4|6,7,4/6,240299,4
2,3,24,300,1,755,3,7,2,2,5,single-choice,spatial-relational,2|5,7,2/5,240300,2
2,3,24,301,1,686,3,9,3,3,6,single-choice,spatial-relational,3|6,7,3/6,240301,3
2,3,24,302,1,700,1,13,6,6,7,single-choice,spatial-relational,6|7,7,6/7,240302,6
2,3,24,303,1,909,2,12,5,5,7,single-choice,spatial-relational,5|7,7,5/7,240303,5
2,3,24,304,1,574,4,10,3,3,7,single-choice,spatial-relational,3|7,7,3/7,240304,3
2,3,24,305,1,740,1,7,3,3,4,single-choice,spatial-relational,3|4,7,3/4,240305,3
2,3,24,306,1,728,5,9,2,2,7,single-choice,spatial-relational,2|7,7,2/7,240306,2
2,3,24,307,1,658,4,6,1,1,5,single-choice,spatial-relational,1|5,7,1/5,240307,1
2,3,24,308,0,607,2,4,1,3,3,single-choice,spatial-relational,1|3,7,1/3,240308,1
2,3,24,309,1,610,2,4,1,1,3,single-choice,spatial-relational,1|3,7,1/3,240309,1
2,3,24,310,1,755,3,7,2,2,5,single-choice,spatial-relational,2|5,7,2/5,240310,2
2,3,24,311,0,756,2,10,4,6,6,single-choice,spatial-relational,4|6,7,4/6,240311,4
2,3,24,312,1,620,3,11,4,4,7,single-choice,spatial-relational,4|7,7,4/7,240312,4
2,3,24,313,1,604,4,10,3,3,7,single-choice,spatial-relational,3|7,7,3/7,240313,3
2,3,24,314,1,662,3,11,4,4,7,single-choice,spatial-relational,4|7,7,4/7,240314,4
2,3,24,315,0,572,4,8,2,6,6,single-choice,spatial-relational,2|6,7,2/6,240315,2
2,3,24,316,0,855,1,9,4,5,5,single-choice,spatial-relational,4|5,7,4/5,240316,4
2,3,24,317,1,558,1,5,2,2,3,single-choice,spatial-relational,2|3,7,2/3,240317,2
2,3,24,318,1,582,2,8,3,3,5,single-choice,spatial-relational,3|5,7,3/5,240318,3
2,3,24,319,1,571,1,7,3,3,4,single-choice,spatial-relational,3|4,7,3/4,240319,3
2,3,24,320,1,603,3,9,3,3,6,single-choice,spatial-relational,3|6,7,3/6,240320,3
2,3,24,321,1,891,2,6,2,2,4,single-choice,spatial-relational,2|4,7,2/4,240321,2
2,3,24,322,0,545,4,8,2,6,6,single-choice,spatial-relational,2|6,7,2/6,240322,2
2,3,24,323,1,722,1,13,6,6,7,single-choice,spatial-relational,6|7,7,6/7,240323,6
2,3,24,324,1,683,5,9,2,2,7,single-choice,spatial-relational,2|7,7,2/7,240324,2
2,3,24,325,1,736,1,3,1,1,2,single-choice,spatial-relational,1|2,7,1/2,240325,1
2,3,24,326,1,620,6,8,1,1,7,single-choice,spatial-relational,1|7,7,1/7,240326,1
2,3,24,327,1,707,4,6,1,1,5,single-choice,spatial-relational,1|5,7,1/5,240327,1
2,3,24,328,0,669,1,9,4,5,5,single-choice,spatial-relational,4|5,7,4/5,240328,4
2,3,24,329,0,52,2,12,5,7,7,single-choice,spatial-relational,5|7,7,5/7,240329,5
2,3,24,330,0,561,1,3,1,2,2,single-choice,spatial-relational,1|2,7,1/2,240330,1
2,3,24,331,1,554,5,7,1,1,6,single-choice,spatial-relational,1|6,7,1/6,240331,1
2,3,24,332,1,519,3,5,1,1,4,single-choice,spatial-relational,1|4,7,1/4,240332,1
2,3,24,333,1,529,3,5,1,1,4,single-choice,spatial-relational,1|4,7,1/4,240333,1
2,3,24,334,1,658,2,8,3,3,5,single-choice,spatial-relational,3|5,7,3/5,240334,3
2,3,24,335,1,654,5,7,1,1,6,single-choice,spatial-relational,1|6,7,1/6,240335,1
2,3,24,336,0,670,1,5,2,3,3,single-choice,spatial-relational,2|3,7,2/3,240336,2
2,3,24,337,1,516,1,3,1,1,2,single-choice,spatial-relational,1|2,7,1/2,240337,1
2,3,24,338,1,705,1,9,4,4,5,single-choice,spatial-relational,4|5,7,4/5,240338,4
2,3,24,339,1,605,2,12,5,5,7,single-choice,spatial-relational,5|7,7,5/7,240339,5
2,3,24,340,1,650,1,7,3,3,4,single-choice,spatial-relational,3|4,7,3/4,240340,3
2,3,24,341,1,691,2,12,5,5,7,single-choice,spatial-relational,5|7,7,5/7,240341,5
2,3,24,342,1,643,1,5,2,2,3,single-choice,spatial-relational,2|3,7,2/3,240342,2
2,3,24,343,1,662,6,8,1,1,7,single-choice,spatial-relational,1|7,7,1/7,240343,1
2,3,24,344,0,1032,2,4,1,3,3,single-choice,spatial-relational,1|3,7,1/3,240344,1
2,3,24,345,0,591,1,5,2,3,3,single-choice,spatial-relational,2|3,7,2/3,240345,2
2,3,24,346,1,625,3,11,4,4,7,single-choice,spatial-relational,4|7,7,4/7,240346,4
2,3,24,347,0,650,1,9,4,5,5,single-choice,spatial-relational,4|5,7,4/5,240347,4
2,3,24,348,1,700,5,7,1,1,6,single-choice,spatial-relational,1|6,7,1/6,240348,1
2,3,24,349,1,813,4,8,2,2,6,single-choice,spatial-relational,2|6,7,2/6,240349,2
2,3,24,350,0,664,1,11,5,6,6,single-choice,spatial-relational,5|6,7,5/6,240350,5
2,3,24,351,1,603,3,9,3,3,6,single-choice,spatial-relational,3|6,7,3/6,240351,3
2,3,24,352,0,620,1,3,1,2,2,single-choice,spatial-relational,1|2,7,1/2,240352,1
2,3,24,353,1,517,1,13,6,6,7,single-choice,spatial-relational,6|7,7,6/7,240353,6
2,3,24,354,1,618,6,8,1,1,7,single-choice,spatial-relational,1|7,7,1/7,240354,1
2,3,24,355,1,564,3,5,1,1,4,single-choice,spatial-relational,1|4,7,1/4,240355,1
2,3,24,356,0,604,2,4,1,3,3,single-choice,spatial-relational,1|3,7,1/3,240356,1
2,3,24,357,1,592,3,9,3,3,6,single-choice,spatial-relational,3|6,7,3/6,240357,3
2,3,24,358,1,577,3,7,2,2,5,single-choice,spatial-relational,2|5,7,2/5,240358,2
2,3,24,359,1,631,5,9,2,2,7,single-choice,spatial-relational,2|7,7,2/7,240359,2
2,3,24,360,1,595,1,7,3,3,4,single-choice,spatial-relational,3|4,7,3/4,240360,3
2,3,24,361,0,619,2,8,3,5,5,single-choice,spatial-relational,3|5,7,3/5,240361,3
2,3,24,362,1,580,4,6,1,1,5,single-choice,spatial-relational,1|5,7,1/5,240362,1
2,3,24,363,0,493,1,11,5,6,6,single-choice,spatial-relational,5|6,7,5/6,240363,5
2,3,24,364,0,632,2,10,4,6,6,single-choice,spatial-relational,4|6,7,4/6,240364,4
2,3,24,365,1,595,3,7,2,2,5,single-choice,spatial-relational,2|5,7,2/5,240365,2
2,3,24,366,1,734,4,10,3,3,7,single-choice,spatial-relational,3|7,7,3/7,240366,3
2,3,24,367,1,584,3,5,1,1,4,single-choice,spatial-relational,1|4,7,1/4,240367,1
2,3,24,368,0,760,4,8,2,6,6,single-choice,spatial-relational,2|6,7,2/6,240368,2
2,3,24,369,1,742,2,10,4,4,6,single-choice,spatial-relational,4|6,7,4/6,240369,4
2,3,24,370,1,642,2,6,2,2,4,single-choice,spatial-relational,2|4,7,2/4,240370,2
2,3,24,371,1,588,4,6,1,1,5,single-choice,spatial-relational,1|5,7,1/5,240371,1
2,3,24,372,1,861,5,9,2,2,7,single-choice,spatial-relational,2|7,7,2/7,240372,2
2,3,24,373,0,1088,2,8,3,5,5,single-choice,spatial-relational,3|5,7,3/5,240373,3
2,3,24,374,1,803,2,6,2,2,4,single-choice,spatial-relational,2|4,7,2/4,240374,2
2,3,24,375,1,584,1,13,6,6,7,single-choice,spatial-relational,6|7,7,6/7,240375,6
2,3,24,376,1,705,5,7,1,1,6,single-choice,spatial-relational,1|6,7,1/6,240376,1
2,3,24,377,1,573,4,10,3,3,7,single-choice,spatial-relational,3|7,7,3/7,240377,3
2,3,24,378,1,616,3,11,4,4,7,single-choice,spatial-relational,4|7,7,4/7,240378,4
2,3,24,379,1,741,3,11,4,4,7,single-choice,spatial-relational,4|7,7,4/7,240379,4
2,3,24,380,1,580,2,8,3,3,5,single-choice,spatial-relational,3|5,7,3/5,240380,3
2,3,24,381,1,2416,2,6,2,2,4,single-choice,spatial-relational,2|4,7,2/4,240381,2
2,3,24,382,1,805,1,7,3,3,4,single-choice,spatial-relational,3|4,7,3/4,240382,3
2,3,24,383,1,2171,3,9,3,3,6,single-choice,spatial-relational,3|6,7,3/6,240383,3
2,3,24,384,1,4,1,7,3,3,4,single-choice,spatial-relational,3|4,7,3/4,240384,3
2,3,24,385,0,28,2,12,5,7,7,single-choice,spatial-relational,5|7,7,5/7,240385,5
2,3,24,386,1,565,1,13,6,6,7,single-choice,spatial-relational,6|7,7,6/7,240386,6
2,3,24,387,0,1025,2,4,1,3,3,single-choice,spatial-relational,1|3,7,1/3,240387,1
2,3,24,388,0,28,3,11,4,7,7,single-choice,spatial-relational,4|7,7,4/7,240388,4
2,3,24,389,1,479,1,9,4,4,5,single-choice,spatial-relational,4|5,7,4/5,240389,4
2,3,24,390,0,505,4,8,2,6,6,single-choice,spatial-relational,2|6,7,2/6,240390,2
2,3,24,391,1,669,2,6,2,2,4,single-choice,spatial-relational,2|4,7,2/4,240391,2
2,3,24,392,0,1725,2,6,2,4,4,single-choice,spatial-relational,2|4,7,2/4,240392,2
2,3,24,393,1,837,5,9,2,2,7,single-choice,spatial-relational,2|7,7,2/7,240393,2
2,3,24,394,1,597,1,11,5,5,6,single-choice,spatial-relational,5|6,7,5/6,240394,5
2,3,24,395,0,1435,1,11,5,6,6,single-choice,spatial-relational,5|6,7,5/6,240395,5
2,3,24,396,0,557,3,5,1,4,4,single-choice,spatial-relational,1|4,7,1/4,240396,1
2,3,24,397,0,746,6,8,1,7,7,single-choice,spatial-relational,1|7,7,1/7,240397,1
2,3,24,398,1,1219,2,8,3,3,5,single-choice,spatial-relational,3|5,7,3/5,240398,3
2,3,24,399,1,651,4,6,1,1,5,single-choice,spatial-relational,1|5,7,1/5,240399,1
2,3,24,400,1,654,3,7,2,2,5,single-choice,spatial-relational,2|5,7,2/5,240400,2
2,3,24,401,1,568,1,7,3,3,4,single-choice,spatial-relational,3|4,7,3/4,240401,3
2,3,24,402,1,566,1,9,4,4,5,single-choice,spatial-relational,4|5,7,4/5,240402,4
2,3,24,403,1,548,5,9,2,2,7,single-choice,spatial-relational,2|7,7,2/7,240403,2
2,3,24,404,1,552,4,10,3,3,7,single-choice,spatial-relational,3|7,7,3/7,240404,3
2,3,24,405,1,977,6,8,1,1,7,single-choice,spatial-relational,1|7,7,1/7,240405,1
2,3,24,406,0,606,2,8,3,5,5,single-choice,spatial-relational,3|5,7,3/5,240406,3
2,3,24,407,0,615,1,5,2,3,3,single-choice,spatial-relational,2|3,7,2/3,240407,2
2,3,24,408,0,663,4,8,2,6,6,single-choice,spatial-relational,2|6,7,2/6,240408,2
2,3,24,409,1,651,3,11,4,4,7,single-choice,spatial-relational,4|7,7,4/7,240409,4
2,3,24,410,1,620,1,3,1,1,2,single-choice,spatial-relational,1|2,7,1/2,240410,1
2,3,24,411,1,587,1,13,6,6,7,single-choice,spatial-relational,6|7,7,6/7,240411,6
2,3,24,412,1,602,3,9,3,3,6,single-choice,spatial-relational,3|6,7,3/6,240412,3
2,3,24,413,1,717,3,7,2,2,5,single-choice,spatial-relational,2|5,7,2/5,240413,2
2,3,24,414,0,1029,2,4,1,3,3,single-choice,spatial-relational,1|3,7,1/3,240414,1
2,3,24,415,0,596,4,6,1,5,5,single-choice,spatial-relational,1|5,7,1/5,240415,1
2,3,24,416,1,779,5,7,1,1,6,single-choice,spatial-relational,1|6,7,1/6,240416,1
2,3,24,417,0,509,3,5,1,4,4,single-choice,spatial-relational,1|4,7,1/4,240417,1
2,3,24,418,0,31,2,10,4,6,6,single-choice,spatial-relational,4|6,7,4/6,240418,4
2,3,24,419,1,552,4,10,3,3,7,single-choice,spatial-relational,3|7,7,3/7,240419,3
2,3,24,420,1,590,5,7,1,1,6,single-choice,spatial-relational,1|6,7,1/6,240420,1
2,3,24,421,0,652,2,10,4,6,6,single-choice,spatial-relational,4|6,7,4/6,240421,4
2,3,24,422,1,838,2,12,5,5,7,single-choice,spatial-relational,5|7,7,5/7,240422,5
2,3,24,423,1,762,1,3,1,1,2,single-choice,spatial-relational,1|2,7,1/2,240423,1
2,3,24,424,0,493,1,5,2,3,3,single-choice,spatial-relational,2|3,7,2/3,240424,2
2,3,24,425,0,226,4,10,3,7,7,single-choice,spatial-relational,3|7,7,3/7,240425,3
2,3,24,426,1,571,3,11,4,4,7,single-choice,spatial-relational,4|7,7,4/7,240426,4
2,3,24,427,0,567,2,10,4,6,6,single-choice,spatial-relational,4|6,7,4/6,240427,4
2,3,24,428,0,991,1,5,2,3,3,single-choice,spatial-relational,2|3,7,2/3,240428,2
2,3,24,429,1,654,1,13,6,6,7,single-choice,spatial-relational,6|7,7,6/7,240429,6
2,3,24,430,1,868,1,5,2,2,3,single-choice,spatial-relational,2|3,7,2/3,240430,2
2,3,24,431,1,580,5,7,1,1,6,single-choice,spatial-relational,1|6,7,1/6,240431,1
2,3,24,432,1,585,5,7,1,1,6,single-choice,spatial-relational,1|6,7,1/6,240432,1
2,3,24,433,1,546,3,7,2,2,5,single-choice,spatial-relational,2|5,7,2/5,240433,2
2,3,24,434,1,866,1,9,4,4,5,single-choice,spatial-relational,4|5,7,4/5,240434,4
2,3,24,435,1,667,2,8,3,3,5,single-choice,spatial-relational,3|5,7,3/5,240435,3
2,3,24,436,1,669,5,9,2,2,7,single-choice,spatial-relational,2|7,7,2/7,240436,2
2,3,24,437,1,562,4,6,1,1,5,single-choice,spatial-relational,1|5,7,1/5,240437,1
2,3,24,438,1,586,3,9,3,3,6,single-choice,spatial-relational,3|6,7,3/6,240438,3
2,3,24,439,0,673,1,3,1,2,2,single-choice,spatial-relational,1|2,7,1/2,240439,1
2,3,24,440,1,958,2,12,5,5,7,single-choice,spatial-relational,5|7,7,5/7,240440,5
2,3,24,441,0,904,3,7,2,5,5,single-choice,spatial-relational,2|5,7,2/5,240441,2
2,3,24,442,0,1213,4,8,2,6,6,single-choice,spatial-relational,2|6,7,2/6,240442,2
2,3,24,443,1,602,2,4,1,1,3,single-choice,spatial-relational,1|3,7,1/3,240443,1
2,3,24,444,0,481,3,5,1,4,4,single-choice,spatial-relational,1|4,7,1/4,240444,1
2,3,24,445,1,800,1,11,5,5,6,single-choice,spatial-relational,5|6,7,5/6,240445,5
2,3,24,446,1,632,6,8,1,1,7,single-choice,spatial-relational,1|7,7,1/7,240446,1
2,3,24,447,1,571,4,10,3,3,7,single-choice,spatial-relational,3|7,7,3/7,240447,3
2,3,24,448,1,544,4,6,1,1,5,single-choice,spatial-relational,1|5,7,1/5,240448,1
2,3,24,449,1,596,6,8,1,1,7,single-choice,spatial-relational,1|7,7,1/7,240449,1
2,3,24,450,0,601,2,6,2,4,4,single-choice,spatial-relational,2|4,7,2/4,240450,2
2,3,24,451,1,684,1,7,3,3,4,single-choice,spatial-relational,3|4,7,3/4,240451,3
2,3,24,452,1,850,4,8,2,2,6,single-choice,spatial-relational,2|6,7,2/6,240452,2
2,3,24,453,0,569,1,3,1,2,2,single-choice,spatial-relational,1|2,7,1/2,240453,1
2,3,24,454,1,797,3,11,4,4,7,single-choice,spatial-relational,4|7,7,4/7,240454,4
2,3,24,455,1,462,1,13,6,6,7,single-choice,spatial-relational,6|7,7,6/7,240455,6
2,3,24,456,1,880,3,9,3,3,6,single-choice,spatial-relational,3|6,7,3/6,240456,3
2,3,24,457,1,801,2,12,5,5,7,single-choice,spatial-relational,5|7,7,5/7,240457,5
2,3,24,458,1,628,1,9,4,4,5,single-choice,spatial-relational,4|5,7,4/5,240458,4
2,3,24,459,0,671,1,11,5,6,6,single-choice,spatial-relational,5|6,7,5/6,240459,5
2,3,24,460,1,546,5,9,2,2,7,single-choice,spatial-relational,2|7,7,2/7,240460,2
2,3,24,461,0,648,3,5,1,4,4,single-choice,spatial-relational,1|4,7,1/4,240461,1
2,3,24,462,0,1101,2,10,4,6,6,single-choice,spatial-relational,4|6,7,4/6,240462,4
2,3,24,463,1,847,2,8,3,3,5,single-choice,spatial-relational,3|5,7,3/5,240463,3
2,3,24,464,1,573,1,7,3,3,4,single-choice,spatial-relational,3|4,7,3/4,240464,3
2,3,24,465,1,583,2,4,1,1,3,single-choice,spatial-relational,1|3,7,1/3,240465,1
2,3,24,466,1,680,2,6,2,2,4,single-choice,spatial-relational,2|4,7,2/4,240466,2
2,3,24,467,0,580,2,10,4,6,6,single-choice,spatial-relational,4|6,7,4/6,240467,4
2,3,24,468,1,665,1,13,6,6,7,single-choice,spatial-relational,6|7,7,6/7,240468,6
2,3,24,469,1,609,3,5,1,1,4,single-choice,spatial-relational,1|4,7,1/4,240469,1
2,3,24,470,1,721,5,9,2,2,7,single-choice,spatial-relational,2|7,7,2/7,240470,2
2,3,24,471,1,753,1,3,1,1,2,single-choice,spatial-relational,1|2,7,1/2,240471,1
2,3,24,472,1,629,1,9,4,4,5,single-choice,spatial-relational,4|5,7,4/5,240472,4
2,3,24,473,1,629,3,7,2,2,5,single-choice,spatial-relational,2|5,7,2/5,240473,2
2,3,24,474,0,631,3,5,1,4,4,single-choice,spatial-relational,1|4,7,1/4,240474,1
2,3,24,475,1,702,3,9,3,3,6,single-choice,spatial-relational,3|6,7,3/6,240475,3
2,3,24,476,0,711,1,7,3,4,4,single-choice,spatial-relational,3|4,7,3/4,240476,3
2,3,24,477,1,653,2,10,4,4,6,single-choice,spatial-relational,4|6,7,4/6,240477,4
2,3,24,478,1,687,5,7,1,1,6,single-choice,spatial-relational,1|6,7,1/6,240478,1
2,3,24,479,0,559,1,3,1,2,2,single-choice,spatial-relational,1|2,7,1/2,240479,1
2,3,24,480,1,1175,2,6,2,2,4,single-choice,spatial-relational,2|4,7,2/4,240480,2
2,3,24,481,1,682,4,6,1,1,5,single-choice,spatial-relational,1|5,7,1/5,240481,1
2,3,24,482,1,662,2,12,5,5,7,single-choice,spatial-relational,5|7,7,5/7,240482,5
2,3,24,483,1,766,4,8,2,2,6,single-choice,spatial-relational,2|6,7,2/6,240483,2
2,3,24,484,1,585,4,10,3,3,7,single-choice,spatial-relational,3|7,7,3/7,240484,3
2,3,24,485,1,733,6,8,1,1,7,single-choice,spatial-relational,1|7,7,1/7,240485,1
2,3,24,486,1,629,1,11,5,5,6,single-choice,spatial-relational,5|6,7,5/6,240486,5
2,3,24,487,1,751,5,7,1,1,6,single-choice,spatial-relational,1|6,7,1/6,240487,1
2,3,24,488,1,614,3,9,3,3,6,single-choice,spatial-relational,3|6,7,3/6,240488,3
2,3,24,489,0,628,1,11,5,6,6,single-choice,spatial-relational,5|6,7,5/6,240489,5
2,3,24,490,0,653,2,8,3,5,5,single-choice,spatial-relational,3|5,7,3/5,240490,3
2,3,24,491,1,656,2,4,1,1,3,single-choice,spatial-relational,1|3,7,1/3,240491,1
2,3,24,492,0,660,6,8,1,7,7,single-choice,spatial-relational,1|7,7,1/7,240492,1
2,3,24,493,0,1121,2,4,1,3,3,single-choice,spatial-relational,1|3,7,1/3,240493,1
2,3,24,494,1,832,2,6,2,2,4,single-choice,spatial-relational,2|4,7,2/4,240494,2
2,3,24,495,1,707,4,10,3,3,7,single-choice,spatial-relational,3|7,7,3/7,240495,3
2,3,24,496,0,722,1,9,4,5,5,single-choice,spatial-relational,4|5,7,4/5,240496,4
2,3,24,497,1,677,3,11,4,4,7,single-choice,spatial-relational,4|7,7,4/7,240497,4
2,3,24,498,1,640,2,12,5,5,7,single-choice,spatial-relational,5|7,7,5/7,240498,5
2,3,24,499,1,656,2,8,3,3,5,single-choice,spatial-relational,3|5,7,3/5,240499,3
2,3,24,500,1,721,5,9,2,2,7,single-choice,spatial-relational,2|7,7,2/7,240500,2
2,3,24,501,1,722,4,8,2,2,6,single-choice,spatial-relational,2|6,7,2/6,240501,2
2,3,24,502,0,635,1,5,2,3,3,single-choice,spatial-relational,2|3,7,2/3,240502,2
2,3,24,503,1,569,3,7,2,2,5,single-choice,spatial-relational,2|5,7,2/5,240503,2
2,3,24,504,0,607,1,5,2,3,3,single-choice,spatial-relational,2|3,7,2/3,240504,2
2,3,24,505,1,1154,1,7,3,3,4,single-choice,spatial-relational,3|4,7,3/4,240505,3
2,3,24,506,1,507,1,13,6,6,7,single-choice,spatial-relational,6|7,7,6/7,240506,6
2,3,24,507,1,631,4,6,1,1,5,single-choice,spatial-relational,1|5,7,1/5,240507,1
2,3,24,508,1,663,3,11,4,4,7,single-choice,spatial-relational,4|7,7,4/7,240508,4
2,3,24,509,1,686,3,11,4,4,7,single-choice,spatial-relational,4|7,7,4/7,240509,4
2,3,24,510,1,814,2,4,1,1,3,single-choice,spatial-relational,1|3,7,1/3,240510,1
2,3,24,511,1,634,2,10,4,4,6,single-choice,spatial-relational,4|6,7,4/6,240511,4
2,3,24,512,1,689,3,5,1,1,4,single-choice,spatial-relational,1|4,7,1/4,240512,1
2,3,24,513,0,567,1,3,1,2,2,single-choice,spatial-relational,1|2,7,1/2,240513,1
2,3,24,514,1,685,2,8,3,3,5,single-choice,spatial-relational,3|5,7,3/5,240514,3
2,3,24,515,1,576,1,7,3,3,4,single-choice,spatial-relational,3|4,7,3/4,240515,3
2,3,24,516,1,636,5,7,1,1,6,single-choice,spatial-relational,1|6,7,1/6,240516,1
2,3,24,517,1,709,2,12,5,5,7,single-choice,spatial-relational,5|7,7,5/7,240517,5
2,3,24,518,1,713,1,13,6,6,7,single-choice,spatial-relational,6|7,7,6/7,240518,6
2,3,24,519,1,639,3,9,3,3,6,single-choice,spatial-relational,3|6,7,3/6,240519,3
2,3,24,520,0,600,3,5,1,4,4,single-choice,spatial-relational,1|4,7,1/4,240520,1
2,3,24,521,1,645,1,7,3,3,4,single-choice,spatial-relational,3|4,7,3/4,240521,3
2,3,24,522,1,795,3,7,2,2,5,single-choice,spatial-relational,2|5,7,2/5,240522,2
2,3,24,523,1,811,5,9,2,2,7,single-choice,spatial-relational,2|7,7,2/7,240523,2
2,3,24,524,1,711,2,6,2,2,4,single-choice,spatial-relational,2|4,7,2/4,240524,2
2,3,24,525,0,581,2,10,4,6,6,single-choice,spatial-relational,4|6,7,4/6,240525,4
2,3,24,526,1,1598,3,11,4,4,7,single-choice,spatial-relational,4|7,7,4/7,240526,4
2,3,24,527,1,681,2,12,5,5,7,single-choice,spatial-relational,5|7,7,5/7,240527,5
2,3,24,528,0,676,2,4,1,3,3,single-choice,spatial-relational,1|3,7,1/3,240528,1
2,3,24,529,1,704,4,6,1,1,5,single-choice,spatial-relational,1|5,7,1/5,240529,1
2,3,24,530,1,609,3,7,2,2,5,single-choice,spatial-relational,2|5,7,2/5,240530,2
2,3,24,531,1,647,5,9,2,2,7,single-choice,spatial-relational,2|7,7,2/7,240531,2
2,3,24,532,1,606,4,10,3,3,7,single-choice,spatial-relational,3|7,7,3/7,240532,3
2,3,24,533,0,629,1,11,5,6,6,single-choice,spatial-relational,5|6,7,5/6,240533,5
2,3,24,534,1,607,6,8,1,1,7,single-choice,spatial-relational,1|7,7,1/7,240534,1
2,3,24,535,1,591,3,9,3,3,6,single-choice,spatial-relational,3|6,7,3/6,240535,3
2,3,24,536,1,685,6,8,1,1,7,single-choice,spatial-relational,1|7,7,1/7,240536,1
2,3,24,537,0,553,4,8,2,6,6,single-choice,spatial-relational,2|6,7,2/6,240537,2
2,3,24,538,1,620,5,7,1,1,6,single-choice,spatial-relational,1|6,7,1/6,240538,1
2,3,24,539,0,576,1,9,4,5,5,single-choice,spatial-relational,4|5,7,4/5,240539,4
2,3,24,540,1,707,1,5,2,2,3,single-choice,spatial-relational,2|3,7,2/3,240540,2
2,3,24,541,1,496,1,13,6,6,7,single-choice,spatial-relational,6|7,7,6/7,240541,6
2,3,24,542,1,654,4,10,3,3,7,single-choice,spatial-relational,3|7,7,3/7,240542,3
2,3,24,543,0,586,1,11,5,6,6,single-choice,spatial-relational,5|6,7,5/6,240543,5
2,3,24,544,0,933,1,9,4,5,5,single-choice,spatial-relational,4|5,7,4/5,240544,4
2,3,24,545,1,649,1,3,1,1,2,single-choice,spatial-relational,1|2,7,1/2,240545,1
2,3,24,546,1,589,2,8,3,3,5,single-choice,spatial-relational,3|5,7,3/5,240546,3
2,3,24,547,1,564,2,6,2,2,4,single-choice,spatial-relational,2|4,7,2/4,240547,2
2,3,24,548,1,663,4,8,2,2,6,single-choice,spatial-relational,2|6,7,2/6,240548,2
2,3,24,549,1,726,1,5,2,2,3,single-choice,spatial-relational,2|3,7,2/3,240549,2
2,3,24,550,1,531,4,6,1,1,5,single-choice,spatial-relational,1|5,7,1/5,240550,1
2,3,24,551,1,609,1,9,4,4,5,single-choice,spatial-relational,4|5,7,4/5,240551,4
2,3,24,552,1,630,3,9,3,3,6,single-choice,spatial-relational,3|6,7,3/6,240552,3
2,3,24,553,1,505,1,13,6,6,7,single-choice,spatial-relational,6|7,7,6/7,240553,6
2,3,24,554,1,718,6,8,1,1,7,single-choice,spatial-relational,1|7,7,1/7,240554,1
2,3,24,555,0,629,1,3,1,2,2,single-choice,spatial-relational,1|2,7,1/2,240555,1
2,3,24,556,1,603,4,10,3,3,7,single-choice,spatial-relational,3|7,7,3/7,240556,3
2,3,24,557,1,633,2,10,4,4,6,single-choice,spatial-relational,4|6,7,4/6,240557,4
2,3,24,558,1,727,3,9,3,3,6,single-choice,spatial-relational,3|6,7,3/6,240558,3
2,3,24,559,0,887,2,12,5,7,7,single-choice,spatial-relational,5|7,7,5/7,240559,5
2,3,24,560,1,55,1,11,5,5,6,single-choice,spatial-relational,5|6,7,5/6,240560,5
2,3,24,561,1,658,3,11,4,4,7,single-choice,spatial-relational,4|7,7,4/7,240561,4
2,3,24,562,1,702,1,5,2,2,3,single-choice,spatial-relational,2|3,7,2/3,240562,2
2,3,24,563,1,673,1,5,2,2,3,single-choice,spatial-relational,2|3,7,2/3,240563,2
2,3,24,564,1,719,2,10,4,4,6,single-choice,spatial-relational,4|6,7,4/6,240564,4
2,3,24,565,1,594,3,11,4,4,7,single-choice,spatial-relational,4|7,7,4/7,240565,4
2,3,24,566,0,727,5,9,2,7,7,single-choice,spatial-relational,2|7,7,2/7,240566,2
2,3,24,567,1,545,5,7,1,1,6,single-choice,spatial-relational,1|6,7,1/6,240567,1
2,3,24,568,1,763,2,8,3,3,5,single-choice,spatial-relational,3|5,7,3/5,240568,3
2,3,24,569,0,620,2,4,1,3,3,single-choice,spatial-relational,1|3,7,1/3,240569,1
2,3,24,570,0,29,4,10,3,7,7,single-choice,spatial-relational,3|7,7,3/7,240570,3
2,3,24,571,0,5,1,7,3,4,4,single-choice,spatial-relational,3|4,7,3/4,240571,3
2,3,24,572,1,670,1,13,6,6,7,single-choice,spatial-relational,6|7,7,6/7,240572,6
2,3,24,573,0,906,1,3,1,2,2,single-choice,spatial-relational,1|2,7,1/2,240573,1
2,3,24,574,1,512,6,8,1,1,7,single-choice,spatial-relational,1|7,7,1/7,240574,1
2,3,24,575,1,652,3,5,1,1,4,single-choice,spatial-relational,1|4,7,1/4,240575,1
2,3,24,576,0,618,4,6,1,5,5,single-choice,spatial-relational,1|5,7,1/5,240576,1
2,3,24,577,0,716,1,9,4,5,5,single-choice,spatial-relational,4|5,7,4/5,240577,4
2,3,24,578,1,609,2,8,3,3,5,single-choice,spatial-relational,3|5,7,3/5,240578,3
2,3,24,579,0,697,4,8,2,6,6,single-choice,spatial-relational,2|6,7,2/6,240579,2
2,3,24,580,1,878,3,7,2,2,5,single-choice,spatial-relational,2|5,7,2/5,240580,2
2,3,24,581,1,624,5,7,1,1,6,single-choice,spatial-relational,1|6,7,1/6,240581,1
2,3,24,582,1,646,2,4,1,1,3,single-choice,spatial-relational,1|3,7,1/3,240582,1
2,3,24,583,1,604,5,9,2,2,7,single-choice,spatial-relational,2|7,7,2/7,240583,2
2,3,24,584,1,655,1,11,5,5,6,single-choice,spatial-relational,5|6,7,5/6,240584,5
2,3,24,585,1,765,4,8,2,2,6,single-choice,spatial-relational,2|6,7,2/6,240585,2
2,3,24,586,1,675,2,6,2,2,4,single-choice,spatial-relational,2|4,7,2/4,240586,2
2,3,24,587,1,622,3,7,2,2,5,single-choice,spatial-relational,2|5,7,2/5,240587,2
2,3,24,588,0,623,2,6,2,4,4,single-choice,spatial-relational,2|4,7,2/4,240588,2
2,3,24,589,1,662,4,6,1,1,5,single-choice,spatial-relational,1|5,7,1/5,240589,1
2,3,24,590,1,808,2,12,5,5,7,single-choice,spatial-relational,5|7,7,5/7,240590,5
2,3,24,591,1,741,1,7,3,3,4,single-choice,spatial-relational,3|4,7,3/4,240591,3
2,3,24,592,1,741,3,5,1,1,4,single-choice,spatial-relational,1|4,7,1/4,240592,1
2,3,24,593,1,595,4,6,1,1,5,single-choice,spatial-relational,1|5,7,1/5,240593,1
2,3,24,594,1,601,1,13,6,6,7,single-choice,spatial-relational,6|7,7,6/7,240594,6
2,3,24,595,1,642,3,7,2,2,5,single-choice,spatial-relational,2|5,7,2/5,240595,2
2,3,24,596,1,668,1,5,2,2,3,single-choice,spatial-relational,2|3,7,2/3,240596,2
2,3,24,597,1,719,5,9,2,2,7,single-choice,spatial-relational,2|7,7,2/7,240597,2
2,3,24,598,1,581,1,3,1,1,2,single-choice,spatial-relational,1|2,7,1/2,240598,1
2,3,24,599,1,754,4,8,2,2,6,single-choice,spatial-relational,2|6,7,2/6,240599,2
2,3,24,600,1,659,5,9,2,2,7,single-choice,spatial-relational,2|7,7,2/7,240600,2
2,3,24,601,1,793,2,6,2,2,4,single-choice,spatial-relational,2|4,7,2/4,240601,2
2,3,24,602,0,666,1,11,5,6,6,single-choice,spatial-relational,5|6,7,5/6,240602,5
2,3,24,603,1,710,2,12,5,5,7,single-choice,spatial-relational,5|7,7,5/7,240603,5
2,3,24,604,1,750,1,5,2,2,3,single-choice,spatial-relational,2|3,7,2/3,240604,2
2,3,24,605,1,729,6,8,1,1,7,single-choice,spatial-relational,1|7,7,1/7,240605,1
2,3,24,606,1,811,2,6,2,2,4,single-choice,spatial-relational,2|4,7,2/4,240606,2
2,3,24,607,1,608,3,7,2,2,5,single-choice,spatial-relational,2|5,7,2/5,240607,2
2,3,24,608,0,651,2,8,3,5,5,single-choice,spatial-relational,3|5,7,3/5,240608,3
2,3,24,609,1,596,3,9,3,3,6,single-choice,spatial-relational,3|6,7,3/6,240609,3
2,3,24,610,0,674,1,9,4,5,5,single-choice,spatial-relational,4|5,7,4/5,240610,4
2,3,24,611,1,731,1,7,3,3,4,single-choice,spatial-relational,3|4,7,3/4,240611,3
2,3,24,612,1,773,3,5,1,1,4,single-choice,spatial-relational,1|4,7,1/4,240612,1
2,3,24,613,0,3,3,9,3,6,6,single-choice,spatial-relational,3|6,7,3/6,240613,3
2,3,24,614,1,677,5,7,1,1,6,single-choice,spatial-relational,1|6,7,1/6,240614,1
2,3,24,615,1,631,1,13,6,6,7,single-choice,spatial-relational,6|7,7,6/7,240615,6
2,3,24,616,1,584,4,10,3,3,7,single-choice,spatial-relational,3|7,7,3/7,240616,3
2,3,24,617,1,641,4,10,3,3,7,single-choice,spatial-relational,3|7,7,3/7,240617,3
2,3,24,618,0,748,3,11,4,7,7,single-choice,spatial-relational,4|7,7,4/7,240618,4
2,3,24,619,1,819,5,7,1,1,6,single-choice,spatial-relational,1|6,7,1/6,240619,1
2,3,24,620,0,684,2,4,1,3,3,single-choice,spatial-relational,1|3,7,1/3,240620,1
2,3,24,621,1,1982,6,8,1,1,7,single-choice,spatial-relational,1|7,7,1/7,240621,1
2,3,24,622,1,586,2,12,5,5,7,single-choice,spatial-relational,5|7,7,5/7,240622,5
2,3,24,623,1,653,4,8,2,2,6,single-choice,spatial-relational,2|6,7,2/6,240623,2
2,3,24,624,1,656,2,8,3,3,5,single-choice,spatial-relational,3|5,7,3/5,240624,3
2,3,24,625,0,647,2,10,4,6,6,single-choice,spatial-relational,4|6,7,4/6,240625,4
2,3,24,626,1,675,4,6,1,1,5,single-choice,spatial-relational,1|5,7,1/5,240626,1
2,3,24,627,1,695,1,11,5,5,6,single-choice,spatial-relational,5|6,7,5/6,240627,5
2,3,24,628,1,765,1,7,3,3,4,single-choice,spatial-relational,3|4,7,3/4,240628,3
2,3,24,629,1,566,3,5,1,1,4,single-choice,spatial-relational,1|4,7,1/4,240629,1
2,3,24,630,1,633,3,11,4,4,7,single-choice,spatial-relational,4|7,7,4/7,240630,4
2,3,24,631,1,672,2,10,4,4,6,single-choice,spatial-relational,4|6,7,4/6,240631,4
2,3,24,632,1,740,1,9,4,4,5,single-choice,spatial-relational,4|5,7,4/5,240632,4
2,3,24,633,0,646,1,3,1,2,2,single-choice,spatial-relational,1|2,7,1/2,240633,1
2,3,24,634,1,618,2,4,1,1,3,single-choice,spatial-relational,1|3,7,1/3,240634,1
2,3,24,635,1,690,2,10,4,4,6,single-choice,spatial-relational,4|6,7,4/6,240635,4
2,3,24,636,0,1078,2,8,3,5,5,single-choice,spatial-relational,3|5,7,3/5,240636,3
2,3,24,637,1,734,3,5,1,1,4,single-choice,spatial-relational,1|4,7,1/4,240637,1
2,3,24,638,1,656,3,9,3,3,6,single-choice,spatial-relational,3|6,7,3/6,240638,3
2,3,24,639,0,672,2,6,2,4,4,single-choice,spatial-relational,2|4,7,2/4,240639,2
2,3,24,640,1,621,2,8,3,3,5,single-choice,spatial-relational,3|5,7,3/5,240640,3
2,3,24,641,1,720,2,10,4,4,6,single-choice,spatial-relational,4|6,7,4/6,240641,4
2,3,24,642,1,741,4,10,3,3,7,single-choice,spatial-relational,3|7,7,3/7,240642,3
2,3,24,643,1,632,5,9,2,2,7,single-choice,spatial-relational,2|7,7,2/7,240643,2
2,3,24,644,1,652,3,5,1,1,4,single-choice,spatial-relational,1|4,7,1/4,240644,1
2,3,24,645,1,653,4,6,1,1,5,single-choice,spatial-relational,1|5,7,1/5,240645,1
2,3,24,646,0,670,1,11,5,6,6,single-choice,spatial-relational,5|6,7,5/6,240646,5
2,3,24,647,1,694,5,9,2,2,7,single-choice,spatial-relational,2|7,7,2/7,240647,2
2,3,24,648,1,668,2,6,2,2,4,single-choice,spatial-relational,2|4,7,2/4,240648,2
2,3,24,649,1,638,3,7,2,2,5,single-choice,spatial-relational,2|5,7,2/5,240649,2
2,3,24,650,1,569,3,11,4,4,7,single-choice,spatial-relational,4|7,7,4/7,240650,4
2,3,24,651,1,617,1,3,1,1,2,single-choice,spatial-relational,1|2,7,1/2,240651,1
2,3,24,652,0,588,1,5,2,3,3,single-choice,spatial-relational,2|3,7,2/3,240652,2
2,3,24,653,1,654,2,4,1,1,3,single-choice,spatial-relational,1|3,7,1/3,240653,1
2,3,24,654,0,526,3,9,3,6,6,single-choice,spatial-relational,3|6,7,3/6,240654,3
2,3,24,655,1,756,1,13,6,6,7,single-choice,spatial-relational,6|7,7,6/7,240655,6
2,3,24,656,1,706,4,10,3,3,7,single-choice,spatial-relational,3|7,7,3/7,240656,3
2,3,24,657,0,1002,2,12,5,7,7,single-choice,spatial-relational,5|7,7,5/7,240657,5
2,3,24,658,1,678,4,8,2,2,6,single-choice,spatial-relational,2|6,7,2/6,240658,2
2,3,24,659,1,619,5,7,1,1,6,single-choice,spatial-relational,1|6,7,1/6,240659,1
2,3,24,660,1,608,1,7,3,3,4,single-choice,spatial-relational,3|4,7,3/4,240660,3
2,3,24,661,1,588,1,7,3,3,4,single-choice,spatial-relational,3|4,7,3/4,240661,3
2,3,24,662,1,552,3,7,2,2,5,single-choice,spatial-relational,2|5,7,2/5,240662,2
2,3,24,663,1,681,4,8,2,2,6,single-choice,spatial-relational,2|6,7,2/6,240663,2
2,3,24,664,1,519,1,5,2,2,3,single-choice,spatial-relational,2|3,7,2/3,240664,2
2,3,24,665,0,673,1,13,6,7,7,single-choice,spatial-relational,6|7,7,6/7,240665,6
2,3,24,666,0,901,1,9,4,5,5,single-choice,spatial-relational,4|5,7,4/5,240666,4
2,3,24,667,1,662,4,6,1,1,5,single-choice,spatial-relational,1|5,7,1/5,240667,1
2,3,24,668,1,640,5,7,1,1,6,single-choice,spatial-relational,1|6,7,1/6,240668,1
2,3,24,669,1,650,6,8,1,1,7,single-choice,spatial-relational,1|7,7,1/7,240669,1
2,3,24,670,1,665,1,11,5,5,6,single-choice,spatial-relational,5|6,7,5/6,240670,5
2,3,24,671,1,763,2,4,1,1,3,single-choice,spatial-relational,1|3,7,1/3,240671,1
2,3,24,672,1,634,1,9,4,4,5,single-choice,spatial-relational,4|5,7,4/5,240672,4
2,3,24,673,0,672,1,3,1,2,2,single-choice,spatial-relational,1|2,7,1/2,240673,1
2,3,24,674,1,606,6,8,1,1,7,single-choice,spatial-relational,1|7,7,1/7,240674,1
2,3,24,675,1,618,2,12,5,5,7,single-choice,spatial-relational,5|7,7,5/7,240675,5
2,3,24,676,1,635,3,11,4,4,7,single-choice,spatial-relational,4|7,7,4/7,240676,4
2,3,24,677,1,739,2,6,2,2,4,single-choice,spatial-relational,2|4,7,2/4,240677,2
2,3,24,678,1,671,2,12,5,5,7,single-choice,spatial-relational,5|7,7,5/7,240678,5
2,3,24,679,1,678,4,8,2,2,6,single-choice,spatial-relational,2|6,7,2/6,240679,2
2,3,24,680,1,642,2,10,4,4,6,single-choice,spatial-relational,4|6,7,4/6,240680,4
2,3,24,681,1,614,3,9,3,3,6,single-choice,spatial-relational,3|6,7,3/6,240681,3
2,3,24,682,1,768,2,6,2,2,4,single-choice,spatial-relational,2|4,7,2/4,240682,2
2,3,24,683,1,762,1,7,3,3,4,single-choice,spatial-relational,3|4,7,3/4,240683,3
2,3,24,684,1,685,4,6,1,1,5,single-choice,spatial-relational,1|5,7,1/5,240684,1
2,3,24,685,1,643,1,5,2,2,3,single-choice,spatial-relational,2|3,7,2/3,240685,2
2,3,24,686,1,1155,1,11,5,5,6,single-choice,spatial-relational,5|6,7,5/6,240686,5
2,3,24,687,1,751,2,8,3,3,5,single-choice,spatial-relational,3|5,7,3/5,240687,3
2,3,24,688,1,630,6,8,1,1,7,single-choice,spatial-relational,1|7,7,1/7,240688,1
2,3,24,689,1,650,2,12,5,5,7,single-choice,spatial-relational,5|7,7,5/7,240689,5
2,3,24,690,0,797,2,4,1,3,3,single-choice,spatial-relational,1|3,7,1/3,240690,1
2,3,24,691,1,19,3,11,4,4,7,single-choice,spatial-relational,4|7,7,4/7,240691,4
2,3,24,692,0,661,2,10,4,6,6,single-choice,spatial-relational,4|6,7,4/6,240692,4
2,3,24,693,1,719,4,10,3,3,7,single-choice,spatial-relational,3|7,7,3/7,240693,3
2,3,24,694,1,779,1,9,4,4,5,single-choice,spatial-relational,4|5,7,4/5,240694,4
2,3,24,695,1,676,3,5,1,1,4,single-choice,spatial-relational,1|4,7,1/4,240695,1
2,3,24,696,0,598,5,7,1,6,6,single-choice,spatial-relational,1|6,7,1/6,240696,1
2,3,24,697,1,717,3,5,1,1,4,single-choice,spatial-relational,1|4,7,1/4,240697,1
2,3,24,698,0,642,2,8,3,5,5,single-choice,spatial-relational,3|5,7,3/5,240698,3
2,3,24,699,1,748,5,9,2,2,7,single-choice,spatial-relational,2|7,7,2/7,240699,2
2,3,24,700,0,628,1,11,5,6,6,single-choice,spatial-relational,5|6,7,5/6,240700,5
2,3,24,701,1,709,4,10,3,3,7,single-choice,spatial-relational,3|7,7,3/7,240701,3
2,3,24,702,1,879,1,9,4,4,5,single-choice,spatial-relational,4|5,7,4/5,240702,4
2,3,24,703,1,628,5,7,1,1,6,single-choice,spatial-relational,1|6,7,1/6,240703,1
2,3,24,704,1,767,2,4,1,1,3,single-choice,spatial-relational,1|3,7,1/3,240704,1
2,3,24,705,0,598,4,8,2,6,6,single-choice,spatial-relational,2|6,7,2/6,240705,2
2,3,24,706,1,752,1,3,1,1,2,single-choice,spatial-relational,1|2,7,1/2,240706,1
2,3,24,707,1,552,1,7,3,3,4,single-choice,spatial-relational,3|4,7,3/4,240707,3
2,3,24,708,1,622,5,9,2,2,7,single-choice,spatial-relational,2|7,7,2/7,240708,2
2,3,24,709,0,718,1,13,6,7,7,single-choice,spatial-relational,6|7,7,6/7,240709,6
2,3,24,710,1,696,1,5,2,2,3,single-choice,spatial-relational,2|3,7,2/3,240710,2
2,3,24,711,1,788,4,6,1,1,5,single-choice,spatial-relational,1|5,7,1/5,240711,1
2,3,24,712,1,675,3,7,2,2,5,single-choice,spatial-relational,2|5,7,2/5,240712,2
2,3,24,713,1,697,1,13,6,6,7,single-choice,spatial-relational,6|7,7,6/7,240713,6
2,3,24,714,1,704,3,7,2,2,5,single-choice,spatial-relational,2|5,7,2/5,240714,2
2,3,24,715,1,565,3,9,3,3,6,single-choice,spatial-relational,3|6,7,3/6,240715,3
2,3,24,716,1,1008,1,3,1,1,2,single-choice,spatial-relational,1|2,7,1/2,240716,1
2,3,24,717,1,619,6,8,1,1,7,single-choice,spatial-relational,1|7,7,1/7,240717,1
2,3,24,718,1,680,3,11,4,4,7,single-choice,spatial-relational,4|7,7,4/7,240718,4
2,3,24,719,1,867,6,8,1,1,7,single-choice,spatial-relational,1|7,7,1/7,240719,1
2,3,24,720,1,745,3,5,1,1,4,single-choice,spatial-relational,1|4,7,1/4,240720,1
2,3,24,721,0,538,3,7,2,5,5,single-choice,spatial-relational,2|5,7,2/5,240721,2
2,3,24,722,1,661,1,5,2,2,3,single-choice,spatial-relational,2|3,7,2/3,240722,2
2,3,24,723,0,787,1,13,6,7,7,single-choice,spatial-relational,6|7,7,6/7,240723,6
2,3,24,724,1,1036,4,10,3,3,7,single-choice,spatial-relational,3|7,7,3/7,240724,3
2,3,24,725,1,1046,2,8,3,3,5,single-choice,spatial-relational,3|5,7,3/5,240725,3
2,3,24,726,1,621,4,10,3,3,7,single-choice,spatial-relational,3|7,7,3/7,240726,3
2,3,24,727,1,599,1,11,5,5,6,single-choice,spatial-relational,5|6,7,5/6,240727,5
2,3,24,728,1,605,4,6,1,1,5,single-choice,spatial-relational,1|5,7,1/5,240728,1
2,3,24,729,1,697,2,10,4,4,6,single-choice,spatial-relational,4|6,7,4/6,240729,4
2,3,24,730,1,575,2,4,1,1,3,single-choice,spatial-relational,1|3,7,1/3,240730,1
2,3,24,731,1,619,1,3,1,1,2,single-choice,spatial-relational,1|2,7,1/2,240731,1
2,3,24,732,1,644,2,12,5,5,7,single-choice,spatial-relational,5|7,7,5/7,240732,5
2,3,24,733,1,655,1,3,1,1,2,single-choice,spatial-relational,1|2,7,1/2,240733,1
2,3,24,734,1,727,4,6,1,1,5,single-choice,spatial-relational,1|5,7,1/5,240734,1
2,3,24,735,1,658,5,9,2,2,7,single-choice,spatial-relational,2|7,7,2/7,240735,2
2,3,24,736,1,632,5,7,1,1,6,single-choice,spatial-relational,1|6,7,1/6,240736,1
2,3,24,737,1,622,6,8,1,1,7,single-choice,spatial-relational,1|7,7,1/7,240737,1
2,3,24,738,1,680,3,7,2,2,5,single-choice,spatial-relational,2|5,7,2/5,240738,2
2,3,24,739,1,674,2,8,3,3,5,single-choice,spatial-relational,3|5,7,3/5,240739,3
2,3,24,740,1,596,3,5,1,1,4,single-choice,spatial-relational,1|4,7,1/4,240740,1
2,3,24,741,1,721,1,9,4,4,5,single-choice,spatial-relational,4|5,7,4/5,240741,4
2,3,24,742,1,814,2,6,2,2,4,single-choice,spatial-relational,2|4,7,2/4,240742,2
2,3,24,743,1,650,1,13,6,6,7,single-choice,spatial-relational,6|7,7,6/7,240743,6
2,3,24,744,1,758,3,9,3,3,6,single-choice,spatial-relational,3|6,7,3/6,240744,3
2,3,24,745,1,603,2,10,4,4,6,single-choice,spatial-relational,4|6,7,4/6,240745,4
2,3,24,746,1,674,3,9,3,3,6,single-choice,spatial-relational,3|6,7,3/6,240746,3
2,3,24,747,1,660,2,6,2,2,4,single-choice,spatial-relational,2|4,7,2/4,240747,2
2,3,24,748,1,562,3,11,4,4,7,single-choice,spatial-relational,4|7,7,4/7,240748,4
2,3,24,749,1,591,5,9,2,2,7,single-choice,spatial-relational,2|7,7,2/7,240749,2
2,3,24,750,0,1016,2,12,5,7,7,single-choice,spatial-relational,5|7,7,5/7,240750,5
2,3,24,751,1,38,1,7,3,3,4,single-choice,spatial-relational,3|4,7,3/4,240751,3
2,3,24,752,1,711,2,4,1,1,3,single-choice,spatial-relational,1|3,7,1/3,240752,1
2,3,24,753,0,680,1,11,5,6,6,single-choice,spatial-relational,5|6,7,5/6,240753,5
2,3,24,754,1,52,4,8,2,2,6,single-choice,spatial-relational,2|6,7,2/6,240754,2
2,3,24,755,1,897,3,11,4,4,7,single-choice,spatial-relational,4|7,7,4/7,240755,4
2,3,24,756,0,558,4,8,2,6,6,single-choice,spatial-relational,2|6,7,2/6,240756,2
2,3,24,757,1,770,1,9,4,4,5,single-choice,spatial-relational,4|5,7,4/5,240757,4
2,3,24,758,1,593,1,7,3,3,4,single-choice,spatial-relational,3|4,7,3/4,240758,3
2,3,24,759,0,633,1,5,2,3,3,single-choice,spatial-relational,2|3,7,2/3,240759,2
2,3,24,760,1,3342,5,7,1,1,6,single-choice,spatial-relational,1|6,7,1/6,240760,1
2,3,24,761,1,773,1,7,3,3,4,single-choice,spatial-relational,3|4,7,3/4,240761,3
2,3,24,762,1,626,2,6,2,2,4,single-choice,spatial-relational,2|4,7,2/4,240762,2
2,3,24,763,1,723,4,8,2,2,6,single-choice,spatial-relational,2|6,7,2/6,240763,2
2,3,24,764,0,756,4,6,1,5,5,single-choice,spatial-relational,1|5,7,1/5,240764,1
2,3,24,765,1,874,3,11,4,4,7,single-choice,spatial-relational,4|7,7,4/7,240765,4
2,3,24,766,1,658,1,5,2,2,3,single-choice,spatial-relational,2|3,7,2/3,240766,2
2,3,24,767,1,672,4,6,1,1,5,single-choice,spatial-relational,1|5,7,1/5,240767,1
2,3,24,768,1,669,3,11,4,4,7,single-choice,spatial-relational,4|7,7,4/7,240768,4
2,3,24,769,1,779,2,8,3,3,5,single-choice,spatial-relational,3|5,7,3/5,240769,3
2,3,24,770,1,795,2,6,2,2,4,single-choice,spatial-relational,2|4,7,2/4,240770,2
2,3,24,771,0,789,2,12,5,7,7,single-choice,spatial-relational,5|7,7,5/7,240771,5
2,3,24,772,1,650,1,9,4,4,5,single-choice,spatial-relational,4|5,7,4/5,240772,4
2,3,24,773,1,616,1,13,6,6,7,single-choice,spatial-relational,6|7,7,6/7,240773,6
2,3,24,774,1,5905,2,10,4,4,6,single-choice,spatial-relational,4|6,7,4/6,240774,4
2,3,24,775,1,699,3,9,3,3,6,single-choice,spatial-relational,3|6,7,3/6,240775,3
2,3,24,776,0,35,4,10,3,7,7,single-choice,spatial-relational,3|7,7,3/7,240776,3
2,3,24,777,0,62,4,8,2,6,6,single-choice,spatial-relational,2|6,7,2/6,240777,2
2,3,24,778,1,647,1,11,5,5,6,single-choice,spatial-relational,5|6,7,5/6,240778,5
2,3,24,779,0,587,1,5,2,3,3,single-choice,spatial-relational,2|3,7,2/3,240779,2
2,3,24,780,1,609,5,7,1,1,6,single-choice,spatial-relational,1|6,7,1/6,240780,1
2,3,24,781,1,550,1,13,6,6,7,single-choice,spatial-relational,6|7,7,6/7,240781,6
2,3,24,782,1,786,4,10,3,3,7,single-choice,spatial-relational,3|7,7,3/7,240782,3
3,3,24,1,1,674,1,13,6,6,7,single-choice,spatial-relational,6|7,7,6/7,240001,6
3,3,24,2,0,719,2,8,3,5,5,single-choice,spatial-relational,3|5,7,3/5,240002,3
3,3,24,3,1,458,2,8,3,3,5,single-choice,spatial-relational,3|5,7,3/5,240003,3
3,3,24,4,1,529,4,10,3,3,7,single-choice,spatial-relational,3|7,7,3/7,240004,3
3,3,24,5,1,575,6,8,1,1,7,single-choice,spatial-relational,1|7,7,1/7,240005,1
3,3,24,6,1,506,5,7,1,1,6,single-choice,spatial-relational,1|6,7,1/6,240006,1
3,3,24,7,1,530,2,12,5,5,7,single-choice,spatial-relational,5|7,7,5/7,240007,5
3,3,24,8,1,524,5,7,1,1,6,single-choice,spatial-relational,1|6,7,1/6,240008,1
3,3,24,9,0,537,1,11,5,6,6,single-choice,spatial-relational,5|6,7,5/6,240009,5
3,3,24,10,1,664,4,8,2,2,6,single-choice,spatial-relational,2|6,7,2/6,240010,2
3,3,24,11,1,669,3,5,1,1,4,single-choice,spatial-relational,1|4,7,1/4,240011,1
3,3,24,12,1,552,1,13,6,6,7,single-choice,spatial-relational,6|7,7,6/7,240012,6
3,3,24,13,0,585,2,10,4,6,6,single-choice,spatial-relational,4|6,7,4/6,240013,4
3,3,24,14,1,657,2,4,1,1,3,single-choice,spatial-relational,1|3,7,1/3,240014,1
3,3,24,15,1,620,2,12,5,5,7,single-choice,spatial-relational,5|7,7,5/7,240015,5
3,3,24,16,1,562,4,8,2,2,6,single-choice,spatial-relational,2|6,7,2/6,240016,2
3,3,24,17,1,514,1,5,2,2,3,single-choice,spatial-relational,2|3,7,2/3,240017,2
3,3,24,18,1,565,3,9,3,3,6,single-choice,spatial-relational,3|6,7,3/6,240018,3
3,3,24,19,1,505,1,7,3,3,4,single-choice,spatial-relational,3|4,7,3/4,240019,3
3,3,24,20,0,52,4,6,1,5,5,single-choice,spatial-relational,1|5,7,1/5,240020,1
3,3,24,21,1,566,1,9,4,4,5,single-choice,spatial-relational,4|5,7,4/5,240021,4
3,3,24,22,1,618,5,9,2,2,7,single-choice,spatial-relational,2|7,7,2/7,240022,2
3,3,24,23,1,539,5,9,2,2,7,single-choice,spatial-relational,2|7,7,2/7,240023,2
3,3,24,24,1,549,3,11,4,4,7,single-choice,spatial-relational,4|7,7,4/7,240024,4
3,3,24,25,1,593,2,6,2,2,4,single-choice,spatial-relational,2|4,7,2/4,240025,2
3,3,24,26,1,583,1,3,1,1,2,single-choice,spatial-relational,1|2,7,1/2,240026,1
3,3,24,27,1,509,3,9,3,3,6,single-choice,spatial-relational,3|6,7,3/6,240027,3
3,3,24,28,0,562,2,4,1,3,3,single-choice,spatial-relational,1|3,7,1/3,240028,1
3,3,24,29,1,577,1,5,2,2,3,single-choice,spatial-relational,2|3,7,2/3,240029,2
3,3,24,30,1,516,3,11,4,4,7,single-choice,spatial-relational,4|7,7,4/7,240030,4
3,3,24,31,0,481,1,11,5,6,6,single-choice,spatial-relational,5|6,7,5/6,240031,5
3,3,24,32,1,1180,4,10,3,3,7,single-choice,spatial-relational,3|7,7,3/7,240032,3
3,3,24,33,1,462,2,10,4,4,6,single-choice,spatial-relational,4|6,7,4/6,240033,4
3,3,24,34,0,737,3,7,2,5,5,single-choice,spatial-relational,2|5,7,2/5,240034,2
3,3,24,35,1,578,3,5,1,1,4,single-choice,spatial-relational,1|4,7,1/4,240035,1
3,3,24,36,1,503,6,8,1,1,7,single-choice,spatial-relational,1|7,7,1/7,240036,1
3,3,24,37,1,611,1,9,4,4,5,single-choice,spatial-relational,4|5,7,4/5,240037,4
3,3,24,38,0,674,2,6,2,4,4,single-choice,spatial-relational,2|4,7,2/4,240038,2
3,3,24,39,0,1072,1,3,1,2,2,single-choice,spatial-relational,1|2,7,1/2,240039,1
3,3,24,40,1,586,1,7,3,3,4,single-choice,spatial-relational,3|4,7,3/4,240040,3
3,3,24,41,1,577,4,6,1,1,5,single-choice,spatial-relational,1|5,7,1/5,240041,1
3,3,24,42,1,526,3,7,2,2,5,single-choice,spatial-relational,2|5,7,2/5,240042,2
3,3,24,43,1,632,5,9,2,2,7,single-choice,spatial-relational,2|7,7,2/7,240043,2
3,3,24,44,0,642,2,10,4,6,6,single-choice,spatial-relational,4|6,7,4/6,240044,4
3,3,24,45,1,461,4,10,3,3,7,single-choice,spatial-relational,3|7,7,3/7,240045,3
3,3,24,46,0,605,2,12,5,7,7,single-choice,spatial-relational,5|7,7,5/7,240046,5
3,3,24,47,1,557,2,10,4,4,6,single-choice,spatial-relational,4|6,7,4/6,240047,4
3,3,24,48,0,487,5,7,1,6,6,single-choice,spatial-relational,1|6,7,1/6,240048,1
3,3,24,49,1,572,4,8,2,2,6,single-choice,spatial-relational,2|6,7,2/6,240049,2
3,3,24,50,1,705,2,4,1,1,3,single-choice,spatial-relational,1|3,7,1/3,240050,1
3,3,24,51,1,537,4,10,3,3,7,single-choice,spatial-relational,3|7,7,3/7,240051,3
3,3,24,52,1,714,2,4,1,1,3,single-choice,spatial-relational,1|3,7,1/3,240052,1
3,3,24,53,0,706,2,8,3,5,5,single-choice,spatial-relational,3|5,7,3/5,240053,3
3,3,24,54,0,40,2,12,5,7,7,single-choice,spatial-relational,5|7,7,5/7,240054,5
3,3,24,55,1,555,6,8,1,1,7,single-choice,spatial-relational,1|7,7,1/7,240055,1
3,3,24,56,1,639,3,5,1,1,4,single-choice,spatial-relational,1|4,7,1/4,240056,1
3,3,24,57,1,581,4,6,1,1,5,single-choice,spatial-relational,1|5,7,1/5,240057,1
3,3,24,58,1,644,3,9,3,3,6,single-choice,spatial-relational,3|6,7,3/6,240058,3
3,3,24,59,1,615,1,5,2,2,3,single-choice,spatial-relational,2|3,7,2/3,240059,2
3,3,24,60,1,580,1,7,3,3,4,single-choice,spatial-relational,3|4,7,3/4,240060,3
3,3,24,61,1,582,2,6,2,2,4,single-choice,spatial-relational,2|4,7,2/4,240061,2
3,3,24,62,1,628,4,6,1,1,5,single-choice,spatial-relational,1|5,7,1/5,240062,1
3,3,24,63,1,584,1,3,1,1,2,single-choice,spatial-relational,1|2,7,1/2,240063,1
3,3,24,64,0,705,1,3,1,2,2,single-choice,spatial-relational,1|2,7,1/2,240064,1
3,3,24,65,0,976,1,9,4,5,5,single-choice,spatial-relational,4|5,7,4/5,240065,4
3,3,24,66,1,623,3,11,4,4,7,single-choice,spatial-relational,4|7,7,4/7,240066,4
3,3,24,67,1,642,3,11,4,4,7,single-choice,spatial-relational,4|7,7,4/7,240067,4
3,3,24,68,0,641,1,11,5,6,6,single-choice,spatial-relational,5|6,7,5/6,240068,5
3,3,24,69,0,1179,1,13,6,7,7,single-choice,spatial-relational,6|7,7,6/7,240069,6
3,3,24,70,1,473,6,8,1,1,7,single-choice,spatial-relational,1|7,7,1/7,240070,1
3,3,24,71,1,683,2,8,3,3,5,single-choice,spatial-relational,3|5,7,3/5,240071,3
3,3,24,72,1,740,1,7,3,3,4,single-choice,spatial-relational,3|4,7,3/4,240072,3
3,3,24,73,1,543,3,5,1,1,4,single-choice,spatial-relational,1|4,7,1/4,240073,1
3,3,24,74,1,594,2,6,2,2,4,single-choice,spatial-relational,2|4,7,2/4,240074,2
3,3,24,75,1,658,3,7,2,2,5,single-choice,spatial-relational,2|5,7,2/5,240075,2
3,3,24,76,1,657,1,13,6,6,7,single-choice,spatial-relational,6|7,7,6/7,240076,6
3,3,24,77,0,594,1,9,4,5,5,single-choice,spatial-relational,4|5,7,4/5,240077,4
3,3,24,78,1,544,4,8,2,2,6,single-choice,spatial-relational,2|6,7,2/6,240078,2
3,3,24,79,1,772,5,9,2,2,7,single-choice,spatial-relational,2|7,7,2/7,240079,2
3,3,24,80,1,767,3,7,2,2,5,single-choice,spatial-relational,2|5,7,2/5,240080,2
3,3,24,81,0,706,1,5,2,3,3,single-choice,spatial-relational,2|3,7,2/3,240081,2
3,3,24,82,1,535,1,11,5,5,6,single-choice,spatial-relational,5|6,7,5/6,240082,5
3,3,24,83,1,627,3,9,3,3,6,single-choice,spatial-relational,3|6,7,3/6,240083,3
3,3,24,84,1,616,5,7,1,1,6,single-choice,spatial-relational,1|6,7,1/6,240084,1
3,3,24,85,1,544,1,5,2,2,3,single-choice,spatial-relational,2|3,7,2/3,240085,2
3,3,24,86,0,610,1,3,1,2,2,single-choice,spatial-relational,1|2,7,1/2,240086,1
3,3,24,87,1,546,5,7,1,1,6,single-choice,spatial-relational,1|6,7,1/6,240087,1
3,3,24,88,1,588,5,7,1,1,6,single-choice,spatial-relational,1|6,7,1/6,240088,1
3,3,24,89,1,690,1,13,6,6,7,single-choice,spatial-relational,6|7,7,6/7,240089,6
3,3,24,90,1,601,2,12,5,5,7,single-choice,spatial-relational,5|7,7,5/7,240090,5
3,3,24,91,1,572,1,7,3,3,4,single-choice,spatial-relational,3|4,7,3/4,240091,3
3,3,24,92,1,664,3,7,2,2,5,single-choice,spatial-relational,2|5,7,2/5,240092,2
3,3,24,93,1,717,3,9,3,3,6,single-choice,spatial-relational,3|6,7,3/6,240093,3
3,3,24,94,1,680,1,5,2,2,3,single-choice,spatial-relational,2|3,7,2/3,240094,2
3,3,24,95,0,663,1,9,4,5,5,single-choice,spatial-relational,4|5,7,4/5,240095,4
3,3,24,96,0,652,1,11,5,6,6,single-choice,spatial-relational,5|6,7,5/6,240096,5
3,3,24,97,1,675,6,8,1,1,7,single-choice,spatial-relational,1|7,7,1/7,240097,1
3,3,24,98,1,690,2,12,5,5,7,single-choice,spatial-relational,5|7,7,5/7,240098,5
3,3,24,99,1,769,1,7,3,3,4,single-choice,spatial-relational,3|4,7,3/4,240099,3
3,3,24,100,1,591,3,5,1,1,4,single-choice,spatial-relational,1|4,7,1/4,240100,1
3,3,24,101,1,631,3,11,4,4,7,single-choice,spatial-relational,4|7,7,4/7,240101,4
3,3,24,102,1,582,3,9,3,3,6,single-choice,spatial-relational,3|6,7,3/6,240102,3
3,3,24,103,1,773,6,8,1,1,7,single-choice,spatial-relational,1|7,7,1/7,240103,1
3,3,24,104,1,695,5,9,2,2,7,single-choice,spatial-relational,2|7,7,2/7,240104,2
3,3,24,105,1,603,2,10,4,4,6,single-choice,spatial-relational,4|6,7,4/6,240105,4
3,3,24,106,1,620,1,13,6,6,7,single-choice,spatial-relational,6|7,7,6/7,240106,6
3,3,24,107,1,697,1,3,1,1,2,single-choice,spatial-relational,1|2,7,1/2,240107,1
3,3,24,108,1,653,2,8,3,3,5,single-choice,spatial-relational,3|5,7,3/5,240108,3
3,3,24,109,1,689,3,5,1,1,4,single-choice,spatial-relational,1|4,7,1/4,240109,1
3,3,24,110,1,561,4,10,3,3,7,single-choice,spatial-relational,3|7,7,3/7,240110,3
3,3,24,111,1,618,2,4,1,1,3,single-choice,spatial-relational,1|3,7,1/3,240111,1
3,3,24,112,1,573,4,6,1,1,5,single-choice,spatial-relational,1|5,7,1/5,240112,1
3,3,24,113,1,608,3,11,4,4,7,single-choice,spatial-relational,4|7,7,4/7,240113,4
3,3,24,114,1,707,2,8,3,3,5,single-choice,spatial-relational,3|5,7,3/5,240114,3
3,3,24,115,0,590,2,10,4,6,6,single-choice,spatial-relational,4|6,7,4/6,240115,4
3,3,24,116,1,647,2,6,2,2,4,single-choice,spatial-relational,2|4,7,2/4,240116,2
3,3,24,117,1,561,4,6,1,1,5,single-choice,spatial-relational,1|5,7,1/5,240117,1
3,3,24,118,1,595,1,11,5,5,6,single-choice,spatial-relational,5|6,7,5/6,240118,5
3,3,24,119,1,573,4,8,2,2,6,single-choice,spatial-relational,2|6,7,2/6,240119,2
3,3,24,120,1,552,5,9,2,2,7,single-choice,spatial-relational,2|7,7,2/7,240120,2
3,3,24,121,1,693,2,4,1,1,3,single-choice,spatial-relational,1|3,7,1/3,240121,1
3,3,24,122,1,673,1,9,4,4,5,single-choice,spatial-relational,4|5,7,4/5,240122,4
3,3,24,123,1,607,4,8,2,2,6,single-choice,spatial-relational,2|6,7,2/6,240123,2
3,3,24,124,1,643,2,6,2,2,4,single-choice,spatial-relational,2|4,7,2/4,240124,2
3,3,24,125,1,647,3,7,2,2,5,single-choice,spatial-relational,2|5,7,2/5,240125,2
3,3,24,126,1,708,4,10,3,3,7,single-choice,spatial-relational,3|7,7,3/7,240126,3
3,3,24,127,1,546,5,9,2,2,7,single-choice,spatial-relational,2|7,7,2/7,240127,2
3,3,24,128,1,606,2,8,3,3,5,single-choice,spatial-relational,3|5,7,3/5,240128,3
3,3,24,129,1,602,1,7,3,3,4,single-choice,spatial-relational,3|4,7,3/4,240129,3
3,3,24,130,1,516,4,10,3,3,7,single-choice,spatial-relational,3|7,7,3/7,240130,3
3,3,24,131,1,622,5,7,1,1,6,single-choice,spatial-relational,1|6,7,1/6,240131,1
3,3,24,132,0,563,4,8,2,6,6,single-choice,spatial-relational,2|6,7,2/6,240132,2
3,3,24,133,1,1383,3,9,3,3,6,single-choice,spatial-relational,3|6,7,3/6,240133,3
3,3,24,134,1,654,4,6,1,1,5,single-choice,spatial-relational,1|5,7,1/5,240134,1
3,3,24,135,1,663,3,5,1,1,4,single-choice,spatial-relational,1|4,7,1/4,240135,1
3,3,24,136,1,610,2,10,4,4,6,single-choice,spatial-relational,4|6,7,4/6,240136,4
3,3,24,137,1,590,4,6,1,1,5,single-choice,spatial-relational,1|5,7,1/5,240137,1
3,3,24,138,1,583,4,10,3,3,7,single-choice,spatial-relational,3|7,7,3/7,240138,3
3,3,24,139,1,520,5,9,2,2,7,single-choice,spatial-relational,2|7,7,2/7,240139,2
3,3,24,140,1,646,3,9,3,3,6,single-choice,spatial-relational,3|6,7,3/6,240140,3
3,3,24,141,1,700,2,6,2,2,4,single-choice,spatial-relational,2|4,7,2/4,240141,2
3,3,24,142,1,605,1,13,6,6,7,single-choice,spatial-relational,6|7,7,6/7,240142,6
3,3,24,143,1,667,2,4,1,1,3,single-choice,spatial-relational,1|3,7,1/3,240143,1
3,3,24,144,1,662,2,6,2,2,4,single-choice,spatial-relational,2|4,7,2/4,240144,2
3,3,24,145,1,660,3,5,1,1,4,single-choice,spatial-relational,1|4,7,1/4,240145,1
3,3,24,146,0,653,1,11,5,6,6,single-choice,spatial-relational,5|6,7,5/6,240146,5
3,3,24,147,0,673,1,3,1,2,2,single-choice,spatial-relational,1|2,7,1/2,240147,1
3,3,24,148,1,533,3,7,2,2,5,single-choice,spatial-relational,2|5,7,2/5,240148,2
3,3,24,149,1,566,1,11,5,5,6,single-choice,spatial-relational,5|6,7,5/6,240149,5
3,3,24,150,1,650,2,10,4,4,6,single-choice,spatial-relational,4|6,7,4/6,240150,4
3,3,24,151,1,636,2,12,5,5,7,single-choice,spatial-relational,5|7,7,5/7,240151,5
3,3,24,152,1,730,1,9,4,4,5,single-choice,spatial-relational,4|5,7,4/5,240152,4
3,3,24,153,1,595,6,8,1,1,7,single-choice,spatial-relational,1|7,7,1/7,240153,1
3,3,24,154,1,684,2,8,3,3,5,single-choice,spatial-relational,3|5,7,3/5,240154,3
3,3,24,155,1,628,1,7,3,3,4,single-choice,spatial-relational,3|4,7,3/4,240155,3
3,3,24,156,0,1138,4,8,2,6,6,single-choice,spatial-relational,2|6,7,2/6,240156,2
3,3,24,157,1,756,3,11,4,4,7,single-choice,spatial-relational,4|7,7,4/7,240157,4
3,3,24,158,0,595,1,3,1,2,2,single-choice,spatial-relational,1|2,7,1/2,240158,1
3,3,24,159,1,609,6,8,1,1,7,single-choice,spatial-relational,1|7,7,1/7,240159,1
3,3,24,160,1,646,1,5,2,2,3,single-choice,spatial-relational,2|3,7,2/3,240160,2
3,3,24,161,1,1164,1,13,6,6,7,single-choice,spatial-relational,6|7,7,6/7,240161,6
3,3,24,162,0,1233,2,12,5,7,7,single-choice,spatial-relational,5|7,7,5/7,240162,5
3,3,24,163,0,558,1,9,4,5,5,single-choice,spatial-relational,4|5,7,4/5,240163,4
3,3,24,164,1,666,2,4,1,1,3,single-choice,spatial-relational,1|3,7,1/3,240164,1
3,3,24,165,1,576,1,5,2,2,3,single-choice,spatial-relational,2|3,7,2/3,240165,2
3,3,24,166,1,661,3,11,4,4,7,single-choice,spatial-relational,4|7,7,4/7,240166,4
3,3,24,167,1,646,3,7,2,2,5,single-choice,spatial-relational,2|5,7,2/5,240167,2
3,3,24,168,1,578,5,7,1,1,6,single-choice,spatial-relational,1|6,7,1/6,240168,1
3,3,24,169,1,579,1,7,3,3,4,single-choice,spatial-relational,3|4,7,3/4,240169,3
3,3,24,170,1,649,2,10,4,4,6,single-choice,spatial-relational,4|6,7,4/6,240170,4
3,3,24,171,1,672,3,5,1,1,4,single-choice,spatial-relational,1|4,7,1/4,240171,1
3,3,24,172,1,591,1,13,6,6,7,single-choice,spatial-relational,6|7,7,6/7,240172,6
3,3,24,173,1,623,2,10,4,4,6,single-choice,spatial-relational,4|6,7,4/6,240173,4
3,3,24,174,1,642,1,3,1,1,2,single-choice,spatial-relational,1|2,7,1/2,240174,1
3,3,24,175,1,563,5,7,1,1,6,single-choice,spatial-relational,1|6,7,1/6,240175,1
3,3,24,176,1,774,2,6,2,2,4,single-choice,spatial-relational,2|4,7,2/4,240176,2
3,3,24,177,1,618,3,5,1,1,4,single-choice,spatial-relational,1|4,7,1/4,240177,1
3,3,24,178,1,683,4,10,3,3,7,single-choice,spatial-relational,3|7,7,3/7,240178,3
3,3,24,179,1,762,2,12,5,5,7,single-choice,spatial-relational,5|7,7,5/7,240179,5
3,3,24,180,1,632,1,9,4,4,5,single-choice,spatial-relational,4|5,7,4/5,240180,4
3,3,24,181,1,569,2,8,3,3,5,single-choice,spatial-relational,3|5,7,3/5,240181,3
3,3,24,182,1,662,5,9,2,2,7,single-choice,spatial-relational,2|7,7,2/7,240182,2
3,3,24,183,1,652,4,6,1,1,5,single-choice,spatial-relational,1|5,7,1/5,240183,1
3,3,24,184,1,604,4,6,1,1,5,single-choice,spatial-relational,1|5,7,1/5,240184,1
3,3,24,185,1,582,1,11,5,5,6,single-choice,spatial-relational,5|6,7,5/6,240185,5
3,3,24,186,0,799,1,13,6,7,7,single-choice,spatial-relational,6|7,7,6/7,240186,6
3,3,24,187,1,683,6,8,1,1,7,single-choice,spatial-relational,1|7,7,1/7,240187,1
3,3,24,188,1,570,3,9,3,3,6,single-choice,spatial-relational,3|6,7,3/6,240188,3
3,3,24,189,1,712,1,7,3,3,4,single-choice,spatial-relational,3|4,7,3/4,240189,3
3,3,24,190,0,725,3,11,4,7,7,single-choice,spatial-relational,4|7,7,4/7,240190,4
3,3,24,191,1,491,5,9,2,2,7,single-choice,spatial-relational,2|7,7,2/7,240191,2
3,3,24,192,1,557,4,10,3,3,7,single-choice,spatial-relational,3|7,7,3/7,240192,3
3,3,24,193,1,652,3,9,3,3,6,single-choice,spatial-relational,3|6,7,3/6,240193,3
3,3,24,194,1,603,5,7,1,1,6,single-choice,spatial-relational,1|6,7,1/6,240194,1
3,3,24,195,1,601,2,8,3,3,5,single-choice,spatial-relational,3|5,7,3/5,240195,3
3,3,24,196,1,590,6,8,1,1,7,single-choice,spatial-relational,1|7,7,1/7,240196,1
3,3,24,197,1,647,1,3,1,1,2,single-choice,spatial-relational,1|2,7,1/2,240197,1
3,3,24,198,0,627,2,4,1,3,3,single-choice,spatial-relational,1|3,7,1/3,240198,1
3,3,24,199,1,617,1,5,2,2,3,single-choice,spatial-relational,2|3,7,2/3,240199,2
3,3,24,200,1,533,2,4,1,1,3,single-choice,spatial-relational,1|3,7,1/3,240200,1
3,3,24,201,0,745,1,11,5,6,6,single-choice,spatial-relational,5|6,7,5/6,240201,5
3,3,24,202,1,583,4,8,2,2,6,single-choice,spatial-relational,2|6,7,2/6,240202,2
3,3,24,203,0,580,1,9,4,5,5,single-choice,spatial-relational,4|5,7,4/5,240203,4
3,3,24,204,1,583,3,7,2,2,5,single-choice,spatial-relational,2|5,7,2/5,240204,2
3,3,24,205,1,560,4,8,2,2,6,single-choice,spatial-relational,2|6,7,2/6,240205,2
3,3,24,206,1,623,3,11,4,4,7,single-choice,spatial-relational,4|7,7,4/7,240206,4
3,3,24,207,1,622,3,7,2,2,5,single-choice,spatial-relational,2|5,7,2/5,240207,2
3,3,24,208,1,962,1,5,2,2,3,single-choice,spatial-relational,2|3,7,2/3,240208,2
3,3,24,209,1,636,2,6,2,2,4,single-choice,spatial-relational,2|4,7,2/4,240209,2
3,3,24,210,1,629,2,12,5,5,7,single-choice,spatial-relational,5|7,7,5/7,240210,5
3,3,24,211,1,641,2,6,2,2,4,single-choice,spatial-relational,2|4,7,2/4,240211,2
3,3,24,212,1,704,5,9,2,2,7,single-choice,spatial-relational,2|7,7,2/7,240212,2
3,3,24,213,1,877,2,12,5,5,7,single-choice,spatial-relational,5|7,7,5/7,240213,5
3,3,24,214,1,599,3,9,3,3,6,single-choice,spatial-relational,3|6,7,3/6,240214,3
3,3,24,215,1,615,1,7,3,3,4,single-choice,spatial-relational,3|4,7,3/4,240215,3
3,3,24,216,1,619,2,12,5,5,7,single-choice,spatial-relational,5|7,7,5/7,240216,5
3,3,24,217,1,584,2,8,3,3,5,single-choice,spatial-relational,3|5,7,3/5,240217,3
3,3,24,218,1,724,2,8,3,3,5,single-choice,spatial-relational,3|5,7,3/5,240218,3
3,3,24,219,1,744,4,8,2,2,6,single-choice,spatial-relational,2|6,7,2/6,240219,2
3,3,24,220,0,759,1,13,6,7,7,single-choice,spatial-relational,6|7,7,6/7,240220,6
3,3,24,221,0,587,1,5,2,3,3,single-choice,spatial-relational,2|3,7,2/3,240221,2
3,3,24,222,1,568,2,6,2,2,4,single-choice,spatial-relational,2|4,7,2/4,240222,2
3,3,24,223,1,650,3,5,1,1,4,single-choice,spatial-relational,1|4,7,1/4,240223,1
3,3,24,224,0,658,1,5,2,3,3,single-choice,spatial-relational,2|3,7,2/3,240224,2
3,3,24,225,1,562,5,7,1,1,6,single-choice,spatial-relational,1|6,7,1/6,240225,1
3,3,24,226,1,655,3,7,2,2,5,single-choice,spatial-relational,2|5,7,2/5,240226,2
3,3,24,227,1,694,2,4,1,1,3,single-choice,spatial-relational,1|3,7,1/3,240227,1
3,3,24,228,1,662,2,10,4,4,6,single-choice,spatial-relational,4|6,7,4/6,240228,4
3,3,24,229,1,773,1,13,6,6,7,single-choice,spatial-relational,6|7,7,6/7,240229,6
3,3,24,230,1,640,6,8,1,1,7,single-choice,spatial-relational,1|7,7,1/7,240230,1
3,3,24,231,1,704,4,10,3,3,7,single-choice,spatial-relational,3|7,7,3/7,240231,3
3,3,24,232,1,582,1,3,1,1,2,single-choice,spatial-relational,1|2,7,1/2,240232,1
3,3,24,233,1,589,4,10,3,3,7,single-choice,spatial-relational,3|7,7,3/7,240233,3
3,3,24,234,1,649,4,8,2,2,6,single-choice,spatial-relational,2|6,7,2/6,240234,2
3,3,24,235,1,680,6,8,1,1,7,single-choice,spatial-relational,1|7,7,1/7,240235,1
3,3,24,236,1,593,3,11,4,4,7,single-choice,spatial-relational,4|7,7,4/7,240236,4
3,3,24,237,1,629,4,6,1,1,5,single-choice,spatial-relational,1|5,7,1/5,240237,1
3,3,24,238,1,639,3,7,2,2,5,single-choice,spatial-relational,2|5,7,2/5,240238,2
3,3,24,239,1,622,5,7,1,1,6,single-choice,spatial-relational,1|6,7,1/6,240239,1
3,3,24,240,0,580,1,9,4,5,5,single-choice,spatial-relational,4|5,7,4/5,240240,4
3,3,24,241,1,615,2,4,1,1,3,single-choice,spatial-relational,1|3,7,1/3,240241,1
3,3,24,242,1,646,2,10,4,4,6,single-choice,spatial-relational,4|6,7,4/6,240242,4
3,3,24,243,1,585,3,5,1,1,4,single-choice,spatial-relational,1|4,7,1/4,240243,1
3,3,24,244,1,626,3,11,4,4,7,single-choice,spatial-relational,4|7,7,4/7,240244,4
3,3,24,245,1,553,1,7,3,3,4,single-choice,spatial-relational,3|4,7,3/4,240245,3
3,3,24,246,0,662,1,11,5,6,6,single-choice,spatial-relational,5|6,7,5/6,240246,5
3,3,24,247,1,1722,1,3,1,1,2,single-choice,spatial-relational,1|2,7,1/2,240247,1
3,3,24,248,1,552,4,6,1,1,5,single-choice,spatial-relational,1|5,7,1/5,240248,1
3,3,24,249,1,644,3,9,3,3,6,single-choice,spatial-relational,3|6,7,3/6,240249,3
3,3,24,250,1,580,1,11,5,5,6,single-choice,spatial-relational,5|6,7,5/6,240250,5
3,3,24,251,1,635,5,9,2,2,7,single-choice,spatial-relational,2|7,7,2/7,240251,2
3,3,24,252,1,695,1,9,4,4,5,single-choice,spatial-relational,4|5,7,4/5,240252,4
3,3,24,253,1,592,3,11,4,4,7,single-choice,spatial-relational,4|7,7,4/7,240253,4
3,3,24,254,1,667,1,7,3,3,4,single-choice,spatial-relational,3|4,7,3/4,240254,3
3,3,24,255,1,614,1,13,6,6,7,single-choice,spatial-relational,6|7,7,6/7,240255,6
3,3,24,256,0,632,1,5,2,3,3,single-choice,spatial-relational,2|3,7,2/3,240256,2
3,3,24,257,1,560,1,7,3,3,4,single-choice,spatial-relational,3|4,7,3/4,240257,3
3,3,24,258,1,571,5,9,2,2,7,single-choice,spatial-relational,2|7,7,2/7,240258,2
3,3,24,259,1,581,2,4,1,1,3,single-choice,spatial-relational,1|3,7,1/3,240259,1
3,3,24,260,1,596,2,12,5,5,7,single-choice,spatial-relational,5|7,7,5/7,240260,5
3,3,24,261,1,597,2,6,2,2,4,single-choice,spatial-relational,2|4,7,2/4,240261,2
3,3,24,262,1,589,1,13,6,6,7,single-choice,spatial-relational,6|7,7,6/7,240262,6
3,3,24,263,1,879,2,8,3,3,5,single-choice,spatial-relational,3|5,7,3/5,240263,3
3,3,24,264,1,633,1,11,5,5,6,single-choice,spatial-relational,5|6,7,5/6,240264,5
3,3,24,265,1,613,3,9,3,3,6,single-choice,spatial-relational,3|6,7,3/6,240265,3
3,3,24,266,1,583,1,3,1,1,2,single-choice,spatial-relational,1|2,7,1/2,240266,1
3,3,24,267,1,665,2,12,5,5,7,single-choice,spatial-relational,5|7,7,5/7,240267,5
3,3,24,268,1,722,1,11,5,5,6,single-choice,spatial-relational,5|6,7,5/6,240268,5
3,3,24,269,1,544,4,6,1,1,5,single-choice,spatial-relational,1|5,7,1/5,240269,1
3,3,24,270,1,571,4,10,3,3,7,single-choice,spatial-relational,3|7,7,3/7,240270,3
3,3,24,271,1,636,4,6,1,1,5,single-choice,spatial-relational,1|5,7,1/5,240271,1
3,3,24,272,1,649,6,8,1,1,7,single-choice,spatial-relational,1|7,7,1/7,240272,1
3,3,24,273,1,575,3,7,2,2,5,single-choice,spatial-relational,2|5,7,2/5,240273,2
3,3,24,274,1,651,2,10,4,4,6,single-choice,spatial-relational,4|6,7,4/6,240274,4
3,3,24,275,1,651,1,9,4,4,5,single-choice,spatial-relational,4|5,7,4/5,240275,4
3,3,24,276,1,662,4,8,2,2,6,single-choice,spatial-relational,2|6,7,2/6,240276,2
3,3,24,277,0,572,1,3,1,2,2,single-choice,spatial-relational,1|2,7,1/2,240277,1
3,3,24,278,0,662,1,5,2,3,3,single-choice,spatial-relational,2|3,7,2/3,240278,2
3,3,24,279,1,621,4,10,3,3,7,single-choice,spatial-relational,3|7,7,3/7,240279,3
3,3,24,280,1,593,3,11,4,4,7,single-choice,spatial-relational,4|7,7,4/7,240280,4
3,3,24,281,0,635,1,9,4,5,5,single-choice,spatial-relational,4|5,7,4/5,240281,4
3,3,24,282,1,648,4,8,2,2,6,single-choice,spatial-relational,2|6,7,2/6,240282,2
3,3,24,283,0,590,3,5,1,4,4,single-choice,spatial-relational,1|4,7,1/4,240283,1
3,3,24,284,1,649,5,7,1,1,6,single-choice,spatial-relational,1|6,7,1/6,240284,1
3,3,24,285,1,743,6,8,1,1,7,single-choice,spatial-relational,1|7,7,1/7,240285,1
3,3,24,286,1,678,2,8,3,3,5,single-choice,spatial-relational,3|5,7,3/5,240286,3
3,3,24,287,1,627,2,6,2,2,4,single-choice,spatial-relational,2|4,7,2/4,240287,2
3,3,24,288,1,655,3,7,2,2,5,single-choice,spatial-relational,2|5,7,2/5,240288,2
3,3,24,289,1,652,3,9,3,3,6,single-choice,spatial-relational,3|6,7,3/6,240289,3
3,3,24,290,1,601,5,9,2,2,7,single-choice,spatial-relational,2|7,7,2/7,240290,2
3,3,24,291,1,649,2,4,1,1,3,single-choice,spatial-relational,1|3,7,1/3,240291,1
3,3,24,292,1,658,3,5,1,1,4,single-choice,spatial-relational,1|4,7,1/4,240292,1
3,3,24,293,1,552,5,7,1,1,6,single-choice,spatial-relational,1|6,7,1/6,240293,1
3,3,24,294,1,594,2,10,4,4,6,single-choice,spatial-relational,4|6,7,4/6,240294,4
3,3,24,295,1,693,3,7,2,2,5,single-choice,spatial-relational,2|5,7,2/5,240295,2
3,3,24,296,1,602,6,8,1,1,7,single-choice,spatial-relational,1|7,7,1/7,240296,1
3,3,24,297,1,551,5,7,1,1,6,single-choice,spatial-relational,1|6,7,1/6,240297,1
3,3,24,298,1,644,2,12,5,5,7,single-choice,spatial-relational,5|7,7,5/7,240298,5
3,3,24,299,1,603,4,6,1,1,5,single-choice,spatial-relational,1|5,7,1/5,240299,1
3,3,24,300,1,705,1,13,6,6,7,single-choice,spatial-relational,6|7,7,6/7,240300,6
3,3,24,301,1,709,1,7,3,3,4,single-choice,spatial-relational,3|4,7,3/4,240301,3
3,3,24,302,0,701,2,6,2,4,4,single-choice,spatial-relational,2|4,7,2/4,240302,2
3,3,24,303,1,548,2,6,2,2,4,single-choice,spatial-relational,2|4,7,2/4,240303,2
3,3,24,304,1,610,3,11,4,4,7,single-choice,spatial-relational,4|7,7,4/7,240304,4
3,3,24,305,1,632,6,8,1,1,7,single-choice,spatial-relational,1|7,7,1/7,240305,1
3,3,24,306,1,828,3,5,1,1,4,single-choice,spatial-relational,1|4,7,1/4,240306,1
3,3,24,307,1,760,5,9,2,2,7,single-choice,spatial-relational,2|7,7,2/7,240307,2
3,3,24,308,1,603,5,9,2,2,7,single-choice,spatial-relational,2|7,7,2/7,240308,2
3,3,24,309,1,602,5,7,1,1,6,single-choice,spatial-relational,1|6,7,1/6,240309,1
3,3,24,310,1,659,1,9,4,4,5,single-choice,spatial-relational,4|5,7,4/5,240310,4
3,3,24,311,1,614,2,8,3,3,5,single-choice,spatial-relational,3|5,7,3/5,240311,3
3,3,24,312,1,565,3,5,1,1,4,single-choice,spatial-relational,1|4,7,1/4,240312,1
3,3,24,313,1,623,2,8,3,3,5,single-choice,spatial-relational,3|5,7,3/5,240313,3
3,3,24,314,1,623,4,6,1,1,5,single-choice,spatial-relational,1|5,7,1/5,240314,1
3,3,24,315,1,622,3,7,2,2,5,single-choice,spatial-relational,2|5,7,2/5,240315,2
3,3,24,316,0,707,2,4,1,3,3,single-choice,spatial-relational,1|3,7,1/3,240316,1
3,3,24,317,1,796,3,11,4,4,7,single-choice,spatial-relational,4|7,7,4/7,240317,4
3,3,24,318,1,709,2,12,5,5,7,single-choice,spatial-relational,5|7,7,5/7,240318,5
3,3,24,319,0,604,1,3,1,2,2,single-choice,spatial-relational,1|2,7,1/2,240319,1
3,3,24,320,1,618,3,9,3,3,6,single-choice,spatial-relational,3|6,7,3/6,240320,3
3,3,24,321,1,573,1,11,5,5,6,single-choice,spatial-relational,5|6,7,5/6,240321,5
3,3,24,322,1,627,4,10,3,3,7,single-choice,spatial-relational,3|7,7,3/7,240322,3
3,3,24,323,1,621,2,4,1,1,3,single-choice,spatial-relational,1|3,7,1/3,240323,1
3,3,24,324,1,623,1,9,4,4,5,single-choice,spatial-relational,4|5,7,4/5,240324,4
3,3,24,325,1,663,4,8,2,2,6,single-choice,spatial-relational,2|6,7,2/6,240325,2
3,3,24,326,1,629,2,10,4,4,6,single-choice,spatial-relational,4|6,7,4/6,240326,4
3,3,24,327,1,624,1,3,1,1,2,single-choice,spatial-relational,1|2,7,1/2,240327,1
3,3,24,328,0,611,1,5,2,3,3,single-choice,spatial-relational,2|3,7,2/3,240328,2
3,3,24,329,1,569,4,8,2,2,6,single-choice,spatial-relational,2|6,7,2/6,240329,2
3,3,24,330,0,795,1,11,5,6,6,single-choice,spatial-relational,5|6,7,5/6,240330,5
3,3,24,331,0,619,1,7,3,4,4,single-choice,spatial-relational,3|4,7,3/4,240331,3
3,3,24,332,1,519,1,5,2,2,3,single-choice,spatial-relational,2|3,7,2/3,240332,2
3,3,24,333,1,573,4,10,3,3,7,single-choice,spatial-relational,3|7,7,3/7,240333,3
3,3,24,334,0,68,3,9,3,6,6,single-choice,spatial-relational,3|6,7,3/6,240334,3
3,3,24,335,1,626,1,13,6,6,7,single-choice,spatial-relational,6|7,7,6/7,240335,6
3,3,24,336,0,615,2,10,4,6,6,single-choice,spatial-relational,4|6,7,4/6,240336,4
3,3,24,337,1,608,5,7,1,1,6,single-choice,spatial-relational,1|6,7,1/6,240337,1
3,3,24,338,1,682,2,4,1,1,3,single-choice,spatial-relational,1|3,7,1/3,240338,1
3,3,24,339,1,612,6,8,1,1,7,single-choice,spatial-relational,1|7,7,1/7,240339,1
3,3,24,340,1,607,2,6,2,2,4,single-choice,spatial-relational,2|4,7,2/4,240340,2
3,3,24,341,1,799,2,4,1,1,3,single-choice,spatial-relational,1|3,7,1/3,240341,1
3,3,24,342,0,614,1,11,5,6,6,single-choice,spatial-relational,5|6,7,5/6,240342,5
3,3,24,343,0,701,1,13,6,7,7,single-choice,spatial-relational,6|7,7,6/7,240343,6
3,3,24,344,1,970,1,9,4,4,5,single-choice,spatial-relational,4|5,7,4/5,240344,4
3,3,24,345,1,571,3,11,4,4,7,single-choice,spatial-relational,4|7,7,4/7,240345,4
3,3,24,346,1,645,3,7,2,2,5,single-choice,spatial-relational,2|5,7,2/5,240346,2
3,3,24,347,1,549,1,3,1,1,2,single-choice,spatial-relational,1|2,7,1/2,240347,1
3,3,24,348,1,610,1,5,2,2,3,single-choice,spatial-relational,2|3,7,2/3,240348,2
3,3,24,349,1,714,5,9,2,2,7,single-choice,spatial-relational,2|7,7,2/7,240349,2
3,3,24,350,0,711,2,6,2,4,4,single-choice,spatial-relational,2|4,7,2/4,240350,2
3,3,24,351,0,1350,4,8,2,6,6,single-choice,spatial-relational,2|6,7,2/6,240351,2
3,3,24,352,1,533,4,6,1,1,5,single-choice,spatial-relational,1|5,7,1/5,240352,1
3,3,24,353,1,557,3,9,3,3,6,single-choice,spatial-relational,3|6,7,3/6,240353,3
3,3,24,354,1,635,3,9,3,3,6,single-choice,spatial-relational,3|6,7,3/6,240354,3
3,3,24,355,1,672,3,7,2,2,5,single-choice,spatial-relational,2|5,7,2/5,240355,2
3,3,24,356,1,624,4,6,1,1,5,single-choice,spatial-relational,1|5,7,1/5,240356,1
3,3,24,357,1,603,1,13,6,6,7,single-choice,spatial-relational,6|7,7,6/7,240357,6
3,3,24,358,1,594,2,12,5,5,7,single-choice,spatial-relational,5|7,7,5/7,240358,5
3,3,24,359,1,588,1,5,2,2,3,single-choice,spatial-relational,2|3,7,2/3,240359,2
3,3,24,360,1,698,4,8,2,2,6,single-choice,spatial-relational,2|6,7,2/6,240360,2
3,3,24,361,1,645,5,9,2,2,7,single-choice,spatial-relational,2|7,7,2/7,240361,2
3,3,24,362,1,610,3,5,1,1,4,single-choice,spatial-relational,1|4,7,1/4,240362,1
3,3,24,363,1,554,1,7,3,3,4,single-choice,spatial-relational,3|4,7,3/4,240363,3
3,3,24,364,1,572,4,10,3,3,7,single-choice,spatial-relational,3|7,7,3/7,240364,3
3,3,24,365,0,718,1,7,3,4,4,single-choice,spatial-relational,3|4,7,3/4,240365,3
3,3,24,366,1,539,5,7,1,1,6,single-choice,spatial-relational,1|6,7,1/6,240366,1
3,3,24,367,0,552,1,3,1,2,2,single-choice,spatial-relational,1|2,7,1/2,240367,1
3,3,24,368,1,690,2,12,5,5,7,single-choice,spatial-relational,5|7,7,5/7,240368,5
3,3,24,369,1,623,1,9,4,4,5,single-choice,spatial-relational,4|5,7,4/5,240369,4
3,3,24,370,1,635,3,5,1,1,4,single-choice,spatial-relational,1|4,7,1/4,240370,1
3,3,24,371,1,607,3,11,4,4,7,single-choice,spatial-relational,4|7,7,4/7,240371,4
3,3,24,372,1,601,2,10,4,4,6,single-choice,spatial-relational,4|6,7,4/6,240372,4
3,3,24,373,1,706,2,8,3,3,5,single-choice,spatial-relational,3|5,7,3/5,240373,3
3,3,24,374,1,636,2,10,4,4,6,single-choice,spatial-relational,4|6,7,4/6,240374,4
3,3,24,375,1,622,1,11,5,5,6,single-choice,spatial-relational,5|6,7,5/6,240375,5
3,3,24,376,1,637,6,8,1,1,7,single-choice,spatial-relational,1|7,7,1/7,240376,1
3,3,24,377,1,655,2,8,3,3,5,single-choice,spatial-relational,3|5,7,3/5,240377,3
3,3,24,378,1,562,4,10,3,3,7,single-choice,spatial-relational,3|7,7,3/7,240378,3
3,3,24,379,1,884,4,6,1,1,5,single-choice,spatial-relational,1|5,7,1/5,240379,1
3,3,24,380,1,611,4,8,2,2,6,single-choice,spatial-relational,2|6,7,2/6,240380,2
3,3,24,381,1,744,3,7,2,2,5,single-choice,spatial-relational,2|5,7,2/5,240381,2
3,3,24,382,0,587,1,9,4,5,5,single-choice,spatial-relational,4|5,7,4/5,240382,4
3,3,24,383,0,52,2,4,1,3,3,single-choice,spatial-relational,1|3,7,1/3,240383,1
3,3,24,384,1,154,1,5,2,2,3,single-choice,spatial-relational,2|3,7,2/3,240384,2
3,3,24,385,1,676,2,10,4,4,6,single-choice,spatial-relational,4|6,7,4/6,240385,4
3,3,24,386,1,593,5,9,2,2,7,single-choice,spatial-relational,2|7,7,2/7,240386,2
3,3,24,387,0,740,2,6,2,4,4,single-choice,spatial-relational,2|4,7,2/4,240387,2
3,3,24,388,1,564,5,7,1,1,6,single-choice,spatial-relational,1|6,7,1/6,240388,1
3,3,24,389,1,571,3,9,3,3,6,single-choice,spatial-relational,3|6,7,3/6,240389,3
3,3,24,390,0,608,1,3,1,2,2,single-choice,spatial-relational,1|2,7,1/2,240390,1
3,3,24,391,0,652,2,10,4,6,6,single-choice,spatial-relational,4|6,7,4/6,240391,4
3,3,24,392,1,591,1,13,6,6,7,single-choice,spatial-relational,6|7,7,6/7,240392,6
3,3,24,393,1,571,3,9,3,3,6,single-choice,spatial-relational,3|6,7,3/6,240393,3
3,3,24,394,1,624,3,5,1,1,4,single-choice,spatial-relational,1|4,7,1/4,240394,1
3,3,24,395,1,549,6,8,1,1,7,single-choice,spatial-relational,1|7,7,1/7,240395,1
3,3,24,396,1,858,2,12,5,5,7,single-choice,spatial-relational,5|7,7,5/7,240396,5
3,3,24,397,1,742,2,6,2,2,4,single-choice,spatial-relational,2|4,7,2/4,240397,2
3,3,24,398,1,878,1,7,3,3,4,single-choice,spatial-relational,3|4,7,3/4,240398,3
3,3,24,399,0,664,3,11,4,7,7,single-choice,spatial-relational,4|7,7,4/7,240399,4
3,3,24,400,1,534,4,6,1,1,5,single-choice,spatial-relational,1|5,7,1/5,240400,1
3,3,24,401,1,538,4,10,3,3,7,single-choice,spatial-relational,3|7,7,3/7,240401,3
3,3,24,402,1,752,3,7,2,2,5,single-choice,spatial-relational,2|5,7,2/5,240402,2
3,3,24,403,1,709,4,10,3,3,7,single-choice,spatial-relational,3|7,7,3/7,240403,3
3,3,24,404,1,604,2,12,5,5,7,single-choice,spatial-relational,5|7,7,5/7,240404,5
3,3,24,405,1,621,5,9,2,2,7,single-choice,spatial-relational,2|7,7,2/7,240405,2
3,3,24,406,1,704,2,8,3,3,5,single-choice,spatial-relational,3|5,7,3/5,240406,3
3,3,24,407,1,668,3,11,4,4,7,single-choice,spatial-relational,4|7,7,4/7,240407,4
3,3,24,408,1,641,1,9,4,4,5,single-choice,spatial-relational,4|5,7,4/5,240408,4
3,3,24,409,1,814,1,3,1,1,2,single-choice,spatial-relational,1|2,7,1/2,240409,1
3,3,24,410,0,644,1,11,5,6,6,single-choice,spatial-relational,5|6,7,5/6,240410,5
3,3,24,411,1,594,1,11,5,5,6,single-choice,spatial-relational,5|6,7,5/6,240411,5
3,3,24,412,1,631,3,5,1,1,4,single-choice,spatial-relational,1|4,7,1/4,240412,1
3,3,24,413,1,646,4,8,2,2,6,single-choice,spatial-relational,2|6,7,2/6,240413,2
3,3,24,414,0,641,1,13,6,7,7,single-choice,spatial-relational,6|7,7,6/7,240414,6
3,3,24,415,1,568,5,7,1,1,6,single-choice,spatial-relational,1|6,7,1/6,240415,1
3,3,24,416,1,582,2,4,1,1,3,single-choice,spatial-relational,1|3,7,1/3,240416,1
3,3,24,417,1,583,1,7,3,3,4,single-choice,spatial-relational,3|4,7,3/4,240417,3
3,3,24,418,1,536,6,8,1,1,7,single-choice,spatial-relational,1|7,7,1/7,240418,1
3,3,24,419,1,736,2,8,3,3,5,single-choice,spatial-relational,3|5,7,3/5,240419,3
3,3,24,420,0,618,1,5,2,3,3,single-choice,spatial-relational,2|3,7,2/3,240420,2
3,3,24,421,1,531,1,3,1,1,2,single-choice,spatial-relational,1|2,7,1/2,240421,1
3,3,24,422,1,545,6,8,1,1,7,single-choice,spatial-relational,1|7,7,1/7,240422,1
3,3,24,423,1,593,3,5,1,1,4,single-choice,spatial-relational,1|4,7,1/4,240423,1
3,3,24,424,0,967,2,12,5,7,7,single-choice,spatial-relational,5|7,7,5/7,240424,5
3,3,24,425,1,553,4,8,2,2,6,single-choice,spatial-relational,2|6,7,2/6,240425,2
3,3,24,426,1,603,2,10,4,4,6,single-choice,spatial-relational,4|6,7,4/6,240426,4
3,3,24,427,0,825,1,5,2,3,3,single-choice,spatial-relational,2|3,7,2/3,240427,2
3,3,24,428,1,628,1,11,5,5,6,single-choice,spatial-relational,5|6,7,5/6,240428,5
3,3,24,429,0,742,5,7,1,6,6,single-choice,spatial-relational,1|6,7,1/6,240429,1
3,3,24,430,1,596,4,6,1,1,5,single-choice,spatial-relational,1|5,7,1/5,240430,1
3,3,24,431,1,676,2,6,2,2,4,single-choice,spatial-relational,2|4,7,2/4,240431,2
3,3,24,432,0,570,1,3,1,2,2,single-choice,spatial-relational,1|2,7,1/2,240432,1
3,3,24,433,1,552,5,7,1,1,6,single-choice,spatial-relational,1|6,7,1/6,240433,1
3,3,24,434,1,843,5,9,2,2,7,single-choice,spatial-relational,2|7,7,2/7,240434,2
3,3,24,435,1,743,3,11,4,4,7,single-choice,spatial-relational,4|7,7,4/7,240435,4
3,3,24,436,0,751,2,4,1,3,3,single-choice,spatial-relational,1|3,7,1/3,240436,1
3,3,24,437,1,811,4,8,2,2,6,single-choice,spatial-relational,2|6,7,2/6,240437,2
3,3,24,438,1,761,1,7,3,3,4,single-choice,spatial-relational,3|4,7,3/4,240438,3
3,3,24,439,0,598,2,4,1,3,3,single-choice,spatial-relational,1|3,7,1/3,240439,1
3,3,24,440,1,633,2,10,4,4,6,single-choice,spatial-relational,4|6,7,4/6,240440,4
3,3,24,441,1,598,3,7,2,2,5,single-choice,spatial-relational,2|5,7,2/5,240441,2
3,3,24,442,1,588,1,7,3,3,4,single-choice,spatial-relational,3|4,7,3/4,240442,3
3,3,24,443,1,578,2,6,2,2,4,single-choice,spatial-relational,2|4,7,2/4,240443,2
3,3,24,444,1,617,5,9,2,2,7,single-choice,spatial-relational,2|7,7,2/7,240444,2
3,3,24,445,0,732,1,11,5,6,6,single-choice,spatial-relational,5|6,7,5/6,240445,5
3,3,24,446,1,1235,3,9,3,3,6,single-choice,spatial-relational,3|6,7,3/6,240446,3
3,3,24,447,1,565,3,11,4,4,7,single-choice,spatial-relational,4|7,7,4/7,240447,4
3,3,24,448,0,842,1,5,2,3,3,single-choice,spatial-relational,2|3,7,2/3,240448,2
3,3,24,449,1,504,3,7,2,2,5,single-choice,spatial-relational,2|5,7,2/5,240449,2
3,3,24,450,1,599,1,13,6,6,7,single-choice,spatial-relational,6|7,7,6/7,240450,6
3,3,24,451,1,626,2,8,3,3,5,single-choice,spatial-relational,3|5,7,3/5,240451,3
3,3,24,452,1,590,2,12,5,5,7,single-choice,spatial-relational,5|7,7,5/7,240452,5
3,3,24,453,0,797,1,13,6,7,7,single-choice,spatial-relational,6|7,7,6/7,240453,6
3,3,24,454,1,594,3,9,3,3,6,single-choice,spatial-relational,3|6,7,3/6,240454,3
3,3,24,455,1,606,6,8,1,1,7,single-choice,spatial-relational,1|7,7,1/7,240455,1
3,3,24,456,1,625,4,10,3,3,7,single-choice,spatial-relational,3|7,7,3/7,240456,3
3,3,24,457,0,596,1,9,4,5,5,single-choice,spatial-relational,4|5,7,4/5,240457,4
3,3,24,458,1,673,1,9,4,4,5,single-choice,spatial-relational,4|5,7,4/5,240458,4
3,3,24,459,1,582,4,10,3,3,7,single-choice,spatial-relational,3|7,7,3/7,240459,3
3,3,24,460,0,649,4,6,1,5,5,single-choice,spatial-relational,1|5,7,1/5,240460,1
3,3,24,461,1,592,2,8,3,3,5,single-choice,spatial-relational,3|5,7,3/5,240461,3
3,3,24,462,1,546,3,5,1,1,4,single-choice,spatial-relational,1|4,7,1/4,240462,1
3,3,24,463,1,533,3,5,1,1,4,single-choice,spatial-relational,1|4,7,1/4,240463,1
3,3,24,464,1,578,3,11,4,4,7,single-choice,spatial-relational,4|7,7,4/7,240464,4
3,3,24,465,0,562,1,3,1,2,2,single-choice,spatial-relational,1|2,7,1/2,240465,1
3,3,24,466,1,1343,1,13,6,6,7,single-choice,spatial-relational,6|7,7,6/7,240466,6
3,3,24,467,0,693,1,13,6,7,7,single-choice,spatial-relational,6|7,7,6/7,240467,6
3,3,24,468,0,587,2,4,1,3,3,single-choice,spatial-relational,1|3,7,1/3,240468,1
3,3,24,469,1,671,1,7,3,3,4,single-choice,spatial-relational,3|4,7,3/4,240469,3
3,3,24,470,1,608,4,8,2,2,6,single-choice,spatial-relational,2|6,7,2/6,240470,2
3,3,24,471,1,591,1,7,3,3,4,single-choice,spatial-relational,3|4,7,3/4,240471,3
3,3,24,472,1,650,2,8,3,3,5,single-choice,spatial-relational,3|5,7,3/5,240472,3
3,3,24,473,1,742,3,5,1,1,4,single-choice,spatial-relational,1|4,7,1/4,240473,1
3,3,24,474,1,602,5,7,1,1,6,single-choice,spatial-relational,1|6,7,1/6,240474,1
3,3,24,475,1,608,2,8,3,3,5,single-choice,spatial-relational,3|5,7,3/5,240475,3
3,3,24,476,1,596,2,4,1,1,3,single-choice,spatial-relational,1|3,7,1/3,240476,1
3,3,24,477,1,579,2,12,5,5,7,single-choice,spatial-relational,5|7,7,5/7,240477,5
3,3,24,478,0,675,3,11,4,7,7,single-choice,spatial-relational,4|7,7,4/7,240478,4
3,3,24,479,1,540,4,10,3,3,7,single-choice,spatial-relational,3|7,7,3/7,240479,3
3,3,24,480,1,912,2,12,5,5,7,single-choice,spatial-relational,5|7,7,5/7,240480,5
3,3,24,481,1,647,3,9,3,3,6,single-choice,spatial-relational,3|6,7,3/6,240481,3
3,3,24,482,1,713,6,8,1,1,7,single-choice,spatial-relational,1|7,7,1/7,240482,1
3,3,24,483,1,719,2,6,2,2,4,single-choice,spatial-relational,2|4,7,2/4,240483,2
3,3,24,484,0,584,1,11,5,6,6,single-choice,spatial-relational,5|6,7,5/6,240484,5
3,3,24,485,1,504,6,8,1,1,7,single-choice,spatial-relational,1|7,7,1/7,240485,1
3,3,24,486,1,593,2,10,4,4,6,single-choice,spatial-relational,4|6,7,4/6,240486,4
3,3,24,487,1,573,5,7,1,1,6,single-choice,spatial-relational,1|6,7,1/6,240487,1
3,3,24,488,1,673,3,9,3,3,6,single-choice,spatial-relational,3|6,7,3/6,240488,3
3,3,24,489,0,612,2,6,2,4,4,single-choice,spatial-relational,2|4,7,2/4,240489,2
3,3,24,490,0,72,5,9,2,7,7,single-choice,spatial-relational,2|7,7,2/7,240490,2
3,3,24,491,0,578,1,3,1,2,2,single-choice,spatial-relational,1|2,7,1/2,240491,1
3,3,24,492,1,523,1,5,2,2,3,single-choice,spatial-relational,2|3,7,2/3,240492,2
3,3,24,493,1,665,4,10,3,3,7,single-choice,spatial-relational,3|7,7,3/7,240493,3
3,3,24,494,0,595,1,5,2,3,3,single-choice,spatial-relational,2|3,7,2/3,240494,2
3,3,24,495,0,743,1,9,4,5,5,single-choice,spatial-relational,4|5,7,4/5,240495,4
3,3,24,496,1,520,4,8,2,2,6,single-choice,spatial-relational,2|6,7,2/6,240496,2
3,3,24,497,1,593,3,7,2,2,5,single-choice,spatial-relational,2|5,7,2/5,240497,2
3,3,24,498,1,696,1,9,4,4,5,single-choice,spatial-relational,4|5,7,4/5,240498,4
3,3,24,499,1,581,4,6,1,1,5,single-choice,spatial-relational,1|5,7,1/5,240499,1
3,3,24,500,1,541,5,9,2,2,7,single-choice,spatial-relational,2|7,7,2/7,240500,2
3,3,24,501,1,616,3,7,2,2,5,single-choice,spatial-relational,2|5,7,2/5,240501,2
3,3,24,502,1,582,1,11,5,5,6,single-choice,spatial-relational,5|6,7,5/6,240502,5
3,3,24,503,1,647,4,6,1,1,5,single-choice,spatial-relational,1|5,7,1/5,240503,1
3,3,24,504,0,605,2,10,4,6,6,single-choice,spatial-relational,4|6,7,4/6,240504,4
3,3,24,505,1,35,3,5,1,1,4,single-choice,spatial-relational,1|4,7,1/4,240505,1
3,3,24,506,1,679,5,9,2,2,7,single-choice,spatial-relational,2|7,7,2/7,240506,2
3,3,24,507,1,594,2,10,4,4,6,single-choice,spatial-relational,4|6,7,4/6,240507,4
3,3,24,508,0,644,2,10,4,6,6,single-choice,spatial-relational,4|6,7,4/6,240508,4
3,3,24,509,1,41,4,10,3,3,7,single-choice,spatial-relational,3|7,7,3/7,240509,3
3,3,24,510,1,661,4,6,1,1,5,single-choice,spatial-relational,1|5,7,1/5,240510,1
3,3,24,511,0,600,1,9,4,5,5,single-choice,spatial-relational,4|5,7,4/5,240511,4
3,3,24,512,1,564,1,11,5,5,6,single-choice,spatial-relational,5|6,7,5/6,240512,5
3,3,24,513,1,563,1,13,6,6,7,single-choice,spatial-relational,6|7,7,6/7,240513,6
3,3,24,514,1,638,2,6,2,2,4,single-choice,spatial-relational,2|4,7,2/4,240514,2
3,3,24,515,1,634,3,7,2,2,5,single-choice,spatial-relational,2|5,7,2/5,240515,2
3,3,24,516,1,698,4,10,3,3,7,single-choice,spatial-relational,3|7,7,3/7,240516,3
3,3,24,517,1,634,3,5,1,1,4,single-choice,spatial-relational,1|4,7,1/4,240517,1
3,3,24,518,1,660,4,8,2,2,6,single-choice,spatial-relational,2|6,7,2/6,240518,2
3,3,24,519,1,661,6,8,1,1,7,single-choice,spatial-relational,1|7,7,1/7,240519,1
3,3,24,520,1,621,3,9,3,3,6,single-choice,spatial-relational,3|6,7,3/6,240520,3
3,3,24,521,1,637,4,8,2,2,6,single-choice,spatial-relational,2|6,7,2/6,240521,2
3,3,24,522,0,606,1,11,5,6,6,single-choice,spatial-relational,5|6,7,5/6,240522,5
3,3,24,523,1,571,2,8,3,3,5,single-choice,spatial-relational,3|5,7,3/5,240523,3
3,3,24,524,1,588,5,7,1,1,6,single-choice,spatial-relational,1|6,7,1/6,240524,1
3,3,24,525,0,575,1,3,1,2,2,single-choice,spatial-relational,1|2,7,1/2,240525,1
3,3,24,526,1,535,3,11,4,4,7,single-choice,spatial-relational,4|7,7,4/7,240526,4
3,3,24,527,1,610,5,7,1,1,6,single-choice,spatial-relational,1|6,7,1/6,240527,1
3,3,24,528,1,606,1,5,2,2,3,single-choice,spatial-relational,2|3,7,2/3,240528,2
3,3,24,529,1,586,2,12,5,5,7,single-choice,spatial-relational,5|7,7,5/7,240529,5
3,3,24,530,1,686,2,8,3,3,5,single-choice,spatial-relational,3|5,7,3/5,240530,3
3,3,24,531,1,582,1,5,2,2,3,single-choice,spatial-relational,2|3,7,2/3,240531,2
3,3,24,532,0,556,1,13,6,7,7,single-choice,spatial-relational,6|7,7,6/7,240532,6
3,3,24,533,1,552,5,9,2,2,7,single-choice,spatial-relational,2|7,7,2/7,240533,2
3,3,24,534,1,586,3,7,2,2,5,single-choice,spatial-relational,2|5,7,2/5,240534,2
3,3,24,535,1,595,4,6,1,1,5,single-choice,spatial-relational,1|5,7,1/5,240535,1
3,3,24,536,1,705,1,7,3,3,4,single-choice,spatial-relational,3|4,7,3/4,240536,3
3,3,24,537,1,607,6,8,1,1,7,single-choice,spatial-relational,1|7,7,1/7,240537,1
3,3,24,538,1,585,3,9,3,3,6,single-choice,spatial-relational,3|6,7,3/6,240538,3
3,3,24,539,1,630,2,6,2,2,4,single-choice,spatial-relational,2|4,7,2/4,240539,2
3,3,24,540,1,661,1,7,3,3,4,single-choice,spatial-relational,3|4,7,3/4,240540,3
3,3,24,541,1,620,3,11,4,4,7,single-choice,spatial-relational,4|7,7,4/7,240541,4
3,3,24,542,0,615,2,4,1,3,3,single-choice,spatial-relational,1|3,7,1/3,240542,1
3,3,24,543,0,583,1,3,1,2,2,single-choice,spatial-relational,1|2,7,1/2,240543,1
3,3,24,544,1,565,2,4,1,1,3,single-choice,spatial-relational,1|3,7,1/3,240544,1
3,3,24,545,0,621,2,12,5,7,7,single-choice,spatial-relational,5|7,7,5/7,240545,5
3,3,24,546,0,698,1,9,4,5,5,single-choice,spatial-relational,4|5,7,4/5,240546,4
3,3,24,547,0,48,5,9,2,7,7,single-choice,spatial-relational,2|7,7,2/7,240547,2
3,3,24,548,1,560,3,7,2,2,5,single-choice,spatial-relational,2|5,7,2/5,240548,2
3,3,24,549,1,570,3,5,1,1,4,single-choice,spatial-relational,1|4,7,1/4,240549,1
3,3,24,550,1,560,2,12,5,5,7,single-choice,spatial-relational,5|7,7,5/7,240550,5
3,3,24,551,0,730,2,10,4,6,6,single-choice,spatial-relational,4|6,7,4/6,240551,4
3,3,24,552,1,519,1,3,1,1,2,single-choice,spatial-relational,1|2,7,1/2,240552,1
3,3,24,553,1,530,1,13,6,6,7,single-choice,spatial-relational,6|7,7,6/7,240553,6
3,3,24,554,1,612,1,13,6,6,7,single-choice,spatial-relational,6|7,7,6/7,240554,6
3,3,24,555,1,765,1,9,4,4,5,single-choice,spatial-relational,4|5,7,4/5,240555,4
3,3,24,556,1,606,1,5,2,2,3,single-choice,spatial-relational,2|3,7,2/3,240556,2
3,3,24,557,1,790,1,7,3,3,4,single-choice,spatial-relational,3|4,7,3/4,240557,3
3,3,24,558,1,728,4,6,1,1,5,single-choice,spatial-relational,1|5,7,1/5,240558,1
3,3,24,559,1,687,1,9,4,4,5,single-choice,spatial-relational,4|5,7,4/5,240559,4
3,3,24,560,1,568,6,8,1,1,7,single-choice,spatial-relational,1|7,7,1/7,240560,1
3,3,24,561,1,575,4,8,2,2,6,single-choice,spatial-relational,2|6,7,2/6,240561,2
3,3,24,562,1,635,2,10,4,4,6,single-choice,spatial-relational,4|6,7,4/6,240562,4
3,3,24,563,1,746,1,3,1,1,2,single-choice,spatial-relational,1|2,7,1/2,240563,1
3,3,24,564,1,662,5,7,1,1,6,single-choice,spatial-relational,1|6,7,1/6,240564,1
3,3,24,565,1,671,4,8,2,2,6,single-choice,spatial-relational,2|6,7,2/6,240565,2
3,3,24,566,0,613,3,7,2,5,5,single-choice,spatial-relational,2|5,7,2/5,240566,2
3,3,24,567,0,1304,1,5,2,3,3,single-choice,spatial-relational,2|3,7,2/3,240567,2
3,3,24,568,0,44,3,5,1,4,4,single-choice,spatial-relational,1|4,7,1/4,240568,1
3,3,24,569,1,597,3,11,4,4,7,single-choice,spatial-relational,4|7,7,4/7,240569,4
3,3,24,570,1,654,5,7,1,1,6,single-choice,spatial-relational,1|6,7,1/6,240570,1
3,3,24,571,1,969,6,8,1,1,7,single-choice,spatial-relational,1|7,7,1/7,240571,1
3,3,24,572,0,6850,2,4,1,3,3,single-choice,spatial-relational,1|3,7,1/3,240572,1
3,3,24,573,1,617,3,11,4,4,7,single-choice,spatial-relational,4|7,7,4/7,240573,4
3,3,24,574,1,751,1,11,5,5,6,single-choice,spatial-relational,5|6,7,5/6,240574,5
3,3,24,575,1,772,4,10,3,3,7,single-choice,spatial-relational,3|7,7,3/7,240575,3
3,3,24,576,1,551,1,7,3,3,4,single-choice,spatial-relational,3|4,7,3/4,240576,3
3,3,24,577,1,651,3,9,3,3,6,single-choice,spatial-relational,3|6,7,3/6,240577,3
3,3,24,578,1,585,2,8,3,3,5,single-choice,spatial-relational,3|5,7,3/5,240578,3
3,3,24,579,1,617,3,9,3,3,6,single-choice,spatial-relational,3|6,7,3/6,240579,3
3,3,24,580,1,720,2,4,1,1,3,single-choice,spatial-relational,1|3,7,1/3,240580,1
3,3,24,581,1,593,1,11,5,5,6,single-choice,spatial-relational,5|6,7,5/6,240581,5
3,3,24,582,1,625,4,6,1,1,5,single-choice,spatial-relational,1|5,7,1/5,240582,1
3,3,24,583,1,573,4,10,3,3,7,single-choice,spatial-relational,3|7,7,3/7,240583,3
3,3,24,584,1,641,2,8,3,3,5,single-choice,spatial-relational,3|5,7,3/5,240584,3
3,3,24,585,1,588,2,6,2,2,4,single-choice,spatial-relational,2|4,7,2/4,240585,2
3,3,24,586,1,878,2,6,2,2,4,single-choice,spatial-relational,2|4,7,2/4,240586,2
3,3,24,587,1,728,2,12,5,5,7,single-choice,spatial-relational,5|7,7,5/7,240587,5
3,3,24,588,1,2259,5,9,2,2,7,single-choice,spatial-relational,2|7,7,2/7,240588,2
3,3,24,589,0,1760,2,6,2,4,4,single-choice,spatial-relational,2|4,7,2/4,240589,2
3,3,24,590,0,662,1,7,3,4,4,single-choice,spatial-relational,3|4,7,3/4,240590,3
3,3,24,591,1,565,1,7,3,3,4,single-choice,spatial-relational,3|4,7,3/4,240591,3
3,3,24,592,1,596,4,6,1,1,5,single-choice,spatial-relational,1|5,7,1/5,240592,1
3,3,24,593,1,641,3,5,1,1,4,single-choice,spatial-relational,1|4,7,1/4,240593,1
3,3,24,594,1,695,2,10,4,4,6,single-choice,spatial-relational,4|6,7,4/6,240594,4
3,3,24,595,1,564,3,9,3,3,6,single-choice,spatial-relational,3|6,7,3/6,240595,3
3,3,24,596,1,662,4,10,3,3,7,single-choice,spatial-relational,3|7,7,3/7,240596,3
3,3,24,597,1,679,6,8,1,1,7,single-choice,spatial-relational,1|7,7,1/7,240597,1
3,3,24,598,1,659,3,11,4,4,7,single-choice,spatial-relational,4|7,7,4/7,240598,4
3,3,24,599,0,625,1,11,5,6,6,single-choice,spatial-relational,5|6,7,5/6,240599,5
3,3,24,600,1,580,5,7,1,1,6,single-choice,spatial-relational,1|6,7,1/6,240600,1
1,4,21,1,1,748,1,13,6,6,7,single-choice,spatial-relational,6|7,7,6/7,210001,6
1,4,21,2,1,719,1,7,3,3,4,single-choice,spatial-relational,3|4,7,3/4,210002,3
1,4,21,3,1,903,1,9,4,4,5,single-choice,spatial-relational,4|5,7,4/5,210003,4
1,4,21,4,1,709,1,11,5,5,6,single-choice,spatial-relational,5|6,7,5/6,210004,5
1,4,21,5,0,635,1,3,1,2,2,single-choice,spatial-relational,1|2,7,1/2,210005,1
1,4,21,6,0,620,1,9,4,5,5,single-choice,spatial-relational,4|5,7,4/5,210006,4
1,4,21,7,1,934,1,7,3,3,4,single-choice,spatial-relational,3|4,7,3/4,210007,3
1,4,21,8,1,728,1,3,1,1,2,single-choice,spatial-relational,1|2,7,1/2,210008,1
1,4,21,9,0,487,1,5,2,3,3,single-choice,spatial-relational,2|3,7,2/3,210009,2
1,4,21,10,0,807,1,11,5,6,6,single-choice,spatial-relational,5|6,7,5/6,210010,5
1,4,21,11,0,790,1,5,2,3,3,single-choice,spatial-relational,2|3,7,2/3,210011,2
1,4,21,12,1,778,1,13,6,6,7,single-choice,spatial-relational,6|7,7,6/7,210012,6
1,4,21,13,0,1379,1,11,5,6,6,single-choice,spatial-relational,5|6,7,5/6,210013,5
1,4,21,14,1,635,1,13,6,6,7,single-choice,spatial-relational,6|7,7,6/7,210014,6
1,4,21,15,0,926,1,11,5,6,6,single-choice,spatial-relational,5|6,7,5/6,210015,5
1,4,21,16,0,742,1,5,2,3,3,single-choice,spatial-relational,2|3,7,2/3,210016,2
1,4,21,17,1,1008,1,9,4,4,5,single-choice,spatial-relational,4|5,7,4/5,210017,4
1,4,21,18,1,941,1,3,1,1,2,single-choice,spatial-relational,1|2,7,1/2,210018,1
1,4,21,19,1,951,1,3,1,1,2,single-choice,spatial-relational,1|2,7,1/2,210019,1
1,4,21,20,0,681,1,7,3,4,4,single-choice,spatial-relational,3|4,7,3/4,210020,3
1,4,21,21,0,864,1,5,2,3,3,single-choice,spatial-relational,2|3,7,2/3,210021,2
1,4,21,22,0,715,1,9,4,5,5,single-choice,spatial-relational,4|5,7,4/5,210022,4
1,4,21,23,1,679,1,13,6,6,7,single-choice,spatial-relational,6|7,7,6/7,210023,6
1,4,21,24,0,1622,1,7,3,4,4,single-choice,spatial-relational,3|4,7,3/4,210024,3
1,4,21,25,0,49,1,3,1,2,2,single-choice,spatial-relational,1|2,7,1/2,210025,1
1,4,21,26,1,653,1,3,1,1,2,single-choice,spatial-relational,1|2,7,1/2,210026,1
1,4,21,27,0,717,1,11,5,6,6,single-choice,spatial-relational,5|6,7,5/6,210027,5
1,4,21,28,0,720,1,7,3,4,4,single-choice,spatial-relational,3|4,7,3/4,210028,3
1,4,21,29,0,1010,1,11,5,6,6,single-choice,spatial-relational,5|6,7,5/6,210029,5
1,4,21,30,1,1135,1,13,6,6,7,single-choice,spatial-relational,6|7,7,6/7,210030,6
1,4,21,31,1,1152,1,5,2,2,3,single-choice,spatial-relational,2|3,7,2/3,210031,2
1,4,21,32,1,1134,1,7,3,3,4,single-choice,spatial-relational,3|4,7,3/4,210032,3
1,4,21,33,1,830,1,5,2,2,3,single-choice,spatial-relational,2|3,7,2/3,210033,2
1,4,21,34,1,1016,1,13,6,6,7,single-choice,spatial-relational,6|7,7,6/7,210034,6
1,4,21,35,1,1991,1,9,4,4,5,single-choice,spatial-relational,4|5,7,4/5,210035,4
1,4,21,36,0,10175,1,9,4,5,5,single-choice,spatial-relational,4|5,7,4/5,210036,4
1,4,21,37,1,842,1,5,2,2,3,single-choice,spatial-relational,2|3,7,2/3,210037,2
1,4,21,38,1,967,1,9,4,4,5,single-choice,spatial-relational,4|5,7,4/5,210038,4
1,4,21,39,0,1520,1,7,3,4,4,single-choice,spatial-relational,3|4,7,3/4,210039,3
1,4,21,40,1,724,1,3,1,1,2,single-choice,spatial-relational,1|2,7,1/2,210040,1
1,4,21,41,1,1098,1,5,2,2,3,single-choice,spatial-relational,2|3,7,2/3,210041,2
1,4,21,42,0,788,1,11,5,6,6,single-choice,spatial-relational,5|6,7,5/6,210042,5
1,4,21,43,1,877,1,13,6,6,7,single-choice,spatial-relational,6|7,7,6/7,210043,6
1,4,21,44,0,1963,1,11,5,6,6,single-choice,spatial-relational,5|6,7,5/6,210044,5
1,4,21,45,1,1110,1,13,6,6,7,single-choice,spatial-relational,6|7,7,6/7,210045,6
1,4,21,46,0,2634,1,9,4,5,5,single-choice,spatial-relational,4|5,7,4/5,210046,4
1,4,21,47,0,880,1,7,3,4,4,single-choice,spatial-relational,3|4,7,3/4,210047,3
1,4,21,48,1,966,1,3,1,1,2,single-choice,spatial-relational,1|2,7,1/2,210048,1
1,4,21,49,1,976,1,13,6,6,7,single-choice,spatial-relational,6|7,7,6/7,210049,6
1,4,21,50,1,1528,1,9,4,4,5,single-choice,spatial-relational,4|5,7,4/5,210050,4
1,4,21,51,1,1461,1,3,1,1,2,single-choice,spatial-relational,1|2,7,1/2,210051,1
1,4,21,52,1,861,1,5,2,2,3,single-choice,spatial-relational,2|3,7,2/3,210052,2
1,4,21,53,1,809,1,13,6,6,7,single-choice,spatial-relational,6|7,7,6/7,210053,6
1,4,21,54,1,953,1,5,2,2,3,single-choice,spatial-relational,2|3,7,2/3,210054,2
1,4,21,55,0,732,1,7,3,4,4,single-choice,spatial-relational,3|4,7,3/4,210055,3
1,4,21,56,0,575,1,11,5,6,6,single-choice,spatial-relational,5|6,7,5/6,210056,5
1,4,21,57,0,685,1,11,5,6,6,single-choice,spatial-relational,5|6,7,5/6,210057,5
1,4,21,58,0,979,1,9,4,5,5,single-choice,spatial-relational,4|5,7,4/5,210058,4
1,4,21,59,0,665,1,3,1,2,2,single-choice,spatial-relational,1|2,7,1/2,210059,1
1,4,21,60,1,2,1,7,3,3,4,single-choice,spatial-relational,3|4,7,3/4,210060,3
1,4,21,61,1,980,1,3,1,1,2,single-choice,spatial-relational,1|2,7,1/2,210061,1
1,4,21,62,0,857,1,11,5,6,6,single-choice,spatial-relational,5|6,7,5/6,210062,5
1,4,21,63,1,607,1,5,2,2,3,single-choice,spatial-relational,2|3,7,2/3,210063,2
1,4,21,64,0,1695,1,3,1,2,2,single-choice,spatial-relational,1|2,7,1/2,210064,1
1,4,21,65,1,744,1,5,2,2,3,single-choice,spatial-relational,2|3,7,2/3,210065,2
1,4,21,66,1,1403,1,9,4,4,5,single-choice,spatial-relational,4|5,7,4/5,210066,4
1,4,21,67,0,1089,1,7,3,4,4,single-choice,spatial-relational,3|4,7,3/4,210067,3
1,4,21,68,0,643,1,7,3,4,4,single-choice,spatial-relational,3|4,7,3/4,210068,3
1,4,21,69,1,708,1,13,6,6,7,single-choice,spatial-relational,6|7,7,6/7,210069,6
1,4,21,70,0,757,1,11,5,6,6,single-choice,spatial-relational,5|6,7,5/6,210070,5
1,4,21,71,1,831,1,9,4,4,5,single-choice,spatial-relational,4|5,7,4/5,210071,4
1,4,21,72,1,1444,1,13,6,6,7,single-choice,spatial-relational,6|7,7,6/7,210072,6
1,4,21,73,1,2372,1,9,4,4,5,single-choice,spatial-relational,4|5,7,4/5,210073,4
1,4,21,74,1,880,1,9,4,4,5,single-choice,spatial-relational,4|5,7,4/5,210074,4
1,4,21,75,1,757,1,13,6,6,7,single-choice,spatial-relational,6|7,7,6/7,210075,6
1,4,21,76,0,950,1,7,3,4,4,single-choice,spatial-relational,3|4,7,3/4,210076,3
1,4,21,77,0,643,1,11,5,6,6,single-choice,spatial-relational,5|6,7,5/6,210077,5
1,4,21,78,1,620,1,5,2,2,3,single-choice,spatial-relational,2|3,7,2/3,210078,2
1,4,21,79,1,962,1,5,2,2,3,single-choice,spatial-relational,2|3,7,2/3,210079,2
1,4,21,80,0,1063,1,3,1,2,2,single-choice,spatial-relational,1|2,7,1/2,210080,1
1,4,21,81,0,731,1,7,3,4,4,single-choice,spatial-relational,3|4,7,3/4,210081,3
1,4,21,82,0,777,1,11,5,6,6,single-choice,spatial-relational,5|6,7,5/6,210082,5
1,4,21,83,0,1057,1,3,1,2,2,single-choice,spatial-relational,1|2,7,1/2,210083,1
1,4,21,84,1,616,1,13,6,6,7,single-choice,spatial-relational,6|7,7,6/7,210084,6
1,4,21,85,0,1117,1,11,5,6,6,single-choice,spatial-relational,5|6,7,5/6,210085,5
1,4,21,86,1,1276,1,3,1,1,2,single-choice,spatial-relational,1|2,7,1/2,210086,1
1,4,21,87,1,685,1,13,6,6,7,single-choice,spatial-relational,6|7,7,6/7,210087,6
1,4,21,88,0,1273,1,3,1,2,2,single-choice,spatial-relational,1|2,7,1/2,210088,1
1,4,21,89,0,747,1,7,3,4,4,single-choice,spatial-relational,3|4,7,3/4,210089,3
1,4,21,90,0,604,1,11,5,6,6,single-choice,spatial-relational,5|6,7,5/6,210090,5
1,4,21,91,1,864,1,9,4,4,5,single-choice,spatial-relational,4|5,7,4/5,210091,4
1,4,21,92,1,967,1,9,4,4,5,single-choice,spatial-relational,4|5,7,4/5,210092,4
1,4,21,93,1,723,1,13,6,6,7,single-choice,spatial-relational,6|7,7,6/7,210093,6
1,4,21,94,1,919,1,5,2,2,3,single-choice,spatial-relational,2|3,7,2/3,210094,2
1,4,21,95,0,1193,1,7,3,4,4,single-choice,spatial-relational,3|4,7,3/4,210095,3
1,4,21,96,1,1822,1,5,2,2,3,single-choice,spatial-relational,2|3,7,2/3,210096,2
1,4,21,97,1,816,1,7,3,3,4,single-choice,spatial-relational,3|4,7,3/4,210097,3
1,4,21,98,1,829,1,13,6,6,7,single-choice,spatial-relational,6|7,7,6/7,210098,6
1,4,21,99,1,1057,1,13,6,6,7,single-choice,spatial-relational,6|7,7,6/7,210099,6
1,4,21,100,1,2404,1,9,4,4,5,single-choice,spatial-relational,4|5,7,4/5,210100,4
1,4,21,101,0,1023,1,3,1,2,2,single-choice,spatial-relational,1|2,7,1/2,210101,1
1,4,21,102,0,771,1,11,5,6,6,single-choice,spatial-relational,5|6,7,5/6,210102,5
1,4,21,103,1,663,1,5,2,2,3,single-choice,spatial-relational,2|3,7,2/3,210103,2
1,4,21,104,0,1229,1,3,1,2,2,single-choice,spatial-relational,1|2,7,1/2,210104,1
1,4,21,105,0,1142,1,9,4,5,5,single-choice,spatial-relational,4|5,7,4/5,210105,4
1,4,21,106,0,747,1,5,2,3,3,single-choice,spatial-relational,2|3,7,2/3,210106,2
1,4,21,107,0,839,1,11,5,6,6,single-choice,spatial-relational,5|6,7,5/6,210107,5
1,4,21,108,0,734,1,7,3,4,4,single-choice,spatial-relational,3|4,7,3/4,210108,3
1,4,21,109,0,1392,1,9,4,5,5,single-choice,spatial-relational,4|5,7,4/5,210109,4
1,4,21,110,1,858,1,3,1,1,2,single-choice,spatial-relational,1|2,7,1/2,210110,1
1,4,21,111,0,665,1,11,5,6,6,single-choice,spatial-relational,5|6,7,5/6,210111,5
1,4,21,112,1,1158,1,13,6,6,7,single-choice,spatial-relational,6|7,7,6/7,210112,6
1,4,21,113,0,1420,1,5,2,3,3,single-choice,spatial-relational,2|3,7,2/3,210113,2
1,4,21,114,1,664,1,13,6,6,7,single-choice,spatial-relational,6|7,7,6/7,210114,6
1,4,21,115,0,789,1,11,5,6,6,single-choice,spatial-relational,5|6,7,5/6,210115,5
1,4,21,116,0,733,1,3,1,2,2,single-choice,spatial-relational,1|2,7,1/2,210116,1
1,4,21,117,0,1,1,5,2,3,3,single-choice,spatial-relational,2|3,7,2/3,210117,2
1,4,21,118,0,1023,1,7,3,4,4,single-choice,spatial-relational,3|4,7,3/4,210118,3
1,4,21,119,1,980,1,9,4,4,5,single-choice,spatial-relational,4|5,7,4/5,210119,4
1,4,21,120,0,1519,1,7,3,4,4,single-choice,spatial-relational,3|4,7,3/4,210120,3
1,4,21,121,1,1560,1,9,4,4,5,single-choice,spatial-relational,4|5,7,4/5,210121,4
1,4,21,122,1,761,1,5,2,2,3,single-choice,spatial-relational,2|3,7,2/3,210122,2
1,4,21,123,1,878,1,13,6,6,7,single-choice,spatial-relational,6|7,7,6/7,210123,6
1,4,21,124,0,1053,1,3,1,2,2,single-choice,spatial-relational,1|2,7,1/2,210124,1
1,4,21,125,1,597,1,13,6,6,7,single-choice,spatial-relational,6|7,7,6/7,210125,6
1,4,21,126,0,2193,1,7,3,4,4,single-choice,spatial-relational,3|4,7,3/4,210126,3
1,4,21,127,0,622,1,11,5,6,6,single-choice,spatial-relational,5|6,7,5/6,210127,5
1,4,21,128,0,969,1,7,3,4,4,single-choice,spatial-relational,3|4,7,3/4,210128,3
1,4,21,129,0,1245,1,3,1,2,2,single-choice,spatial-relational,1|2,7,1/2,210129,1
1,4,21,130,0,567,1,11,5,6,6,single-choice,spatial-relational,5|6,7,5/6,210130,5
1,4,21,131,0,5,1,5,2,3,3,single-choice,spatial-relational,2|3,7,2/3,210131,2
1,4,21,132,1,3,1,9,4,4,5,single-choice,spatial-relational,4|5,7,4/5,210132,4
1,4,21,133,1,1684,1,5,2,2,3,single-choice,spatial-relational,2|3,7,2/3,210133,2
1,4,21,134,0,1194,1,11,5,6,6,single-choice,spatial-relational,5|6,7,5/6,210134,5
1,4,21,135,0,802,1,11,5,6,6,single-choice,spatial-relational,5|6,7,5/6,210135,5
1,4,21,136,0,755,1,7,3,4,4,single-choice,spatial-relational,3|4,7,3/4,210136,3
1,4,21,137,1,1235,1,7,3,3,4,single-choice,spatial-relational,3|4,7,3/4,210137,3
1,4,21,138,1,1313,1,5,2,2,3,single-choice,spatial-relational,2|3,7,2/3,210138,2
1,4,21,139,0,932,1,3,1,2,2,single-choice,spatial-relational,1|2,7,1/2,210139,1
1,4,21,140,1,1045,1,9,4,4,5,single-choice,spatial-relational,4|5,7,4/5,210140,4
1,4,21,141,1,1175,1,13,6,6,7,single-choice,spatial-relational,6|7,7,6/7,210141,6
1,4,21,142,0,2655,1,3,1,2,2,single-choice,spatial-relational,1|2,7,1/2,210142,1
1,4,21,143,0,1560,1,9,4,5,5,single-choice,spatial-relational,4|5,7,4/5,210143,4
1,4,21,144,0,1067,1,13,6,7,7,single-choice,spatial-relational,6|7,7,6/7,210144,6
1,4,21,145,1,1381,1,3,1,1,2,single-choice,spatial-relational,1|2,7,1/2,210145,1
1,4,21,146,1,877,1,13,6,6,7,single-choice,spatial-relational,6|7,7,6/7,210146,6
1,4,21,147,0,1471,1,9,4,5,5,single-choice,spatial-relational,4|5,7,4/5,210147,4
1,4,21,148,1,1118,1,7,3,3,4,single-choice,spatial-relational,3|4,7,3/4,210148,3
1,4,21,149,0,1228,1,5,2,3,3,single-choice,spatial-relational,2|3,7,2/3,210149,2
1,4,21,150,1,802,1,13,6,6,7,single-choice,spatial-relational,6|7,7,6/7,210150,6
1,4,21,151,0,1851,1,7,3,4,4,single-choice,spatial-relational,3|4,7,3/4,210151,3
1,4,21,152,0,1337,1,5,2,3,3,single-choice,spatial-relational,2|3,7,2/3,210152,2
1,4,21,153,0,893,1,11,5,6,6,single-choice,spatial-relational,5|6,7,5/6,210153,5
1,4,21,154,0,988,1,3,1,2,2,single-choice,spatial-relational,1|2,7,1/2,210154,1
1,4,21,155,0,661,1,11,5,6,6,single-choice,spatial-relational,5|6,7,5/6,210155,5
1,4,21,156,0,1258,1,9,4,5,5,single-choice,spatial-relational,4|5,7,4/5,210156,4
1,4,21,157,1,1031,1,7,3,3,4,single-choice,spatial-relational,3|4,7,3/4,210157,3
1,4,21,158,0,3147,1,13,6,7,7,single-choice,spatial-relational,6|7,7,6/7,210158,6
1,4,21,159,0,913,1,11,5,6,6,single-choice,spatial-relational,5|6,7,5/6,210159,5
1,4,21,160,1,2375,1,3,1,1,2,single-choice,spatial-relational,1|2,7,1/2,210160,1
1,4,21,161,0,879,1,11,5,6,6,single-choice,spatial-relational,5|6,7,5/6,210161,5
1,4,21,162,0,876,1,5,2,3,3,single-choice,spatial-relational,2|3,7,2/3,210162,2
1,4,21,163,1,937,1,13,6,6,7,single-choice,spatial-relational,6|7,7,6/7,210163,6
1,4,21,164,0,2384,1,9,4,5,5,single-choice,spatial-relational,4|5,7,4/5,210164,4
1,4,21,165,1,954,1,7,3,3,4,single-choice,spatial-relational,3|4,7,3/4,210165,3
1,4,21,166,1,1979,1,9,4,4,5,single-choice,spatial-relational,4|5,7,4/5,210166,4
1,4,21,167,0,1330,1,5,2,3,3,single-choice,spatial-relational,2|3,7,2/3,210167,2
1,4,21,168,0,1493,1,3,1,2,2,single-choice,spatial-relational,1|2,7,1/2,210168,1
1,4,21,169,0,681,1,11,5,6,6,single-choice,spatial-relational,5|6,7,5/6,210169,5
1,4,21,170,1,915,1,7,3,3,4,single-choice,spatial-relational,3|4,7,3/4,210170,3
1,4,21,171,0,874,1,5,2,3,3,single-choice,spatial-relational,2|3,7,2/3,210171,2
1,4,21,172,1,1185,1,13,6,6,7,single-choice,spatial-relational,6|7,7,6/7,210172,6
1,4,21,173,0,1806,1,7,3,4,4,single-choice,spatial-relational,3|4,7,3/4,210173,3
1,4,21,174,1,1171,1,13,6,6,7,single-choice,spatial-relational,6|7,7,6/7,210174,6
1,4,21,175,0,1624,1,3,1,2,2,single-choice,spatial-relational,1|2,7,1/2,210175,1
1,4,21,176,1,1053,1,9,4,4,5,single-choice,spatial-relational,4|5,7,4/5,210176,4
1,4,21,177,0,1325,1,5,2,3,3,single-choice,spatial-relational,2|3,7,2/3,210177,2
1,4,21,178,1,1109,1,3,1,1,2,single-choice,spatial-relational,1|2,7,1/2,210178,1
1,4,21,179,1,1459,1,9,4,4,5,single-choice,spatial-relational,4|5,7,4/5,210179,4
1,4,21,180,0,1003,1,11,5,6,6,single-choice,spatial-relational,5|6,7,5/6,210180,5
1,4,21,181,1,934,1,13,6,6,7,single-choice,spatial-relational,6|7,7,6/7,210181,6
1,4,21,182,0,1746,1,9,4,5,5,single-choice,spatial-relational,4|5,7,4/5,210182,4
1,4,21,183,1,765,1,13,6,6,7,single-choice,spatial-relational,6|7,7,6/7,210183,6
1,4,21,184,0,1680,1,7,3,4,4,single-choice,spatial-relational,3|4,7,3/4,210184,3
1,4,21,185,0,1330,1,11,5,6,6,single-choice,spatial-relational,5|6,7,5/6,210185,5
1,4,21,186,1,1195,1,3,1,1,2,single-choice,spatial-relational,1|2,7,1/2,210186,1
1,4,21,187,0,2397,1,7,3,4,4,single-choice,spatial-relational,3|4,7,3/4,210187,3
1,4,21,188,0,767,1,11,5,6,6,single-choice,spatial-relational,5|6,7,5/6,210188,5
1,4,21,189,1,686,1,9,4,4,5,single-choice,spatial-relational,4|5,7,4/5,210189,4
1,4,21,190,0,1902,1,5,2,3,3,single-choice,spatial-relational,2|3,7,2/3,210190,2
1,4,21,191,1,1013,1,3,1,1,2,single-choice,spatial-relational,1|2,7,1/2,210191,1
1,4,21,192,0,1418,1,5,2,3,3,single-choice,spatial-relational,2|3,7,2/3,210192,2
1,4,21,193,1,686,1,5,2,2,3,single-choice,spatial-relational,2|3,7,2/3,210193,2
1,4,21,194,1,895,1,3,1,1,2,single-choice,spatial-relational,1|2,7,1/2,210194,1
1,4,21,195,0,915,1,11,5,6,6,single-choice,spatial-relational,5|6,7,5/6,210195,5
1,4,21,196,1,1239,1,5,2,2,3,single-choice,spatial-relational,2|3,7,2/3,210196,2
1,4,21,197,0,2351,1,7,3,4,4,single-choice,spatial-relational,3|4,7,3/4,210197,3
1,4,21,198,1,641,1,13,6,6,7,single-choice,spatial-relational,6|7,7,6/7,210198,6
1,4,21,199,0,2560,1,7,3,4,4,single-choice,spatial-relational,3|4,7,3/4,210199,3
1,4,21,200,1,667,1,13,6,6,7,single-choice,spatial-relational,6|7,7,6/7,210200,6
1,4,21,201,0,1008,1,11,5,6,6,single-choice,spatial-relational,5|6,7,5/6,210201,5
1,4,21,202,1,1026,1,9,4,4,5,single-choice,spatial-relational,4|5,7,4/5,210202,4
1,4,21,203,1,1407,1,9,4,4,5,single-choice,spatial-relational,4|5,7,4/5,210203,4
1,4,21,204,1,2774,1,3,1,1,2,single-choice,spatial-relational,1|2,7,1/2,210204,1
1,4,21,205,0,937,1,7,3,4,4,single-choice,spatial-relational,3|4,7,3/4,210205,3
1,4,21,206,0,581,1,11,5,6,6,single-choice,spatial-relational,5|6,7,5/6,210206,5
1,4,21,207,1,763,1,5,2,2,3,single-choice,spatial-relational,2|3,7,2/3,210207,2
1,4,21,208,1,925,1,5,2,2,3,single-choice,spatial-relational,2|3,7,2/3,210208,2
1,4,21,209,1,1953,1,3,1,1,2,single-choice,spatial-relational,1|2,7,1/2,210209,1
1,4,21,210,1,2039,1,13,6,6,7,single-choice,spatial-relational,6|7,7,6/7,210210,6
1,4,21,211,0,2333,1,9,4,5,5,single-choice,spatial-relational,4|5,7,4/5,210211,4
1,4,21,212,0,1325,1,7,3,4,4,single-choice,spatial-relational,3|4,7,3/4,210212,3
1,4,21,213,1,636,1,13,6,6,7,single-choice,spatial-relational,6|7,7,6/7,210213,6
1,4,21,214,0,1015,1,11,5,6,6,single-choice,spatial-relational,5|6,7,5/6,210214,5
1,4,21,215,0,1868,1,9,4,5,5,single-choice,spatial-relational,4|5,7,4/5,210215,4
1,4,21,216,1,521,1,3,1,1,2,single-choice,spatial-relational,1|2,7,1/2,210216,1
1,4,21,217,1,1143,1,13,6,6,7,single-choice,spatial-relational,6|7,7,6/7,210217,6
1,4,21,218,0,3116,1,3,1,2,2,single-choice,spatial-relational,1|2,7,1/2,210218,1
1,4,21,219,0,1543,1,9,4,5,5,single-choice,spatial-relational,4|5,7,4/5,210219,4
1,4,21,220,1,1306,1,5,2,2,3,single-choice,spatial-relational,2|3,7,2/3,210220,2
1,4,21,221,0,1653,1,9,4,5,5,single-choice,spatial-relational,4|5,7,4/5,210221,4
1,4,21,222,0,721,1,11,5,6,6,single-choice,spatial-relational,5|6,7,5/6,210222,5
1,4,21,223,1,1482,1,3,1,1,2,single-choice,spatial-relational,1|2,7,1/2,210223,1
1,4,21,224,1,1772,1,5,2,2,3,single-choice,spatial-relational,2|3,7,2/3,210224,2
1,4,21,225,0,800,1,11,5,6,6,single-choice,spatial-relational,5|6,7,5/6,210225,5
1,4,21,226,1,904,1,7,3,3,4,single-choice,spatial-relational,3|4,7,3/4,210226,3
1,4,21,227,0,1085,1,7,3,4,4,single-choice,spatial-relational,3|4,7,3/4,210227,3
1,4,21,228,1,1448,1,13,6,6,7,single-choice,spatial-relational,6|7,7,6/7,210228,6
1,4,21,229,1,2517,1,13,6,6,7,single-choice,spatial-relational,6|7,7,6/7,210229,6
1,4,21,230,0,2509,1,11,5,6,6,single-choice,spatial-relational,5|6,7,5/6,210230,5
1,4,21,231,1,939,1,3,1,1,2,single-choice,spatial-relational,1|2,7,1/2,210231,1
1,4,21,232,1,1253,1,5,2,2,3,single-choice,spatial-relational,2|3,7,2/3,210232,2
1,4,21,233,0,1468,1,9,4,5,5,single-choice,spatial-relational,4|5,7,4/5,210233,4
1,4,21,234,0,619,1,5,2,3,3,single-choice,spatial-relational,2|3,7,2/3,210234,2
1,4,21,235,0,651,1,11,5,6,6,single-choice,spatial-relational,5|6,7,5/6,210235,5
1,4,21,236,1,695,1,7,3,3,4,single-choice,spatial-relational,3|4,7,3/4,210236,3
1,4,21,237,1,2406,1,3,1,1,2,single-choice,spatial-relational,1|2,7,1/2,210237,1
1,4,21,238,1,876,1,13,6,6,7,single-choice,spatial-relational,6|7,7,6/7,210238,6
1,4,21,239,1,969,1,7,3,3,4,single-choice,spatial-relational,3|4,7,3/4,210239,3
1,4,21,240,0,1654,1,9,4,5,5,single-choice,spatial-relational,4|5,7,4/5,210240,4
1,4,21,241,0,1096,1,11,5,6,6,single-choice,spatial-relational,5|6,7,5/6,210241,5
1,4,21,242,1,1137,1,9,4,4,5,single-choice,spatial-relational,4|5,7,4/5,210242,4
1,4,21,243,1,1242,1,13,6,6,7,single-choice,spatial-relational,6|7,7,6/7,210243,6
1,4,21,244,1,1413,1,5,2,2,3,single-choice,spatial-relational,2|3,7,2/3,210244,2
1,4,21,245,0,1258,1,11,5,6,6,single-choice,spatial-relational,5|6,7,5/6,210245,5
1,4,21,246,1,5,1,13,6,6,7,single-choice,spatial-relational,6|7,7,6/7,210246,6
1,4,21,247,1,1500,1,9,4,4,5,single-choice,spatial-relational,4|5,7,4/5,210247,4
1,4,21,248,1,1080,1,3,1,1,2,single-choice,spatial-relational,1|2,7,1/2,210248,1
1,4,21,249,1,1034,1,7,3,3,4,single-choice,spatial-relational,3|4,7,3/4,210249,3
1,4,21,250,0,1503,1,5,2,3,3,single-choice,spatial-relational,2|3,7,2/3,210250,2
1,4,21,251,1,1117,1,7,3,3,4,single-choice,spatial-relational,3|4,7,3/4,210251,3
1,4,21,252,1,741,1,3,1,1,2,single-choice,spatial-relational,1|2,7,1/2,210252,1
1,4,21,253,1,727,1,13,6,6,7,single-choice,spatial-relational,6|7,7,6/7,210253,6
1,4,21,254,0,737,1,11,5,6,6,single-choice,spatial-relational,5|6,7,5/6,210254,5
1,4,21,255,1,1505,1,9,4,4,5,single-choice,spatial-relational,4|5,7,4/5,210255,4
1,4,21,256,1,1351,1,3,1,1,2,single-choice,spatial-relational,1|2,7,1/2,210256,1
1,4,21,257,1,1052,1,9,4,4,5,single-choice,spatial-relational,4|5,7,4/5,210257,4
1,4,21,258,0,954,1,11,5,6,6,single-choice,spatial-relational,5|6,7,5/6,210258,5
1,4,21,259,1,605,1,7,3,3,4,single-choice,spatial-relational,3|4,7,3/4,210259,3
1,4,21,260,1,1328,1,3,1,1,2,single-choice,spatial-relational,1|2,7,1/2,210260,1
1,4,21,261,1,744,1,13,6,6,7,single-choice,spatial-relational,6|7,7,6/7,210261,6
1,4,21,262,0,1024,1,5,2,3,3,single-choice,spatial-relational,2|3,7,2/3,210262,2
1,4,21,263,1,990,1,7,3,3,4,single-choice,spatial-relational,3|4,7,3/4,210263,3
1,4,21,264,1,1371,1,5,2,2,3,single-choice,spatial-relational,2|3,7,2/3,210264,2
1,4,21,265,1,821,1,9,4,4,5,single-choice,spatial-relational,4|5,7,4/5,210265,4
1,4,21,266,1,1910,1,13,6,6,7,single-choice,spatial-relational,6|7,7,6/7,210266,6
1,4,21,267,1,903,1,3,1,1,2,single-choice,spatial-relational,1|2,7,1/2,210267,1
1,4,21,268,1,806,1,3,1,1,2,single-choice,spatial-relational,1|2,7,1/2,210268,1
1,4,21,269,1,1857,1,13,6,6,7,single-choice,spatial-relational,6|7,7,6/7,210269,6
1,4,21,270,1,1837,1,7,3,3,4,single-choice,spatial-relational,3|4,7,3/4,210270,3
1,4,21,271,0,1465,1,11,5,6,6,single-choice,spatial-relational,5|6,7,5/6,210271,5
1,4,21,272,0,642,1,9,4,5,5,single-choice,spatial-relational,4|5,7,4/5,210272,4
1,4,21,273,0,747,1,5,2,3,3,single-choice,spatial-relational,2|3,7,2/3,210273,2
1,4,21,274,0,731,1,11,5,6,6,single-choice,spatial-relational,5|6,7,5/6,210274,5
1,4,21,275,0,1100,1,5,2,3,3,single-choice,spatial-relational,2|3,7,2/3,210275,2
1,4,21,276,1,3,1,7,3,3,4,single-choice,spatial-relational,3|4,7,3/4,210276,3
1,4,21,277,1,1016,1,9,4,4,5,single-choice,spatial-relational,4|5,7,4/5,210277,4
1,4,21,278,1,2046,1,9,4,4,5,single-choice,spatial-relational,4|5,7,4/5,210278,4
1,4,21,279,0,1781,1,5,2,3,3,single-choice,spatial-relational,2|3,7,2/3,210279,2
1,4,21,280,1,697,1,13,6,6,7,single-choice,spatial-relational,6|7,7,6/7,210280,6
1,4,21,281,1,2428,1,3,1,1,2,single-choice,spatial-relational,1|2,7,1/2,210281,1
1,4,21,282,1,993,1,5,2,2,3,single-choice,spatial-relational,2|3,7,2/3,210282,2
1,4,21,283,0,1483,1,7,3,4,4,single-choice,spatial-relational,3|4,7,3/4,210283,3
1,4,21,284,1,973,1,3,1,1,2,single-choice,spatial-relational,1|2,7,1/2,210284,1
1,4,21,285,1,2568,1,7,3,3,4,single-choice,spatial-relational,3|4,7,3/4,210285,3
1,4,21,286,0,884,1,11,5,6,6,single-choice,spatial-relational,5|6,7,5/6,210286,5
1,4,21,287,0,599,1,11,5,6,6,single-choice,spatial-relational,5|6,7,5/6,210287,5
1,4,21,288,1,1717,1,13,6,6,7,single-choice,spatial-relational,6|7,7,6/7,210288,6
1,4,21,289,0,1035,1,3,1,2,2,single-choice,spatial-relational,1|2,7,1/2,210289,1
1,4,21,290,1,913,1,13,6,6,7,single-choice,spatial-relational,6|7,7,6/7,210290,6
1,4,21,291,1,1155,1,9,4,4,5,single-choice,spatial-relational,4|5,7,4/5,210291,4
1,4,21,292,0,1537,1,11,5,6,6,single-choice,spatial-relational,5|6,7,5/6,210292,5
1,4,21,293,1,71,1,5,2,2,3,single-choice,spatial-relational,2|3,7,2/3,210293,2
1,4,21,294,1,1080,1,7,3,3,4,single-choice,spatial-relational,3|4,7,3/4,210294,3
1,4,21,295,0,51,1,5,2,3,3,single-choice,spatial-relational,2|3,7,2/3,210295,2
1,4,21,296,1,994,1,9,4,4,5,single-choice,spatial-relational,4|5,7,4/5,210296,4
1,4,21,297,1,931,1,7,3,3,4,single-choice,spatial-relational,3|4,7,3/4,210297,3
1,4,21,298,1,1184,1,3,1,1,2,single-choice,spatial-relational,1|2,7,1/2,210298,1
1,4,21,299,0,1201,1,13,6,7,7,single-choice,spatial-relational,6|7,7,6/7,210299,6
1,4,21,300,0,745,1,11,5,6,6,single-choice,spatial-relational,5|6,7,5/6,210300,5
1,4,21,301,0,1217,1,5,2,3,3,single-choice,spatial-relational,2|3,7,2/3,210301,2
1,4,21,302,0,9,1,3,1,2,2,single-choice,spatial-relational,1|2,7,1/2,210302,1
1,4,21,303,0,893,1,11,5,6,6,single-choice,spatial-relational,5|6,7,5/6,210303,5
1,4,21,304,1,852,1,9,4,4,5,single-choice,spatial-relational,4|5,7,4/5,210304,4
1,4,21,305,0,2196,1,5,2,3,3,single-choice,spatial-relational,2|3,7,2/3,210305,2
1,4,21,306,1,746,1,13,6,6,7,single-choice,spatial-relational,6|7,7,6/7,210306,6
1,4,21,307,1,1992,1,3,1,1,2,single-choice,spatial-relational,1|2,7,1/2,210307,1
1,4,21,308,0,1212,1,7,3,4,4,single-choice,spatial-relational,3|4,7,3/4,210308,3
1,4,21,309,0,867,1,11,5,6,6,single-choice,spatial-relational,5|6,7,5/6,210309,5
1,4,21,310,1,832,1,9,4,4,5,single-choice,spatial-relational,4|5,7,4/5,210310,4
1,4,21,311,1,1521,1,13,6,6,7,single-choice,spatial-relational,6|7,7,6/7,210311,6
1,4,21,312,0,2270,1,7,3,4,4,single-choice,spatial-relational,3|4,7,3/4,210312,3
1,4,21,313,1,759,1,13,6,6,7,single-choice,spatial-relational,6|7,7,6/7,210313,6
1,4,21,314,0,1602,1,3,1,2,2,single-choice,spatial-relational,1|2,7,1/2,210314,1
1,4,21,315,1,885,1,9,4,4,5,single-choice,spatial-relational,4|5,7,4/5,210315,4
1,4,21,316,1,1590,1,13,6,6,7,single-choice,spatial-relational,6|7,7,6/7,210316,6
1,4,21,317,0,2357,1,5,2,3,3,single-choice,spatial-relational,2|3,7,2/3,210317,2
1,4,21,318,0,1060,1,7,3,4,4,single-choice,spatial-relational,3|4,7,3/4,210318,3
1,4,21,319,0,57,1,11,5,6,6,single-choice,spatial-relational,5|6,7,5/6,210319,5
1,4,21,320,0,752,1,11,5,6,6,single-choice,spatial-relational,5|6,7,5/6,210320,5
1,4,21,321,1,930,1,3,1,1,2,single-choice,spatial-relational,1|2,7,1/2,210321,1
1,4,21,322,0,1066,1,5,2,3,3,single-choice,spatial-relational,2|3,7,2/3,210322,2
1,4,21,323,1,787,1,9,4,4,5,single-choice,spatial-relational,4|5,7,4/5,210323,4
1,4,21,324,0,2027,1,7,3,4,4,single-choice,spatial-relational,3|4,7,3/4,210324,3
1,4,21,325,1,1024,1,13,6,6,7,single-choice,spatial-relational,6|7,7,6/7,210325,6
1,4,21,326,1,820,1,13,6,6,7,single-choice,spatial-relational,6|7,7,6/7,210326,6
1,4,21,327,0,2417,1,11,5,6,6,single-choice,spatial-relational,5|6,7,5/6,210327,5
1,4,21,328,0,708,1,11,5,6,6,single-choice,spatial-relational,5|6,7,5/6,210328,5
1,4,21,329,0,871,1,7,3,4,4,single-choice,spatial-relational,3|4,7,3/4,210329,3
1,4,21,330,1,766,1,9,4,4,5,single-choice,spatial-relational,4|5,7,4/5,210330,4
1,4,21,331,0,844,1,5,2,3,3,single-choice,spatial-relational,2|3,7,2/3,210331,2
1,4,21,332,1,1013,1,3,1,1,2,single-choice,spatial-relational,1|2,7,1/2,210332,1
1,4,21,333,1,37,1,5,2,2,3,single-choice,spatial-relational,2|3,7,2/3,210333,2
1,4,21,334,1,814,1,9,4,4,5,single-choice,spatial-relational,4|5,7,4/5,210334,4
1,4,21,335,1,790,1,3,1,1,2,single-choice,spatial-relational,1|2,7,1/2,210335,1
1,4,21,336,0,1069,1,7,3,4,4,single-choice,spatial-relational,3|4,7,3/4,210336,3
1,4,21,337,0,755,1,11,5,6,6,single-choice,spatial-relational,5|6,7,5/6,210337,5
1,4,21,338,0,10,1,13,6,7,7,single-choice,spatial-relational,6|7,7,6/7,210338,6
1,4,21,339,0,1156,1,11,5,6,6,single-choice,spatial-relational,5|6,7,5/6,210339,5
1,4,21,340,0,1485,1,5,2,3,3,single-choice,spatial-relational,2|3,7,2/3,210340,2
1,4,21,341,0,1100,1,3,1,2,2,single-choice,spatial-relational,1|2,7,1/2,210341,1
1,4,21,342,1,1231,1,9,4,4,5,single-choice,spatial-relational,4|5,7,4/5,210342,4
1,4,21,343,1,1094,1,7,3,3,4,single-choice,spatial-relational,3|4,7,3/4,210343,3
1,4,21,344,1,741,1,13,6,6,7,single-choice,spatial-relational,6|7,7,6/7,210344,6
1,4,21,345,1,3466,1,5,2,2,3,single-choice,spatial-relational,2|3,7,2/3,210345,2
1,4,21,346,1,1210,1,3,1,1,2,single-choice,spatial-relational,1|2,7,1/2,210346,1
1,4,21,347,1,934,1,9,4,4,5,single-choice,spatial-relational,4|5,7,4/5,210347,4
1,4,21,348,0,2418,1,7,3,4,4,single-choice,spatial-relational,3|4,7,3/4,210348,3
1,4,21,349,1,884,1,9,4,4,5,single-choice,spatial-relational,4|5,7,4/5,210349,4
1,4,21,350,1,1734,1,3,1,1,2,single-choice,spatial-relational,1|2,7,1/2,210350,1
1,4,21,351,1,1522,1,7,3,3,4,single-choice,spatial-relational,3|4,7,3/4,210351,3
1,4,21,352,1,1066,1,13,6,6,7,single-choice,spatial-relational,6|7,7,6/7,210352,6
1,4,21,353,0,1090,1,11,5,6,6,single-choice,spatial-relational,5|6,7,5/6,210353,5
1,4,21,354,0,647,1,11,5,6,6,single-choice,spatial-relational,5|6,7,5/6,210354,5
1,4,21,355,1,832,1,9,4,4,5,single-choice,spatial-relational,4|5,7,4/5,210355,4
1,4,21,356,0,1124,1,5,2,3,3,single-choice,spatial-relational,2|3,7,2/3,210356,2
1,4,21,357,1,1452,1,7,3,3,4,single-choice,spatial-relational,3|4,7,3/4,210357,3
1,4,21,358,1,999,1,3,1,1,2,single-choice,spatial-relational,1|2,7,1/2,210358,1
1,4,21,359,1,650,1,13,6,6,7,single-choice,spatial-relational,6|7,7,6/7,210359,6
1,4,21,360,1,2416,1,5,2,2,3,single-choice,spatial-relational,2|3,7,2/3,210360,2
1,4,21,361,0,890,1,7,3,4,4,single-choice,spatial-relational,3|4,7,3/4,210361,3
1,4,21,362,1,681,1,9,4,4,5,single-choice,spatial-relational,4|5,7,4/5,210362,4
1,4,21,363,0,580,1,11,5,6,6,single-choice,spatial-relational,5|6,7,5/6,210363,5
1,4,21,364,1,1021,1,3,1,1,2,single-choice,spatial-relational,1|2,7,1/2,210364,1
1,4,21,365,1,811,1,5,2,2,3,single-choice,spatial-relational,2|3,7,2/3,210365,2
1,4,21,366,0,1291,1,3,1,2,2,single-choice,spatial-relational,1|2,7,1/2,210366,1
1,4,21,367,1,612,1,13,6,6,7,single-choice,spatial-relational,6|7,7,6/7,210367,6
1,4,21,368,1,2191,1,9,4,4,5,single-choice,spatial-relational,4|5,7,4/5,210368,4
1,4,21,369,0,876,1,5,2,3,3,single-choice,spatial-relational,2|3,7,2/3,210369,2
1,4,21,370,1,780,1,13,6,6,7,single-choice,spatial-relational,6|7,7,6/7,210370,6
1,4,21,371,0,1603,1,11,5,6,6,single-choice,spatial-relational,5|6,7,5/6,210371,5
1,4,21,372,1,1033,1,7,3,3,4,single-choice,spatial-relational,3|4,7,3/4,210372,3
1,4,21,373,0,959,1,5,2,3,3,single-choice,spatial-relational,2|3,7,2/3,210373,2
1,4,21,374,0,760,1,5,2,3,3,single-choice,spatial-relational,2|3,7,2/3,210374,2
1,4,21,375,0,2297,1,7,3,4,4,single-choice,spatial-relational,3|4,7,3/4,210375,3
1,4,21,376,0,1268,1,9,4,5,5,single-choice,spatial-relational,4|5,7,4/5,210376,4
1,4,21,377,1,935,1,3,1,1,2,single-choice,spatial-relational,1|2,7,1/2,210377,1
1,4,21,378,0,1680,1,7,3,4,4,single-choice,spatial-relational,3|4,7,3/4,210378,3
1,4,21,379,1,1211,1,9,4,4,5,single-choice,spatial-relational,4|5,7,4/5,210379,4
1,4,21,380,0,1005,1,11,5,6,6,single-choice,spatial-relational,5|6,7,5/6,210380,5
1,4,21,381,1,681,1,13,6,6,7,single-choice,spatial-relational,6|7,7,6/7,210381,6
1,4,21,382,1,1551,1,3,1,1,2,single-choice,spatial-relational,1|2,7,1/2,210382,1
1,4,21,383,0,746,1,11,5,6,6,single-choice,spatial-relational,5|6,7,5/6,210383,5
1,4,21,384,1,1026,1,13,6,6,7,single-choice,spatial-relational,6|7,7,6/7,210384,6
1,4,21,385,1,4015,1,13,6,6,7,single-choice,spatial-relational,6|7,7,6/7,210385,6
1,4,21,386,1,1116,1,13,6,6,7,single-choice,spatial-relational,6|7,7,6/7,210386,6
1,4,21,387,0,1297,1,5,2,3,3,single-choice,spatial-relational,2|3,7,2/3,210387,2
1,4,21,388,1,755,1,9,4,4,5,single-choice,spatial-relational,4|5,7,4/5,210388,4
1,4,21,389,0,854,1,11,5,6,6,single-choice,spatial-relational,5|6,7,5/6,210389,5
1,4,21,390,0,770,1,5,2,3,3,single-choice,spatial-relational,2|3,7,2/3,210390,2
1,4,21,391,1,2528,1,7,3,3,4,single-choice,spatial-relational,3|4,7,3/4,210391,3
1,4,21,392,1,869,1,9,4,4,5,single-choice,spatial-relational,4|5,7,4/5,210392,4
1,4,21,393,0,2315,1,7,3,4,4,single-choice,spatial-relational,3|4,7,3/4,210393,3
1,4,21,394,1,941,1,3,1,1,2,single-choice,spatial-relational,1|2,7,1/2,210394,1
1,4,21,395,1,1041,1,3,1,1,2,single-choice,spatial-relational,1|2,7,1/2,210395,1
1,4,21,396,0,694,1,11,5,6,6,single-choice,spatial-relational,5|6,7,5/6,210396,5
1,4,21,397,0,644,1,5,2,3,3,single-choice,spatial-relational,2|3,7,2/3,210397,2
1,4,21,398,1,695,1,9,4,4,5,single-choice,spatial-relational,4|5,7,4/5,210398,4
1,4,21,399,1,994,1,7,3,3,4,single-choice,spatial-relational,3|4,7,3/4,210399,3
1,4,21,400,0,1359,1,3,1,2,2,single-choice,spatial-relational,1|2,7,1/2,210400,1
1,4,21,401,1,745,1,13,6,6,7,single-choice,spatial-relational,6|7,7,6/7,210401,6
1,4,21,402,1,620,1,13,6,6,7,single-choice,spatial-relational,6|7,7,6/7,210402,6
1,4,21,403,0,2393,1,11,5,6,6,single-choice,spatial-relational,5|6,7,5/6,210403,5
1,4,21,404,1,908,1,3,1,1,2,single-choice,spatial-relational,1|2,7,1/2,210404,1
1,4,21,405,0,688,1,11,5,6,6,single-choice,spatial-relational,5|6,7,5/6,210405,5
1,4,21,406,1,1075,1,7,3,3,4,single-choice,spatial-relational,3|4,7,3/4,210406,3
1,4,21,407,0,862,1,5,2,3,3,single-choice,spatial-relational,2|3,7,2/3,210407,2
1,4,21,408,1,672,1,9,4,4,5,single-choice,spatial-relational,4|5,7,4/5,210408,4
1,4,21,409,0,872,1,7,3,4,4,single-choice,spatial-relational,3|4,7,3/4,210409,3
1,4,21,410,0,810,1,5,2,3,3,single-choice,spatial-relational,2|3,7,2/3,210410,2
1,4,21,411,0,1235,1,5,2,3,3,single-choice,spatial-relational,2|3,7,2/3,210411,2
1,4,21,412,0,1016,1,11,5,6,6,single-choice,spatial-relational,5|6,7,5/6,210412,5
1,4,21,413,1,877,1,9,4,4,5,single-choice,spatial-relational,4|5,7,4/5,210413,4
1,4,21,414,1,1269,1,9,4,4,5,single-choice,spatial-relational,4|5,7,4/5,210414,4
1,4,21,415,0,1588,1,13,6,7,7,single-choice,spatial-relational,6|7,7,6/7,210415,6
1,4,21,416,0,1171,1,11,5,6,6,single-choice,spatial-relational,5|6,7,5/6,210416,5
1,4,21,417,0,764,1,7,3,4,4,single-choice,spatial-relational,3|4,7,3/4,210417,3
1,4,21,418,1,959,1,3,1,1,2,single-choice,spatial-relational,1|2,7,1/2,210418,1
1,4,21,419,1,1686,1,13,6,6,7,single-choice,spatial-relational,6|7,7,6/7,210419,6
1,4,21,420,1,1458,1,3,1,1,2,single-choice,spatial-relational,1|2,7,1/2,210420,1
1,4,21,421,1,1148,1,3,1,1,2,single-choice,spatial-relational,1|2,7,1/2,210421,1
1,4,21,422,0,649,1,5,2,3,3,single-choice,spatial-relational,2|3,7,2/3,210422,2
1,4,21,423,1,981,1,13,6,6,7,single-choice,spatial-relational,6|7,7,6/7,210423,6
1,4,21,424,1,760,1,13,6,6,7,single-choice,spatial-relational,6|7,7,6/7,210424,6
1,4,21,425,1,920,1,5,2,2,3,single-choice,spatial-relational,2|3,7,2/3,210425,2
1,4,21,426,0,679,1,11,5,6,6,single-choice,spatial-relational,5|6,7,5/6,210426,5
1,4,21,427,1,649,1,3,1,1,2,single-choice,spatial-relational,1|2,7,1/2,210427,1
1,4,21,428,0,854,1,9,4,5,5,single-choice,spatial-relational,4|5,7,4/5,210428,4
1,4,21,429,1,51,1,9,4,4,5,single-choice,spatial-relational,4|5,7,4/5,210429,4
1,4,21,430,0,853,1,7,3,4,4,single-choice,spatial-relational,3|4,7,3/4,210430,3
1,4,21,431,0,901,1,11,5,6,6,single-choice,spatial-relational,5|6,7,5/6,210431,5
1,4,21,432,0,806,1,7,3,4,4,single-choice,spatial-relational,3|4,7,3/4,210432,3
1,4,21,433,0,1251,1,5,2,3,3,single-choice,spatial-relational,2|3,7,2/3,210433,2
1,4,21,434,1,925,1,9,4,4,5,single-choice,spatial-relational,4|5,7,4/5,210434,4
1,4,21,435,1,1627,1,3,1,1,2,single-choice,spatial-relational,1|2,7,1/2,210435,1
1,4,21,436,1,913,1,9,4,4,5,single-choice,spatial-relational,4|5,7,4/5,210436,4
1,4,21,437,0,681,1,11,5,6,6,single-choice,spatial-relational,5|6,7,5/6,210437,5
1,4,21,438,0,1049,1,11,5,6,6,single-choice,spatial-relational,5|6,7,5/6,210438,5
1,4,21,439,0,972,1,7,3,4,4,single-choice,spatial-relational,3|4,7,3/4,210439,3
1,4,21,440,0,1205,1,13,6,7,7,single-choice,spatial-relational,6|7,7,6/7,210440,6
1,4,21,441,1,1119,1,3,1,1,2,single-choice,spatial-relational,1|2,7,1/2,210441,1
1,4,21,442,1,827,1,5,2,2,3,single-choice,spatial-relational,2|3,7,2/3,210442,2
1,4,21,443,0,1288,1,13,6,7,7,single-choice,spatial-relational,6|7,7,6/7,210443,6
1,4,21,444,0,1304,1,7,3,4,4,single-choice,spatial-relational,3|4,7,3/4,210444,3
1,4,21,445,0,752,1,7,3,4,4,single-choice,spatial-relational,3|4,7,3/4,210445,3
1,4,21,446,1,4,1,5,2,2,3,single-choice,spatial-relational,2|3,7,2/3,210446,2
1,4,21,447,0,1244,1,11,5,6,6,single-choice,spatial-relational,5|6,7,5/6,210447,5
1,4,21,448,0,1674,1,13,6,7,7,single-choice,spatial-relational,6|7,7,6/7,210448,6
1,4,21,449,1,244,1,5,2,2,3,single-choice,spatial-relational,2|3,7,2/3,210449,2
1,4,21,450,1,1364,1,3,1,1,2,single-choice,spatial-relational,1|2,7,1/2,210450,1
1,4,21,451,0,919,1,11,5,6,6,single-choice,spatial-relational,5|6,7,5/6,210451,5
1,4,21,452,1,870,1,9,4,4,5,single-choice,spatial-relational,4|5,7,4/5,210452,4
1,4,21,453,1,2957,1,7,3,3,4,single-choice,spatial-relational,3|4,7,3/4,210453,3
1,4,21,454,0,1268,1,13,6,7,7,single-choice,spatial-relational,6|7,7,6/7,210454,6
1,4,21,455,0,7,1,9,4,5,5,single-choice,spatial-relational,4|5,7,4/5,210455,4
1,4,21,456,1,820,1,3,1,1,2,single-choice,spatial-relational,1|2,7,1/2,210456,1
1,4,21,457,0,1022,1,11,5,6,6,single-choice,spatial-relational,5|6,7,5/6,210457,5
1,4,21,458,1,1059,1,5,2,2,3,single-choice,spatial-relational,2|3,7,2/3,210458,2
1,4,21,459,0,728,1,11,5,6,6,single-choice,spatial-relational,5|6,7,5/6,210459,5
1,4,21,460,1,63,1,9,4,4,5,single-choice,spatial-relational,4|5,7,4/5,210460,4
1,4,21,461,1,653,1,3,1,1,2,single-choice,spatial-relational,1|2,7,1/2,210461,1
1,4,21,462,0,744,1,13,6,7,7,single-choice,spatial-relational,6|7,7,6/7,210462,6
1,4,21,463,0,790,1,3,1,2,2,single-choice,spatial-relational,1|2,7,1/2,210463,1
1,4,21,464,1,295,1,7,3,3,4,single-choice,spatial-relational,3|4,7,3/4,210464,3
1,4,21,465,0,607,1,5,2,3,3,single-choice,spatial-relational,2|3,7,2/3,210465,2
1,4,21,466,0,420,1,7,3,4,4,single-choice,spatial-relational,3|4,7,3/4,210466,3
1,4,21,467,1,1060,1,9,4,4,5,single-choice,spatial-relational,4|5,7,4/5,210467,4
1,4,21,468,1,1529,1,13,6,6,7,single-choice,spatial-relational,6|7,7,6/7,210468,6
1,4,21,469,0,1561,1,13,6,7,7,single-choice,spatial-relational,6|7,7,6/7,210469,6
1,4,21,470,0,1147,1,7,3,4,4,single-choice,spatial-relational,3|4,7,3/4,210470,3
1,4,21,471,1,893,1,9,4,4,5,single-choice,spatial-relational,4|5,7,4/5,210471,4
1,4,21,472,1,1583,1,9,4,4,5,single-choice,spatial-relational,4|5,7,4/5,210472,4
1,4,21,473,0,2884,1,11,5,6,6,single-choice,spatial-relational,5|6,7,5/6,210473,5
1,4,21,474,0,813,1,7,3,4,4,single-choice,spatial-relational,3|4,7,3/4,210474,3
1,4,21,475,0,950,1,3,1,2,2,single-choice,spatial-relational,1|2,7,1/2,210475,1
1,4,21,476,1,731,1,13,6,6,7,single-choice,spatial-relational,6|7,7,6/7,210476,6
1,4,21,477,0,858,1,5,2,3,3,single-choice,spatial-relational,2|3,7,2/3,210477,2
1,4,21,478,1,1210,1,3,1,1,2,single-choice,spatial-relational,1|2,7,1/2,210478,1
1,4,21,479,0,2265,1,5,2,3,3,single-choice,spatial-relational,2|3,7,2/3,210479,2
1,4,21,480,1,3,1,11,5,5,6,single-choice,spatial-relational,5|6,7,5/6,210480,5
1,4,21,481,1,3,1,5,2,2,3,single-choice,spatial-relational,2|3,7,2/3,210481,2
1,4,21,482,0,8,1,11,5,6,6,single-choice,spatial-relational,5|6,7,5/6,210482,5
1,4,21,483,0,869,1,7,3,4,4,single-choice,spatial-relational,3|4,7,3/4,210483,3
1,4,21,484,1,1447,1,3,1,1,2,single-choice,spatial-relational,1|2,7,1/2,210484,1
1,4,21,485,1,1182,1,11,5,5,6,single-choice,spatial-relational,5|6,7,5/6,210485,5
1,4,21,486,1,2212,1,13,6,6,7,single-choice,spatial-relational,6|7,7,6/7,210486,6
1,4,21,487,0,2,1,7,3,4,4,single-choice,spatial-relational,3|4,7,3/4,210487,3
1,4,21,488,0,863,1,9,4,5,5,single-choice,spatial-relational,4|5,7,4/5,210488,4
1,4,21,489,0,1413,1,13,6,7,7,single-choice,spatial-relational,6|7,7,6/7,210489,6
1,4,21,490,1,1155,1,3,1,1,2,single-choice,spatial-relational,1|2,7,1/2,210490,1
1,4,21,491,0,282,1,5,2,3,3,single-choice,spatial-relational,2|3,7,2/3,210491,2
1,4,21,492,1,1355,1,9,4,4,5,single-choice,spatial-relational,4|5,7,4/5,210492,4
1,4,21,493,1,814,1,13,6,6,7,single-choice,spatial-relational,6|7,7,6/7,210493,6
1,4,21,494,1,268,1,3,1,1,2,single-choice,spatial-relational,1|2,7,1/2,210494,1
1,4,21,495,0,699,1,11,5,6,6,single-choice,spatial-relational,5|6,7,5/6,210495,5
1,4,21,496,0,88,1,3,1,2,2,single-choice,spatial-relational,1|2,7,1/2,210496,1
1,4,21,497,0,1076,1,7,3,4,4,single-choice,spatial-relational,3|4,7,3/4,210497,3
1,4,21,498,1,901,1,9,4,4,5,single-choice,spatial-relational,4|5,7,4/5,210498,4
1,4,21,499,0,1335,1,5,2,3,3,single-choice,spatial-relational,2|3,7,2/3,210499,2
1,4,21,500,0,1877,1,5,2,3,3,single-choice,spatial-relational,2|3,7,2/3,210500,2
1,4,21,501,0,1162,1,11,5,6,6,single-choice,spatial-relational,5|6,7,5/6,210501,5
1,4,21,502,0,2267,1,7,3,4,4,single-choice,spatial-relational,3|4,7,3/4,210502,3
1,4,21,503,1,920,1,13,6,6,7,single-choice,spatial-relational,6|7,7,6/7,210503,6
1,4,21,504,1,2297,1,9,4,4,5,single-choice,spatial-relational,4|5,7,4/5,210504,4
1,4,21,505,0,1325,1,3,1,2,2,single-choice,spatial-relational,1|2,7,1/2,210505,1
1,4,21,506,0,1478,1,11,5,6,6,single-choice,spatial-relational,5|6,7,5/6,210506,5
1,4,21,507,1,869,1,9,4,4,5,single-choice,spatial-relational,4|5,7,4/5,210507,4
1,4,21,508,1,7,1,3,1,1,2,single-choice,spatial-relational,1|2,7,1/2,210508,1
1,4,21,509,0,431,1,5,2,3,3,single-choice,spatial-relational,2|3,7,2/3,210509,2
1,4,21,510,0,23,1,7,3,4,4,single-choice,spatial-relational,3|4,7,3/4,210510,3
1,4,21,511,1,1053,1,13,6,6,7,single-choice,spatial-relational,6|7,7,6/7,210511,6
1,4,21,512,0,1033,1,7,3,4,4,single-choice,spatial-relational,3|4,7,3/4,210512,3
1,4,21,513,0,1266,1,11,5,6,6,single-choice,spatial-relational,5|6,7,5/6,210513,5
1,4,21,514,1,1035,1,5,2,2,3,single-choice,spatial-relational,2|3,7,2/3,210514,2
1,4,21,515,1,983,1,9,4,4,5,single-choice,spatial-relational,4|5,7,4/5,210515,4
1,4,21,516,1,1567,1,13,6,6,7,single-choice,spatial-relational,6|7,7,6/7,210516,6
1,4,21,517,0,966,1,11,5,6,6,single-choice,spatial-relational,5|6,7,5/6,210517,5
1,4,21,518,1,1251,1,3,1,1,2,single-choice,spatial-relational,1|2,7,1/2,210518,1
1,4,21,519,0,684,1,7,3,4,4,single-choice,spatial-relational,3|4,7,3/4,210519,3
1,4,21,520,1,1025,1,9,4,4,5,single-choice,spatial-relational,4|5,7,4/5,210520,4
1,4,21,521,1,1152,1,5,2,2,3,single-choice,spatial-relational,2|3,7,2/3,210521,2
1,4,21,522,0,1526,1,11,5,6,6,single-choice,spatial-relational,5|6,7,5/6,210522,5
1,4,21,523,1,1259,1,13,6,6,7,single-choice,spatial-relational,6|7,7,6/7,210523,6
1,4,21,524,0,1472,1,5,2,3,3,single-choice,spatial-relational,2|3,7,2/3,210524,2
1,4,21,525,1,945,1,3,1,1,2,single-choice,spatial-relational,1|2,7,1/2,210525,1
1,4,21,526,1,1248,1,13,6,6,7,single-choice,spatial-relational,6|7,7,6/7,210526,6
1,4,21,527,1,1380,1,9,4,4,5,single-choice,spatial-relational,4|5,7,4/5,210527,4
1,4,21,528,0,1662,1,7,3,4,4,single-choice,spatial-relational,3|4,7,3/4,210528,3
1,4,21,529,0,1214,1,11,5,6,6,single-choice,spatial-relational,5|6,7,5/6,210529,5
1,4,21,530,1,1498,1,13,6,6,7,single-choice,spatial-relational,6|7,7,6/7,210530,6
1,4,21,531,1,1646,1,3,1,1,2,single-choice,spatial-relational,1|2,7,1/2,210531,1
1,4,21,532,1,948,1,9,4,4,5,single-choice,spatial-relational,4|5,7,4/5,210532,4
1,4,21,533,1,1456,1,5,2,2,3,single-choice,spatial-relational,2|3,7,2/3,210533,2
1,4,21,534,1,831,1,9,4,4,5,single-choice,spatial-relational,4|5,7,4/5,210534,4
1,4,21,535,0,1474,1,7,3,4,4,single-choice,spatial-relational,3|4,7,3/4,210535,3
1,4,21,536,0,5,1,5,2,3,3,single-choice,spatial-relational,2|3,7,2/3,210536,2
1,4,21,537,1,13,1,3,1,1,2,single-choice,spatial-relational,1|2,7,1/2,210537,1
1,4,21,538,1,1338,1,13,6,6,7,single-choice,spatial-relational,6|7,7,6/7,210538,6
1,4,21,539,0,1241,1,7,3,4,4,single-choice,spatial-relational,3|4,7,3/4,210539,3
1,4,21,540,1,168,1,11,5,5,6,single-choice,spatial-relational,5|6,7,5/6,210540,5
1,4,21,541,0,921,1,7,3,4,4,single-choice,spatial-relational,3|4,7,3/4,210541,3
1,4,21,542,0,1450,1,11,5,6,6,single-choice,spatial-relational,5|6,7,5/6,210542,5
1,4,21,543,1,1453,1,13,6,6,7,single-choice,spatial-relational,6|7,7,6/7,210543,6
1,4,21,544,1,974,1,9,4,4,5,single-choice,spatial-relational,4|5,7,4/5,210544,4
1,4,21,545,1,1666,1,3,1,1,2,single-choice,spatial-relational,1|2,7,1/2,210545,1
1,4,21,546,0,671,1,11,5,6,6,single-choice,spatial-relational,5|6,7,5/6,210546,5
1,4,21,547,1,1459,1,13,6,6,7,single-choice,spatial-relational,6|7,7,6/7,210547,6
1,4,21,548,1,2444,1,5,2,2,3,single-choice,spatial-relational,2|3,7,2/3,210548,2
1,4,21,549,1,1196,1,3,1,1,2,single-choice,spatial-relational,1|2,7,1/2,210549,1
1,4,21,550,1,1339,1,9,4,4,5,single-choice,spatial-relational,4|5,7,4/5,210550,4
1,4,21,551,0,1713,1,7,3,4,4,single-choice,spatial-relational,3|4,7,3/4,210551,3
1,4,21,552,0,753,1,5,2,3,3,single-choice,spatial-relational,2|3,7,2/3,210552,2
1,4,21,553,1,1190,1,13,6,6,7,single-choice,spatial-relational,6|7,7,6/7,210553,6
1,4,21,554,1,999,1,13,6,6,7,single-choice,spatial-relational,6|7,7,6/7,210554,6
1,4,21,555,1,1633,1,7,3,3,4,single-choice,spatial-relational,3|4,7,3/4,210555,3
1,4,21,556,1,1132,1,3,1,1,2,single-choice,spatial-relational,1|2,7,1/2,210556,1
1,4,21,557,0,823,1,11,5,6,6,single-choice,spatial-relational,5|6,7,5/6,210557,5
1,4,21,558,0,825,1,5,2,3,3,single-choice,spatial-relational,2|3,7,2/3,210558,2
1,4,21,559,1,1279,1,9,4,4,5,single-choice,spatial-relational,4|5,7,4/5,210559,4
1,4,21,560,0,853,1,5,2,3,3,single-choice,spatial-relational,2|3,7,2/3,210560,2
1,4,21,561,1,882,1,3,1,1,2,single-choice,spatial-relational,1|2,7,1/2,210561,1
1,4,21,562,0,857,1,11,5,6,6,single-choice,spatial-relational,5|6,7,5/6,210562,5
1,4,21,563,1,82,1,9,4,4,5,single-choice,spatial-relational,4|5,7,4/5,210563,4
1,4,21,564,0,895,1,7,3,4,4,single-choice,spatial-relational,3|4,7,3/4,210564,3
1,4,21,565,0,973,1,5,2,3,3,single-choice,spatial-relational,2|3,7,2/3,210565,2
1,4,21,566,0,870,1,7,3,4,4,single-choice,spatial-relational,3|4,7,3/4,210566,3
1,4,21,567,1,1283,1,13,6,6,7,single-choice,spatial-relational,6|7,7,6/7,210567,6
1,4,21,568,1,10,1,11,5,5,6,single-choice,spatial-relational,5|6,7,5/6,210568,5
1,4,21,569,1,740,1,3,1,1,2,single-choice,spatial-relational,1|2,7,1/2,210569,1
1,4,21,570,0,334,1,9,4,5,5,single-choice,spatial-relational,4|5,7,4/5,210570,4
1,4,21,571,1,1665,1,9,4,4,5,single-choice,spatial-relational,4|5,7,4/5,210571,4
1,4,21,572,1,1034,1,3,1,1,2,single-choice,spatial-relational,1|2,7,1/2,210572,1
1,4,21,573,0,1060,1,7,3,4,4,single-choice,spatial-relational,3|4,7,3/4,210573,3
1,4,21,574,1,778,1,5,2,2,3,single-choice,spatial-relational,2|3,7,2/3,210574,2
1,4,21,575,0,997,1,11,5,6,6,single-choice,spatial-relational,5|6,7,5/6,210575,5
1,4,21,576,1,754,1,13,6,6,7,single-choice,spatial-relational,6|7,7,6/7,210576,6
1,4,21,577,0,776,1,5,2,3,3,single-choice,spatial-relational,2|3,7,2/3,210577,2
1,4,21,578,0,1312,1,11,5,6,6,single-choice,spatial-relational,5|6,7,5/6,210578,5
1,4,21,579,0,1012,1,11,5,6,6,single-choice,spatial-relational,5|6,7,5/6,210579,5
1,4,21,580,1,789,1,3,1,1,2,single-choice,spatial-relational,1|2,7,1/2,210580,1
1,4,21,581,1,836,1,3,1,1,2,single-choice,spatial-relational,1|2,7,1/2,210581,1
1,4,21,582,1,1007,1,13,6,6,7,single-choice,spatial-relational,6|7,7,6/7,210582,6
1,4,21,583,1,962,1,13,6,6,7,single-choice,spatial-relational,6|7,7,6/7,210583,6
1,4,21,584,1,3102,1,9,4,4,5,single-choice,spatial-relational,4|5,7,4/5,210584,4
1,4,21,585,1,894,1,5,2,2,3,single-choice,spatial-relational,2|3,7,2/3,210585,2
1,4,21,586,0,1873,1,7,3,4,4,single-choice,spatial-relational,3|4,7,3/4,210586,3
1,4,21,587,1,1188,1,9,4,4,5,single-choice,spatial-relational,4|5,7,4/5,210587,4
1,4,21,588,1,127,1,7,3,3,4,single-choice,spatial-relational,3|4,7,3/4,210588,3
1,4,21,589,1,1737,1,9,4,4,5,single-choice,spatial-relational,4|5,7,4/5,210589,4
1,4,21,590,1,689,1,3,1,1,2,single-choice,spatial-relational,1|2,7,1/2,210590,1
1,4,21,591,0,700,1,7,3,4,4,single-choice,spatial-relational,3|4,7,3/4,210591,3
1,4,21,592,0,882,1,5,2,3,3,single-choice,spatial-relational,2|3,7,2/3,210592,2
1,4,21,593,1,1116,1,9,4,4,5,single-choice,spatial-relational,4|5,7,4/5,210593,4
1,4,21,594,1,1204,1,5,2,2,3,single-choice,spatial-relational,2|3,7,2/3,210594,2
1,4,21,595,0,890,1,11,5,6,6,single-choice,spatial-relational,5|6,7,5/6,210595,5
1,4,21,596,1,608,1,7,3,3,4,single-choice,spatial-relational,3|4,7,3/4,210596,3
1,4,21,597,1,1642,1,13,6,6,7,single-choice,spatial-relational,6|7,7,6/7,210597,6
1,4,21,598,0,1086,1,3,1,2,2,single-choice,spatial-relational,1|2,7,1/2,210598,1
1,4,21,599,1,850,1,13,6,6,7,single-choice,spatial-relational,6|7,7,6/7,210599,6
1,4,21,600,0,1950,1,11,5,6,6,single-choice,spatial-relational,5|6,7,5/6,210600,5
2,4,21,1,1,697,1,13,6,6,7,single-choice,spatial-relational,6|7,7,6/7,210001,6
2,4,21,2,1,681,1,13,6,6,7,single-choice,spatial-relational,6|7,7,6/7,210002,6
2,4,21,3,1,1052,1,9,4,4,5,single-choice,spatial-relational,4|5,7,4/5,210003,4
2,4,21,4,0,549,1,3,1,2,2,single-choice,spatial-relational,1|2,7,1/2,210004,1
2,4,21,5,0,579,1,11,5,6,6,single-choice,spatial-relational,5|6,7,5/6,210005,5
2,4,21,6,1,613,1,9,4,4,5,single-choice,spatial-relational,4|5,7,4/5,210006,4
2,4,21,7,1,768,1,5,2,2,3,single-choice,spatial-relational,2|3,7,2/3,210007,2
2,4,21,8,0,940,1,7,3,4,4,single-choice,spatial-relational,3|4,7,3/4,210008,3
2,4,21,9,0,583,1,7,3,4,4,single-choice,spatial-relational,3|4,7,3/4,210009,3
2,4,21,10,0,854,1,11,5,6,6,single-choice,spatial-relational,5|6,7,5/6,210010,5
2,4,21,11,1,648,1,3,1,1,2,single-choice,spatial-relational,1|2,7,1/2,210011,1
2,4,21,12,0,732,1,5,2,3,3,single-choice,spatial-relational,2|3,7,2/3,210012,2
2,4,21,13,1,767,1,9,4,4,5,single-choice,spatial-relational,4|5,7,4/5,210013,4
2,4,21,14,0,843,1,11,5,6,6,single-choice,spatial-relational,5|6,7,5/6,210014,5
2,4,21,15,1,648,1,3,1,1,2,single-choice,spatial-relational,1|2,7,1/2,210015,1
2,4,21,16,1,655,1,13,6,6,7,single-choice,spatial-relational,6|7,7,6/7,210016,6
2,4,21,17,0,1278,1,13,6,7,7,single-choice,spatial-relational,6|7,7,6/7,210017,6
2,4,21,18,0,590,1,7,3,4,4,single-choice,spatial-relational,3|4,7,3/4,210018,3
2,4,21,19,0,788,1,11,5,6,6,single-choice,spatial-relational,5|6,7,5/6,210019,5
2,4,21,20,1,670,1,3,1,1,2,single-choice,spatial-relational,1|2,7,1/2,210020,1
2,4,21,21,1,1241,1,9,4,4,5,single-choice,spatial-relational,4|5,7,4/5,210021,4
2,4,21,22,0,811,1,7,3,4,4,single-choice,spatial-relational,3|4,7,3/4,210022,3
2,4,21,23,0,744,1,5,2,3,3,single-choice,spatial-relational,2|3,7,2/3,210023,2
2,4,21,24,0,824,1,5,2,3,3,single-choice,spatial-relational,2|3,7,2/3,210024,2
2,4,21,25,1,931,1,13,6,6,7,single-choice,spatial-relational,6|7,7,6/7,210025,6
2,4,21,26,1,1106,1,9,4,4,5,single-choice,spatial-relational,4|5,7,4/5,210026,4
2,4,21,27,1,1283,1,7,3,3,4,single-choice,spatial-relational,3|4,7,3/4,210027,3
2,4,21,28,1,1288,1,3,1,1,2,single-choice,spatial-relational,1|2,7,1/2,210028,1
2,4,21,29,1,1044,1,13,6,6,7,single-choice,spatial-relational,6|7,7,6/7,210029,6
2,4,21,30,0,1395,1,11,5,6,6,single-choice,spatial-relational,5|6,7,5/6,210030,5
2,4,21,31,0,705,1,7,3,4,4,single-choice,spatial-relational,3|4,7,3/4,210031,3
2,4,21,32,0,744,1,5,2,3,3,single-choice,spatial-relational,2|3,7,2/3,210032,2
2,4,21,33,1,982,1,5,2,2,3,single-choice,spatial-relational,2|3,7,2/3,210033,2
2,4,21,34,0,892,1,11,5,6,6,single-choice,spatial-relational,5|6,7,5/6,210034,5
2,4,21,35,0,32,1,3,1,2,2,single-choice,spatial-relational,1|2,7,1/2,210035,1
2,4,21,36,1,940,1,9,4,4,5,single-choice,spatial-relational,4|5,7,4/5,210036,4
2,4,21,37,1,905,1,9,4,4,5,single-choice,spatial-relational,4|5,7,4/5,210037,4
2,4,21,38,0,1169,1,13,6,7,7,single-choice,spatial-relational,6|7,7,6/7,210038,6
2,4,21,39,1,1521,1,5,2,2,3,single-choice,spatial-relational,2|3,7,2/3,210039,2
2,4,21,40,1,783,1,9,4,4,5,single-choice,spatial-relational,4|5,7,4/5,210040,4
2,4,21,41,1,991,1,7,3,3,4,single-choice,spatial-relational,3|4,7,3/4,210041,3
2,4,21,42,1,981,1,5,2,2,3,single-choice,spatial-relational,2|3,7,2/3,210042,2
2,4,21,43,1,943,1,3,1,1,2,single-choice,spatial-relational,1|2,7,1/2,210043,1
2,4,21,44,0,1046,1,7,3,4,4,single-choice,spatial-relational,3|4,7,3/4,210044,3
2,4,21,45,0,851,1,11,5,6,6,single-choice,spatial-relational,5|6,7,5/6,210045,5
2,4,21,46,1,737,1,3,1,1,2,single-choice,spatial-relational,1|2,7,1/2,210046,1
2,4,21,47,0,1023,1,13,6,7,7,single-choice,spatial-relational,6|7,7,6/7,210047,6
2,4,21,48,1,1088,1,11,5,5,6,single-choice,spatial-relational,5|6,7,5/6,210048,5
2,4,21,49,1,986,1,9,4,4,5,single-choice,spatial-relational,4|5,7,4/5,210049,4
2,4,21,50,1,1136,1,13,6,6,7,single-choice,spatial-relational,6|7,7,6/7,210050,6
2,4,21,51,0,638,1,7,3,4,4,single-choice,spatial-relational,3|4,7,3/4,210051,3
2,4,21,52,0,837,1,5,2,3,3,single-choice,spatial-relational,2|3,7,2/3,210052,2
2,4,21,53,1,765,1,5,2,2,3,single-choice,spatial-relational,2|3,7,2/3,210053,2
2,4,21,54,1,1000,1,3,1,1,2,single-choice,spatial-relational,1|2,7,1/2,210054,1
2,4,21,55,1,1136,1,11,5,5,6,single-choice,spatial-relational,5|6,7,5/6,210055,5
2,4,21,56,1,1473,1,13,6,6,7,single-choice,spatial-relational,6|7,7,6/7,210056,6
2,4,21,57,1,1902,1,9,4,4,5,single-choice,spatial-relational,4|5,7,4/5,210057,4
2,4,21,58,1,1076,1,3,1,1,2,single-choice,spatial-relational,1|2,7,1/2,210058,1
2,4,21,59,0,1108,1,11,5,6,6,single-choice,spatial-relational,5|6,7,5/6,210059,5
2,4,21,60,0,659,1,7,3,4,4,single-choice,spatial-relational,3|4,7,3/4,210060,3
2,4,21,61,0,830,1,7,3,4,4,single-choice,spatial-relational,3|4,7,3/4,210061,3
2,4,21,62,0,666,1,7,3,4,4,single-choice,spatial-relational,3|4,7,3/4,210062,3
2,4,21,63,1,1094,1,11,5,5,6,single-choice,spatial-relational,5|6,7,5/6,210063,5
2,4,21,64,1,850,1,5,2,2,3,single-choice,spatial-relational,2|3,7,2/3,210064,2
2,4,21,65,1,1068,1,13,6,6,7,single-choice,spatial-relational,6|7,7,6/7,210065,6
2,4,21,66,0,1618,1,13,6,7,7,single-choice,spatial-relational,6|7,7,6/7,210066,6
2,4,21,67,0,1209,1,9,4,5,5,single-choice,spatial-relational,4|5,7,4/5,210067,4
2,4,21,68,0,728,1,11,5,6,6,single-choice,spatial-relational,5|6,7,5/6,210068,5
2,4,21,69,1,742,1,3,1,1,2,single-choice,spatial-relational,1|2,7,1/2,210069,1
2,4,21,70,0,1273,1,3,1,2,2,single-choice,spatial-relational,1|2,7,1/2,210070,1
2,4,21,71,0,1578,1,9,4,5,5,single-choice,spatial-relational,4|5,7,4/5,210071,4
2,4,21,72,0,887,1,5,2,3,3,single-choice,spatial-relational,2|3,7,2/3,210072,2
2,4,21,73,1,1400,1,13,6,6,7,single-choice,spatial-relational,6|7,7,6/7,210073,6
2,4,21,74,1,1390,1,7,3,3,4,single-choice,spatial-relational,3|4,7,3/4,210074,3
2,4,21,75,1,1962,1,3,1,1,2,single-choice,spatial-relational,1|2,7,1/2,210075,1
2,4,21,76,1,909,1,5,2,2,3,single-choice,spatial-relational,2|3,7,2/3,210076,2
2,4,21,77,0,965,1,3,1,2,2,single-choice,spatial-relational,1|2,7,1/2,210077,1
2,4,21,78,0,772,1,11,5,6,6,single-choice,spatial-relational,5|6,7,5/6,210078,5
2,4,21,79,0,1341,1,5,2,3,3,single-choice,spatial-relational,2|3,7,2/3,210079,2
2,4,21,80,0,800,1,7,3,4,4,single-choice,spatial-relational,3|4,7,3/4,210080,3
2,4,21,81,1,1528,1,9,4,4,5,single-choice,spatial-relational,4|5,7,4/5,210081,4
2,4,21,82,0,1069,1,11,5,6,6,single-choice,spatial-relational,5|6,7,5/6,210082,5
2,4,21,83,1,1805,1,9,4,4,5,single-choice,spatial-relational,4|5,7,4/5,210083,4
2,4,21,84,0,1052,1,13,6,7,7,single-choice,spatial-relational,6|7,7,6/7,210084,6
2,4,21,85,0,1219,1,11,5,6,6,single-choice,spatial-relational,5|6,7,5/6,210085,5
2,4,21,86,0,570,1,7,3,4,4,single-choice,spatial-relational,3|4,7,3/4,210086,3
2,4,21,87,0,56,1,3,1,2,2,single-choice,spatial-relational,1|2,7,1/2,210087,1
2,4,21,88,1,1200,1,13,6,6,7,single-choice,spatial-relational,6|7,7,6/7,210088,6
2,4,21,89,0,764,1,7,3,4,4,single-choice,spatial-relational,3|4,7,3/4,210089,3
2,4,21,90,1,900,1,5,2,2,3,single-choice,spatial-relational,2|3,7,2/3,210090,2
2,4,21,91,1,1902,1,13,6,6,7,single-choice,spatial-relational,6|7,7,6/7,210091,6
2,4,21,92,1,1905,1,9,4,4,5,single-choice,spatial-relational,4|5,7,4/5,210092,4
2,4,21,93,1,1008,1,5,2,2,3,single-choice,spatial-relational,2|3,7,2/3,210093,2
2,4,21,94,0,1060,1,3,1,2,2,single-choice,spatial-relational,1|2,7,1/2,210094,1
2,4,21,95,1,2184,1,9,4,4,5,single-choice,spatial-relational,4|5,7,4/5,210095,4
2,4,21,96,0,1080,1,11,5,6,6,single-choice,spatial-relational,5|6,7,5/6,210096,5
2,4,21,97,0,609,1,3,1,2,2,single-choice,spatial-relational,1|2,7,1/2,210097,1
2,4,21,98,1,1471,1,5,2,2,3,single-choice,spatial-relational,2|3,7,2/3,210098,2
2,4,21,99,0,1848,1,9,4,5,5,single-choice,spatial-relational,4|5,7,4/5,210099,4
2,4,21,100,1,911,1,5,2,2,3,single-choice,spatial-relational,2|3,7,2/3,210100,2
2,4,21,101,1,1666,1,13,6,6,7,single-choice,spatial-relational,6|7,7,6/7,210101,6
2,4,21,102,1,1591,1,7,3,3,4,single-choice,spatial-relational,3|4,7,3/4,210102,3
2,4,21,103,0,2151,1,11,5,6,6,single-choice,spatial-relational,5|6,7,5/6,210103,5
2,4,21,104,1,1269,1,9,4,4,5,single-choice,spatial-relational,4|5,7,4/5,210104,4
2,4,21,105,1,1080,1,7,3,3,4,single-choice,spatial-relational,3|4,7,3/4,210105,3
2,4,21,106,0,1886,1,11,5,6,6,single-choice,spatial-relational,5|6,7,5/6,210106,5
2,4,21,107,1,1208,1,3,1,1,2,single-choice,spatial-relational,1|2,7,1/2,210107,1
2,4,21,108,0,1876,1,13,6,7,7,single-choice,spatial-relational,6|7,7,6/7,210108,6
2,4,21,109,0,903,1,7,3,4,4,single-choice,spatial-relational,3|4,7,3/4,210109,3
2,4,21,110,1,1631,1,9,4,4,5,single-choice,spatial-relational,4|5,7,4/5,210110,4
2,4,21,111,0,918,1,3,1,2,2,single-choice,spatial-relational,1|2,7,1/2,210111,1
2,4,21,112,0,1120,1,11,5,6,6,single-choice,spatial-relational,5|6,7,5/6,210112,5
2,4,21,113,1,1199,1,3,1,1,2,single-choice,spatial-relational,1|2,7,1/2,210113,1
2,4,21,114,0,1168,1,7,3,4,4,single-choice,spatial-relational,3|4,7,3/4,210114,3
2,4,21,115,1,976,1,9,4,4,5,single-choice,spatial-relational,4|5,7,4/5,210115,4
2,4,21,116,0,1222,1,11,5,6,6,single-choice,spatial-relational,5|6,7,5/6,210116,5
2,4,21,117,1,2124,1,13,6,6,7,single-choice,spatial-relational,6|7,7,6/7,210117,6
2,4,21,118,0,1658,1,5,2,3,3,single-choice,spatial-relational,2|3,7,2/3,210118,2
2,4,21,119,1,1376,1,5,2,2,3,single-choice,spatial-relational,2|3,7,2/3,210119,2
2,4,21,120,1,1497,1,13,6,6,7,single-choice,spatial-relational,6|7,7,6/7,210120,6
2,4,21,121,1,1542,1,9,4,4,5,single-choice,spatial-relational,4|5,7,4/5,210121,4
2,4,21,122,0,2365,1,11,5,6,6,single-choice,spatial-relational,5|6,7,5/6,210122,5
2,4,21,123,0,827,1,5,2,3,3,single-choice,spatial-relational,2|3,7,2/3,210123,2
2,4,21,124,1,1268,1,13,6,6,7,single-choice,spatial-relational,6|7,7,6/7,210124,6
2,4,21,125,1,1105,1,3,1,1,2,single-choice,spatial-relational,1|2,7,1/2,210125,1
2,4,21,126,0,1471,1,3,1,2,2,single-choice,spatial-relational,1|2,7,1/2,210126,1
2,4,21,127,0,855,1,7,3,4,4,single-choice,spatial-relational,3|4,7,3/4,210127,3
2,4,21,128,0,32,1,5,2,3,3,single-choice,spatial-relational,2|3,7,2/3,210128,2
2,4,21,129,0,662,1,11,5,6,6,single-choice,spatial-relational,5|6,7,5/6,210129,5
2,4,21,130,1,1264,1,13,6,6,7,single-choice,spatial-relational,6|7,7,6/7,210130,6
2,4,21,131,1,1513,1,9,4,4,5,single-choice,spatial-relational,4|5,7,4/5,210131,4
2,4,21,132,1,408,1,7,3,3,4,single-choice,spatial-relational,3|4,7,3/4,210132,3
2,4,21,133,1,878,1,5,2,2,3,single-choice,spatial-relational,2|3,7,2/3,210133,2
2,4,21,134,0,955,1,11,5,6,6,single-choice,spatial-relational,5|6,7,5/6,210134,5
2,4,21,135,0,920,1,11,5,6,6,single-choice,spatial-relational,5|6,7,5/6,210135,5
2,4,21,136,1,719,1,9,4,4,5,single-choice,spatial-relational,4|5,7,4/5,210136,4
2,4,21,137,0,842,1,3,1,2,2,single-choice,spatial-relational,1|2,7,1/2,210137,1
2,4,21,138,1,635,1,3,1,1,2,single-choice,spatial-relational,1|2,7,1/2,210138,1
2,4,21,139,1,1110,1,13,6,6,7,single-choice,spatial-relational,6|7,7,6/7,210139,6
2,4,21,140,0,1620,1,7,3,4,4,single-choice,spatial-relational,3|4,7,3/4,210140,3
2,4,21,141,0,931,1,7,3,4,4,single-choice,spatial-relational,3|4,7,3/4,210141,3
2,4,21,142,0,719,1,5,2,3,3,single-choice,spatial-relational,2|3,7,2/3,210142,2
2,4,21,143,1,1119,1,13,6,6,7,single-choice,spatial-relational,6|7,7,6/7,210143,6
2,4,21,144,0,1190,1,9,4,5,5,single-choice,spatial-relational,4|5,7,4/5,210144,4
2,4,21,145,0,903,1,11,5,6,6,single-choice,spatial-relational,5|6,7,5/6,210145,5
2,4,21,146,1,1339,1,3,1,1,2,single-choice,spatial-relational,1|2,7,1/2,210146,1
2,4,21,147,0,857,1,7,3,4,4,single-choice,spatial-relational,3|4,7,3/4,210147,3
2,4,21,148,1,771,1,13,6,6,7,single-choice,spatial-relational,6|7,7,6/7,210148,6
2,4,21,149,0,1160,1,5,2,3,3,single-choice,spatial-relational,2|3,7,2/3,210149,2
2,4,21,150,0,740,1,5,2,3,3,single-choice,spatial-relational,2|3,7,2/3,210150,2
2,4,21,151,1,978,1,13,6,6,7,single-choice,spatial-relational,6|7,7,6/7,210151,6
2,4,21,152,1,1261,1,9,4,4,5,single-choice,spatial-relational,4|5,7,4/5,210152,4
2,4,21,153,1,1248,1,3,1,1,2,single-choice,spatial-relational,1|2,7,1/2,210153,1
2,4,21,154,0,846,1,7,3,4,4,single-choice,spatial-relational,3|4,7,3/4,210154,3
2,4,21,155,1,785,1,9,4,4,5,single-choice,spatial-relational,4|5,7,4/5,210155,4
2,4,21,156,0,1146,1,11,5,6,6,single-choice,spatial-relational,5|6,7,5/6,210156,5
2,4,21,157,1,943,1,5,2,2,3,single-choice,spatial-relational,2|3,7,2/3,210157,2
2,4,21,158,0,748,1,7,3,4,4,single-choice,spatial-relational,3|4,7,3/4,210158,3
2,4,21,159,0,667,1,11,5,6,6,single-choice,spatial-relational,5|6,7,5/6,210159,5
2,4,21,160,1,952,1,13,6,6,7,single-choice,spatial-relational,6|7,7,6/7,210160,6
2,4,21,161,1,1508,1,9,4,4,5,single-choice,spatial-relational,4|5,7,4/5,210161,4
2,4,21,162,0,1894,1,3,1,2,2,single-choice,spatial-relational,1|2,7,1/2,210162,1
2,4,21,163,1,951,1,5,2,2,3,single-choice,spatial-relational,2|3,7,2/3,210163,2
2,4,21,164,0,754,1,7,3,4,4,single-choice,spatial-relational,3|4,7,3/4,210164,3
2,4,21,165,0,52,1,9,4,5,5,single-choice,spatial-relational,4|5,7,4/5,210165,4
2,4,21,166,1,1528,1,13,6,6,7,single-choice,spatial-relational,6|7,7,6/7,210166,6
2,4,21,167,1,1355,1,11,5,5,6,single-choice,spatial-relational,5|6,7,5/6,210167,5
2,4,21,168,1,2152,1,3,1,1,2,single-choice,spatial-relational,1|2,7,1/2,210168,1
2,4,21,169,0,1608,1,11,5,6,6,single-choice,spatial-relational,5|6,7,5/6,210169,5
2,4,21,170,1,1135,1,7,3,3,4,single-choice,spatial-relational,3|4,7,3/4,210170,3
2,4,21,171,1,1640,1,5,2,2,3,single-choice,spatial-relational,2|3,7,2/3,210171,2
2,4,21,172,1,1408,1,5,2,2,3,single-choice,spatial-relational,2|3,7,2/3,210172,2
2,4,21,173,1,1887,1,13,6,6,7,single-choice,spatial-relational,6|7,7,6/7,210173,6
2,4,21,174,0,2759,1,3,1,2,2,single-choice,spatial-relational,1|2,7,1/2,210174,1
2,4,21,175,0,893,1,3,1,2,2,single-choice,spatial-relational,1|2,7,1/2,210175,1
2,4,21,176,0,1073,1,11,5,6,6,single-choice,spatial-relational,5|6,7,5/6,210176,5
2,4,21,177,0,903,1,13,6,7,7,single-choice,spatial-relational,6|7,7,6/7,210177,6
2,4,21,178,0,1319,1,9,4,5,5,single-choice,spatial-relational,4|5,7,4/5,210178,4
2,4,21,179,1,1069,1,7,3,3,4,single-choice,spatial-relational,3|4,7,3/4,210179,3
2,4,21,180,1,2233,1,9,4,4,5,single-choice,spatial-relational,4|5,7,4/5,210180,4
2,4,21,181,0,1292,1,11,5,6,6,single-choice,spatial-relational,5|6,7,5/6,210181,5
2,4,21,182,1,962,1,3,1,1,2,single-choice,spatial-relational,1|2,7,1/2,210182,1
2,4,21,183,0,1061,1,5,2,3,3,single-choice,spatial-relational,2|3,7,2/3,210183,2
2,4,21,184,0,1539,1,7,3,4,4,single-choice,spatial-relational,3|4,7,3/4,210184,3
2,4,21,185,1,1789,1,13,6,6,7,single-choice,spatial-relational,6|7,7,6/7,210185,6
2,4,21,186,0,1547,1,3,1,2,2,single-choice,spatial-relational,1|2,7,1/2,210186,1
2,4,21,187,1,1383,1,7,3,3,4,single-choice,spatial-relational,3|4,7,3/4,210187,3
2,4,21,188,0,1053,1,5,2,3,3,single-choice,spatial-relational,2|3,7,2/3,210188,2
2,4,21,189,0,743,1,11,5,6,6,single-choice,spatial-relational,5|6,7,5/6,210189,5
2,4,21,190,1,1281,1,9,4,4,5,single-choice,spatial-relational,4|5,7,4/5,210190,4
2,4,21,191,0,1100,1,13,6,7,7,single-choice,spatial-relational,6|7,7,6/7,210191,6
2,4,21,192,1,1426,1,9,4,4,5,single-choice,spatial-relational,4|5,7,4/5,210192,4
2,4,21,193,0,1079,1,3,1,2,2,single-choice,spatial-relational,1|2,7,1/2,210193,1
2,4,21,194,0,753,1,11,5,6,6,single-choice,spatial-relational,5|6,7,5/6,210194,5
2,4,21,195,0,893,1,7,3,4,4,single-choice,spatial-relational,3|4,7,3/4,210195,3
2,4,21,196,1,1444,1,13,6,6,7,single-choice,spatial-relational,6|7,7,6/7,210196,6
2,4,21,197,0,1720,1,5,2,3,3,single-choice,spatial-relational,2|3,7,2/3,210197,2
2,4,21,198,1,1092,1,13,6,6,7,single-choice,spatial-relational,6|7,7,6/7,210198,6
2,4,21,199,0,3025,1,9,4,5,5,single-choice,spatial-relational,4|5,7,4/5,210199,4
2,4,21,200,0,1477,1,11,5,6,6,single-choice,spatial-relational,5|6,7,5/6,210200,5
2,4,21,201,1,998,1,5,2,2,3,single-choice,spatial-relational,2|3,7,2/3,210201,2
2,4,21,202,1,1496,1,9,4,4,5,single-choice,spatial-relational,4|5,7,4/5,210202,4
2,4,21,203,1,1140,1,7,3,3,4,single-choice,spatial-relational,3|4,7,3/4,210203,3
2,4,21,204,0,962,1,3,1,2,2,single-choice,spatial-relational,1|2,7,1/2,210204,1
2,4,21,205,1,936,1,9,4,4,5,single-choice,spatial-relational,4|5,7,4/5,210205,4
2,4,21,206,1,1527,1,13,6,6,7,single-choice,spatial-relational,6|7,7,6/7,210206,6
2,4,21,207,1,1321,1,5,2,2,3,single-choice,spatial-relational,2|3,7,2/3,210207,2
2,4,21,208,0,1942,1,7,3,4,4,single-choice,spatial-relational,3|4,7,3/4,210208,3
2,4,21,209,0,638,1,11,5,6,6,single-choice,spatial-relational,5|6,7,5/6,210209,5
2,4,21,210,0,784,1,5,2,3,3,single-choice,spatial-relational,2|3,7,2/3,210210,2
2,4,21,211,0,951,1,3,1,2,2,single-choice,spatial-relational,1|2,7,1/2,210211,1
2,4,21,212,1,784,1,3,1,1,2,single-choice,spatial-relational,1|2,7,1/2,210212,1
2,4,21,213,1,1367,1,13,6,6,7,single-choice,spatial-relational,6|7,7,6/7,210213,6
2,4,21,214,0,782,1,7,3,4,4,single-choice,spatial-relational,3|4,7,3/4,210214,3
2,4,21,215,1,1077,1,9,4,4,5,single-choice,spatial-relational,4|5,7,4/5,210215,4
2,4,21,216,0,1445,1,11,5,6,6,single-choice,spatial-relational,5|6,7,5/6,210216,5
2,4,21,217,0,1326,1,11,5,6,6,single-choice,spatial-relational,5|6,7,5/6,210217,5
2,4,21,218,1,1062,1,7,3,3,4,single-choice,spatial-relational,3|4,7,3/4,210218,3
2,4,21,219,0,1543,1,11,5,6,6,single-choice,spatial-relational,5|6,7,5/6,210219,5
2,4,21,220,1,1055,1,7,3,3,4,single-choice,spatial-relational,3|4,7,3/4,210220,3
2,4,21,221,0,1325,1,13,6,7,7,single-choice,spatial-relational,6|7,7,6/7,210221,6
2,4,21,222,1,1772,1,9,4,4,5,single-choice,spatial-relational,4|5,7,4/5,210222,4
2,4,21,223,0,1363,1,3,1,2,2,single-choice,spatial-relational,1|2,7,1/2,210223,1
2,4,21,224,1,1417,1,5,2,2,3,single-choice,spatial-relational,2|3,7,2/3,210224,2
2,4,21,225,0,1289,1,9,4,5,5,single-choice,spatial-relational,4|5,7,4/5,210225,4
2,4,21,226,0,911,1,5,2,3,3,single-choice,spatial-relational,2|3,7,2/3,210226,2
2,4,21,227,1,1306,1,3,1,1,2,single-choice,spatial-relational,1|2,7,1/2,210227,1
2,4,21,228,1,1073,1,13,6,6,7,single-choice,spatial-relational,6|7,7,6/7,210228,6
2,4,21,229,1,1780,1,11,5,5,6,single-choice,spatial-relational,5|6,7,5/6,210229,5
2,4,21,230,1,1565,1,3,1,1,2,single-choice,spatial-relational,1|2,7,1/2,210230,1
2,4,21,231,0,1183,1,5,2,3,3,single-choice,spatial-relational,2|3,7,2/3,210231,2
2,4,21,232,1,944,1,13,6,6,7,single-choice,spatial-relational,6|7,7,6/7,210232,6
2,4,21,233,1,1587,1,9,4,4,5,single-choice,spatial-relational,4|5,7,4/5,210233,4
2,4,21,234,1,3093,1,11,5,5,6,single-choice,spatial-relational,5|6,7,5/6,210234,5
2,4,21,235,1,2043,1,9,4,4,5,single-choice,spatial-relational,4|5,7,4/5,210235,4
2,4,21,236,1,1459,1,13,6,6,7,single-choice,spatial-relational,6|7,7,6/7,210236,6
2,4,21,237,0,1496,1,5,2,3,3,single-choice,spatial-relational,2|3,7,2/3,210237,2
2,4,21,238,0,747,1,7,3,4,4,single-choice,spatial-relational,3|4,7,3/4,210238,3
2,4,21,239,1,1049,1,3,1,1,2,single-choice,spatial-relational,1|2,7,1/2,210239,1
2,4,21,240,0,1586,1,7,3,4,4,single-choice,spatial-relational,3|4,7,3/4,210240,3
2,4,21,241,1,59,1,5,2,2,3,single-choice,spatial-relational,2|3,7,2/3,210241,2
2,4,21,242,0,1529,1,11,5,6,6,single-choice,spatial-relational,5|6,7,5/6,210242,5
2,4,21,243,1,1236,1,9,4,4,5,single-choice,spatial-relational,4|5,7,4/5,210243,4
2,4,21,244,1,1716,1,13,6,6,7,single-choice,spatial-relational,6|7,7,6/7,210244,6
2,4,21,245,1,4241,1,7,3,3,4,single-choice,spatial-relational,3|4,7,3/4,210245,3
2,4,21,246,1,1333,1,7,3,3,4,single-choice,spatial-relational,3|4,7,3/4,210246,3
2,4,21,247,1,987,1,3,1,1,2,single-choice,spatial-relational,1|2,7,1/2,210247,1
2,4,21,248,0,972,1,11,5,6,6,single-choice,spatial-relational,5|6,7,5/6,210248,5
2,4,21,249,1,1151,1,13,6,6,7,single-choice,spatial-relational,6|7,7,6/7,210249,6
2,4,21,250,0,1013,1,5,2,3,3,single-choice,spatial-relational,2|3,7,2/3,210250,2
2,4,21,251,1,2075,1,9,4,4,5,single-choice,spatial-relational,4|5,7,4/5,210251,4
2,4,21,252,1,1096,1,3,1,1,2,single-choice,spatial-relational,1|2,7,1/2,210252,1
2,4,21,253,1,1153,1,9,4,4,5,single-choice,spatial-relational,4|5,7,4/5,210253,4
2,4,21,254,1,1191,1,9,4,4,5,single-choice,spatial-relational,4|5,7,4/5,210254,4
2,4,21,255,1,1711,1,13,6,6,7,single-choice,spatial-relational,6|7,7,6/7,210255,6
2,4,21,256,1,938,1,3,1,1,2,single-choice,spatial-relational,1|2,7,1/2,210256,1
2,4,21,257,1,1379,1,13,6,6,7,single-choice,spatial-relational,6|7,7,6/7,210257,6
2,4,21,258,0,2331,1,7,3,4,4,single-choice,spatial-relational,3|4,7,3/4,210258,3
2,4,21,259,0,1064,1,11,5,6,6,single-choice,spatial-relational,5|6,7,5/6,210259,5
2,4,21,260,0,1067,1,5,2,3,3,single-choice,spatial-relational,2|3,7,2/3,210260,2
2,4,21,261,0,916,1,11,5,6,6,single-choice,spatial-relational,5|6,7,5/6,210261,5
2,4,21,262,0,981,1,5,2,3,3,single-choice,spatial-relational,2|3,7,2/3,210262,2
2,4,21,263,1,1171,1,3,1,1,2,single-choice,spatial-relational,1|2,7,1/2,210263,1
2,4,21,264,1,1737,1,7,3,3,4,single-choice,spatial-relational,3|4,7,3/4,210264,3
2,4,21,265,1,1311,1,3,1,1,2,single-choice,spatial-relational,1|2,7,1/2,210265,1
2,4,21,266,1,1253,1,13,6,6,7,single-choice,spatial-relational,6|7,7,6/7,210266,6
2,4,21,267,0,2388,1,9,4,5,5,single-choice,spatial-relational,4|5,7,4/5,210267,4
2,4,21,268,1,1129,1,5,2,2,3,single-choice,spatial-relational,2|3,7,2/3,210268,2
2,4,21,269,0,883,1,3,1,2,2,single-choice,spatial-relational,1|2,7,1/2,210269,1
2,4,21,270,1,1127,1,13,6,6,7,single-choice,spatial-relational,6|7,7,6/7,210270,6
2,4,21,271,0,2657,1,7,3,4,4,single-choice,spatial-relational,3|4,7,3/4,210271,3
2,4,21,272,1,942,1,9,4,4,5,single-choice,spatial-relational,4|5,7,4/5,210272,4
2,4,21,273,0,1888,1,11,5,6,6,single-choice,spatial-relational,5|6,7,5/6,210273,5
2,4,21,274,0,880,1,5,2,3,3,single-choice,spatial-relational,2|3,7,2/3,210274,2
2,4,21,275,0,1311,1,11,5,6,6,single-choice,spatial-relational,5|6,7,5/6,210275,5
2,4,21,276,0,1704,1,7,3,4,4,single-choice,spatial-relational,3|4,7,3/4,210276,3
2,4,21,277,1,3047,1,9,4,4,5,single-choice,spatial-relational,4|5,7,4/5,210277,4
2,4,21,278,0,2521,1,11,5,6,6,single-choice,spatial-relational,5|6,7,5/6,210278,5
2,4,21,279,1,1607,1,5,2,2,3,single-choice,spatial-relational,2|3,7,2/3,210279,2
2,4,21,280,1,1926,1,3,1,1,2,single-choice,spatial-relational,1|2,7,1/2,210280,1
2,4,21,281,0,2196,1,11,5,6,6,single-choice,spatial-relational,5|6,7,5/6,210281,5
2,4,21,282,1,1930,1,5,2,2,3,single-choice,spatial-relational,2|3,7,2/3,210282,2
2,4,21,283,1,2517,1,7,3,3,4,single-choice,spatial-relational,3|4,7,3/4,210283,3
2,4,21,284,1,1513,1,13,6,6,7,single-choice,spatial-relational,6|7,7,6/7,210284,6
2,4,21,285,1,2188,1,9,4,4,5,single-choice,spatial-relational,4|5,7,4/5,210285,4
2,4,21,286,1,2768,1,7,3,3,4,single-choice,spatial-relational,3|4,7,3/4,210286,3
2,4,21,287,0,1482,1,13,6,7,7,single-choice,spatial-relational,6|7,7,6/7,210287,6
2,4,21,288,1,996,1,3,1,1,2,single-choice,spatial-relational,1|2,7,1/2,210288,1
2,4,21,289,1,1548,1,9,4,4,5,single-choice,spatial-relational,4|5,7,4/5,210289,4
2,4,21,290,1,1505,1,11,5,5,6,single-choice,spatial-relational,5|6,7,5/6,210290,5
2,4,21,291,1,1192,1,5,2,2,3,single-choice,spatial-relational,2|3,7,2/3,210291,2
2,4,21,292,1,2109,1,13,6,6,7,single-choice,spatial-relational,6|7,7,6/7,210292,6
2,4,21,293,0,1528,1,3,1,2,2,single-choice,spatial-relational,1|2,7,1/2,210293,1
2,4,21,294,0,761,1,7,3,4,4,single-choice,spatial-relational,3|4,7,3/4,210294,3
2,4,21,295,0,1111,1,9,4,5,5,single-choice,spatial-relational,4|5,7,4/5,210295,4
2,4,21,296,0,1957,1,11,5,6,6,single-choice,spatial-relational,5|6,7,5/6,210296,5
2,4,21,297,0,1093,1,3,1,2,2,single-choice,spatial-relational,1|2,7,1/2,210297,1
2,4,21,298,0,1160,1,5,2,3,3,single-choice,spatial-relational,2|3,7,2/3,210298,2
2,4,21,299,1,1500,1,13,6,6,7,single-choice,spatial-relational,6|7,7,6/7,210299,6
2,4,21,300,0,2549,1,7,3,4,4,single-choice,spatial-relational,3|4,7,3/4,210300,3
2,4,21,301,0,1049,1,7,3,4,4,single-choice,spatial-relational,3|4,7,3/4,210301,3
2,4,21,302,1,2295,1,9,4,4,5,single-choice,spatial-relational,4|5,7,4/5,210302,4
2,4,21,303,1,1693,1,9,4,4,5,single-choice,spatial-relational,4|5,7,4/5,210303,4
2,4,21,304,1,847,1,3,1,1,2,single-choice,spatial-relational,1|2,7,1/2,210304,1
2,4,21,305,0,1592,1,11,5,6,6,single-choice,spatial-relational,5|6,7,5/6,210305,5
2,4,21,306,1,1048,1,3,1,1,2,single-choice,spatial-relational,1|2,7,1/2,210306,1
2,4,21,307,1,929,1,5,2,2,3,single-choice,spatial-relational,2|3,7,2/3,210307,2
2,4,21,308,0,1467,1,11,5,6,6,single-choice,spatial-relational,5|6,7,5/6,210308,5
2,4,21,309,1,2204,1,13,6,6,7,single-choice,spatial-relational,6|7,7,6/7,210309,6
2,4,21,310,0,1499,1,5,2,3,3,single-choice,spatial-relational,2|3,7,2/3,210310,2
2,4,21,311,0,1287,1,7,3,4,4,single-choice,spatial-relational,3|4,7,3/4,210311,3
2,4,21,312,1,1273,1,13,6,6,7,single-choice,spatial-relational,6|7,7,6/7,210312,6
2,4,21,313,1,1646,1,9,4,4,5,single-choice,spatial-relational,4|5,7,4/5,210313,4
2,4,21,314,0,1741,1,11,5,6,6,single-choice,spatial-relational,5|6,7,5/6,210314,5
2,4,21,315,1,1141,1,3,1,1,2,single-choice,spatial-relational,1|2,7,1/2,210315,1
2,4,21,316,1,1288,1,13,6,6,7,single-choice,spatial-relational,6|7,7,6/7,210316,6
2,4,21,317,0,1769,1,7,3,4,4,single-choice,spatial-relational,3|4,7,3/4,210317,3
2,4,21,318,0,782,1,5,2,3,3,single-choice,spatial-relational,2|3,7,2/3,210318,2
2,4,21,319,1,1027,1,3,1,1,2,single-choice,spatial-relational,1|2,7,1/2,210319,1
2,4,21,320,1,1322,1,13,6,6,7,single-choice,spatial-relational,6|7,7,6/7,210320,6
2,4,21,321,1,1361,1,5,2,2,3,single-choice,spatial-relational,2|3,7,2/3,210321,2
2,4,21,322,1,1071,1,7,3,3,4,single-choice,spatial-relational,3|4,7,3/4,210322,3
2,4,21,323,0,1862,1,9,4,5,5,single-choice,spatial-relational,4|5,7,4/5,210323,4
2,4,21,324,0,1273,1,11,5,6,6,single-choice,spatial-relational,5|6,7,5/6,210324,5
2,4,21,325,1,1794,1,9,4,4,5,single-choice,spatial-relational,4|5,7,4/5,210325,4
2,4,21,326,1,2391,1,13,6,6,7,single-choice,spatial-relational,6|7,7,6/7,210326,6
2,4,21,327,0,2166,1,11,5,6,6,single-choice,spatial-relational,5|6,7,5/6,210327,5
2,4,21,328,1,1450,1,3,1,1,2,single-choice,spatial-relational,1|2,7,1/2,210328,1
2,4,21,329,1,912,1,7,3,3,4,single-choice,spatial-relational,3|4,7,3/4,210329,3
2,4,21,330,1,1753,1,5,2,2,3,single-choice,spatial-relational,2|3,7,2/3,210330,2
2,4,21,331,1,1674,1,3,1,1,2,single-choice,spatial-relational,1|2,7,1/2,210331,1
2,4,21,332,1,962,1,5,2,2,3,single-choice,spatial-relational,2|3,7,2/3,210332,2
2,4,21,333,1,906,1,9,4,4,5,single-choice,spatial-relational,4|5,7,4/5,210333,4
2,4,21,334,1,1114,1,13,6,6,7,single-choice,spatial-relational,6|7,7,6/7,210334,6
2,4,21,335,1,1611,1,11,5,5,6,single-choice,spatial-relational,5|6,7,5/6,210335,5
2,4,21,336,1,2452,1,7,3,3,4,single-choice,spatial-relational,3|4,7,3/4,210336,3
2,4,21,337,0,1541,1,5,2,3,3,single-choice,spatial-relational,2|3,7,2/3,210337,2
2,4,21,338,0,1350,1,9,4,5,5,single-choice,spatial-relational,4|5,7,4/5,210338,4
2,4,21,339,0,1829,1,11,5,6,6,single-choice,spatial-relational,5|6,7,5/6,210339,5
2,4,21,340,1,1874,1,13,6,6,7,single-choice,spatial-relational,6|7,7,6/7,210340,6
2,4,21,341,1,2189,1,7,3,3,4,single-choice,spatial-relational,3|4,7,3/4,210341,3
2,4,21,342,0,1437,1,3,1,2,2,single-choice,spatial-relational,1|2,7,1/2,210342,1
2,4,21,343,1,1079,1,7,3,3,4,single-choice,spatial-relational,3|4,7,3/4,210343,3
2,4,21,344,1,1149,1,3,1,1,2,single-choice,spatial-relational,1|2,7,1/2,210344,1
2,4,21,345,1,1441,1,11,5,5,6,single-choice,spatial-relational,5|6,7,5/6,210345,5
2,4,21,346,1,1677,1,13,6,6,7,single-choice,spatial-relational,6|7,7,6/7,210346,6
2,4,21,347,1,1616,1,9,4,4,5,single-choice,spatial-relational,4|5,7,4/5,210347,4
2,4,21,348,1,1889,1,5,2,2,3,single-choice,spatial-relational,2|3,7,2/3,210348,2
2,4,21,349,1,1434,1,5,2,2,3,single-choice,spatial-relational,2|3,7,2/3,210349,2
2,4,21,350,1,1919,1,9,4,4,5,single-choice,spatial-relational,4|5,7,4/5,210350,4
2,4,21,351,1,1504,1,13,6,6,7,single-choice,spatial-relational,6|7,7,6/7,210351,6
2,4,21,352,1,2224,1,7,3,3,4,single-choice,spatial-relational,3|4,7,3/4,210352,3
2,4,21,353,1,1655,1,3,1,1,2,single-choice,spatial-relational,1|2,7,1/2,210353,1
2,4,21,354,1,945,1,9,4,4,5,single-choice,spatial-relational,4|5,7,4/5,210354,4
2,4,21,355,1,1851,1,5,2,2,3,single-choice,spatial-relational,2|3,7,2/3,210355,2
2,4,21,356,1,1179,1,13,6,6,7,single-choice,spatial-relational,6|7,7,6/7,210356,6
2,4,21,357,1,1693,1,11,5,5,6,single-choice,spatial-relational,5|6,7,5/6,210357,5
2,4,21,358,0,1251,1,3,1,2,2,single-choice,spatial-relational,1|2,7,1/2,210358,1
2,4,21,359,0,1313,1,7,3,4,4,single-choice,spatial-relational,3|4,7,3/4,210359,3
2,4,21,360,0,1831,1,11,5,6,6,single-choice,spatial-relational,5|6,7,5/6,210360,5
2,4,21,361,1,918,1,5,2,2,3,single-choice,spatial-relational,2|3,7,2/3,210361,2
2,4,21,362,0,2548,1,11,5,6,6,single-choice,spatial-relational,5|6,7,5/6,210362,5
2,4,21,363,0,1747,1,7,3,4,4,single-choice,spatial-relational,3|4,7,3/4,210363,3
2,4,21,364,1,1160,1,13,6,6,7,single-choice,spatial-relational,6|7,7,6/7,210364,6
2,4,21,365,0,1945,1,7,3,4,4,single-choice,spatial-relational,3|4,7,3/4,210365,3
2,4,21,366,1,977,1,13,6,6,7,single-choice,spatial-relational,6|7,7,6/7,210366,6
2,4,21,367,0,1376,1,5,2,3,3,single-choice,spatial-relational,2|3,7,2/3,210367,2
2,4,21,368,0,923,1,3,1,2,2,single-choice,spatial-relational,1|2,7,1/2,210368,1
2,4,21,369,1,1384,1,9,4,4,5,single-choice,spatial-relational,4|5,7,4/5,210369,4
2,4,21,370,1,1456,1,9,4,4,5,single-choice,spatial-relational,4|5,7,4/5,210370,4
2,4,21,371,1,1289,1,3,1,1,2,single-choice,spatial-relational,1|2,7,1/2,210371,1
2,4,21,372,0,1680,1,11,5,6,6,single-choice,spatial-relational,5|6,7,5/6,210372,5
2,4,21,373,1,1649,1,11,5,5,6,single-choice,spatial-relational,5|6,7,5/6,210373,5
2,4,21,374,0,1152,1,5,2,3,3,single-choice,spatial-relational,2|3,7,2/3,210374,2
2,4,21,375,0,1094,1,3,1,2,2,single-choice,spatial-relational,1|2,7,1/2,210375,1
2,4,21,376,0,1473,1,5,2,3,3,single-choice,spatial-relational,2|3,7,2/3,210376,2
2,4,21,377,1,1617,1,11,5,5,6,single-choice,spatial-relational,5|6,7,5/6,210377,5
2,4,21,378,1,1151,1,13,6,6,7,single-choice,spatial-relational,6|7,7,6/7,210378,6
2,4,21,379,0,2361,1,3,1,2,2,single-choice,spatial-relational,1|2,7,1/2,210379,1
2,4,21,380,1,1764,1,9,4,4,5,single-choice,spatial-relational,4|5,7,4/5,210380,4
2,4,21,381,0,2404,1,7,3,4,4,single-choice,spatial-relational,3|4,7,3/4,210381,3
2,4,21,382,0,2149,1,13,6,7,7,single-choice,spatial-relational,6|7,7,6/7,210382,6
2,4,21,383,0,1566,1,9,4,5,5,single-choice,spatial-relational,4|5,7,4/5,210383,4
2,4,21,384,1,1596,1,7,3,3,4,single-choice,spatial-relational,3|4,7,3/4,210384,3
2,4,21,385,0,1419,1,11,5,6,6,single-choice,spatial-relational,5|6,7,5/6,210385,5
2,4,21,386,0,1332,1,7,3,4,4,single-choice,spatial-relational,3|4,7,3/4,210386,3
2,4,21,387,1,1550,1,13,6,6,7,single-choice,spatial-relational,6|7,7,6/7,210387,6
2,4,21,388,0,3172,1,9,4,5,5,single-choice,spatial-relational,4|5,7,4/5,210388,4
2,4,21,389,1,1225,1,5,2,2,3,single-choice,spatial-relational,2|3,7,2/3,210389,2
2,4,21,390,0,1200,1,3,1,2,2,single-choice,spatial-relational,1|2,7,1/2,210390,1
2,4,21,391,1,1161,1,9,4,4,5,single-choice,spatial-relational,4|5,7,4/5,210391,4
2,4,21,392,1,2149,1,7,3,3,4,single-choice,spatial-relational,3|4,7,3/4,210392,3
2,4,21,393,1,1181,1,3,1,1,2,single-choice,spatial-relational,1|2,7,1/2,210393,1
2,4,21,394,0,1105,1,5,2,3,3,single-choice,spatial-relational,2|3,7,2/3,210394,2
2,4,21,395,1,1331,1,13,6,6,7,single-choice,spatial-relational,6|7,7,6/7,210395,6
2,4,21,396,0,1718,1,11,5,6,6,single-choice,spatial-relational,5|6,7,5/6,210396,5
2,4,21,397,0,1909,1,7,3,4,4,single-choice,spatial-relational,3|4,7,3/4,210397,3
2,4,21,398,1,2240,1,3,1,1,2,single-choice,spatial-relational,1|2,7,1/2,210398,1
2,4,21,399,1,1070,1,5,2,2,3,single-choice,spatial-relational,2|3,7,2/3,210399,2
2,4,21,400,0,1935,1,11,5,6,6,single-choice,spatial-relational,5|6,7,5/6,210400,5
2,4,21,401,1,1237,1,9,4,4,5,single-choice,spatial-relational,4|5,7,4/5,210401,4
2,4,21,402,1,2222,1,9,4,4,5,single-choice,spatial-relational,4|5,7,4/5,210402,4
2,4,21,403,1,2642,1,13,6,6,7,single-choice,spatial-relational,6|7,7,6/7,210403,6
2,4,21,404,1,1420,1,7,3,3,4,single-choice,spatial-relational,3|4,7,3/4,210404,3
2,4,21,405,1,1090,1,13,6,6,7,single-choice,spatial-relational,6|7,7,6/7,210405,6
2,4,21,406,1,1741,1,11,5,5,6,single-choice,spatial-relational,5|6,7,5/6,210406,5
2,4,21,407,1,1379,1,5,2,2,3,single-choice,spatial-relational,2|3,7,2/3,210407,2
2,4,21,408,0,817,1,3,1,2,2,single-choice,spatial-relational,1|2,7,1/2,210408,1
2,4,21,409,0,1242,1,3,1,2,2,single-choice,spatial-relational,1|2,7,1/2,210409,1
2,4,21,410,0,1548,1,5,2,3,3,single-choice,spatial-relational,2|3,7,2/3,210410,2
2,4,21,411,0,947,1,13,6,7,7,single-choice,spatial-relational,6|7,7,6/7,210411,6
2,4,21,412,1,1108,1,7,3,3,4,single-choice,spatial-relational,3|4,7,3/4,210412,3
2,4,21,413,0,1116,1,5,2,3,3,single-choice,spatial-relational,2|3,7,2/3,210413,2
2,4,21,414,1,1136,1,9,4,4,5,single-choice,spatial-relational,4|5,7,4/5,210414,4
2,4,21,415,1,1703,1,11,5,5,6,single-choice,spatial-relational,5|6,7,5/6,210415,5
2,4,21,416,1,2504,1,13,6,6,7,single-choice,spatial-relational,6|7,7,6/7,210416,6
2,4,21,417,1,1295,1,9,4,4,5,single-choice,spatial-relational,4|5,7,4/5,210417,4
2,4,21,418,1,1866,1,7,3,3,4,single-choice,spatial-relational,3|4,7,3/4,210418,3
2,4,21,419,0,1233,1,11,5,6,6,single-choice,spatial-relational,5|6,7,5/6,210419,5
2,4,21,420,1,1110,1,3,1,1,2,single-choice,spatial-relational,1|2,7,1/2,210420,1
2,4,21,421,1,1129,1,3,1,1,2,single-choice,spatial-relational,1|2,7,1/2,210421,1
2,4,21,422,0,884,1,7,3,4,4,single-choice,spatial-relational,3|4,7,3/4,210422,3
2,4,21,423,0,1243,1,7,3,4,4,single-choice,spatial-relational,3|4,7,3/4,210423,3
2,4,21,424,0,1718,1,11,5,6,6,single-choice,spatial-relational,5|6,7,5/6,210424,5
2,4,21,425,0,1451,1,5,2,3,3,single-choice,spatial-relational,2|3,7,2/3,210425,2
2,4,21,426,0,1458,1,9,4,5,5,single-choice,spatial-relational,4|5,7,4/5,210426,4
2,4,21,427,0,800,1,3,1,2,2,single-choice,spatial-relational,1|2,7,1/2,210427,1
2,4,21,428,1,1176,1,13,6,6,7,single-choice,spatial-relational,6|7,7,6/7,210428,6
2,4,21,429,1,1891,1,11,5,5,6,single-choice,spatial-relational,5|6,7,5/6,210429,5
2,4,21,430,1,1954,1,9,4,4,5,single-choice,spatial-relational,4|5,7,4/5,210430,4
2,4,21,431,0,672,1,13,6,7,7,single-choice,spatial-relational,6|7,7,6/7,210431,6
2,4,21,432,0,1315,1,5,2,3,3,single-choice,spatial-relational,2|3,7,2/3,210432,2
2,4,21,433,0,1732,1,3,1,2,2,single-choice,spatial-relational,1|2,7,1/2,210433,1
2,4,21,434,0,1405,1,11,5,6,6,single-choice,spatial-relational,5|6,7,5/6,210434,5
2,4,21,435,0,1248,1,5,2,3,3,single-choice,spatial-relational,2|3,7,2/3,210435,2
2,4,21,436,1,2481,1,13,6,6,7,single-choice,spatial-relational,6|7,7,6/7,210436,6
2,4,21,437,0,1535,1,9,4,5,5,single-choice,spatial-relational,4|5,7,4/5,210437,4
2,4,21,438,1,4577,1,11,5,5,6,single-choice,spatial-relational,5|6,7,5/6,210438,5
2,4,21,439,1,2663,1,7,3,3,4,single-choice,spatial-relational,3|4,7,3/4,210439,3
2,4,21,440,1,1735,1,9,4,4,5,single-choice,spatial-relational,4|5,7,4/5,210440,4
2,4,21,441,1,1289,1,5,2,2,3,single-choice,spatial-relational,2|3,7,2/3,210441,2
2,4,21,442,0,1489,1,13,6,7,7,single-choice,spatial-relational,6|7,7,6/7,210442,6
2,4,21,443,0,822,1,7,3,4,4,single-choice,spatial-relational,3|4,7,3/4,210443,3
2,4,21,444,1,832,1,3,1,1,2,single-choice,spatial-relational,1|2,7,1/2,210444,1
2,4,21,445,0,1121,1,5,2,3,3,single-choice,spatial-relational,2|3,7,2/3,210445,2
2,4,21,446,0,1319,1,7,3,4,4,single-choice,spatial-relational,3|4,7,3/4,210446,3
2,4,21,447,1,1044,1,13,6,6,7,single-choice,spatial-relational,6|7,7,6/7,210447,6
2,4,21,448,1,2333,1,5,2,2,3,single-choice,spatial-relational,2|3,7,2/3,210448,2
2,4,21,449,0,1360,1,7,3,4,4,single-choice,spatial-relational,3|4,7,3/4,210449,3
2,4,21,450,0,1303,1,11,5,6,6,single-choice,spatial-relational,5|6,7,5/6,210450,5
2,4,21,451,1,1201,1,13,6,6,7,single-choice,spatial-relational,6|7,7,6/7,210451,6
2,4,21,452,1,1582,1,3,1,1,2,single-choice,spatial-relational,1|2,7,1/2,210452,1
2,4,21,453,1,765,1,3,1,1,2,single-choice,spatial-relational,1|2,7,1/2,210453,1
2,4,21,454,1,1258,1,9,4,4,5,single-choice,spatial-relational,4|5,7,4/5,210454,4
2,4,21,455,0,1556,1,9,4,5,5,single-choice,spatial-relational,4|5,7,4/5,210455,4
2,4,21,456,0,1927,1,11,5,6,6,single-choice,spatial-relational,5|6,7,5/6,210456,5
2,4,21,457,1,920,1,5,2,2,3,single-choice,spatial-relational,2|3,7,2/3,210457,2
2,4,21,458,0,1141,1,13,6,7,7,single-choice,spatial-relational,6|7,7,6/7,210458,6
2,4,21,459,1,1095,1,9,4,4,5,single-choice,spatial-relational,4|5,7,4/5,210459,4
2,4,21,460,1,1257,1,11,5,5,6,single-choice,spatial-relational,5|6,7,5/6,210460,5
2,4,21,461,1,1712,1,7,3,3,4,single-choice,spatial-relational,3|4,7,3/4,210461,3
2,4,21,462,1,1417,1,13,6,6,7,single-choice,spatial-relational,6|7,7,6/7,210462,6
2,4,21,463,0,2256,1,3,1,2,2,single-choice,spatial-relational,1|2,7,1/2,210463,1
2,4,21,464,0,746,1,7,3,4,4,single-choice,spatial-relational,3|4,7,3/4,210464,3
2,4,21,465,0,1394,1,9,4,5,5,single-choice,spatial-relational,4|5,7,4/5,210465,4
2,4,21,466,1,923,1,3,1,1,2,single-choice,spatial-relational,1|2,7,1/2,210466,1
2,4,21,467,0,945,1,5,2,3,3,single-choice,spatial-relational,2|3,7,2/3,210467,2
2,4,21,468,1,1948,1,11,5,5,6,single-choice,spatial-relational,5|6,7,5/6,210468,5
2,4,21,469,1,1974,1,9,4,4,5,single-choice,spatial-relational,4|5,7,4/5,210469,4
2,4,21,470,1,1266,1,5,2,2,3,single-choice,spatial-relational,2|3,7,2/3,210470,2
2,4,21,471,0,1848,1,3,1,2,2,single-choice,spatial-relational,1|2,7,1/2,210471,1
2,4,21,472,0,2208,1,11,5,6,6,single-choice,spatial-relational,5|6,7,5/6,210472,5
2,4,21,473,0,823,1,3,1,2,2,single-choice,spatial-relational,1|2,7,1/2,210473,1
2,4,21,474,0,982,1,5,2,3,3,single-choice,spatial-relational,2|3,7,2/3,210474,2
2,4,21,475,0,2811,1,11,5,6,6,single-choice,spatial-relational,5|6,7,5/6,210475,5
2,4,21,476,1,1268,1,13,6,6,7,single-choice,spatial-relational,6|7,7,6/7,210476,6
2,4,21,477,1,1437,1,9,4,4,5,single-choice,spatial-relational,4|5,7,4/5,210477,4
2,4,21,478,1,1620,1,7,3,3,4,single-choice,spatial-relational,3|4,7,3/4,210478,3
2,4,21,479,0,1669,1,7,3,4,4,single-choice,spatial-relational,3|4,7,3/4,210479,3
2,4,21,480,1,883,1,13,6,6,7,single-choice,spatial-relational,6|7,7,6/7,210480,6
2,4,21,481,1,1688,1,11,5,5,6,single-choice,spatial-relational,5|6,7,5/6,210481,5
2,4,21,482,1,1690,1,9,4,4,5,single-choice,spatial-relational,4|5,7,4/5,210482,4
2,4,21,483,0,1806,1,5,2,3,3,single-choice,spatial-relational,2|3,7,2/3,210483,2
2,4,21,484,0,1927,1,7,3,4,4,single-choice,spatial-relational,3|4,7,3/4,210484,3
2,4,21,485,1,1837,1,11,5,5,6,single-choice,spatial-relational,5|6,7,5/6,210485,5
2,4,21,486,1,1356,1,7,3,3,4,single-choice,spatial-relational,3|4,7,3/4,210486,3
2,4,21,487,0,1312,1,13,6,7,7,single-choice,spatial-relational,6|7,7,6/7,210487,6
2,4,21,488,0,1083,1,9,4,5,5,single-choice,spatial-relational,4|5,7,4/5,210488,4
2,4,21,489,0,1064,1,3,1,2,2,single-choice,spatial-relational,1|2,7,1/2,210489,1
2,4,21,490,0,1526,1,5,2,3,3,single-choice,spatial-relational,2|3,7,2/3,210490,2
2,4,21,491,1,1807,1,3,1,1,2,single-choice,spatial-relational,1|2,7,1/2,210491,1
2,4,21,492,1,1128,1,13,6,6,7,single-choice,spatial-relational,6|7,7,6/7,210492,6
2,4,21,493,1,2530,1,13,6,6,7,single-choice,spatial-relational,6|7,7,6/7,210493,6
2,4,21,494,1,3585,1,7,3,3,4,single-choice,spatial-relational,3|4,7,3/4,210494,3
2,4,21,495,1,1419,1,3,1,1,2,single-choice,spatial-relational,1|2,7,1/2,210495,1
2,4,21,496,0,897,1,9,4,5,5,single-choice,spatial-relational,4|5,7,4/5,210496,4
2,4,21,497,0,1021,1,5,2,3,3,single-choice,spatial-relational,2|3,7,2/3,210497,2
2,4,21,498,0,1047,1,7,3,4,4,single-choice,spatial-relational,3|4,7,3/4,210498,3
2,4,21,499,1,1312,1,3,1,1,2,single-choice,spatial-relational,1|2,7,1/2,210499,1
2,4,21,500,0,1594,1,9,4,5,5,single-choice,spatial-relational,4|5,7,4/5,210500,4
2,4,21,501,0,1168,1,5,2,3,3,single-choice,spatial-relational,2|3,7,2/3,210501,2
2,4,21,502,1,1032,1,13,6,6,7,single-choice,spatial-relational,6|7,7,6/7,210502,6
2,4,21,503,1,2510,1,11,5,5,6,single-choice,spatial-relational,5|6,7,5/6,210503,5
2,4,21,504,1,1605,1,11,5,5,6,single-choice,spatial-relational,5|6,7,5/6,210504,5
2,4,21,505,1,1302,1,3,1,1,2,single-choice,spatial-relational,1|2,7,1/2,210505,1
2,4,21,506,1,1697,1,9,4,4,5,single-choice,spatial-relational,4|5,7,4/5,210506,4
2,4,21,507,1,1245,1,13,6,6,7,single-choice,spatial-relational,6|7,7,6/7,210507,6
2,4,21,508,1,1325,1,7,3,3,4,single-choice,spatial-relational,3|4,7,3/4,210508,3
2,4,21,509,1,1062,1,3,1,1,2,single-choice,spatial-relational,1|2,7,1/2,210509,1
2,4,21,510,0,1327,1,11,5,6,6,single-choice,spatial-relational,5|6,7,5/6,210510,5
2,4,21,511,1,1393,1,9,4,4,5,single-choice,spatial-relational,4|5,7,4/5,210511,4
2,4,21,512,1,1440,1,5,2,2,3,single-choice,spatial-relational,2|3,7,2/3,210512,2
2,4,21,513,1,1403,1,13,6,6,7,single-choice,spatial-relational,6|7,7,6/7,210513,6
2,4,21,514,1,1924,1,5,2,2,3,single-choice,spatial-relational,2|3,7,2/3,210514,2
2,4,21,515,0,1230,1,7,3,4,4,single-choice,spatial-relational,3|4,7,3/4,210515,3
2,4,21,516,0,931,1,11,5,6,6,single-choice,spatial-relational,5|6,7,5/6,210516,5
2,4,21,517,1,2115,1,11,5,5,6,single-choice,spatial-relational,5|6,7,5/6,210517,5
2,4,21,518,1,1220,1,13,6,6,7,single-choice,spatial-relational,6|7,7,6/7,210518,6
2,4,21,519,0,2328,1,9,4,5,5,single-choice,spatial-relational,4|5,7,4/5,210519,4
2,4,21,520,1,837,1,3,1,1,2,single-choice,spatial-relational,1|2,7,1/2,210520,1
2,4,21,521,1,1697,1,7,3,3,4,single-choice,spatial-relational,3|4,7,3/4,210521,3
2,4,21,522,1,1581,1,5,2,2,3,single-choice,spatial-relational,2|3,7,2/3,210522,2
2,4,21,523,1,1049,1,13,6,6,7,single-choice,spatial-relational,6|7,7,6/7,210523,6
2,4,21,524,1,1472,1,3,1,1,2,single-choice,spatial-relational,1|2,7,1/2,210524,1
2,4,21,525,1,1116,1,9,4,4,5,single-choice,spatial-relational,4|5,7,4/5,210525,4
2,4,21,526,0,1343,1,5,2,3,3,single-choice,spatial-relational,2|3,7,2/3,210526,2
2,4,21,527,0,1156,1,11,5,6,6,single-choice,spatial-relational,5|6,7,5/6,210527,5
2,4,21,528,0,1229,1,7,3,4,4,single-choice,spatial-relational,3|4,7,3/4,210528,3
2,4,21,529,1,2355,1,11,5,5,6,single-choice,spatial-relational,5|6,7,5/6,210529,5
2,4,21,530,0,2058,1,11,5,6,6,single-choice,spatial-relational,5|6,7,5/6,210530,5
2,4,21,531,1,1119,1,13,6,6,7,single-choice,spatial-relational,6|7,7,6/7,210531,6
2,4,21,532,1,1813,1,7,3,3,4,single-choice,spatial-relational,3|4,7,3/4,210532,3
2,4,21,533,1,1687,1,9,4,4,5,single-choice,spatial-relational,4|5,7,4/5,210533,4
2,4,21,534,0,1517,1,5,2,3,3,single-choice,spatial-relational,2|3,7,2/3,210534,2
2,4,21,535,1,1025,1,3,1,1,2,single-choice,spatial-relational,1|2,7,1/2,210535,1
2,4,21,536,1,2286,1,9,4,4,5,single-choice,spatial-relational,4|5,7,4/5,210536,4
2,4,21,537,0,1124,1,3,1,2,2,single-choice,spatial-relational,1|2,7,1/2,210537,1
2,4,21,538,0,604,1,7,3,4,4,single-choice,spatial-relational,3|4,7,3/4,210538,3
2,4,21,539,1,1749,1,13,6,6,7,single-choice,spatial-relational,6|7,7,6/7,210539,6
2,4,21,540,0,1385,1,5,2,3,3,single-choice,spatial-relational,2|3,7,2/3,210540,2
2,4,21,541,1,905,1,13,6,6,7,single-choice,spatial-relational,6|7,7,6/7,210541,6
2,4,21,542,1,55,1,3,1,1,2,single-choice,spatial-relational,1|2,7,1/2,210542,1
2,4,21,543,0,1118,1,5,2,3,3,single-choice,spatial-relational,2|3,7,2/3,210543,2
2,4,21,544,1,1200,1,7,3,3,4,single-choice,spatial-relational,3|4,7,3/4,210544,3
2,4,21,545,1,1627,1,5,2,2,3,single-choice,spatial-relational,2|3,7,2/3,210545,2
2,4,21,546,1,1342,1,11,5,5,6,single-choice,spatial-relational,5|6,7,5/6,210546,5
2,4,21,547,0,1247,1,7,3,4,4,single-choice,spatial-relational,3|4,7,3/4,210547,3
2,4,21,548,0,1846,1,9,4,5,5,single-choice,spatial-relational,4|5,7,4/5,210548,4
2,4,21,549,1,760,1,3,1,1,2,single-choice,spatial-relational,1|2,7,1/2,210549,1
2,4,21,550,1,1697,1,9,4,4,5,single-choice,spatial-relational,4|5,7,4/5,210550,4
2,4,21,551,0,2819,1,11,5,6,6,single-choice,spatial-relational,5|6,7,5/6,210551,5
2,4,21,552,1,2386,1,13,6,6,7,single-choice,spatial-relational,6|7,7,6/7,210552,6
2,4,21,553,1,1236,1,13,6,6,7,single-choice,spatial-relational,6|7,7,6/7,210553,6
2,4,21,554,1,1662,1,3,1,1,2,single-choice,spatial-relational,1|2,7,1/2,210554,1
2,4,21,555,1,1836,1,9,4,4,5,single-choice,spatial-relational,4|5,7,4/5,210555,4
2,4,21,556,1,1353,1,5,2,2,3,single-choice,spatial-relational,2|3,7,2/3,210556,2
2,4,21,557,0,1250,1,9,4,5,5,single-choice,spatial-relational,4|5,7,4/5,210557,4
2,4,21,558,1,972,1,5,2,2,3,single-choice,spatial-relational,2|3,7,2/3,210558,2
2,4,21,559,0,2371,1,11,5,6,6,single-choice,spatial-relational,5|6,7,5/6,210559,5
2,4,21,560,1,1751,1,7,3,3,4,single-choice,spatial-relational,3|4,7,3/4,210560,3
2,4,21,561,1,1819,1,7,3,3,4,single-choice,spatial-relational,3|4,7,3/4,210561,3
2,4,21,562,1,2493,1,11,5,5,6,single-choice,spatial-relational,5|6,7,5/6,210562,5
2,4,21,563,0,1628,1,3,1,2,2,single-choice,spatial-relational,1|2,7,1/2,210563,1
2,4,21,564,1,2314,1,13,6,6,7,single-choice,spatial-relational,6|7,7,6/7,210564,6
2,4,21,565,0,859,1,3,1,2,2,single-choice,spatial-relational,1|2,7,1/2,210565,1
2,4,21,566,1,1526,1,9,4,4,5,single-choice,spatial-relational,4|5,7,4/5,210566,4
2,4,21,567,1,1015,1,13,6,6,7,single-choice,spatial-relational,6|7,7,6/7,210567,6
2,4,21,568,1,2522,1,13,6,6,7,single-choice,spatial-relational,6|7,7,6/7,210568,6
2,4,21,569,1,1838,1,7,3,3,4,single-choice,spatial-relational,3|4,7,3/4,210569,3
2,4,21,570,1,1525,1,11,5,5,6,single-choice,spatial-relational,5|6,7,5/6,210570,5
2,4,21,571,0,2334,1,5,2,3,3,single-choice,spatial-relational,2|3,7,2/3,210571,2
2,4,21,572,1,1053,1,5,2,2,3,single-choice,spatial-relational,2|3,7,2/3,210572,2
2,4,21,573,1,1520,1,9,4,4,5,single-choice,spatial-relational,4|5,7,4/5,210573,4
2,4,21,574,1,2054,1,7,3,3,4,single-choice,spatial-relational,3|4,7,3/4,210574,3
2,4,21,575,1,924,1,3,1,1,2,single-choice,spatial-relational,1|2,7,1/2,210575,1
2,4,21,576,1,950,1,11,5,5,6,single-choice,spatial-relational,5|6,7,5/6,210576,5
2,4,21,577,0,1806,1,7,3,4,4,single-choice,spatial-relational,3|4,7,3/4,210577,3
2,4,21,578,0,637,1,3,1,2,2,single-choice,spatial-relational,1|2,7,1/2,210578,1
2,4,21,579,1,1398,1,11,5,5,6,single-choice,spatial-relational,5|6,7,5/6,210579,5
2,4,21,580,1,1321,1,9,4,4,5,single-choice,spatial-relational,4|5,7,4/5,210580,4
2,4,21,581,1,2593,1,5,2,2,3,single-choice,spatial-relational,2|3,7,2/3,210581,2
2,4,21,582,1,1160,1,9,4,4,5,single-choice,spatial-relational,4|5,7,4/5,210582,4
2,4,21,583,0,1720,1,11,5,6,6,single-choice,spatial-relational,5|6,7,5/6,210583,5
2,4,21,584,1,998,1,13,6,6,7,single-choice,spatial-relational,6|7,7,6/7,210584,6
2,4,21,585,1,1009,1,5,2,2,3,single-choice,spatial-relational,2|3,7,2/3,210585,2
2,4,21,586,0,1068,1,3,1,2,2,single-choice,spatial-relational,1|2,7,1/2,210586,1
2,4,21,587,1,1050,1,13,6,6,7,single-choice,spatial-relational,6|7,7,6/7,210587,6
2,4,21,588,0,1175,1,7,3,4,4,single-choice,spatial-relational,3|4,7,3/4,210588,3
2,4,21,589,1,1328,1,7,3,3,4,single-choice,spatial-relational,3|4,7,3/4,210589,3
2,4,21,590,0,930,1,5,2,3,3,single-choice,spatial-relational,2|3,7,2/3,210590,2
2,4,21,591,1,994,1,5,2,2,3,single-choice,spatial-relational,2|3,7,2/3,210591,2
2,4,21,592,1,969,1,13,6,6,7,single-choice,spatial-relational,6|7,7,6/7,210592,6
2,4,21,593,0,1655,1,3,1,2,2,single-choice,spatial-relational,1|2,7,1/2,210593,1
2,4,21,594,1,1161,1,11,5,5,6,single-choice,spatial-relational,5|6,7,5/6,210594,5
2,4,21,595,1,1604,1,13,6,6,7,single-choice,spatial-relational,6|7,7,6/7,210595,6
2,4,21,596,0,2843,1,11,5,6,6,single-choice,spatial-relational,5|6,7,5/6,210596,5
2,4,21,597,1,679,1,3,1,1,2,single-choice,spatial-relational,1|2,7,1/2,210597,1
2,4,21,598,1,1877,1,9,4,4,5,single-choice,spatial-relational,4|5,7,4/5,210598,4
2,4,21,599,1,1336,1,9,4,4,5,single-choice,spatial-relational,4|5,7,4/5,210599,4
2,4,21,600,1,1659,1,7,3,3,4,single-choice,spatial-relational,3|4,7,3/4,210600,3
3,4,21,1,1,530,1,3,1,1,2,single-choice,spatial-relational,1|2,7,1/2,210001,1
3,4,21,2,0,659,1,11,5,6,6,single-choice,spatial-relational,5|6,7,5/6,210002,5
3,4,21,3,0,619,1,5,2,3,3,single-choice,spatial-relational,2|3,7,2/3,210003,2
3,4,21,4,0,595,1,7,3,4,4,single-choice,spatial-relational,3|4,7,3/4,210004,3
3,4,21,5,0,767,1,11,5,6,6,single-choice,spatial-relational,5|6,7,5/6,210005,5
3,4,21,6,0,1030,1,9,4,5,5,single-choice,spatial-relational,4|5,7,4/5,210006,4
3,4,21,7,0,1307,1,7,3,4,4,single-choice,spatial-relational,3|4,7,3/4,210007,3
3,4,21,8,1,797,1,3,1,1,2,single-choice,spatial-relational,1|2,7,1/2,210008,1
3,4,21,9,1,1019,1,9,4,4,5,single-choice,spatial-relational,4|5,7,4/5,210009,4
3,4,21,10,0,1086,1,13,6,7,7,single-choice,spatial-relational,6|7,7,6/7,210010,6
3,4,21,11,1,1076,1,5,2,2,3,single-choice,spatial-relational,2|3,7,2/3,210011,2
3,4,21,12,1,1235,1,13,6,6,7,single-choice,spatial-relational,6|7,7,6/7,210012,6
3,4,21,13,1,1609,1,5,2,2,3,single-choice,spatial-relational,2|3,7,2/3,210013,2
3,4,21,14,0,806,1,3,1,2,2,single-choice,spatial-relational,1|2,7,1/2,210014,1
3,4,21,15,1,1216,1,9,4,4,5,single-choice,spatial-relational,4|5,7,4/5,210015,4
3,4,21,16,1,1195,1,7,3,3,4,single-choice,spatial-relational,3|4,7,3/4,210016,3
3,4,21,17,1,1605,1,11,5,5,6,single-choice,spatial-relational,5|6,7,5/6,210017,5
3,4,21,18,1,1563,1,9,4,4,5,single-choice,spatial-relational,4|5,7,4/5,210018,4
3,4,21,19,1,1818,1,11,5,5,6,single-choice,spatial-relational,5|6,7,5/6,210019,5
3,4,21,20,1,1339,1,7,3,3,4,single-choice,spatial-relational,3|4,7,3/4,210020,3
3,4,21,21,0,775,1,5,2,3,3,single-choice,spatial-relational,2|3,7,2/3,210021,2
3,4,21,22,1,960,1,3,1,1,2,single-choice,spatial-relational,1|2,7,1/2,210022,1
3,4,21,23,1,1472,1,13,6,6,7,single-choice,spatial-relational,6|7,7,6/7,210023,6
3,4,21,24,0,2921,1,13,6,7,7,single-choice,spatial-relational,6|7,7,6/7,210024,6
3,4,21,25,1,1271,1,13,6,6,7,single-choice,spatial-relational,6|7,7,6/7,210025,6
3,4,21,26,0,2206,1,5,2,3,3,single-choice,spatial-relational,2|3,7,2/3,210026,2
3,4,21,27,1,1445,1,11,5,5,6,single-choice,spatial-relational,5|6,7,5/6,210027,5
3,4,21,28,1,1033,1,13,6,6,7,single-choice,spatial-relational,6|7,7,6/7,210028,6
3,4,21,29,0,1364,1,3,1,2,2,single-choice,spatial-relational,1|2,7,1/2,210029,1
3,4,21,30,1,1176,1,7,3,3,4,single-choice,spatial-relational,3|4,7,3/4,210030,3
3,4,21,31,1,943,1,7,3,3,4,single-choice,spatial-relational,3|4,7,3/4,210031,3
3,4,21,32,1,930,1,11,5,5,6,single-choice,spatial-relational,5|6,7,5/6,210032,5
3,4,21,33,1,1440,1,9,4,4,5,single-choice,spatial-relational,4|5,7,4/5,210033,4
3,4,21,34,1,1481,1,3,1,1,2,single-choice,spatial-relational,1|2,7,1/2,210034,1
3,4,21,35,1,1177,1,9,4,4,5,single-choice,spatial-relational,4|5,7,4/5,210035,4
3,4,21,36,0,1927,1,5,2,3,3,single-choice,spatial-relational,2|3,7,2/3,210036,2
3,4,21,37,1,1112,1,11,5,5,6,single-choice,spatial-relational,5|6,7,5/6,210037,5
3,4,21,38,1,2245,1,13,6,6,7,single-choice,spatial-relational,6|7,7,6/7,210038,6
3,4,21,39,0,1975,1,9,4,5,5,single-choice,spatial-relational,4|5,7,4/5,210039,4
3,4,21,40,1,1338,1,5,2,2,3,single-choice,spatial-relational,2|3,7,2/3,210040,2
3,4,21,41,1,933,1,13,6,6,7,single-choice,spatial-relational,6|7,7,6/7,210041,6
3,4,21,42,1,1787,1,7,3,3,4,single-choice,spatial-relational,3|4,7,3/4,210042,3
3,4,21,43,1,1587,1,7,3,3,4,single-choice,spatial-relational,3|4,7,3/4,210043,3
3,4,21,44,1,1109,1,5,2,2,3,single-choice,spatial-relational,2|3,7,2/3,210044,2
3,4,21,45,1,1309,1,11,5,5,6,single-choice,spatial-relational,5|6,7,5/6,210045,5
3,4,21,46,1,1859,1,9,4,4,5,single-choice,spatial-relational,4|5,7,4/5,210046,4
3,4,21,47,1,1292,1,3,1,1,2,single-choice,spatial-relational,1|2,7,1/2,210047,1
3,4,21,48,1,1098,1,3,1,1,2,single-choice,spatial-relational,1|2,7,1/2,210048,1
3,4,21,49,1,1605,1,11,5,5,6,single-choice,spatial-relational,5|6,7,5/6,210049,5
3,4,21,50,1,2028,1,3,1,1,2,single-choice,spatial-relational,1|2,7,1/2,210050,1
3,4,21,51,0,1049,1,5,2,3,3,single-choice,spatial-relational,2|3,7,2/3,210051,2
3,4,21,52,1,945,1,9,4,4,5,single-choice,spatial-relational,4|5,7,4/5,210052,4
3,4,21,53,1,1109,1,7,3,3,4,single-choice,spatial-relational,3|4,7,3/4,210053,3
3,4,21,54,1,1640,1,3,1,1,2,single-choice,spatial-relational,1|2,7,1/2,210054,1
3,4,21,55,1,1140,1,13,6,6,7,single-choice,spatial-relational,6|7,7,6/7,210055,6
3,4,21,56,1,1822,1,7,3,3,4,single-choice,spatial-relational,3|4,7,3/4,210056,3
3,4,21,57,1,1100,1,13,6,6,7,single-choice,spatial-relational,6|7,7,6/7,210057,6
3,4,21,58,1,2251,1,5,2,2,3,single-choice,spatial-relational,2|3,7,2/3,210058,2
3,4,21,59,1,1586,1,11,5,5,6,single-choice,spatial-relational,5|6,7,5/6,210059,5
3,4,21,60,1,1339,1,9,4,4,5,single-choice,spatial-relational,4|5,7,4/5,210060,4
3,4,21,61,1,1324,1,5,2,2,3,single-choice,spatial-relational,2|3,7,2/3,210061,2
3,4,21,62,1,1556,1,13,6,6,7,single-choice,spatial-relational,6|7,7,6/7,210062,6
3,4,21,63,1,2950,1,11,5,5,6,single-choice,spatial-relational,5|6,7,5/6,210063,5
3,4,21,64,0,1807,1,3,1,2,2,single-choice,spatial-relational,1|2,7,1/2,210064,1
3,4,21,65,1,1394,1,7,3,3,4,single-choice,spatial-relational,3|4,7,3/4,210065,3
3,4,21,66,1,953,1,13,6,6,7,single-choice,spatial-relational,6|7,7,6/7,210066,6
3,4,21,67,1,1424,1,7,3,3,4,single-choice,spatial-relational,3|4,7,3/4,210067,3
3,4,21,68,1,1363,1,9,4,4,5,single-choice,spatial-relational,4|5,7,4/5,210068,4
3,4,21,69,1,2233,1,11,5,5,6,single-choice,spatial-relational,5|6,7,5/6,210069,5
3,4,21,70,1,2232,1,9,4,4,5,single-choice,spatial-relational,4|5,7,4/5,210070,4
3,4,21,71,1,2570,1,5,2,2,3,single-choice,spatial-relational,2|3,7,2/3,210071,2
3,4,21,72,0,1126,1,3,1,2,2,single-choice,spatial-relational,1|2,7,1/2,210072,1
3,4,21,73,1,1441,1,9,4,4,5,single-choice,spatial-relational,4|5,7,4/5,210073,4
3,4,21,74,1,1208,1,13,6,6,7,single-choice,spatial-relational,6|7,7,6/7,210074,6
3,4,21,75,0,2612,1,7,3,4,4,single-choice,spatial-relational,3|4,7,3/4,210075,3
3,4,21,76,1,1292,1,5,2,2,3,single-choice,spatial-relational,2|3,7,2/3,210076,2
3,4,21,77,1,1346,1,11,5,5,6,single-choice,spatial-relational,5|6,7,5/6,210077,5
3,4,21,78,0,1790,1,3,1,2,2,single-choice,spatial-relational,1|2,7,1/2,210078,1
3,4,21,79,1,1081,1,7,3,3,4,single-choice,spatial-relational,3|4,7,3/4,210079,3
3,4,21,80,1,1722,1,11,5,5,6,single-choice,spatial-relational,5|6,7,5/6,210080,5
3,4,21,81,0,2475,1,5,2,3,3,single-choice,spatial-relational,2|3,7,2/3,210081,2
3,4,21,82,1,1377,1,9,4,4,5,single-choice,spatial-relational,4|5,7,4/5,210082,4
3,4,21,83,1,1653,1,3,1,1,2,single-choice,spatial-relational,1|2,7,1/2,210083,1
3,4,21,84,0,802,1,13,6,7,7,single-choice,spatial-relational,6|7,7,6/7,210084,6
3,4,21,85,1,1387,1,13,6,6,7,single-choice,spatial-relational,6|7,7,6/7,210085,6
3,4,21,86,1,2223,1,11,5,5,6,single-choice,spatial-relational,5|6,7,5/6,210086,5
3,4,21,87,1,1650,1,13,6,6,7,single-choice,spatial-relational,6|7,7,6/7,210087,6
3,4,21,88,1,1566,1,7,3,3,4,single-choice,spatial-relational,3|4,7,3/4,210088,3
3,4,21,89,1,1304,1,5,2,2,3,single-choice,spatial-relational,2|3,7,2/3,210089,2
3,4,21,90,0,1444,1,7,3,4,4,single-choice,spatial-relational,3|4,7,3/4,210090,3
3,4,21,91,1,1099,1,5,2,2,3,single-choice,spatial-relational,2|3,7,2/3,210091,2
3,4,21,92,0,2019,1,9,4,5,5,single-choice,spatial-relational,4|5,7,4/5,210092,4
3,4,21,93,0,749,1,3,1,2,2,single-choice,spatial-relational,1|2,7,1/2,210093,1
3,4,21,94,0,1314,1,9,4,5,5,single-choice,spatial-relational,4|5,7,4/5,210094,4
3,4,21,95,1,776,1,3,1,1,2,single-choice,spatial-relational,1|2,7,1/2,210095,1
3,4,21,96,1,1626,1,11,5,5,6,single-choice,spatial-relational,5|6,7,5/6,210096,5
3,4,21,97,1,1385,1,5,2,2,3,single-choice,spatial-relational,2|3,7,2/3,210097,2
3,4,21,98,1,2396,1,9,4,4,5,single-choice,spatial-relational,4|5,7,4/5,210098,4
3,4,21,99,1,1490,1,11,5,5,6,single-choice,spatial-relational,5|6,7,5/6,210099,5
3,4,21,100,1,1465,1,7,3,3,4,single-choice,spatial-relational,3|4,7,3/4,210100,3
3,4,21,101,1,1685,1,9,4,4,5,single-choice,spatial-relational,4|5,7,4/5,210101,4
3,4,21,102,0,2285,1,13,6,7,7,single-choice,spatial-relational,6|7,7,6/7,210102,6
3,4,21,103,1,1294,1,13,6,6,7,single-choice,spatial-relational,6|7,7,6/7,210103,6
3,4,21,104,1,2280,1,11,5,5,6,single-choice,spatial-relational,5|6,7,5/6,210104,5
3,4,21,105,0,2345,1,5,2,3,3,single-choice,spatial-relational,2|3,7,2/3,210105,2
3,4,21,106,1,879,1,3,1,1,2,single-choice,spatial-relational,1|2,7,1/2,210106,1
3,4,21,107,0,2073,1,7,3,4,4,single-choice,spatial-relational,3|4,7,3/4,210107,3
3,4,21,108,1,837,1,3,1,1,2,single-choice,spatial-relational,1|2,7,1/2,210108,1
3,4,21,109,1,1295,1,13,6,6,7,single-choice,spatial-relational,6|7,7,6/7,210109,6
3,4,21,110,1,1818,1,11,5,5,6,single-choice,spatial-relational,5|6,7,5/6,210110,5
3,4,21,111,1,2225,1,3,1,1,2,single-choice,spatial-relational,1|2,7,1/2,210111,1
3,4,21,112,1,1109,1,3,1,1,2,single-choice,spatial-relational,1|2,7,1/2,210112,1
3,4,21,113,0,1029,1,7,3,4,4,single-choice,spatial-relational,3|4,7,3/4,210113,3
3,4,21,114,1,1939,1,13,6,6,7,single-choice,spatial-relational,6|7,7,6/7,210114,6
3,4,21,115,1,3743,1,9,4,4,5,single-choice,spatial-relational,4|5,7,4/5,210115,4
3,4,21,116,1,1174,1,11,5,5,6,single-choice,spatial-relational,5|6,7,5/6,210116,5
3,4,21,117,1,1321,1,5,2,2,3,single-choice,spatial-relational,2|3,7,2/3,210117,2
3,4,21,118,1,1273,1,5,2,2,3,single-choice,spatial-relational,2|3,7,2/3,210118,2
3,4,21,119,1,1372,1,7,3,3,4,single-choice,spatial-relational,3|4,7,3/4,210119,3
3,4,21,120,0,1164,1,9,4,5,5,single-choice,spatial-relational,4|5,7,4/5,210120,4
3,4,21,121,1,1697,1,7,3,3,4,single-choice,spatial-relational,3|4,7,3/4,210121,3
3,4,21,122,1,1555,1,11,5,5,6,single-choice,spatial-relational,5|6,7,5/6,210122,5
3,4,21,123,0,2016,1,9,4,5,5,single-choice,spatial-relational,4|5,7,4/5,210123,4
3,4,21,124,0,726,1,5,2,3,3,single-choice,spatial-relational,2|3,7,2/3,210124,2
3,4,21,125,1,1458,1,7,3,3,4,single-choice,spatial-relational,3|4,7,3/4,210125,3
3,4,21,126,1,1130,1,13,6,6,7,single-choice,spatial-relational,6|7,7,6/7,210126,6
3,4,21,127,1,1429,1,3,1,1,2,single-choice,spatial-relational,1|2,7,1/2,210127,1
3,4,21,128,1,1279,1,3,1,1,2,single-choice,spatial-relational,1|2,7,1/2,210128,1
3,4,21,129,1,1611,1,11,5,5,6,single-choice,spatial-relational,5|6,7,5/6,210129,5
3,4,21,130,1,1895,1,9,4,4,5,single-choice,spatial-relational,4|5,7,4/5,210130,4
3,4,21,131,0,1230,1,5,2,3,3,single-choice,spatial-relational,2|3,7,2/3,210131,2
3,4,21,132,1,1064,1,13,6,6,7,single-choice,spatial-relational,6|7,7,6/7,210132,6
3,4,21,133,0,1519,1,5,2,3,3,single-choice,spatial-relational,2|3,7,2/3,210133,2
3,4,21,134,0,642,1,5,2,3,3,single-choice,spatial-relational,2|3,7,2/3,210134,2
3,4,21,135,0,1193,1,7,3,4,4,single-choice,spatial-relational,3|4,7,3/4,210135,3
3,4,21,136,1,1735,1,11,5,5,6,single-choice,spatial-relational,5|6,7,5/6,210136,5
3,4,21,137,1,1560,1,3,1,1,2,single-choice,spatial-relational,1|2,7,1/2,210137,1
3,4,21,138,1,1487,1,13,6,6,7,single-choice,spatial-relational,6|7,7,6/7,210138,6
3,4,21,139,1,2964,1,7,3,3,4,single-choice,spatial-relational,3|4,7,3/4,210139,3
3,4,21,140,1,2146,1,13,6,6,7,single-choice,spatial-relational,6|7,7,6/7,210140,6
3,4,21,141,1,2917,1,9,4,4,5,single-choice,spatial-relational,4|5,7,4/5,210141,4
3,4,21,142,1,2158,1,9,4,4,5,single-choice,spatial-relational,4|5,7,4/5,210142,4
3,4,21,143,0,876,1,3,1,2,2,single-choice,spatial-relational,1|2,7,1/2,210143,1
3,4,21,144,1,1374,1,11,5,5,6,single-choice,spatial-relational,5|6,7,5/6,210144,5
3,4,21,145,0,1699,1,9,4,5,5,single-choice,spatial-relational,4|5,7,4/5,210145,4
3,4,21,146,1,1137,1,13,6,6,7,single-choice,spatial-relational,6|7,7,6/7,210146,6
3,4,21,147,1,2413,1,3,1,1,2,single-choice,spatial-relational,1|2,7,1/2,210147,1
3,4,21,148,0,2248,1,7,3,4,4,single-choice,spatial-relational,3|4,7,3/4,210148,3
3,4,21,149,0,1005,1,3,1,2,2,single-choice,spatial-relational,1|2,7,1/2,210149,1
3,4,21,150,1,1477,1,11,5,5,6,single-choice,spatial-relational,5|6,7,5/6,210150,5
3,4,21,151,1,1506,1,9,4,4,5,single-choice,spatial-relational,4|5,7,4/5,210151,4
3,4,21,152,1,1647,1,5,2,2,3,single-choice,spatial-relational,2|3,7,2/3,210152,2
3,4,21,153,1,1977,1,11,5,5,6,single-choice,spatial-relational,5|6,7,5/6,210153,5
3,4,21,154,1,855,1,7,3,3,4,single-choice,spatial-relational,3|4,7,3/4,210154,3
3,4,21,155,1,1003,1,13,6,6,7,single-choice,spatial-relational,6|7,7,6/7,210155,6
3,4,21,156,1,3033,1,5,2,2,3,single-choice,spatial-relational,2|3,7,2/3,210156,2
3,4,21,157,1,1607,1,3,1,1,2,single-choice,spatial-relational,1|2,7,1/2,210157,1
3,4,21,158,0,1398,1,5,2,3,3,single-choice,spatial-relational,2|3,7,2/3,210158,2
3,4,21,159,0,1182,1,9,4,5,5,single-choice,spatial-relational,4|5,7,4/5,210159,4
3,4,21,160,1,1099,1,7,3,3,4,single-choice,spatial-relational,3|4,7,3/4,210160,3
3,4,21,161,1,1838,1,7,3,3,4,single-choice,spatial-relational,3|4,7,3/4,210161,3
3,4,21,162,0,2018,1,13,6,7,7,single-choice,spatial-relational,6|7,7,6/7,210162,6
3,4,21,163,1,1263,1,11,5,5,6,single-choice,spatial-relational,5|6,7,5/6,210163,5
3,4,21,164,1,2323,1,11,5,5,6,single-choice,spatial-relational,5|6,7,5/6,210164,5
3,4,21,165,0,1229,1,5,2,3,3,single-choice,spatial-relational,2|3,7,2/3,210165,2
3,4,21,166,0,1119,1,3,1,2,2,single-choice,spatial-relational,1|2,7,1/2,210166,1
3,4,21,167,0,36,1,9,4,5,5,single-choice,spatial-relational,4|5,7,4/5,210167,4
3,4,21,168,1,1290,1,13,6,6,7,single-choice,spatial-relational,6|7,7,6/7,210168,6
3,4,21,169,1,1207,1,11,5,5,6,single-choice,spatial-relational,5|6,7,5/6,210169,5
3,4,21,170,1,1419,1,13,6,6,7,single-choice,spatial-relational,6|7,7,6/7,210170,6
3,4,21,171,0,1776,1,9,4,5,5,single-choice,spatial-relational,4|5,7,4/5,210171,4
3,4,21,172,0,1253,1,3,1,2,2,single-choice,spatial-relational,1|2,7,1/2,210172,1
3,4,21,173,1,1416,1,7,3,3,4,single-choice,spatial-relational,3|4,7,3/4,210173,3
3,4,21,174,0,1877,1,9,4,5,5,single-choice,spatial-relational,4|5,7,4/5,210174,4
3,4,21,175,0,40,1,5,2,3,3,single-choice,spatial-relational,2|3,7,2/3,210175,2
3,4,21,176,1,1721,1,11,5,5,6,single-choice,spatial-relational,5|6,7,5/6,210176,5
3,4,21,177,1,1419,1,13,6,6,7,single-choice,spatial-relational,6|7,7,6/7,210177,6
3,4,21,178,1,1993,1,7,3,3,4,single-choice,spatial-relational,3|4,7,3/4,210178,3
3,4,21,179,1,1593,1,5,2,2,3,single-choice,spatial-relational,2|3,7,2/3,210179,2
3,4,21,180,0,1112,1,3,1,2,2,single-choice,spatial-relational,1|2,7,1/2,210180,1
3,4,21,181,1,1561,1,5,2,2,3,single-choice,spatial-relational,2|3,7,2/3,210181,2
3,4,21,182,0,2050,1,7,3,4,4,single-choice,spatial-relational,3|4,7,3/4,210182,3
3,4,21,183,1,1253,1,13,6,6,7,single-choice,spatial-relational,6|7,7,6/7,210183,6
3,4,21,184,1,2797,1,9,4,4,5,single-choice,spatial-relational,4|5,7,4/5,210184,4
3,4,21,185,0,1706,1,3,1,2,2,single-choice,spatial-relational,1|2,7,1/2,210185,1
3,4,21,186,0,1034,1,3,1,2,2,single-choice,spatial-relational,1|2,7,1/2,210186,1
3,4,21,187,1,1167,1,5,2,2,3,single-choice,spatial-relational,2|3,7,2/3,210187,2
3,4,21,188,1,1498,1,11,5,5,6,single-choice,spatial-relational,5|6,7,5/6,210188,5
3,4,21,189,1,2100,1,11,5,5,6,single-choice,spatial-relational,5|6,7,5/6,210189,5
3,4,21,190,1,2186,1,9,4,4,5,single-choice,spatial-relational,4|5,7,4/5,210190,4
3,4,21,191,1,1831,1,7,3,3,4,single-choice,spatial-relational,3|4,7,3/4,210191,3
3,4,21,192,1,2001,1,13,6,6,7,single-choice,spatial-relational,6|7,7,6/7,210192,6
3,4,21,193,1,4516,1,5,2,2,3,single-choice,spatial-relational,2|3,7,2/3,210193,2
3,4,21,194,0,1224,1,3,1,2,2,single-choice,spatial-relational,1|2,7,1/2,210194,1
3,4,21,195,0,1517,1,9,4,5,5,single-choice,spatial-relational,4|5,7,4/5,210195,4
3,4,21,196,1,1824,1,11,5,5,6,single-choice,spatial-relational,5|6,7,5/6,210196,5
3,4,21,197,1,2408,1,7,3,3,4,single-choice,spatial-relational,3|4,7,3/4,210197,3
3,4,21,198,1,1887,1,3,1,1,2,single-choice,spatial-relational,1|2,7,1/2,210198,1
3,4,21,199,1,1426,1,5,2,2,3,single-choice,spatial-relational,2|3,7,2/3,210199,2
3,4,21,200,1,1936,1,9,4,4,5,single-choice,spatial-relational,4|5,7,4/5,210200,4
3,4,21,201,1,1545,1,13,6,6,7,single-choice,spatial-relational,6|7,7,6/7,210201,6
3,4,21,202,1,2036,1,11,5,5,6,single-choice,spatial-relational,5|6,7,5/6,210202,5
3,4,21,203,0,2865,1,13,6,7,7,single-choice,spatial-relational,6|7,7,6/7,210203,6
3,4,21,204,1,1012,1,7,3,3,4,single-choice,spatial-relational,3|4,7,3/4,210204,3
3,4,21,205,0,2687,1,7,3,4,4,single-choice,spatial-relational,3|4,7,3/4,210205,3
3,4,21,206,1,778,1,3,1,1,2,single-choice,spatial-relational,1|2,7,1/2,210206,1
3,4,21,207,1,929,1,13,6,6,7,single-choice,spatial-relational,6|7,7,6/7,210207,6
3,4,21,208,1,2484,1,11,5,5,6,single-choice,spatial-relational,5|6,7,5/6,210208,5
3,4,21,209,1,1401,1,7,3,3,4,single-choice,spatial-relational,3|4,7,3/4,210209,3
3,4,21,210,1,2161,1,13,6,6,7,single-choice,spatial-relational,6|7,7,6/7,210210,6
3,4,21,211,1,2009,1,9,4,4,5,single-choice,spatial-relational,4|5,7,4/5,210211,4
3,4,21,212,0,1505,1,3,1,2,2,single-choice,spatial-relational,1|2,7,1/2,210212,1
3,4,21,213,0,914,1,5,2,3,3,single-choice,spatial-relational,2|3,7,2/3,210213,2
3,4,21,214,0,1458,1,9,4,5,5,single-choice,spatial-relational,4|5,7,4/5,210214,4
3,4,21,215,1,1933,1,11,5,5,6,single-choice,spatial-relational,5|6,7,5/6,210215,5
3,4,21,216,1,1167,1,5,2,2,3,single-choice,spatial-relational,2|3,7,2/3,210216,2
3,4,21,217,1,1444,1,7,3,3,4,single-choice,spatial-relational,3|4,7,3/4,210217,3
3,4,21,218,1,2641,1,9,4,4,5,single-choice,spatial-relational,4|5,7,4/5,210218,4
3,4,21,219,1,4313,1,13,6,6,7,single-choice,spatial-relational,6|7,7,6/7,210219,6
3,4,21,220,0,1249,1,3,1,2,2,single-choice,spatial-relational,1|2,7,1/2,210220,1
3,4,21,221,0,44,1,5,2,3,3,single-choice,spatial-relational,2|3,7,2/3,210221,2
3,4,21,222,1,1191,1,7,3,3,4,single-choice,spatial-relational,3|4,7,3/4,210222,3
3,4,21,223,1,1410,1,11,5,5,6,single-choice,spatial-relational,5|6,7,5/6,210223,5
3,4,21,224,1,2409,1,3,1,1,2,single-choice,spatial-relational,1|2,7,1/2,210224,1
3,4,21,225,1,1717,1,9,4,4,5,single-choice,spatial-relational,4|5,7,4/5,210225,4
3,4,21,226,0,1783,1,5,2,3,3,single-choice,spatial-relational,2|3,7,2/3,210226,2
3,4,21,227,1,1505,1,11,5,5,6,single-choice,spatial-relational,5|6,7,5/6,210227,5
3,4,21,228,1,2361,1,13,6,6,7,single-choice,spatial-relational,6|7,7,6/7,210228,6
3,4,21,229,1,2652,1,3,1,1,2,single-choice,spatial-relational,1|2,7,1/2,210229,1
3,4,21,230,1,1045,1,13,6,6,7,single-choice,spatial-relational,6|7,7,6/7,210230,6
3,4,21,231,1,2782,1,9,4,4,5,single-choice,spatial-relational,4|5,7,4/5,210231,4
3,4,21,232,1,1985,1,11,5,5,6,single-choice,spatial-relational,5|6,7,5/6,210232,5
3,4,21,233,1,3009,1,9,4,4,5,single-choice,spatial-relational,4|5,7,4/5,210233,4
3,4,21,234,0,2191,1,5,2,3,3,single-choice,spatial-relational,2|3,7,2/3,210234,2
3,4,21,235,1,969,1,7,3,3,4,single-choice,spatial-relational,3|4,7,3/4,210235,3
3,4,21,236,1,2588,1,5,2,2,3,single-choice,spatial-relational,2|3,7,2/3,210236,2
3,4,21,237,1,1063,1,3,1,1,2,single-choice,spatial-relational,1|2,7,1/2,210237,1
3,4,21,238,1,1123,1,7,3,3,4,single-choice,spatial-relational,3|4,7,3/4,210238,3
3,4,21,239,1,2711,1,13,6,6,7,single-choice,spatial-relational,6|7,7,6/7,210239,6
3,4,21,240,1,2192,1,11,5,5,6,single-choice,spatial-relational,5|6,7,5/6,210240,5
3,4,21,241,0,2750,1,7,3,4,4,single-choice,spatial-relational,3|4,7,3/4,210241,3
3,4,21,242,0,779,1,5,2,3,3,single-choice,spatial-relational,2|3,7,2/3,210242,2
3,4,21,243,1,2295,1,11,5,5,6,single-choice,spatial-relational,5|6,7,5/6,210243,5
3,4,21,244,1,715,1,3,1,1,2,single-choice,spatial-relational,1|2,7,1/2,210244,1
3,4,21,245,0,728,1,9,4,5,5,single-choice,spatial-relational,4|5,7,4/5,210245,4
3,4,21,246,0,1171,1,9,4,5,5,single-choice,spatial-relational,4|5,7,4/5,210246,4
3,4,21,247,0,797,1,3,1,2,2,single-choice,spatial-relational,1|2,7,1/2,210247,1
3,4,21,248,1,1055,1,7,3,3,4,single-choice,spatial-relational,3|4,7,3/4,210248,3
3,4,21,249,1,1015,1,13,6,6,7,single-choice,spatial-relational,6|7,7,6/7,210249,6
3,4,21,250,1,2234,1,13,6,6,7,single-choice,spatial-relational,6|7,7,6/7,210250,6
3,4,21,251,1,2489,1,11,5,5,6,single-choice,spatial-relational,5|6,7,5/6,210251,5
3,4,21,252,1,3030,1,5,2,2,3,single-choice,spatial-relational,2|3,7,2/3,210252,2
3,4,21,253,0,1219,1,3,1,2,2,single-choice,spatial-relational,1|2,7,1/2,210253,1
3,4,21,254,1,1452,1,7,3,3,4,single-choice,spatial-relational,3|4,7,3/4,210254,3
3,4,21,255,1,1396,1,5,2,2,3,single-choice,spatial-relational,2|3,7,2/3,210255,2
3,4,21,256,1,1095,1,11,5,5,6,single-choice,spatial-relational,5|6,7,5/6,210256,5
3,4,21,257,1,2572,1,11,5,5,6,single-choice,spatial-relational,5|6,7,5/6,210257,5
3,4,21,258,1,2197,1,13,6,6,7,single-choice,spatial-relational,6|7,7,6/7,210258,6
3,4,21,259,0,2405,1,5,2,3,3,single-choice,spatial-relational,2|3,7,2/3,210259,2
3,4,21,260,1,923,1,3,1,1,2,single-choice,spatial-relational,1|2,7,1/2,210260,1
3,4,21,261,0,991,1,9,4,5,5,single-choice,spatial-relational,4|5,7,4/5,210261,4
3,4,21,262,1,1849,1,9,4,4,5,single-choice,spatial-relational,4|5,7,4/5,210262,4
3,4,21,263,1,1121,1,13,6,6,7,single-choice,spatial-relational,6|7,7,6/7,210263,6
3,4,21,264,1,2721,1,7,3,3,4,single-choice,spatial-relational,3|4,7,3/4,210264,3
3,4,21,265,1,1908,1,7,3,3,4,single-choice,spatial-relational,3|4,7,3/4,210265,3
3,4,21,266,0,1905,1,9,4,5,5,single-choice,spatial-relational,4|5,7,4/5,210266,4
3,4,21,267,0,696,1,5,2,3,3,single-choice,spatial-relational,2|3,7,2/3,210267,2
3,4,21,268,1,1429,1,11,5,5,6,single-choice,spatial-relational,5|6,7,5/6,210268,5
3,4,21,269,0,1041,1,13,6,7,7,single-choice,spatial-relational,6|7,7,6/7,210269,6
3,4,21,270,1,1002,1,9,4,4,5,single-choice,spatial-relational,4|5,7,4/5,210270,4
3,4,21,271,0,1275,1,13,6,7,7,single-choice,spatial-relational,6|7,7,6/7,210271,6
3,4,21,272,1,1512,1,7,3,3,4,single-choice,spatial-relational,3|4,7,3/4,210272,3
3,4,21,273,1,1227,1,11,5,5,6,single-choice,spatial-relational,5|6,7,5/6,210273,5
3,4,21,274,1,1492,1,5,2,2,3,single-choice,spatial-relational,2|3,7,2/3,210274,2
3,4,21,275,0,1129,1,3,1,2,2,single-choice,spatial-relational,1|2,7,1/2,210275,1
3,4,21,276,1,1039,1,3,1,1,2,single-choice,spatial-relational,1|2,7,1/2,210276,1
3,4,21,277,0,1069,1,5,2,3,3,single-choice,spatial-relational,2|3,7,2/3,210277,2
3,4,21,278,0,1853,1,9,4,5,5,single-choice,spatial-relational,4|5,7,4/5,210278,4
3,4,21,279,1,1617,1,9,4,4,5,single-choice,spatial-relational,4|5,7,4/5,210279,4
3,4,21,280,0,1761,1,5,2,3,3,single-choice,spatial-relational,2|3,7,2/3,210280,2
3,4,21,281,1,1054,1,11,5,5,6,single-choice,spatial-relational,5|6,7,5/6,210281,5
3,4,21,282,1,1286,1,13,6,6,7,single-choice,spatial-relational,6|7,7,6/7,210282,6
3,4,21,283,0,1266,1,3,1,2,2,single-choice,spatial-relational,1|2,7,1/2,210283,1
3,4,21,284,1,1172,1,11,5,5,6,single-choice,spatial-relational,5|6,7,5/6,210284,5
3,4,21,285,1,1344,1,13,6,6,7,single-choice,spatial-relational,6|7,7,6/7,210285,6
3,4,21,286,1,2701,1,3,1,1,2,single-choice,spatial-relational,1|2,7,1/2,210286,1
3,4,21,287,1,1990,1,7,3,3,4,single-choice,spatial-relational,3|4,7,3/4,210287,3
3,4,21,288,1,1377,1,7,3,3,4,single-choice,spatial-relational,3|4,7,3/4,210288,3
3,4,21,289,1,1369,1,13,6,6,7,single-choice,spatial-relational,6|7,7,6/7,210289,6
3,4,21,290,1,2559,1,7,3,3,4,single-choice,spatial-relational,3|4,7,3/4,210290,3
3,4,21,291,1,1946,1,3,1,1,2,single-choice,spatial-relational,1|2,7,1/2,210291,1
3,4,21,292,0,1792,1,9,4,5,5,single-choice,spatial-relational,4|5,7,4/5,210292,4
3,4,21,293,1,1177,1,3,1,1,2,single-choice,spatial-relational,1|2,7,1/2,210293,1
3,4,21,294,0,1699,1,5,2,3,3,single-choice,spatial-relational,2|3,7,2/3,210294,2
3,4,21,295,1,2416,1,9,4,4,5,single-choice,spatial-relational,4|5,7,4/5,210295,4
3,4,21,296,1,2294,1,11,5,5,6,single-choice,spatial-relational,5|6,7,5/6,210296,5
3,4,21,297,1,1710,1,7,3,3,4,single-choice,spatial-relational,3|4,7,3/4,210297,3
3,4,21,298,1,2010,1,11,5,5,6,single-choice,spatial-relational,5|6,7,5/6,210298,5
3,4,21,299,1,1317,1,13,6,6,7,single-choice,spatial-relational,6|7,7,6/7,210299,6
3,4,21,300,1,1608,1,5,2,2,3,single-choice,spatial-relational,2|3,7,2/3,210300,2
3,4,21,301,1,1134,1,5,2,2,3,single-choice,spatial-relational,2|3,7,2/3,210301,2
3,4,21,302,1,1932,1,13,6,6,7,single-choice,spatial-relational,6|7,7,6/7,210302,6
3,4,21,303,0,1157,1,3,1,2,2,single-choice,spatial-relational,1|2,7,1/2,210303,1
3,4,21,304,0,1715,1,9,4,5,5,single-choice,spatial-relational,4|5,7,4/5,210304,4
3,4,21,305,1,1272,1,7,3,3,4,single-choice,spatial-relational,3|4,7,3/4,210305,3
3,4,21,306,1,1171,1,11,5,5,6,single-choice,spatial-relational,5|6,7,5/6,210306,5
3,4,21,307,0,2526,1,5,2,3,3,single-choice,spatial-relational,2|3,7,2/3,210307,2
3,4,21,308,1,984,1,3,1,1,2,single-choice,spatial-relational,1|2,7,1/2,210308,1
3,4,21,309,1,1022,1,11,5,5,6,single-choice,spatial-relational,5|6,7,5/6,210309,5
3,4,21,310,1,2837,1,9,4,4,5,single-choice,spatial-relational,4|5,7,4/5,210310,4
3,4,21,311,1,995,1,7,3,3,4,single-choice,spatial-relational,3|4,7,3/4,210311,3
3,4,21,312,1,1651,1,13,6,6,7,single-choice,spatial-relational,6|7,7,6/7,210312,6
3,4,21,313,1,2958,1,11,5,5,6,single-choice,spatial-relational,5|6,7,5/6,210313,5
3,4,21,314,1,1186,1,3,1,1,2,single-choice,spatial-relational,1|2,7,1/2,210314,1
3,4,21,315,1,1343,1,9,4,4,5,single-choice,spatial-relational,4|5,7,4/5,210315,4
3,4,21,316,1,1924,1,7,3,3,4,single-choice,spatial-relational,3|4,7,3/4,210316,3
3,4,21,317,0,1153,1,13,6,7,7,single-choice,spatial-relational,6|7,7,6/7,210317,6
3,4,21,318,1,1923,1,5,2,2,3,single-choice,spatial-relational,2|3,7,2/3,210318,2
3,4,21,319,1,1837,1,9,4,4,5,single-choice,spatial-relational,4|5,7,4/5,210319,4
3,4,21,320,0,1654,1,3,1,2,2,single-choice,spatial-relational,1|2,7,1/2,210320,1
3,4,21,321,1,1597,1,11,5,5,6,single-choice,spatial-relational,5|6,7,5/6,210321,5
3,4,21,322,0,1178,1,5,2,3,3,single-choice,spatial-relational,2|3,7,2/3,210322,2
3,4,21,323,1,2053,1,7,3,3,4,single-choice,spatial-relational,3|4,7,3/4,210323,3
3,4,21,324,1,1358,1,13,6,6,7,single-choice,spatial-relational,6|7,7,6/7,210324,6
3,4,21,325,0,3463,1,9,4,5,5,single-choice,spatial-relational,4|5,7,4/5,210325,4
3,4,21,326,1,1507,1,11,5,5,6,single-choice,spatial-relational,5|6,7,5/6,210326,5
3,4,21,327,1,1498,1,13,6,6,7,single-choice,spatial-relational,6|7,7,6/7,210327,6
3,4,21,328,1,2062,1,3,1,1,2,single-choice,spatial-relational,1|2,7,1/2,210328,1
3,4,21,329,1,1345,1,13,6,6,7,single-choice,spatial-relational,6|7,7,6/7,210329,6
3,4,21,330,1,2714,1,7,3,3,4,single-choice,spatial-relational,3|4,7,3/4,210330,3
3,4,21,331,1,1894,1,9,4,4,5,single-choice,spatial-relational,4|5,7,4/5,210331,4
3,4,21,332,1,2390,1,7,3,3,4,single-choice,spatial-relational,3|4,7,3/4,210332,3
3,4,21,333,1,1322,1,5,2,2,3,single-choice,spatial-relational,2|3,7,2/3,210333,2
3,4,21,334,0,831,1,3,1,2,2,single-choice,spatial-relational,1|2,7,1/2,210334,1
3,4,21,335,0,1189,1,5,2,3,3,single-choice,spatial-relational,2|3,7,2/3,210335,2
3,4,21,336,1,1024,1,11,5,5,6,single-choice,spatial-relational,5|6,7,5/6,210336,5
3,4,21,337,0,1510,1,5,2,3,3,single-choice,spatial-relational,2|3,7,2/3,210337,2
3,4,21,338,1,1422,1,3,1,1,2,single-choice,spatial-relational,1|2,7,1/2,210338,1
3,4,21,339,1,931,1,13,6,6,7,single-choice,spatial-relational,6|7,7,6/7,210339,6
3,4,21,340,1,2644,1,13,6,6,7,single-choice,spatial-relational,6|7,7,6/7,210340,6
3,4,21,341,1,2243,1,3,1,1,2,single-choice,spatial-relational,1|2,7,1/2,210341,1
3,4,21,342,1,1722,1,9,4,4,5,single-choice,spatial-relational,4|5,7,4/5,210342,4
3,4,21,343,0,1847,1,9,4,5,5,single-choice,spatial-relational,4|5,7,4/5,210343,4
3,4,21,344,1,1427,1,11,5,5,6,single-choice,spatial-relational,5|6,7,5/6,210344,5
3,4,21,345,1,1290,1,7,3,3,4,single-choice,spatial-relational,3|4,7,3/4,210345,3
3,4,21,346,0,1739,1,5,2,3,3,single-choice,spatial-relational,2|3,7,2/3,210346,2
3,4,21,347,1,923,1,11,5,5,6,single-choice,spatial-relational,5|6,7,5/6,210347,5
3,4,21,348,1,1624,1,7,3,3,4,single-choice,spatial-relational,3|4,7,3/4,210348,3
3,4,21,349,1,1792,1,7,3,3,4,single-choice,spatial-relational,3|4,7,3/4,210349,3
3,4,21,350,0,1920,1,9,4,5,5,single-choice,spatial-relational,4|5,7,4/5,210350,4
3,4,21,351,1,956,1,13,6,6,7,single-choice,spatial-relational,6|7,7,6/7,210351,6
3,4,21,352,1,2968,1,5,2,2,3,single-choice,spatial-relational,2|3,7,2/3,210352,2
3,4,21,353,1,2319,1,5,2,2,3,single-choice,spatial-relational,2|3,7,2/3,210353,2
3,4,21,354,1,1008,1,11,5,5,6,single-choice,spatial-relational,5|6,7,5/6,210354,5
3,4,21,355,0,1504,1,3,1,2,2,single-choice,spatial-relational,1|2,7,1/2,210355,1
3,4,21,356,1,1454,1,7,3,3,4,single-choice,spatial-relational,3|4,7,3/4,210356,3
3,4,21,357,1,782,1,3,1,1,2,single-choice,spatial-relational,1|2,7,1/2,210357,1
3,4,21,358,1,878,1,13,6,6,7,single-choice,spatial-relational,6|7,7,6/7,210358,6
3,4,21,359,1,2511,1,11,5,5,6,single-choice,spatial-relational,5|6,7,5/6,210359,5
3,4,21,360,0,3304,1,9,4,5,5,single-choice,spatial-relational,4|5,7,4/5,210360,4
3,4,21,361,1,972,1,11,5,5,6,single-choice,spatial-relational,5|6,7,5/6,210361,5
3,4,21,362,0,769,1,3,1,2,2,single-choice,spatial-relational,1|2,7,1/2,210362,1
3,4,21,363,1,844,1,13,6,6,7,single-choice,spatial-relational,6|7,7,6/7,210363,6
3,4,21,364,1,1216,1,9,4,4,5,single-choice,spatial-relational,4|5,7,4/5,210364,4
3,4,21,365,1,2240,1,13,6,6,7,single-choice,spatial-relational,6|7,7,6/7,210365,6
3,4,21,366,1,2467,1,5,2,2,3,single-choice,spatial-relational,2|3,7,2/3,210366,2
3,4,21,367,1,1539,1,7,3,3,4,single-choice,spatial-relational,3|4,7,3/4,210367,3
3,4,21,368,1,1719,1,5,2,2,3,single-choice,spatial-relational,2|3,7,2/3,210368,2
3,4,21,369,1,1437,1,9,4,4,5,single-choice,spatial-relational,4|5,7,4/5,210369,4
3,4,21,370,1,1593,1,3,1,1,2,single-choice,spatial-relational,1|2,7,1/2,210370,1
3,4,21,371,0,1387,1,11,5,6,6,single-choice,spatial-relational,5|6,7,5/6,210371,5
3,4,21,372,1,972,1,7,3,3,4,single-choice,spatial-relational,3|4,7,3/4,210372,3
3,4,21,373,1,1782,1,9,4,4,5,single-choice,spatial-relational,4|5,7,4/5,210373,4
3,4,21,374,1,1314,1,13,6,6,7,single-choice,spatial-relational,6|7,7,6/7,210374,6
3,4,21,375,1,2504,1,7,3,3,4,single-choice,spatial-relational,3|4,7,3/4,210375,3
3,4,21,376,1,2762,1,9,4,4,5,single-choice,spatial-relational,4|5,7,4/5,210376,4
3,4,21,377,1,2455,1,11,5,5,6,single-choice,spatial-relational,5|6,7,5/6,210377,5
3,4,21,378,1,2362,1,11,5,5,6,single-choice,spatial-relational,5|6,7,5/6,210378,5
3,4,21,379,1,2106,1,5,2,2,3,single-choice,spatial-relational,2|3,7,2/3,210379,2
3,4,21,380,1,1561,1,7,3,3,4,single-choice,spatial-relational,3|4,7,3/4,210380,3
3,4,21,381,1,1734,1,5,2,2,3,single-choice,spatial-relational,2|3,7,2/3,210381,2
3,4,21,382,0,683,1,3,1,2,2,single-choice,spatial-relational,1|2,7,1/2,210382,1
3,4,21,383,1,1797,1,13,6,6,7,single-choice,spatial-relational,6|7,7,6/7,210383,6
3,4,21,384,1,863,1,3,1,1,2,single-choice,spatial-relational,1|2,7,1/2,210384,1
3,4,21,385,1,1450,1,11,5,5,6,single-choice,spatial-relational,5|6,7,5/6,210385,5
3,4,21,386,1,2099,1,3,1,1,2,single-choice,spatial-relational,1|2,7,1/2,210386,1
3,4,21,387,1,1098,1,13,6,6,7,single-choice,spatial-relational,6|7,7,6/7,210387,6
3,4,21,388,0,1935,1,5,2,3,3,single-choice,spatial-relational,2|3,7,2/3,210388,2
3,4,21,389,1,1045,1,11,5,5,6,single-choice,spatial-relational,5|6,7,5/6,210389,5
3,4,21,390,0,1525,1,5,2,3,3,single-choice,spatial-relational,2|3,7,2/3,210390,2
3,4,21,391,1,1594,1,7,3,3,4,single-choice,spatial-relational,3|4,7,3/4,210391,3
3,4,21,392,1,935,1,13,6,6,7,single-choice,spatial-relational,6|7,7,6/7,210392,6
3,4,21,393,1,2734,1,9,4,4,5,single-choice,spatial-relational,4|5,7,4/5,210393,4
3,4,21,394,0,1217,1,3,1,2,2,single-choice,spatial-relational,1|2,7,1/2,210394,1
3,4,21,395,1,2845,1,7,3,3,4,single-choice,spatial-relational,3|4,7,3/4,210395,3
3,4,21,396,0,2475,1,9,4,5,5,single-choice,spatial-relational,4|5,7,4/5,210396,4
3,4,21,397,1,1003,1,7,3,3,4,single-choice,spatial-relational,3|4,7,3/4,210397,3
3,4,21,398,1,1312,1,9,4,4,5,single-choice,spatial-relational,4|5,7,4/5,210398,4
3,4,21,399,1,1479,1,5,2,2,3,single-choice,spatial-relational,2|3,7,2/3,210399,2
3,4,21,400,1,1249,1,3,1,1,2,single-choice,spatial-relational,1|2,7,1/2,210400,1
3,4,21,401,1,938,1,5,2,2,3,single-choice,spatial-relational,2|3,7,2/3,210401,2
3,4,21,402,0,1502,1,11,5,6,6,single-choice,spatial-relational,5|6,7,5/6,210402,5
3,4,21,403,1,1185,1,11,5,5,6,single-choice,spatial-relational,5|6,7,5/6,210403,5
3,4,21,404,1,2303,1,13,6,6,7,single-choice,spatial-relational,6|7,7,6/7,210404,6
3,4,21,405,1,2707,1,13,6,6,7,single-choice,spatial-relational,6|7,7,6/7,210405,6
3,4,21,406,1,1823,1,7,3,3,4,single-choice,spatial-relational,3|4,7,3/4,210406,3
3,4,21,407,0,1371,1,9,4,5,5,single-choice,spatial-relational,4|5,7,4/5,210407,4
3,4,21,408,0,831,1,3,1,2,2,single-choice,spatial-relational,1|2,7,1/2,210408,1
3,4,21,409,1,1069,1,3,1,1,2,single-choice,spatial-relational,1|2,7,1/2,210409,1
3,4,21,410,1,1188,1,5,2,2,3,single-choice,spatial-relational,2|3,7,2/3,210410,2
3,4,21,411,1,2599,1,7,3,3,4,single-choice,spatial-relational,3|4,7,3/4,210411,3
3,4,21,412,1,1405,1,5,2,2,3,single-choice,spatial-relational,2|3,7,2/3,210412,2
3,4,21,413,1,1211,1,11,5,5,6,single-choice,spatial-relational,5|6,7,5/6,210413,5
3,4,21,414,0,1423,1,3,1,2,2,single-choice,spatial-relational,1|2,7,1/2,210414,1
3,4,21,415,1,911,1,11,5,5,6,single-choice,spatial-relational,5|6,7,5/6,210415,5
3,4,21,416,1,2436,1,9,4,4,5,single-choice,spatial-relational,4|5,7,4/5,210416,4
3,4,21,417,1,1120,1,7,3,3,4,single-choice,spatial-relational,3|4,7,3/4,210417,3
3,4,21,418,1,1509,1,13,6,6,7,single-choice,spatial-relational,6|7,7,6/7,210418,6
3,4,21,419,0,1827,1,13,6,7,7,single-choice,spatial-relational,6|7,7,6/7,210419,6
3,4,21,420,1,2262,1,9,4,4,5,single-choice,spatial-relational,4|5,7,4/5,210420,4
3,4,21,421,0,1734,1,9,4,5,5,single-choice,spatial-relational,4|5,7,4/5,210421,4
3,4,21,422,0,1567,1,7,3,4,4,single-choice,spatial-relational,3|4,7,3/4,210422,3
3,4,21,423,1,1469,1,11,5,5,6,single-choice,spatial-relational,5|6,7,5/6,210423,5
3,4,21,424,1,2474,1,5,2,2,3,single-choice,spatial-relational,2|3,7,2/3,210424,2
3,4,21,425,1,1340,1,5,2,2,3,single-choice,spatial-relational,2|3,7,2/3,210425,2
3,4,21,426,1,1496,1,11,5,5,6,single-choice,spatial-relational,5|6,7,5/6,210426,5
3,4,21,427,1,2606,1,13,6,6,7,single-choice,spatial-relational,6|7,7,6/7,210427,6
3,4,21,428,0,3721,1,9,4,5,5,single-choice,spatial-relational,4|5,7,4/5,210428,4
3,4,21,429,1,843,1,7,3,3,4,single-choice,spatial-relational,3|4,7,3/4,210429,3
3,4,21,430,1,897,1,13,6,6,7,single-choice,spatial-relational,6|7,7,6/7,210430,6
3,4,21,431,1,950,1,3,1,1,2,single-choice,spatial-relational,1|2,7,1/2,210431,1
3,4,21,432,0,764,1,3,1,2,2,single-choice,spatial-relational,1|2,7,1/2,210432,1
3,4,21,433,1,915,1,11,5,5,6,single-choice,spatial-relational,5|6,7,5/6,210433,5
3,4,21,434,1,941,1,7,3,3,4,single-choice,spatial-relational,3|4,7,3/4,210434,3
3,4,21,435,0,675,1,3,1,2,2,single-choice,spatial-relational,1|2,7,1/2,210435,1
3,4,21,436,0,2134,1,9,4,5,5,single-choice,spatial-relational,4|5,7,4/5,210436,4
3,4,21,437,1,822,1,3,1,1,2,single-choice,spatial-relational,1|2,7,1/2,210437,1
3,4,21,438,1,1435,1,5,2,2,3,single-choice,spatial-relational,2|3,7,2/3,210438,2
3,4,21,439,1,1492,1,7,3,3,4,single-choice,spatial-relational,3|4,7,3/4,210439,3
3,4,21,440,1,1377,1,13,6,6,7,single-choice,spatial-relational,6|7,7,6/7,210440,6
3,4,21,441,1,2046,1,11,5,5,6,single-choice,spatial-relational,5|6,7,5/6,210441,5
3,4,21,442,1,2348,1,9,4,4,5,single-choice,spatial-relational,4|5,7,4/5,210442,4
3,4,21,443,1,1492,1,5,2,2,3,single-choice,spatial-relational,2|3,7,2/3,210443,2
3,4,21,444,0,859,1,13,6,7,7,single-choice,spatial-relational,6|7,7,6/7,210444,6
3,4,21,445,0,747,1,3,1,2,2,single-choice,spatial-relational,1|2,7,1/2,210445,1
3,4,21,446,1,1870,1,9,4,4,5,single-choice,spatial-relational,4|5,7,4/5,210446,4
3,4,21,447,0,2482,1,9,4,5,5,single-choice,spatial-relational,4|5,7,4/5,210447,4
3,4,21,448,1,1565,1,11,5,5,6,single-choice,spatial-relational,5|6,7,5/6,210448,5
3,4,21,449,1,2446,1,3,1,1,2,single-choice,spatial-relational,1|2,7,1/2,210449,1
3,4,21,450,1,890,1,11,5,5,6,single-choice,spatial-relational,5|6,7,5/6,210450,5
3,4,21,451,1,1621,1,13,6,6,7,single-choice,spatial-relational,6|7,7,6/7,210451,6
3,4,21,452,1,2322,1,13,6,6,7,single-choice,spatial-relational,6|7,7,6/7,210452,6
3,4,21,453,0,1743,1,5,2,3,3,single-choice,spatial-relational,2|3,7,2/3,210453,2
3,4,21,454,1,2808,1,7,3,3,4,single-choice,spatial-relational,3|4,7,3/4,210454,3
3,4,21,455,1,1192,1,5,2,2,3,single-choice,spatial-relational,2|3,7,2/3,210455,2
3,4,21,456,0,1616,1,7,3,4,4,single-choice,spatial-relational,3|4,7,3/4,210456,3
3,4,21,457,1,964,1,13,6,6,7,single-choice,spatial-relational,6|7,7,6/7,210457,6
3,4,21,458,0,547,1,5,2,3,3,single-choice,spatial-relational,2|3,7,2/3,210458,2
3,4,21,459,1,32,1,11,5,5,6,single-choice,spatial-relational,5|6,7,5/6,210459,5
3,4,21,460,1,948,1,3,1,1,2,single-choice,spatial-relational,1|2,7,1/2,210460,1
3,4,21,461,1,873,1,13,6,6,7,single-choice,spatial-relational,6|7,7,6/7,210461,6
3,4,21,462,0,1867,1,9,4,5,5,single-choice,spatial-relational,4|5,7,4/5,210462,4
3,4,21,463,1,3376,1,11,5,5,6,single-choice,spatial-relational,5|6,7,5/6,210463,5
3,4,21,464,1,2424,1,7,3,3,4,single-choice,spatial-relational,3|4,7,3/4,210464,3
3,4,21,465,1,1355,1,9,4,4,5,single-choice,spatial-relational,4|5,7,4/5,210465,4
3,4,21,466,1,1778,1,5,2,2,3,single-choice,spatial-relational,2|3,7,2/3,210466,2
3,4,21,467,1,942,1,7,3,3,4,single-choice,spatial-relational,3|4,7,3/4,210467,3
3,4,21,468,0,1176,1,3,1,2,2,single-choice,spatial-relational,1|2,7,1/2,210468,1
3,4,21,469,0,1607,1,5,2,3,3,single-choice,spatial-relational,2|3,7,2/3,210469,2
3,4,21,470,1,829,1,3,1,1,2,single-choice,spatial-relational,1|2,7,1/2,210470,1
3,4,21,471,0,1775,1,9,4,5,5,single-choice,spatial-relational,4|5,7,4/5,210471,4
3,4,21,472,1,1073,1,7,3,3,4,single-choice,spatial-relational,3|4,7,3/4,210472,3
3,4,21,473,1,1261,1,13,6,6,7,single-choice,spatial-relational,6|7,7,6/7,210473,6
3,4,21,474,1,2946,1,11,5,5,6,single-choice,spatial-relational,5|6,7,5/6,210474,5
3,4,21,475,1,2341,1,11,5,5,6,single-choice,spatial-relational,5|6,7,5/6,210475,5
3,4,21,476,1,2471,1,13,6,6,7,single-choice,spatial-relational,6|7,7,6/7,210476,6
3,4,21,477,0,2293,1,3,1,2,2,single-choice,spatial-relational,1|2,7,1/2,210477,1
3,4,21,478,0,923,1,9,4,5,5,single-choice,spatial-relational,4|5,7,4/5,210478,4
3,4,21,479,1,1197,1,7,3,3,4,single-choice,spatial-relational,3|4,7,3/4,210479,3
3,4,21,480,1,1137,1,5,2,2,3,single-choice,spatial-relational,2|3,7,2/3,210480,2
3,4,21,481,1,1413,1,9,4,4,5,single-choice,spatial-relational,4|5,7,4/5,210481,4
3,4,21,482,0,1478,1,3,1,2,2,single-choice,spatial-relational,1|2,7,1/2,210482,1
3,4,21,483,0,1061,1,7,3,4,4,single-choice,spatial-relational,3|4,7,3/4,210483,3
3,4,21,484,1,925,1,7,3,3,4,single-choice,spatial-relational,3|4,7,3/4,210484,3
3,4,21,485,1,1261,1,11,5,5,6,single-choice,spatial-relational,5|6,7,5/6,210485,5
3,4,21,486,1,2204,1,9,4,4,5,single-choice,spatial-relational,4|5,7,4/5,210486,4
3,4,21,487,1,1497,1,5,2,2,3,single-choice,spatial-relational,2|3,7,2/3,210487,2
3,4,21,488,1,800,1,11,5,5,6,single-choice,spatial-relational,5|6,7,5/6,210488,5
3,4,21,489,0,1408,1,13,6,7,7,single-choice,spatial-relational,6|7,7,6/7,210489,6
3,4,21,490,1,1056,1,13,6,6,7,single-choice,spatial-relational,6|7,7,6/7,210490,6
3,4,21,491,0,931,1,3,1,2,2,single-choice,spatial-relational,1|2,7,1/2,210491,1
3,4,21,492,0,496,1,5,2,3,3,single-choice,spatial-relational,2|3,7,2/3,210492,2
3,4,21,493,1,901,1,7,3,3,4,single-choice,spatial-relational,3|4,7,3/4,210493,3
3,4,21,494,1,810,1,13,6,6,7,single-choice,spatial-relational,6|7,7,6/7,210494,6
3,4,21,495,0,1228,1,3,1,2,2,single-choice,spatial-relational,1|2,7,1/2,210495,1
3,4,21,496,0,2006,1,7,3,4,4,single-choice,spatial-relational,3|4,7,3/4,210496,3
3,4,21,497,0,1260,1,9,4,5,5,single-choice,spatial-relational,4|5,7,4/5,210497,4
3,4,21,498,1,650,1,3,1,1,2,single-choice,spatial-relational,1|2,7,1/2,210498,1
3,4,21,499,1,1529,1,5,2,2,3,single-choice,spatial-relational,2|3,7,2/3,210499,2
3,4,21,500,1,1013,1,13,6,6,7,single-choice,spatial-relational,6|7,7,6/7,210500,6
3,4,21,501,1,1718,1,11,5,5,6,single-choice,spatial-relational,5|6,7,5/6,210501,5
3,4,21,502,1,1338,1,5,2,2,3,single-choice,spatial-relational,2|3,7,2/3,210502,2
3,4,21,503,1,877,1,11,5,5,6,single-choice,spatial-relational,5|6,7,5/6,210503,5
3,4,21,504,1,2043,1,9,4,4,5,single-choice,spatial-relational,4|5,7,4/5,210504,4
3,4,21,505,1,1271,1,11,5,5,6,single-choice,spatial-relational,5|6,7,5/6,210505,5
3,4,21,506,1,1764,1,7,3,3,4,single-choice,spatial-relational,3|4,7,3/4,210506,3
3,4,21,507,1,1119,1,5,2,2,3,single-choice,spatial-relational,2|3,7,2/3,210507,2
3,4,21,508,1,1110,1,9,4,4,5,single-choice,spatial-relational,4|5,7,4/5,210508,4
3,4,21,509,1,1936,1,9,4,4,5,single-choice,spatial-relational,4|5,7,4/5,210509,4
3,4,21,510,0,860,1,3,1,2,2,single-choice,spatial-relational,1|2,7,1/2,210510,1
3,4,21,511,1,831,1,13,6,6,7,single-choice,spatial-relational,6|7,7,6/7,210511,6
3,4,21,512,1,1381,1,5,2,2,3,single-choice,spatial-relational,2|3,7,2/3,210512,2
3,4,21,513,0,816,1,13,6,7,7,single-choice,spatial-relational,6|7,7,6/7,210513,6
3,4,21,514,0,1236,1,7,3,4,4,single-choice,spatial-relational,3|4,7,3/4,210514,3
3,4,21,515,1,853,1,3,1,1,2,single-choice,spatial-relational,1|2,7,1/2,210515,1
3,4,21,516,1,1148,1,11,5,5,6,single-choice,spatial-relational,5|6,7,5/6,210516,5
3,4,21,517,0,880,1,9,4,5,5,single-choice,spatial-relational,4|5,7,4/5,210517,4
3,4,21,518,0,712,1,5,2,3,3,single-choice,spatial-relational,2|3,7,2/3,210518,2
3,4,21,519,0,706,1,3,1,2,2,single-choice,spatial-relational,1|2,7,1/2,210519,1
3,4,21,520,0,1885,1,3,1,2,2,single-choice,spatial-relational,1|2,7,1/2,210520,1
3,4,21,521,1,938,1,13,6,6,7,single-choice,spatial-relational,6|7,7,6/7,210521,6
3,4,21,522,1,1567,1,11,5,5,6,single-choice,spatial-relational,5|6,7,5/6,210522,5
3,4,21,523,1,1686,1,13,6,6,7,single-choice,spatial-relational,6|7,7,6/7,210523,6
3,4,21,524,1,1506,1,7,3,3,4,single-choice,spatial-relational,3|4,7,3/4,210524,3
3,4,21,525,1,1516,1,9,4,4,5,single-choice,spatial-relational,4|5,7,4/5,210525,4
3,4,21,526,0,1752,1,7,3,4,4,single-choice,spatial-relational,3|4,7,3/4,210526,3
3,4,21,527,0,52454,1,5,2,3,3,single-choice,spatial-relational,2|3,7,2/3,210527,2
3,4,21,528,1,1786,1,11,5,5,6,single-choice,spatial-relational,5|6,7,5/6,210528,5
3,4,21,529,0,1103,1,5,2,3,3,single-choice,spatial-relational,2|3,7,2/3,210529,2
3,4,21,530,0,1063,1,7,3,4,4,single-choice,spatial-relational,3|4,7,3/4,210530,3
3,4,21,531,1,870,1,7,3,3,4,single-choice,spatial-relational,3|4,7,3/4,210531,3
3,4,21,532,1,946,1,13,6,6,7,single-choice,spatial-relational,6|7,7,6/7,210532,6
3,4,21,533,0,2634,1,3,1,2,2,single-choice,spatial-relational,1|2,7,1/2,210533,1
3,4,21,534,1,1119,1,5,2,2,3,single-choice,spatial-relational,2|3,7,2/3,210534,2
3,4,21,535,0,1000,1,9,4,5,5,single-choice,spatial-relational,4|5,7,4/5,210535,4
3,4,21,536,1,1068,1,3,1,1,2,single-choice,spatial-relational,1|2,7,1/2,210536,1
3,4,21,537,0,1187,1,11,5,6,6,single-choice,spatial-relational,5|6,7,5/6,210537,5
3,4,21,538,1,1504,1,13,6,6,7,single-choice,spatial-relational,6|7,7,6/7,210538,6
3,4,21,539,0,2729,1,9,4,5,5,single-choice,spatial-relational,4|5,7,4/5,210539,4
3,4,21,540,1,1657,1,11,5,5,6,single-choice,spatial-relational,5|6,7,5/6,210540,5
3,4,21,541,1,941,1,13,6,6,7,single-choice,spatial-relational,6|7,7,6/7,210541,6
3,4,21,542,1,2561,1,3,1,1,2,single-choice,spatial-relational,1|2,7,1/2,210542,1
3,4,21,543,1,1488,1,7,3,3,4,single-choice,spatial-relational,3|4,7,3/4,210543,3
3,4,21,544,0,1124,1,3,1,2,2,single-choice,spatial-relational,1|2,7,1/2,210544,1
3,4,21,545,0,1795,1,5,2,3,3,single-choice,spatial-relational,2|3,7,2/3,210545,2
3,4,21,546,1,1366,1,9,4,4,5,single-choice,spatial-relational,4|5,7,4/5,210546,4
3,4,21,547,1,1361,1,11,5,5,6,single-choice,spatial-relational,5|6,7,5/6,210547,5
3,4,21,548,1,2355,1,7,3,3,4,single-choice,spatial-relational,3|4,7,3/4,210548,3
3,4,21,549,1,2034,1,11,5,5,6,single-choice,spatial-relational,5|6,7,5/6,210549,5
3,4,21,550,1,1256,1,13,6,6,7,single-choice,spatial-relational,6|7,7,6/7,210550,6
3,4,21,551,0,2879,1,9,4,5,5,single-choice,spatial-relational,4|5,7,4/5,210551,4
3,4,21,552,1,1296,1,5,2,2,3,single-choice,spatial-relational,2|3,7,2/3,210552,2
3,4,21,553,1,1823,1,9,4,4,5,single-choice,spatial-relational,4|5,7,4/5,210553,4
3,4,21,554,1,1588,1,13,6,6,7,single-choice,spatial-relational,6|7,7,6/7,210554,6
3,4,21,555,1,2293,1,7,3,3,4,single-choice,spatial-relational,3|4,7,3/4,210555,3
3,4,21,556,1,1199,1,5,2,2,3,single-choice,spatial-relational,2|3,7,2/3,210556,2
3,4,21,557,0,836,1,3,1,2,2,single-choice,spatial-relational,1|2,7,1/2,210557,1
3,4,21,558,0,1168,1,5,2,3,3,single-choice,spatial-relational,2|3,7,2/3,210558,2
3,4,21,559,1,802,1,13,6,6,7,single-choice,spatial-relational,6|7,7,6/7,210559,6
3,4,21,560,0,1665,1,9,4,5,5,single-choice,spatial-relational,4|5,7,4/5,210560,4
3,4,21,561,1,1748,1,11,5,5,6,single-choice,spatial-relational,5|6,7,5/6,210561,5
3,4,21,562,1,1133,1,11,5,5,6,single-choice,spatial-relational,5|6,7,5/6,210562,5
3,4,21,563,0,2594,1,3,1,2,2,single-choice,spatial-relational,1|2,7,1/2,210563,1
3,4,21,564,1,838,1,7,3,3,4,single-choice,spatial-relational,3|4,7,3/4,210564,3
3,4,21,565,1,2084,1,9,4,4,5,single-choice,spatial-relational,4|5,7,4/5,210565,4
3,4,21,566,1,2412,1,3,1,1,2,single-choice,spatial-relational,1|2,7,1/2,210566,1
3,4,21,567,1,2420,1,11,5,5,6,single-choice,spatial-relational,5|6,7,5/6,210567,5
3,4,21,568,1,2479,1,11,5,5,6,single-choice,spatial-relational,5|6,7,5/6,210568,5
3,4,21,569,1,985,1,7,3,3,4,single-choice,spatial-relational,3|4,7,3/4,210569,3
3,4,21,570,1,2286,1,5,2,2,3,single-choice,spatial-relational,2|3,7,2/3,210570,2
3,4,21,571,1,797,1,13,6,6,7,single-choice,spatial-relational,6|7,7,6/7,210571,6
3,4,21,572,1,2938,1,9,4,4,5,single-choice,spatial-relational,4|5,7,4/5,210572,4
3,4,21,573,1,1974,1,7,3,3,4,single-choice,spatial-relational,3|4,7,3/4,210573,3
3,4,21,574,1,1439,1,13,6,6,7,single-choice,spatial-relational,6|7,7,6/7,210574,6
3,4,21,575,0,1686,1,3,1,2,2,single-choice,spatial-relational,1|2,7,1/2,210575,1
3,4,21,576,0,898,1,5,2,3,3,single-choice,spatial-relational,2|3,7,2/3,210576,2
3,4,21,577,1,665,1,3,1,1,2,single-choice,spatial-relational,1|2,7,1/2,210577,1
3,4,21,578,1,789,1,13,6,6,7,single-choice,spatial-relational,6|7,7,6/7,210578,6
3,4,21,579,0,764,1,5,2,3,3,single-choice,spatial-relational,2|3,7,2/3,210579,2
3,4,21,580,0,4007,1,3,1,2,2,single-choice,spatial-relational,1|2,7,1/2,210580,1
3,4,21,581,1,952,1,7,3,3,4,single-choice,spatial-relational,3|4,7,3/4,210581,3
3,4,21,582,0,1478,1,7,3,4,4,single-choice,spatial-relational,3|4,7,3/4,210582,3
3,4,21,583,1,954,1,13,6,6,7,single-choice,spatial-relational,6|7,7,6/7,210583,6
3,4,21,584,1,2779,1,11,5,5,6,single-choice,spatial-relational,5|6,7,5/6,210584,5
3,4,21,585,1,1392,1,9,4,4,5,single-choice,spatial-relational,4|5,7,4/5,210585,4
3,4,21,586,1,2054,1,11,5,5,6,single-choice,spatial-relational,5|6,7,5/6,210586,5
3,4,21,587,1,2867,1,5,2,2,3,single-choice,spatial-relational,2|3,7,2/3,210587,2
3,4,21,588,1,1412,1,9,4,4,5,single-choice,spatial-relational,4|5,7,4/5,210588,4
3,4,21,589,0,1883,1,9,4,5,5,single-choice,spatial-relational,4|5,7,4/5,210589,4
3,4,21,590,1,1300,1,13,6,6,7,single-choice,spatial-relational,6|7,7,6/7,210590,6
3,4,21,591,1,2084,1,7,3,3,4,single-choice,spatial-relational,3|4,7,3/4,210591,3
3,4,21,592,1,1373,1,11,5,5,6,single-choice,spatial-relational,5|6,7,5/6,210592,5
3,4,21,593,0,1997,1,5,2,3,3,single-choice,spatial-relational,2|3,7,2/3,210593,2
3,4,21,594,0,1589,1,9,4,5,5,single-choice,spatial-relational,4|5,7,4/5,210594,4
3,4,21,595,1,1500,1,13,6,6,7,single-choice,spatial-relational,6|7,7,6/7,210595,6
3,4,21,596,1,719,1,3,1,1,2,single-choice,spatial-relational,1|2,7,1/2,210596,1
3,4,21,597,1,1910,1,11,5,5,6,single-choice,spatial-relational,5|6,7,5/6,210597,5
3,4,21,598,0,1799,1,3,1,2,2,single-choice,spatial-relational,1|2,7,1/2,210598,1
3,4,21,599,0,1122,1,5,2,3,3,single-choice,spatial-relational,2|3,7,2/3,210599,2
3,4,21,600,0,1104,1,7,3,4,4,single-choice,spatial-relational,3|4,7,3/4,210600,3
4,4,21,1,1,1126,1,3,1,1,2,single-choice,spatial-relational,1|2,7,1/2,210001,1
4,4,21,2,1,842,1,13,6,6,7,single-choice,spatial-relational,6|7,7,6/7,210002,6
4,4,21,3,0,1478,1,9,4,5,5,single-choice,spatial-relational,4|5,7,4/5,210003,4
4,4,21,4,0,1394,1,7,3,4,4,single-choice,spatial-relational,3|4,7,3/4,210004,3
4,4,21,5,0,1301,1,11,5,6,6,single-choice,spatial-relational,5|6,7,5/6,210005,5
4,4,21,6,1,3,1,5,2,2,3,single-choice,spatial-relational,2|3,7,2/3,210006,2
4,4,21,7,1,1168,1,7,3,3,4,single-choice,spatial-relational,3|4,7,3/4,210007,3
4,4,21,8,0,1280,1,9,4,5,5,single-choice,spatial-relational,4|5,7,4/5,210008,4
4,4,21,9,1,1292,1,11,5,5,6,single-choice,spatial-relational,5|6,7,5/6,210009,5
4,4,21,10,1,1712,1,13,6,6,7,single-choice,spatial-relational,6|7,7,6/7,210010,6
4,4,21,11,0,1214,1,3,1,2,2,single-choice,spatial-relational,1|2,7,1/2,210011,1
4,4,21,12,1,1072,1,5,2,2,3,single-choice,spatial-relational,2|3,7,2/3,210012,2
4,4,21,13,1,1270,1,9,4,4,5,single-choice,spatial-relational,4|5,7,4/5,210013,4
4,4,21,14,1,1038,1,7,3,3,4,single-choice,spatial-relational,3|4,7,3/4,210014,3
4,4,21,15,1,1174,1,11,5,5,6,single-choice,spatial-relational,5|6,7,5/6,210015,5
4,4,21,16,1,1561,1,7,3,3,4,single-choice,spatial-relational,3|4,7,3/4,210016,3
4,4,21,17,1,1606,1,3,1,1,2,single-choice,spatial-relational,1|2,7,1/2,210017,1
4,4,21,18,1,1333,1,9,4,4,5,single-choice,spatial-relational,4|5,7,4/5,210018,4
4,4,21,19,1,1061,1,3,1,1,2,single-choice,spatial-relational,1|2,7,1/2,210019,1
4,4,21,20,0,856,1,5,2,3,3,single-choice,spatial-relational,2|3,7,2/3,210020,2
4,4,21,21,1,745,1,13,6,6,7,single-choice,spatial-relational,6|7,7,6/7,210021,6
4,4,21,22,1,2382,1,13,6,6,7,single-choice,spatial-relational,6|7,7,6/7,210022,6
4,4,21,23,1,1707,1,5,2,2,3,single-choice,spatial-relational,2|3,7,2/3,210023,2
4,4,21,24,1,1522,1,11,5,5,6,single-choice,spatial-relational,5|6,7,5/6,210024,5
4,4,21,25,1,1317,1,13,6,6,7,single-choice,spatial-relational,6|7,7,6/7,210025,6
4,4,21,26,0,2948,1,7,3,4,4,single-choice,spatial-relational,3|4,7,3/4,210026,3
4,4,21,27,1,784,1,3,1,1,2,single-choice,spatial-relational,1|2,7,1/2,210027,1
4,4,21,28,1,1100,1,11,5,5,6,single-choice,spatial-relational,5|6,7,5/6,210028,5
4,4,21,29,1,1325,1,3,1,1,2,single-choice,spatial-relational,1|2,7,1/2,210029,1
4,4,21,30,1,1095,1,5,2,2,3,single-choice,spatial-relational,2|3,7,2/3,210030,2
4,4,21,31,1,1091,1,5,2,2,3,single-choice,spatial-relational,2|3,7,2/3,210031,2
4,4,21,32,1,1428,1,13,6,6,7,single-choice,spatial-relational,6|7,7,6/7,210032,6
4,4,21,33,0,2775,1,7,3,4,4,single-choice,spatial-relational,3|4,7,3/4,210033,3
4,4,21,34,1,974,1,11,5,5,6,single-choice,spatial-relational,5|6,7,5/6,210034,5
4,4,21,35,1,1413,1,9,4,4,5,single-choice,spatial-relational,4|5,7,4/5,210035,4
4,4,21,36,1,1535,1,9,4,4,5,single-choice,spatial-relational,4|5,7,4/5,210036,4
4,4,21,37,1,1637,1,11,5,5,6,single-choice,spatial-relational,5|6,7,5/6,210037,5
4,4,21,38,0,1250,1,5,2,3,3,single-choice,spatial-relational,2|3,7,2/3,210038,2
4,4,21,39,1,1081,1,9,4,4,5,single-choice,spatial-relational,4|5,7,4/5,210039,4
4,4,21,40,0,1047,1,3,1,2,2,single-choice,spatial-relational,1|2,7,1/2,210040,1
4,4,21,41,1,1199,1,13,6,6,7,single-choice,spatial-relational,6|7,7,6/7,210041,6
4,4,21,42,0,1567,1,3,1,2,2,single-choice,spatial-relational,1|2,7,1/2,210042,1
4,4,21,43,1,1243,1,7,3,3,4,single-choice,spatial-relational,3|4,7,3/4,210043,3
4,4,21,44,1,1950,1,7,3,3,4,single-choice,spatial-relational,3|4,7,3/4,210044,3
4,4,21,45,0,847,1,13,6,7,7,single-choice,spatial-relational,6|7,7,6/7,210045,6
4,4,21,46,1,1493,1,9,4,4,5,single-choice,spatial-relational,4|5,7,4/5,210046,4
4,4,21,47,1,1802,1,11,5,5,6,single-choice,spatial-relational,5|6,7,5/6,210047,5
4,4,21,48,0,974,1,5,2,3,3,single-choice,spatial-relational,2|3,7,2/3,210048,2
4,4,21,49,1,1430,1,9,4,4,5,single-choice,spatial-relational,4|5,7,4/5,210049,4
4,4,21,50,0,2408,1,9,4,5,5,single-choice,spatial-relational,4|5,7,4/5,210050,4
4,4,21,51,1,1507,1,5,2,2,3,single-choice,spatial-relational,2|3,7,2/3,210051,2
4,4,21,52,0,733,1,11,5,6,6,single-choice,spatial-relational,5|6,7,5/6,210052,5
4,4,21,53,1,1639,1,11,5,5,6,single-choice,spatial-relational,5|6,7,5/6,210053,5
4,4,21,54,0,2414,1,5,2,3,3,single-choice,spatial-relational,2|3,7,2/3,210054,2
4,4,21,55,1,7,1,3,1,1,2,single-choice,spatial-relational,1|2,7,1/2,210055,1
4,4,21,56,1,1058,1,7,3,3,4,single-choice,spatial-relational,3|4,7,3/4,210056,3
4,4,21,57,1,1646,1,13,6,6,7,single-choice,spatial-relational,6|7,7,6/7,210057,6
4,4,21,58,1,4013,1,3,1,1,2,single-choice,spatial-relational,1|2,7,1/2,210058,1
4,4,21,59,1,1385,1,13,6,6,7,single-choice,spatial-relational,6|7,7,6/7,210059,6
4,4,21,60,0,2590,1,7,3,4,4,single-choice,spatial-relational,3|4,7,3/4,210060,3
4,4,21,61,1,3,1,11,5,5,6,single-choice,spatial-relational,5|6,7,5/6,210061,5
4,4,21,62,1,1465,1,5,2,2,3,single-choice,spatial-relational,2|3,7,2/3,210062,2
4,4,21,63,1,1382,1,3,1,1,2,single-choice,spatial-relational,1|2,7,1/2,210063,1
4,4,21,64,0,678,1,3,1,2,2,single-choice,spatial-relational,1|2,7,1/2,210064,1
4,4,21,65,1,1270,1,13,6,6,7,single-choice,spatial-relational,6|7,7,6/7,210065,6
4,4,21,66,1,1285,1,13,6,6,7,single-choice,spatial-relational,6|7,7,6/7,210066,6
4,4,21,67,0,2915,1,9,4,5,5,single-choice,spatial-relational,4|5,7,4/5,210067,4
4,4,21,68,1,2179,1,7,3,3,4,single-choice,spatial-relational,3|4,7,3/4,210068,3
4,4,21,69,1,1573,1,5,2,2,3,single-choice,spatial-relational,2|3,7,2/3,210069,2
4,4,21,70,0,1687,1,9,4,5,5,single-choice,spatial-relational,4|5,7,4/5,210070,4
4,4,21,71,1,1240,1,11,5,5,6,single-choice,spatial-relational,5|6,7,5/6,210071,5
4,4,21,72,1,2414,1,7,3,3,4,single-choice,spatial-relational,3|4,7,3/4,210072,3
4,4,21,73,0,2346,1,7,3,4,4,single-choice,spatial-relational,3|4,7,3/4,210073,3
4,4,21,74,0,2361,1,9,4,5,5,single-choice,spatial-relational,4|5,7,4/5,210074,4
4,4,21,75,0,1095,1,3,1,2,2,single-choice,spatial-relational,1|2,7,1/2,210075,1
4,4,21,76,1,10,1,9,4,4,5,single-choice,spatial-relational,4|5,7,4/5,210076,4
4,4,21,77,1,1219,1,13,6,6,7,single-choice,spatial-relational,6|7,7,6/7,210077,6
4,4,21,78,1,2461,1,13,6,6,7,single-choice,spatial-relational,6|7,7,6/7,210078,6
4,4,21,79,1,3250,1,11,5,5,6,single-choice,spatial-relational,5|6,7,5/6,210079,5
4,4,21,80,1,1236,1,5,2,2,3,single-choice,spatial-relational,2|3,7,2/3,210080,2
4,4,21,81,0,1699,1,3,1,2,2,single-choice,spatial-relational,1|2,7,1/2,210081,1
4,4,21,82,1,1071,1,11,5,5,6,single-choice,spatial-relational,5|6,7,5/6,210082,5
4,4,21,83,1,1397,1,5,2,2,3,single-choice,spatial-relational,2|3,7,2/3,210083,2
4,4,21,84,1,2011,1,7,3,3,4,single-choice,spatial-relational,3|4,7,3/4,210084,3
4,4,21,85,1,1798,1,5,2,2,3,single-choice,spatial-relational,2|3,7,2/3,210085,2
4,4,21,86,1,2201,1,9,4,4,5,single-choice,spatial-relational,4|5,7,4/5,210086,4
4,4,21,87,0,1982,1,9,4,5,5,single-choice,spatial-relational,4|5,7,4/5,210087,4
4,4,21,88,0,1994,1,11,5,6,6,single-choice,spatial-relational,5|6,7,5/6,210088,5
4,4,21,89,1,1588,1,13,6,6,7,single-choice,spatial-relational,6|7,7,6/7,210089,6
4,4,21,90,1,3858,1,11,5,5,6,single-choice,spatial-relational,5|6,7,5/6,210090,5
4,4,21,91,1,1462,1,5,2,2,3,single-choice,spatial-relational,2|3,7,2/3,210091,2
4,4,21,92,0,1175,1,3,1,2,2,single-choice,spatial-relational,1|2,7,1/2,210092,1
4,4,21,93,0,841,1,3,1,2,2,single-choice,spatial-relational,1|2,7,1/2,210093,1
4,4,21,94,1,1057,1,13,6,6,7,single-choice,spatial-relational,6|7,7,6/7,210094,6
4,4,21,95,0,1130,1,7,3,4,4,single-choice,spatial-relational,3|4,7,3/4,210095,3
4,4,21,96,1,1410,1,7,3,3,4,single-choice,spatial-relational,3|4,7,3/4,210096,3
4,4,21,97,1,975,1,3,1,1,2,single-choice,spatial-relational,1|2,7,1/2,210097,1
4,4,21,98,1,1418,1,11,5,5,6,single-choice,spatial-relational,5|6,7,5/6,210098,5
4,4,21,99,1,2368,1,5,2,2,3,single-choice,spatial-relational,2|3,7,2/3,210099,2
4,4,21,100,1,1310,1,5,2,2,3,single-choice,spatial-relational,2|3,7,2/3,210100,2
4,4,21,101,1,1298,1,13,6,6,7,single-choice,spatial-relational,6|7,7,6/7,210101,6
4,4,21,102,1,2867,1,9,4,4,5,single-choice,spatial-relational,4|5,7,4/5,210102,4
4,4,21,103,0,2596,1,7,3,4,4,single-choice,spatial-relational,3|4,7,3/4,210103,3
4,4,21,104,1,2157,1,7,3,3,4,single-choice,spatial-relational,3|4,7,3/4,210104,3
4,4,21,105,0,1271,1,3,1,2,2,single-choice,spatial-relational,1|2,7,1/2,210105,1
4,4,21,106,0,1148,1,11,5,6,6,single-choice,spatial-relational,5|6,7,5/6,210106,5
4,4,21,107,1,883,1,13,6,6,7,single-choice,spatial-relational,6|7,7,6/7,210107,6
4,4,21,108,1,702,1,9,4,4,5,single-choice,spatial-relational,4|5,7,4/5,210108,4
4,4,21,109,1,1902,1,5,2,2,3,single-choice,spatial-relational,2|3,7,2/3,210109,2
4,4,21,110,0,1622,1,7,3,4,4,single-choice,spatial-relational,3|4,7,3/4,210110,3
4,4,21,111,1,1316,1,13,6,6,7,single-choice,spatial-relational,6|7,7,6/7,210111,6
4,4,21,112,1,1175,1,11,5,5,6,single-choice,spatial-relational,5|6,7,5/6,210112,5
4,4,21,113,0,2240,1,3,1,2,2,single-choice,spatial-relational,1|2,7,1/2,210113,1
4,4,21,114,1,2085,1,7,3,3,4,single-choice,spatial-relational,3|4,7,3/4,210114,3
4,4,21,115,1,1695,1,11,5,5,6,single-choice,spatial-relational,5|6,7,5/6,210115,5
4,4,21,116,1,2561,1,9,4,4,5,single-choice,spatial-relational,4|5,7,4/5,210116,4
4,4,21,117,1,1464,1,3,1,1,2,single-choice,spatial-relational,1|2,7,1/2,210117,1
4,4,21,118,1,1903,1,9,4,4,5,single-choice,spatial-relational,4|5,7,4/5,210118,4
4,4,21,119,1,1888,1,13,6,6,7,single-choice,spatial-relational,6|7,7,6/7,210119,6
4,4,21,120,1,3368,1,5,2,2,3,single-choice,spatial-relational,2|3,7,2/3,210120,2
4,4,21,121,1,1303,1,5,2,2,3,single-choice,spatial-relational,2|3,7,2/3,210121,2
4,4,21,122,0,2328,1,7,3,4,4,single-choice,spatial-relational,3|4,7,3/4,210122,3
4,4,21,123,0,1750,1,9,4,5,5,single-choice,spatial-relational,4|5,7,4/5,210123,4
4,4,21,124,1,1589,1,3,1,1,2,single-choice,spatial-relational,1|2,7,1/2,210124,1
4,4,21,125,0,1622,1,11,5,6,6,single-choice,spatial-relational,5|6,7,5/6,210125,5
4,4,21,126,1,2211,1,9,4,4,5,single-choice,spatial-relational,4|5,7,4/5,210126,4
4,4,21,127,0,1116,1,13,6,7,7,single-choice,spatial-relational,6|7,7,6/7,210127,6
4,4,21,128,1,2178,1,13,6,6,7,single-choice,spatial-relational,6|7,7,6/7,210128,6
4,4,21,129,0,864,1,7,3,4,4,single-choice,spatial-relational,3|4,7,3/4,210129,3
4,4,21,130,1,4255,1,11,5,5,6,single-choice,spatial-relational,5|6,7,5/6,210130,5
4,4,21,131,1,1184,1,3,1,1,2,single-choice,spatial-relational,1|2,7,1/2,210131,1
4,4,21,132,1,1107,1,5,2,2,3,single-choice,spatial-relational,2|3,7,2/3,210132,2
4,4,21,133,1,1829,1,11,5,5,6,single-choice,spatial-relational,5|6,7,5/6,210133,5
4,4,21,134,1,3500,1,9,4,4,5,single-choice,spatial-relational,4|5,7,4/5,210134,4
4,4,21,135,1,1061,1,7,3,3,4,single-choice,spatial-relational,3|4,7,3/4,210135,3
4,4,21,136,1,1767,1,13,6,6,7,single-choice,spatial-relational,6|7,7,6/7,210136,6
4,4,21,137,0,2856,1,7,3,4,4,single-choice,spatial-relational,3|4,7,3/4,210137,3
4,4,21,138,0,954,1,5,2,3,3,single-choice,spatial-relational,2|3,7,2/3,210138,2
4,4,21,139,1,1377,1,13,6,6,7,single-choice,spatial-relational,6|7,7,6/7,210139,6
4,4,21,140,1,1825,1,11,5,5,6,single-choice,spatial-relational,5|6,7,5/6,210140,5
4,4,21,141,0,2237,1,3,1,2,2,single-choice,spatial-relational,1|2,7,1/2,210141,1
4,4,21,142,1,2470,1,9,4,4,5,single-choice,spatial-relational,4|5,7,4/5,210142,4
4,4,21,143,1,1329,1,3,1,1,2,single-choice,spatial-relational,1|2,7,1/2,210143,1
4,4,21,144,0,1033,1,5,2,3,3,single-choice,spatial-relational,2|3,7,2/3,210144,2
4,4,21,145,1,1403,1,11,5,5,6,single-choice,spatial-relational,5|6,7,5/6,210145,5
4,4,21,146,0,2797,1,9,4,5,5,single-choice,spatial-relational,4|5,7,4/5,210146,4
4,4,21,147,1,1067,1,11,5,5,6,single-choice,spatial-relational,5|6,7,5/6,210147,5
4,4,21,148,1,2136,1,13,6,6,7,single-choice,spatial-relational,6|7,7,6/7,210148,6
4,4,21,149,0,2712,1,5,2,3,3,single-choice,spatial-relational,2|3,7,2/3,210149,2
4,4,21,150,1,1498,1,5,2,2,3,single-choice,spatial-relational,2|3,7,2/3,210150,2
4,4,21,151,1,1300,1,7,3,3,4,single-choice,spatial-relational,3|4,7,3/4,210151,3
4,4,21,152,1,2181,1,7,3,3,4,single-choice,spatial-relational,3|4,7,3/4,210152,3
4,4,21,153,1,1626,1,13,6,6,7,single-choice,spatial-relational,6|7,7,6/7,210153,6
4,4,21,154,0,2896,1,3,1,2,2,single-choice,spatial-relational,1|2,7,1/2,210154,1
4,4,21,155,0,1154,1,9,4,5,5,single-choice,spatial-relational,4|5,7,4/5,210155,4
4,4,21,156,0,1071,1,3,1,2,2,single-choice,spatial-relational,1|2,7,1/2,210156,1
4,4,21,157,1,1618,1,13,6,6,7,single-choice,spatial-relational,6|7,7,6/7,210157,6
4,4,21,158,1,3402,1,7,3,3,4,single-choice,spatial-relational,3|4,7,3/4,210158,3
4,4,21,159,1,1878,1,11,5,5,6,single-choice,spatial-relational,5|6,7,5/6,210159,5
4,4,21,160,1,2798,1,7,3,3,4,single-choice,spatial-relational,3|4,7,3/4,210160,3
4,4,21,161,0,1249,1,9,4,5,5,single-choice,spatial-relational,4|5,7,4/5,210161,4
4,4,21,162,0,893,1,3,1,2,2,single-choice,spatial-relational,1|2,7,1/2,210162,1
4,4,21,163,1,750,1,3,1,1,2,single-choice,spatial-relational,1|2,7,1/2,210163,1
4,4,21,164,1,1197,1,9,4,4,5,single-choice,spatial-relational,4|5,7,4/5,210164,4
4,4,21,165,0,2579,1,5,2,3,3,single-choice,spatial-relational,2|3,7,2/3,210165,2
4,4,21,166,1,1058,1,13,6,6,7,single-choice,spatial-relational,6|7,7,6/7,210166,6
4,4,21,167,0,1131,1,5,2,3,3,single-choice,spatial-relational,2|3,7,2/3,210167,2
4,4,21,168,0,2017,1,11,5,6,6,single-choice,spatial-relational,5|6,7,5/6,210168,5
4,4,21,169,0,594,1,5,2,3,3,single-choice,spatial-relational,2|3,7,2/3,210169,2
4,4,21,170,1,1549,1,11,5,5,6,single-choice,spatial-relational,5|6,7,5/6,210170,5
4,4,21,171,1,1168,1,11,5,5,6,single-choice,spatial-relational,5|6,7,5/6,210171,5
4,4,21,172,1,2833,1,7,3,3,4,single-choice,spatial-relational,3|4,7,3/4,210172,3
4,4,21,173,1,1556,1,13,6,6,7,single-choice,spatial-relational,6|7,7,6/7,210173,6
4,4,21,174,1,1052,1,5,2,2,3,single-choice,spatial-relational,2|3,7,2/3,210174,2
4,4,21,175,1,1404,1,3,1,1,2,single-choice,spatial-relational,1|2,7,1/2,210175,1
4,4,21,176,0,988,1,9,4,5,5,single-choice,spatial-relational,4|5,7,4/5,210176,4
4,4,21,177,1,1623,1,9,4,4,5,single-choice,spatial-relational,4|5,7,4/5,210177,4
4,4,21,178,0,740,1,3,1,2,2,single-choice,spatial-relational,1|2,7,1/2,210178,1
4,4,21,179,1,1086,1,7,3,3,4,single-choice,spatial-relational,3|4,7,3/4,210179,3
4,4,21,180,1,1387,1,13,6,6,7,single-choice,spatial-relational,6|7,7,6/7,210180,6
4,4,21,181,0,2599,1,5,2,3,3,single-choice,spatial-relational,2|3,7,2/3,210181,2
4,4,21,182,0,1828,1,9,4,5,5,single-choice,spatial-relational,4|5,7,4/5,210182,4
4,4,21,183,0,1328,1,11,5,6,6,single-choice,spatial-relational,5|6,7,5/6,210183,5
4,4,21,184,1,1060,1,13,6,6,7,single-choice,spatial-relational,6|7,7,6/7,210184,6
4,4,21,185,1,1173,1,9,4,4,5,single-choice,spatial-relational,4|5,7,4/5,210185,4
4,4,21,186,0,1755,1,3,1,2,2,single-choice,spatial-relational,1|2,7,1/2,210186,1
4,4,21,187,1,890,1,7,3,3,4,single-choice,spatial-relational,3|4,7,3/4,210187,3
4,4,21,188,1,955,1,13,6,6,7,single-choice,spatial-relational,6|7,7,6/7,210188,6
4,4,21,189,0,919,1,3,1,2,2,single-choice,spatial-relational,1|2,7,1/2,210189,1
4,4,21,190,1,1518,1,11,5,5,6,single-choice,spatial-relational,5|6,7,5/6,210190,5
4,4,21,191,1,1656,1,5,2,2,3,single-choice,spatial-relational,2|3,7,2/3,210191,2
4,4,21,192,1,973,1,7,3,3,4,single-choice,spatial-relational,3|4,7,3/4,210192,3
4,4,21,193,1,1550,1,13,6,6,7,single-choice,spatial-relational,6|7,7,6/7,210193,6
4,4,21,194,1,2866,1,9,4,4,5,single-choice,spatial-relational,4|5,7,4/5,210194,4
4,4,21,195,1,2542,1,9,4,4,5,single-choice,spatial-relational,4|5,7,4/5,210195,4
4,4,21,196,0,53,1,11,5,6,6,single-choice,spatial-relational,5|6,7,5/6,210196,5
4,4,21,197,1,2444,1,11,5,5,6,single-choice,spatial-relational,5|6,7,5/6,210197,5
4,4,21,198,0,811,1,13,6,7,7,single-choice,spatial-relational,6|7,7,6/7,210198,6
4,4,21,199,1,1726,1,5,2,2,3,single-choice,spatial-relational,2|3,7,2/3,210199,2
4,4,21,200,0,954,1,5,2,3,3,single-choice,spatial-relational,2|3,7,2/3,210200,2
4,4,21,201,1,1413,1,7,3,3,4,single-choice,spatial-relational,3|4,7,3/4,210201,3
4,4,21,202,0,3003,1,3,1,2,2,single-choice,spatial-relational,1|2,7,1/2,210202,1
4,4,21,203,1,935,1,3,1,1,2,single-choice,spatial-relational,1|2,7,1/2,210203,1
4,4,21,204,1,835,1,7,3,3,4,single-choice,spatial-relational,3|4,7,3/4,210204,3
4,4,21,205,1,2099,1,7,3,3,4,single-choice,spatial-relational,3|4,7,3/4,210205,3
4,4,21,206,1,1592,1,5,2,2,3,single-choice,spatial-relational,2|3,7,2/3,210206,2
4,4,21,207,0,1192,1,3,1,2,2,single-choice,spatial-relational,1|2,7,1/2,210207,1
4,4,21,208,1,793,1,7,3,3,4,single-choice,spatial-relational,3|4,7,3/4,210208,3
4,4,21,209,0,1124,1,11,5,6,6,single-choice,spatial-relational,5|6,7,5/6,210209,5
4,4,21,210,1,975,1,13,6,6,7,single-choice,spatial-relational,6|7,7,6/7,210210,6
4,4,21,211,1,2983,1,5,2,2,3,single-choice,spatial-relational,2|3,7,2/3,210211,2
4,4,21,212,1,1738,1,3,1,1,2,single-choice,spatial-relational,1|2,7,1/2,210212,1
4,4,21,213,1,946,1,13,6,6,7,single-choice,spatial-relational,6|7,7,6/7,210213,6
4,4,21,214,0,2482,1,9,4,5,5,single-choice,spatial-relational,4|5,7,4/5,210214,4
4,4,21,215,0,1511,1,11,5,6,6,single-choice,spatial-relational,5|6,7,5/6,210215,5
4,4,21,216,1,2023,1,9,4,4,5,single-choice,spatial-relational,4|5,7,4/5,210216,4
4,4,21,217,1,1051,1,11,5,5,6,single-choice,spatial-relational,5|6,7,5/6,210217,5
4,4,21,218,1,1852,1,9,4,4,5,single-choice,spatial-relational,4|5,7,4/5,210218,4
4,4,21,219,1,1991,1,13,6,6,7,single-choice,spatial-relational,6|7,7,6/7,210219,6
4,4,21,220,1,2821,1,7,3,3,4,single-choice,spatial-relational,3|4,7,3/4,210220,3
4,4,21,221,1,2305,1,9,4,4,5,single-choice,spatial-relational,4|5,7,4/5,210221,4
4,4,21,222,1,2902,1,5,2,2,3,single-choice,spatial-relational,2|3,7,2/3,210222,2
4,4,21,223,1,845,1,13,6,6,7,single-choice,spatial-relational,6|7,7,6/7,210223,6
4,4,21,224,0,1252,1,5,2,3,3,single-choice,spatial-relational,2|3,7,2/3,210224,2
4,4,21,225,1,897,1,7,3,3,4,single-choice,spatial-relational,3|4,7,3/4,210225,3
4,4,21,226,1,1652,1,3,1,1,2,single-choice,spatial-relational,1|2,7,1/2,210226,1
4,4,21,227,1,1900,1,11,5,5,6,single-choice,spatial-relational,5|6,7,5/6,210227,5
4,4,21,228,1,1155,1,3,1,1,2,single-choice,spatial-relational,1|2,7,1/2,210228,1
4,4,21,229,0,882,1,5,2,3,3,single-choice,spatial-relational,2|3,7,2/3,210229,2
4,4,21,230,1,968,1,13,6,6,7,single-choice,spatial-relational,6|7,7,6/7,210230,6
4,4,21,231,1,1810,1,9,4,4,5,single-choice,spatial-relational,4|5,7,4/5,210231,4
4,4,21,232,0,1923,1,9,4,5,5,single-choice,spatial-relational,4|5,7,4/5,210232,4
4,4,21,233,1,1316,1,7,3,3,4,single-choice,spatial-relational,3|4,7,3/4,210233,3
4,4,21,234,0,842,1,3,1,2,2,single-choice,spatial-relational,1|2,7,1/2,210234,1
4,4,21,235,1,1492,1,11,5,5,6,single-choice,spatial-relational,5|6,7,5/6,210235,5
4,4,21,236,1,2249,1,7,3,3,4,single-choice,spatial-relational,3|4,7,3/4,210236,3
4,4,21,237,1,1350,1,13,6,6,7,single-choice,spatial-relational,6|7,7,6/7,210237,6
4,4,21,238,0,2462,1,3,1,2,2,single-choice,spatial-relational,1|2,7,1/2,210238,1
4,4,21,239,1,1014,1,11,5,5,6,single-choice,spatial-relational,5|6,7,5/6,210239,5
4,4,21,240,1,2280,1,5,2,2,3,single-choice,spatial-relational,2|3,7,2/3,210240,2
4,4,21,241,1,1736,1,9,4,4,5,single-choice,spatial-relational,4|5,7,4/5,210241,4
4,4,21,242,1,1712,1,11,5,5,6,single-choice,spatial-relational,5|6,7,5/6,210242,5
4,4,21,243,0,1245,1,5,2,3,3,single-choice,spatial-relational,2|3,7,2/3,210243,2
4,4,21,244,0,915,1,5,2,3,3,single-choice,spatial-relational,2|3,7,2/3,210244,2
4,4,21,245,1,946,1,13,6,6,7,single-choice,spatial-relational,6|7,7,6/7,210245,6
4,4,21,246,1,2126,1,13,6,6,7,single-choice,spatial-relational,6|7,7,6/7,210246,6
4,4,21,247,1,2779,1,9,4,4,5,single-choice,spatial-relational,4|5,7,4/5,210247,4
4,4,21,248,1,1885,1,7,3,3,4,single-choice,spatial-relational,3|4,7,3/4,210248,3
4,4,21,249,1,1866,1,11,5,5,6,single-choice,spatial-relational,5|6,7,5/6,210249,5
4,4,21,250,1,2597,1,3,1,1,2,single-choice,spatial-relational,1|2,7,1/2,210250,1
4,4,21,251,0,690,1,3,1,2,2,single-choice,spatial-relational,1|2,7,1/2,210251,1
4,4,21,252,1,855,1,7,3,3,4,single-choice,spatial-relational,3|4,7,3/4,210252,3
4,4,21,253,1,1053,1,7,3,3,4,single-choice,spatial-relational,3|4,7,3/4,210253,3
4,4,21,254,1,1650,1,9,4,4,5,single-choice,spatial-relational,4|5,7,4/5,210254,4
4,4,21,255,1,1664,1,13,6,6,7,single-choice,spatial-relational,6|7,7,6/7,210255,6
4,4,21,256,1,2416,1,11,5,5,6,single-choice,spatial-relational,5|6,7,5/6,210256,5
4,4,21,257,1,2203,1,13,6,6,7,single-choice,spatial-relational,6|7,7,6/7,210257,6
4,4,21,258,1,941,1,11,5,5,6,single-choice,spatial-relational,5|6,7,5/6,210258,5
4,4,21,259,0,1298,1,3,1,2,2,single-choice,spatial-relational,1|2,7,1/2,210259,1
4,4,21,260,0,793,1,5,2,3,3,single-choice,spatial-relational,2|3,7,2/3,210260,2
4,4,21,261,1,923,1,7,3,3,4,single-choice,spatial-relational,3|4,7,3/4,210261,3
4,4,21,262,1,1234,1,9,4,4,5,single-choice,spatial-relational,4|5,7,4/5,210262,4
4,4,21,263,1,2079,1,5,2,2,3,single-choice,spatial-relational,2|3,7,2/3,210263,2
4,4,21,264,1,1440,1,3,1,1,2,single-choice,spatial-relational,1|2,7,1/2,210264,1
4,4,21,265,1,868,1,13,6,6,7,single-choice,spatial-relational,6|7,7,6/7,210265,6
4,4,21,266,1,2841,1,11,5,5,6,single-choice,spatial-relational,5|6,7,5/6,210266,5
4,4,21,267,1,1252,1,13,6,6,7,single-choice,spatial-relational,6|7,7,6/7,210267,6
4,4,21,268,0,1926,1,9,4,5,5,single-choice,spatial-relational,4|5,7,4/5,210268,4
4,4,21,269,1,1160,1,7,3,3,4,single-choice,spatial-relational,3|4,7,3/4,210269,3
4,4,21,270,1,1011,1,7,3,3,4,single-choice,spatial-relational,3|4,7,3/4,210270,3
4,4,21,271,1,2439,1,3,1,1,2,single-choice,spatial-relational,1|2,7,1/2,210271,1
4,4,21,272,0,900,1,5,2,3,3,single-choice,spatial-relational,2|3,7,2/3,210272,2
4,4,21,273,1,1046,1,5,2,2,3,single-choice,spatial-relational,2|3,7,2/3,210273,2
4,4,21,274,1,1194,1,3,1,1,2,single-choice,spatial-relational,1|2,7,1/2,210274,1
4,4,21,275,0,1250,1,9,4,5,5,single-choice,spatial-relational,4|5,7,4/5,210275,4
4,4,21,276,1,3602,1,11,5,5,6,single-choice,spatial-relational,5|6,7,5/6,210276,5
4,4,21,277,1,2436,1,5,2,2,3,single-choice,spatial-relational,2|3,7,2/3,210277,2
4,4,21,278,1,2027,1,11,5,5,6,single-choice,spatial-relational,5|6,7,5/6,210278,5
4,4,21,279,1,1743,1,13,6,6,7,single-choice,spatial-relational,6|7,7,6/7,210279,6
4,4,21,280,1,2174,1,13,6,6,7,single-choice,spatial-relational,6|7,7,6/7,210280,6
4,4,21,281,1,2687,1,9,4,4,5,single-choice,spatial-relational,4|5,7,4/5,210281,4
4,4,21,282,1,1951,1,3,1,1,2,single-choice,spatial-relational,1|2,7,1/2,210282,1
4,4,21,283,0,668,1,3,1,2,2,single-choice,spatial-relational,1|2,7,1/2,210283,1
4,4,21,284,0,5,1,11,5,6,6,single-choice,spatial-relational,5|6,7,5/6,210284,5
4,4,21,285,1,1166,1,7,3,3,4,single-choice,spatial-relational,3|4,7,3/4,210285,3
4,4,21,286,1,1231,1,7,3,3,4,single-choice,spatial-relational,3|4,7,3/4,210286,3
4,4,21,287,0,1933,1,9,4,5,5,single-choice,spatial-relational,4|5,7,4/5,210287,4
4,4,21,288,1,1014,1,5,2,2,3,single-choice,spatial-relational,2|3,7,2/3,210288,2
4,4,21,289,1,1130,1,5,2,2,3,single-choice,spatial-relational,2|3,7,2/3,210289,2
4,4,21,290,1,942,1,13,6,6,7,single-choice,spatial-relational,6|7,7,6/7,210290,6
4,4,21,291,0,2346,1,3,1,2,2,single-choice,spatial-relational,1|2,7,1/2,210291,1
4,4,21,292,1,1390,1,5,2,2,3,single-choice,spatial-relational,2|3,7,2/3,210292,2
4,4,21,293,1,2164,1,9,4,4,5,single-choice,spatial-relational,4|5,7,4/5,210293,4
4,4,21,294,1,1642,1,9,4,4,5,single-choice,spatial-relational,4|5,7,4/5,210294,4
4,4,21,295,1,1034,1,13,6,6,7,single-choice,spatial-relational,6|7,7,6/7,210295,6
4,4,21,296,1,2847,1,3,1,1,2,single-choice,spatial-relational,1|2,7,1/2,210296,1
4,4,21,297,1,1026,1,11,5,5,6,single-choice,spatial-relational,5|6,7,5/6,210297,5
4,4,21,298,1,2138,1,11,5,5,6,single-choice,spatial-relational,5|6,7,5/6,210298,5
4,4,21,299,1,2284,1,7,3,3,4,single-choice,spatial-relational,3|4,7,3/4,210299,3
4,4,21,300,1,2027,1,7,3,3,4,single-choice,spatial-relational,3|4,7,3/4,210300,3
4,4,21,301,1,1359,1,5,2,2,3,single-choice,spatial-relational,2|3,7,2/3,210301,2
4,4,21,302,1,1100,1,13,6,6,7,single-choice,spatial-relational,6|7,7,6/7,210302,6
4,4,21,303,1,2356,1,9,4,4,5,single-choice,spatial-relational,4|5,7,4/5,210303,4
4,4,21,304,1,2121,1,3,1,1,2,single-choice,spatial-relational,1|2,7,1/2,210304,1
4,4,21,305,1,1135,1,11,5,5,6,single-choice,spatial-relational,5|6,7,5/6,210305,5
4,4,21,306,1,2548,1,5,2,2,3,single-choice,spatial-relational,2|3,7,2/3,210306,2
4,4,21,307,0,849,1,9,4,5,5,single-choice,spatial-relational,4|5,7,4/5,210307,4
4,4,21,308,1,869,1,7,3,3,4,single-choice,spatial-relational,3|4,7,3/4,210308,3
4,4,21,309,1,977,1,11,5,5,6,single-choice,spatial-relational,5|6,7,5/6,210309,5
4,4,21,310,1,1164,1,7,3,3,4,single-choice,spatial-relational,3|4,7,3/4,210310,3
4,4,21,311,0,719,1,3,1,2,2,single-choice,spatial-relational,1|2,7,1/2,210311,1
4,4,21,312,1,1183,1,13,6,6,7,single-choice,spatial-relational,6|7,7,6/7,210312,6
4,4,21,313,1,951,1,5,2,2,3,single-choice,spatial-relational,2|3,7,2/3,210313,2
4,4,21,314,1,1472,1,9,4,4,5,single-choice,spatial-relational,4|5,7,4/5,210314,4
4,4,21,315,0,1856,1,11,5,6,6,single-choice,spatial-relational,5|6,7,5/6,210315,5
4,4,21,316,0,4204,1,3,1,2,2,single-choice,spatial-relational,1|2,7,1/2,210316,1
4,4,21,317,1,1590,1,3,1,1,2,single-choice,spatial-relational,1|2,7,1/2,210317,1
4,4,21,318,1,1171,1,7,3,3,4,single-choice,spatial-relational,3|4,7,3/4,210318,3
4,4,21,319,1,1024,1,13,6,6,7,single-choice,spatial-relational,6|7,7,6/7,210319,6
4,4,21,320,1,1940,1,5,2,2,3,single-choice,spatial-relational,2|3,7,2/3,210320,2
4,4,21,321,1,3166,1,7,3,3,4,single-choice,spatial-relational,3|4,7,3/4,210321,3
4,4,21,322,1,1497,1,11,5,5,6,single-choice,spatial-relational,5|6,7,5/6,210322,5
4,4,21,323,1,2143,1,9,4,4,5,single-choice,spatial-relational,4|5,7,4/5,210323,4
4,4,21,324,1,1286,1,13,6,6,7,single-choice,spatial-relational,6|7,7,6/7,210324,6
4,4,21,325,0,2262,1,5,2,3,3,single-choice,spatial-relational,2|3,7,2/3,210325,2
4,4,21,326,1,38,1,7,3,3,4,single-choice,spatial-relational,3|4,7,3/4,210326,3
4,4,21,327,1,1537,1,9,4,4,5,single-choice,spatial-relational,4|5,7,4/5,210327,4
4,4,21,328,0,1067,1,3,1,2,2,single-choice,spatial-relational,1|2,7,1/2,210328,1
4,4,21,329,0,754,1,5,2,3,3,single-choice,spatial-relational,2|3,7,2/3,210329,2
4,4,21,330,1,1004,1,13,6,6,7,single-choice,spatial-relational,6|7,7,6/7,210330,6
4,4,21,331,1,1838,1,11,5,5,6,single-choice,spatial-relational,5|6,7,5/6,210331,5
4,4,21,332,1,2338,1,3,1,1,2,single-choice,spatial-relational,1|2,7,1/2,210332,1
4,4,21,333,1,1035,1,7,3,3,4,single-choice,spatial-relational,3|4,7,3/4,210333,3
4,4,21,334,0,1022,1,13,6,7,7,single-choice,spatial-relational,6|7,7,6/7,210334,6
4,4,21,335,0,753,1,9,4,5,5,single-choice,spatial-relational,4|5,7,4/5,210335,4
4,4,21,336,1,1059,1,11,5,5,6,single-choice,spatial-relational,5|6,7,5/6,210336,5
4,4,21,337,1,2616,1,11,5,5,6,single-choice,spatial-relational,5|6,7,5/6,210337,5
4,4,21,338,1,2223,1,9,4,4,5,single-choice,spatial-relational,4|5,7,4/5,210338,4
4,4,21,339,0,2221,1,7,3,4,4,single-choice,spatial-relational,3|4,7,3/4,210339,3
4,4,21,340,1,1596,1,3,1,1,2,single-choice,spatial-relational,1|2,7,1/2,210340,1
4,4,21,341,0,642,1,5,2,3,3,single-choice,spatial-relational,2|3,7,2/3,210341,2
4,4,21,342,0,1095,1,9,4,5,5,single-choice,spatial-relational,4|5,7,4/5,210342,4
4,4,21,343,1,1325,1,7,3,3,4,single-choice,spatial-relational,3|4,7,3/4,210343,3
4,4,21,344,0,908,1,3,1,2,2,single-choice,spatial-relational,1|2,7,1/2,210344,1
4,4,21,345,0,96,1,13,6,7,7,single-choice,spatial-relational,6|7,7,6/7,210345,6
4,4,21,346,1,66,1,13,6,6,7,single-choice,spatial-relational,6|7,7,6/7,210346,6
4,4,21,347,1,919,1,11,5,5,6,single-choice,spatial-relational,5|6,7,5/6,210347,5
4,4,21,348,1,1394,1,5,2,2,3,single-choice,spatial-relational,2|3,7,2/3,210348,2
4,4,21,349,1,1212,1,7,3,3,4,single-choice,spatial-relational,3|4,7,3/4,210349,3
4,4,21,350,1,1442,1,13,6,6,7,single-choice,spatial-relational,6|7,7,6/7,210350,6
4,4,21,351,1,3105,1,9,4,4,5,single-choice,spatial-relational,4|5,7,4/5,210351,4
4,4,21,352,1,2322,1,3,1,1,2,single-choice,spatial-relational,1|2,7,1/2,210352,1
4,4,21,353,1,912,1,11,5,5,6,single-choice,spatial-relational,5|6,7,5/6,210353,5
4,4,21,354,0,1843,1,9,4,5,5,single-choice,spatial-relational,4|5,7,4/5,210354,4
4,4,21,355,1,2,1,7,3,3,4,single-choice,spatial-relational,3|4,7,3/4,210355,3
4,4,21,356,0,1041,1,5,2,3,3,single-choice,spatial-relational,2|3,7,2/3,210356,2
4,4,21,357,0,74,1,5,2,3,3,single-choice,spatial-relational,2|3,7,2/3,210357,2
4,4,21,358,1,1270,1,11,5,5,6,single-choice,spatial-relational,5|6,7,5/6,210358,5
4,4,21,359,0,800,1,3,1,2,2,single-choice,spatial-relational,1|2,7,1/2,210359,1
4,4,21,360,1,1128,1,13,6,6,7,single-choice,spatial-relational,6|7,7,6/7,210360,6
4,4,21,361,1,41,1,5,2,2,3,single-choice,spatial-relational,2|3,7,2/3,210361,2
4,4,21,362,1,1570,1,9,4,4,5,single-choice,spatial-relational,4|5,7,4/5,210362,4
4,4,21,363,1,1161,1,3,1,1,2,single-choice,spatial-relational,1|2,7,1/2,210363,1
4,4,21,364,1,907,1,11,5,5,6,single-choice,spatial-relational,5|6,7,5/6,210364,5
4,4,21,365,1,2379,1,7,3,3,4,single-choice,spatial-relational,3|4,7,3/4,210365,3
4,4,21,366,1,1625,1,13,6,6,7,single-choice,spatial-relational,6|7,7,6/7,210366,6
4,4,21,367,0,2593,1,13,6,7,7,single-choice,spatial-relational,6|7,7,6/7,210367,6
4,4,21,368,1,3900,1,3,1,1,2,single-choice,spatial-relational,1|2,7,1/2,210368,1
4,4,21,369,1,924,1,11,5,5,6,single-choice,spatial-relational,5|6,7,5/6,210369,5
4,4,21,370,1,1585,1,7,3,3,4,single-choice,spatial-relational,3|4,7,3/4,210370,3
4,4,21,371,0,1733,1,5,2,3,3,single-choice,spatial-relational,2|3,7,2/3,210371,2
4,4,21,372,0,898,1,9,4,5,5,single-choice,spatial-relational,4|5,7,4/5,210372,4
4,4,21,373,0,991,1,5,2,3,3,single-choice,spatial-relational,2|3,7,2/3,210373,2
4,4,21,374,1,836,1,3,1,1,2,single-choice,spatial-relational,1|2,7,1/2,210374,1
4,4,21,375,1,881,1,7,3,3,4,single-choice,spatial-relational,3|4,7,3/4,210375,3
4,4,21,376,1,1168,1,11,5,5,6,single-choice,spatial-relational,5|6,7,5/6,210376,5
4,4,21,377,1,1609,1,11,5,5,6,single-choice,spatial-relational,5|6,7,5/6,210377,5
4,4,21,378,1,2124,1,9,4,4,5,single-choice,spatial-relational,4|5,7,4/5,210378,4
4,4,21,379,1,1366,1,13,6,6,7,single-choice,spatial-relational,6|7,7,6/7,210379,6
4,4,21,380,0,1945,1,3,1,2,2,single-choice,spatial-relational,1|2,7,1/2,210380,1
4,4,21,381,0,1734,1,9,4,5,5,single-choice,spatial-relational,4|5,7,4/5,210381,4
4,4,21,382,0,615,1,5,2,3,3,single-choice,spatial-relational,2|3,7,2/3,210382,2
4,4,21,383,1,1278,1,13,6,6,7,single-choice,spatial-relational,6|7,7,6/7,210383,6
4,4,21,384,1,1360,1,7,3,3,4,single-choice,spatial-relational,3|4,7,3/4,210384,3
4,4,21,385,1,1289,1,11,5,5,6,single-choice,spatial-relational,5|6,7,5/6,210385,5
4,4,21,386,1,1543,1,9,4,4,5,single-choice,spatial-relational,4|5,7,4/5,210386,4
4,4,21,387,0,1287,1,3,1,2,2,single-choice,spatial-relational,1|2,7,1/2,210387,1
4,4,21,388,1,2235,1,7,3,3,4,single-choice,spatial-relational,3|4,7,3/4,210388,3
4,4,21,389,0,983,1,3,1,2,2,single-choice,spatial-relational,1|2,7,1/2,210389,1
4,4,21,390,1,2475,1,9,4,4,5,single-choice,spatial-relational,4|5,7,4/5,210390,4
4,4,21,391,1,1364,1,11,5,5,6,single-choice,spatial-relational,5|6,7,5/6,210391,5
4,4,21,392,1,1306,1,13,6,6,7,single-choice,spatial-relational,6|7,7,6/7,210392,6
4,4,21,393,0,1056,1,5,2,3,3,single-choice,spatial-relational,2|3,7,2/3,210393,2
4,4,21,394,0,959,1,5,2,3,3,single-choice,spatial-relational,2|3,7,2/3,210394,2
4,4,21,395,1,1340,1,13,6,6,7,single-choice,spatial-relational,6|7,7,6/7,210395,6
4,4,21,396,0,1344,1,7,3,4,4,single-choice,spatial-relational,3|4,7,3/4,210396,3
4,4,21,397,1,990,1,5,2,2,3,single-choice,spatial-relational,2|3,7,2/3,210397,2
4,4,21,398,0,1239,1,9,4,5,5,single-choice,spatial-relational,4|5,7,4/5,210398,4
4,4,21,399,0,898,1,3,1,2,2,single-choice,spatial-relational,1|2,7,1/2,210399,1
4,4,21,400,0,1437,1,9,4,5,5,single-choice,spatial-relational,4|5,7,4/5,210400,4
4,4,21,401,1,1026,1,11,5,5,6,single-choice,spatial-relational,5|6,7,5/6,210401,5
4,4,21,402,0,1042,1,3,1,2,2,single-choice,spatial-relational,1|2,7,1/2,210402,1
4,4,21,403,1,1572,1,13,6,6,7,single-choice,spatial-relational,6|7,7,6/7,210403,6
4,4,21,404,1,802,1,13,6,6,7,single-choice,spatial-relational,6|7,7,6/7,210404,6
4,4,21,405,1,2279,1,11,5,5,6,single-choice,spatial-relational,5|6,7,5/6,210405,5
4,4,21,406,1,2183,1,7,3,3,4,single-choice,spatial-relational,3|4,7,3/4,210406,3
4,4,21,407,0,2018,1,7,3,4,4,single-choice,spatial-relational,3|4,7,3/4,210407,3
4,4,21,408,0,1468,1,5,2,3,3,single-choice,spatial-relational,2|3,7,2/3,210408,2
4,4,21,409,0,757,1,3,1,2,2,single-choice,spatial-relational,1|2,7,1/2,210409,1
4,4,21,410,0,1513,1,3,1,2,2,single-choice,spatial-relational,1|2,7,1/2,210410,1
4,4,21,411,0,882,1,5,2,3,3,single-choice,spatial-relational,2|3,7,2/3,210411,2
4,4,21,412,1,1053,1,13,6,6,7,single-choice,spatial-relational,6|7,7,6/7,210412,6
4,4,21,413,0,2267,1,11,5,6,6,single-choice,spatial-relational,5|6,7,5/6,210413,5
4,4,21,414,1,991,1,9,4,4,5,single-choice,spatial-relational,4|5,7,4/5,210414,4
4,4,21,415,1,1670,1,7,3,3,4,single-choice,spatial-relational,3|4,7,3/4,210415,3
4,4,21,416,1,1056,1,13,6,6,7,single-choice,spatial-relational,6|7,7,6/7,210416,6
4,4,21,417,1,2238,1,11,5,5,6,single-choice,spatial-relational,5|6,7,5/6,210417,5
4,4,21,418,0,1711,1,7,3,4,4,single-choice,spatial-relational,3|4,7,3/4,210418,3
4,4,21,419,1,1113,1,5,2,2,3,single-choice,spatial-relational,2|3,7,2/3,210419,2
4,4,21,420,1,1634,1,9,4,4,5,single-choice,spatial-relational,4|5,7,4/5,210420,4
4,4,21,421,1,938,1,11,5,5,6,single-choice,spatial-relational,5|6,7,5/6,210421,5
4,4,21,422,1,1753,1,3,1,1,2,single-choice,spatial-relational,1|2,7,1/2,210422,1
4,4,21,423,1,942,1,7,3,3,4,single-choice,spatial-relational,3|4,7,3/4,210423,3
4,4,21,424,1,1246,1,13,6,6,7,single-choice,spatial-relational,6|7,7,6/7,210424,6
4,4,21,425,1,1352,1,13,6,6,7,single-choice,spatial-relational,6|7,7,6/7,210425,6
4,4,21,426,0,1610,1,3,1,2,2,single-choice,spatial-relational,1|2,7,1/2,210426,1
4,4,21,427,0,1054,1,9,4,5,5,single-choice,spatial-relational,4|5,7,4/5,210427,4
4,4,21,428,1,1354,1,5,2,2,3,single-choice,spatial-relational,2|3,7,2/3,210428,2
4,4,21,429,1,1286,1,5,2,2,3,single-choice,spatial-relational,2|3,7,2/3,210429,2
4,4,21,430,1,1502,1,11,5,5,6,single-choice,spatial-relational,5|6,7,5/6,210430,5
4,4,21,431,1,1962,1,7,3,3,4,single-choice,spatial-relational,3|4,7,3/4,210431,3
4,4,21,432,1,2007,1,9,4,4,5,single-choice,spatial-relational,4|5,7,4/5,210432,4
4,4,21,433,1,1049,1,11,5,5,6,single-choice,spatial-relational,5|6,7,5/6,210433,5
4,4,21,434,0,1844,1,9,4,5,5,single-choice,spatial-relational,4|5,7,4/5,210434,4
4,4,21,435,1,1935,1,3,1,1,2,single-choice,spatial-relational,1|2,7,1/2,210435,1
4,4,21,436,1,2950,1,9,4,4,5,single-choice,spatial-relational,4|5,7,4/5,210436,4
4,4,21,437,0,1780,1,11,5,6,6,single-choice,spatial-relational,5|6,7,5/6,210437,5
4,4,21,438,1,1541,1,7,3,3,4,single-choice,spatial-relational,3|4,7,3/4,210438,3
4,4,21,439,1,781,1,13,6,6,7,single-choice,spatial-relational,6|7,7,6/7,210439,6
4,4,21,440,1,1358,1,13,6,6,7,single-choice,spatial-relational,6|7,7,6/7,210440,6
4,4,21,441,1,2145,1,5,2,2,3,single-choice,spatial-relational,2|3,7,2/3,210441,2
4,4,21,442,1,2167,1,7,3,3,4,single-choice,spatial-relational,3|4,7,3/4,210442,3
4,4,21,443,0,709,1,3,1,2,2,single-choice,spatial-relational,1|2,7,1/2,210443,1
4,4,21,444,0,867,1,5,2,3,3,single-choice,spatial-relational,2|3,7,2/3,210444,2
4,4,21,445,1,966,1,13,6,6,7,single-choice,spatial-relational,6|7,7,6/7,210445,6
4,4,21,446,0,705,1,3,1,2,2,single-choice,spatial-relational,1|2,7,1/2,210446,1
4,4,21,447,0,980,1,5,2,3,3,single-choice,spatial-relational,2|3,7,2/3,210447,2
4,4,21,448,1,977,1,3,1,1,2,single-choice,spatial-relational,1|2,7,1/2,210448,1
4,4,21,449,1,1160,1,9,4,4,5,single-choice,spatial-relational,4|5,7,4/5,210449,4
4,4,21,450,1,1444,1,11,5,5,6,single-choice,spatial-relational,5|6,7,5/6,210450,5
4,4,21,451,1,1402,1,5,2,2,3,single-choice,spatial-relational,2|3,7,2/3,210451,2
4,4,21,452,1,827,1,11,5,5,6,single-choice,spatial-relational,5|6,7,5/6,210452,5
4,4,21,453,1,2105,1,7,3,3,4,single-choice,spatial-relational,3|4,7,3/4,210453,3
4,4,21,454,1,2545,1,7,3,3,4,single-choice,spatial-relational,3|4,7,3/4,210454,3
4,4,21,455,0,1100,1,9,4,5,5,single-choice,spatial-relational,4|5,7,4/5,210455,4
4,4,21,456,0,52,1,13,6,7,7,single-choice,spatial-relational,6|7,7,6/7,210456,6
4,4,21,457,1,1472,1,13,6,6,7,single-choice,spatial-relational,6|7,7,6/7,210457,6
4,4,21,458,1,1049,1,11,5,5,6,single-choice,spatial-relational,5|6,7,5/6,210458,5
4,4,21,459,0,1178,1,9,4,5,5,single-choice,spatial-relational,4|5,7,4/5,210459,4
4,4,21,460,0,6,1,13,6,7,7,single-choice,spatial-relational,6|7,7,6/7,210460,6
4,4,21,461,0,1218,1,9,4,5,5,single-choice,spatial-relational,4|5,7,4/5,210461,4
4,4,21,462,1,14,1,5,2,2,3,single-choice,spatial-relational,2|3,7,2/3,210462,2
4,4,21,463,1,795,1,7,3,3,4,single-choice,spatial-relational,3|4,7,3/4,210463,3
4,4,21,464,1,1038,1,11,5,5,6,single-choice,spatial-relational,5|6,7,5/6,210464,5
4,4,21,465,0,2229,1,3,1,2,2,single-choice,spatial-relational,1|2,7,1/2,210465,1
4,4,21,466,1,753,1,3,1,1,2,single-choice,spatial-relational,1|2,7,1/2,210466,1
4,4,21,467,1,1353,1,5,2,2,3,single-choice,spatial-relational,2|3,7,2/3,210467,2
4,4,21,468,1,1187,1,7,3,3,4,single-choice,spatial-relational,3|4,7,3/4,210468,3
4,4,21,469,0,1535,1,3,1,2,2,single-choice,spatial-relational,1|2,7,1/2,210469,1
4,4,21,470,0,1099,1,3,1,2,2,single-choice,spatial-relational,1|2,7,1/2,210470,1
4,4,21,471,1,976,1,7,3,3,4,single-choice,spatial-relational,3|4,7,3/4,210471,3
4,4,21,472,0,2440,1,5,2,3,3,single-choice,spatial-relational,2|3,7,2/3,210472,2
4,4,21,473,0,2290,1,9,4,5,5,single-choice,spatial-relational,4|5,7,4/5,210473,4
4,4,21,474,1,1872,1,9,4,4,5,single-choice,spatial-relational,4|5,7,4/5,210474,4
4,4,21,475,0,924,1,11,5,6,6,single-choice,spatial-relational,5|6,7,5/6,210475,5
4,4,21,476,0,2109,1,5,2,3,3,single-choice,spatial-relational,2|3,7,2/3,210476,2
4,4,21,477,1,673,1,13,6,6,7,single-choice,spatial-relational,6|7,7,6/7,210477,6
4,4,21,478,1,1354,1,13,6,6,7,single-choice,spatial-relational,6|7,7,6/7,210478,6
4,4,21,479,1,2662,1,7,3,3,4,single-choice,spatial-relational,3|4,7,3/4,210479,3
4,4,21,480,0,1197,1,11,5,6,6,single-choice,spatial-relational,5|6,7,5/6,210480,5
4,4,21,481,1,918,1,11,5,5,6,single-choice,spatial-relational,5|6,7,5/6,210481,5
4,4,21,482,1,1699,1,9,4,4,5,single-choice,spatial-relational,4|5,7,4/5,210482,4
4,4,21,483,1,2178,1,9,4,4,5,single-choice,spatial-relational,4|5,7,4/5,210483,4
4,4,21,484,1,1173,1,13,6,6,7,single-choice,spatial-relational,6|7,7,6/7,210484,6
4,4,21,485,1,3785,1,7,3,3,4,single-choice,spatial-relational,3|4,7,3/4,210485,3
4,4,21,486,1,934,1,5,2,2,3,single-choice,spatial-relational,2|3,7,2/3,210486,2
4,4,21,487,1,1246,1,3,1,1,2,single-choice,spatial-relational,1|2,7,1/2,210487,1
4,4,21,488,1,1002,1,11,5,5,6,single-choice,spatial-relational,5|6,7,5/6,210488,5
4,4,21,489,1,1748,1,7,3,3,4,single-choice,spatial-relational,3|4,7,3/4,210489,3
4,4,21,490,1,1906,1,5,2,2,3,single-choice,spatial-relational,2|3,7,2/3,210490,2
4,4,21,491,1,1046,1,13,6,6,7,single-choice,spatial-relational,6|7,7,6/7,210491,6
4,4,21,492,0,1804,1,3,1,2,2,single-choice,spatial-relational,1|2,7,1/2,210492,1
4,4,21,493,1,1083,1,11,5,5,6,single-choice,spatial-relational,5|6,7,5/6,210493,5
4,4,21,494,1,1028,1,7,3,3,4,single-choice,spatial-relational,3|4,7,3/4,210494,3
4,4,21,495,1,1156,1,13,6,6,7,single-choice,spatial-relational,6|7,7,6/7,210495,6
4,4,21,496,1,2639,1,9,4,4,5,single-choice,spatial-relational,4|5,7,4/5,210496,4
4,4,21,497,1,2325,1,9,4,4,5,single-choice,spatial-relational,4|5,7,4/5,210497,4
4,4,21,498,0,1623,1,5,2,3,3,single-choice,spatial-relational,2|3,7,2/3,210498,2
4,4,21,499,0,754,1,3,1,2,2,single-choice,spatial-relational,1|2,7,1/2,210499,1
4,4,21,500,1,875,1,13,6,6,7,single-choice,spatial-relational,6|7,7,6/7,210500,6
4,4,21,501,0,1197,1,5,2,3,3,single-choice,spatial-relational,2|3,7,2/3,210501,2
4,4,21,502,0,957,1,3,1,2,2,single-choice,spatial-relational,1|2,7,1/2,210502,1
4,4,21,503,1,1186,1,11,5,5,6,single-choice,spatial-relational,5|6,7,5/6,210503,5
4,4,21,504,1,1567,1,7,3,3,4,single-choice,spatial-relational,3|4,7,3/4,210504,3
4,4,21,505,1,2191,1,3,1,1,2,single-choice,spatial-relational,1|2,7,1/2,210505,1
4,4,21,506,0,711,1,9,4,5,5,single-choice,spatial-relational,4|5,7,4/5,210506,4
4,4,21,507,1,1089,1,13,6,6,7,single-choice,spatial-relational,6|7,7,6/7,210507,6
4,4,21,508,1,1025,1,7,3,3,4,single-choice,spatial-relational,3|4,7,3/4,210508,3
4,4,21,509,1,1222,1,11,5,5,6,single-choice,spatial-relational,5|6,7,5/6,210509,5
4,4,21,510,1,1161,1,13,6,6,7,single-choice,spatial-relational,6|7,7,6/7,210510,6
4,4,21,511,1,1351,1,5,2,2,3,single-choice,spatial-relational,2|3,7,2/3,210511,2
4,4,21,512,0,1278,1,5,2,3,3,single-choice,spatial-relational,2|3,7,2/3,210512,2
4,4,21,513,0,1165,1,9,4,5,5,single-choice,spatial-relational,4|5,7,4/5,210513,4
4,4,21,514,1,1439,1,7,3,3,4,single-choice,spatial-relational,3|4,7,3/4,210514,3
4,4,21,515,1,1022,1,11,5,5,6,single-choice,spatial-relational,5|6,7,5/6,210515,5
4,4,21,516,0,1469,1,3,1,2,2,single-choice,spatial-relational,1|2,7,1/2,210516,1
4,4,21,517,1,2608,1,3,1,1,2,single-choice,spatial-relational,1|2,7,1/2,210517,1
4,4,21,518,1,1042,1,11,5,5,6,single-choice,spatial-relational,5|6,7,5/6,210518,5
4,4,21,519,1,1805,1,7,3,3,4,single-choice,spatial-relational,3|4,7,3/4,210519,3
4,4,21,520,1,1402,1,5,2,2,3,single-choice,spatial-relational,2|3,7,2/3,210520,2
4,4,21,521,1,1612,1,7,3,3,4,single-choice,spatial-relational,3|4,7,3/4,210521,3
4,4,21,522,1,1918,1,9,4,4,5,single-choice,spatial-relational,4|5,7,4/5,210522,4
4,4,21,523,1,930,1,13,6,6,7,single-choice,spatial-relational,6|7,7,6/7,210523,6
4,4,21,524,0,2627,1,9,4,5,5,single-choice,spatial-relational,4|5,7,4/5,210524,4
4,4,21,525,1,1069,1,13,6,6,7,single-choice,spatial-relational,6|7,7,6/7,210525,6
4,4,21,526,1,1399,1,11,5,5,6,single-choice,spatial-relational,5|6,7,5/6,210526,5
4,4,21,527,0,2812,1,3,1,2,2,single-choice,spatial-relational,1|2,7,1/2,210527,1
4,4,21,528,0,1766,1,5,2,3,3,single-choice,spatial-relational,2|3,7,2/3,210528,2
4,4,21,529,1,6102,1,9,4,4,5,single-choice,spatial-relational,4|5,7,4/5,210529,4
4,4,21,530,1,971,1,7,3,3,4,single-choice,spatial-relational,3|4,7,3/4,210530,3
4,4,21,531,0,28,1,13,6,7,7,single-choice,spatial-relational,6|7,7,6/7,210531,6
4,4,21,532,1,2,1,3,1,1,2,single-choice,spatial-relational,1|2,7,1/2,210532,1
4,4,21,533,0,10981,1,5,2,3,3,single-choice,spatial-relational,2|3,7,2/3,210533,2
4,4,21,534,1,1386,1,11,5,5,6,single-choice,spatial-relational,5|6,7,5/6,210534,5
4,4,21,535,1,1766,1,13,6,6,7,single-choice,spatial-relational,6|7,7,6/7,210535,6
4,4,21,536,1,794,1,11,5,5,6,single-choice,spatial-relational,5|6,7,5/6,210536,5
4,4,21,537,0,158,1,3,1,2,2,single-choice,spatial-relational,1|2,7,1/2,210537,1
4,4,21,538,0,2766,1,7,3,4,4,single-choice,spatial-relational,3|4,7,3/4,210538,3
4,4,21,539,1,3379,1,9,4,4,5,single-choice,spatial-relational,4|5,7,4/5,210539,4
4,4,21,540,1,940,1,5,2,2,3,single-choice,spatial-relational,2|3,7,2/3,210540,2
4,4,21,541,1,1185,1,3,1,1,2,single-choice,spatial-relational,1|2,7,1/2,210541,1
4,4,21,542,1,797,1,13,6,6,7,single-choice,spatial-relational,6|7,7,6/7,210542,6
4,4,21,543,0,2515,1,9,4,5,5,single-choice,spatial-relational,4|5,7,4/5,210543,4
4,4,21,544,0,2473,1,5,2,3,3,single-choice,spatial-relational,2|3,7,2/3,210544,2
4,4,21,545,0,2485,1,11,5,6,6,single-choice,spatial-relational,5|6,7,5/6,210545,5
4,4,21,546,1,1089,1,13,6,6,7,single-choice,spatial-relational,6|7,7,6/7,210546,6
4,4,21,547,0,1488,1,3,1,2,2,single-choice,spatial-relational,1|2,7,1/2,210547,1
4,4,21,548,1,60,1,9,4,4,5,single-choice,spatial-relational,4|5,7,4/5,210548,4
4,4,21,549,1,1568,1,5,2,2,3,single-choice,spatial-relational,2|3,7,2/3,210549,2
4,4,21,550,1,1105,1,11,5,5,6,single-choice,spatial-relational,5|6,7,5/6,210550,5
4,4,21,551,1,1687,1,7,3,3,4,single-choice,spatial-relational,3|4,7,3/4,210551,3
4,4,21,552,1,2136,1,7,3,3,4,single-choice,spatial-relational,3|4,7,3/4,210552,3
4,4,21,553,0,1568,1,3,1,2,2,single-choice,spatial-relational,1|2,7,1/2,210553,1
4,4,21,554,1,1699,1,13,6,6,7,single-choice,spatial-relational,6|7,7,6/7,210554,6
4,4,21,555,1,1205,1,9,4,4,5,single-choice,spatial-relational,4|5,7,4/5,210555,4
4,4,21,556,1,1669,1,13,6,6,7,single-choice,spatial-relational,6|7,7,6/7,210556,6
4,4,21,557,1,1380,1,3,1,1,2,single-choice,spatial-relational,1|2,7,1/2,210557,1
4,4,21,558,1,1194,1,9,4,4,5,single-choice,spatial-relational,4|5,7,4/5,210558,4
4,4,21,559,1,2384,1,7,3,3,4,single-choice,spatial-relational,3|4,7,3/4,210559,3
4,4,21,560,1,1400,1,5,2,2,3,single-choice,spatial-relational,2|3,7,2/3,210560,2
4,4,21,561,1,1228,1,7,3,3,4,single-choice,spatial-relational,3|4,7,3/4,210561,3
4,4,21,562,1,1450,1,11,5,5,6,single-choice,spatial-relational,5|6,7,5/6,210562,5
4,4,21,563,0,1979,1,11,5,6,6,single-choice,spatial-relational,5|6,7,5/6,210563,5
4,4,21,564,1,1141,1,5,2,2,3,single-choice,spatial-relational,2|3,7,2/3,210564,2
4,4,21,565,0,982,1,3,1,2,2,single-choice,spatial-relational,1|2,7,1/2,210565,1
4,4,21,566,1,852,1,9,4,4,5,single-choice,spatial-relational,4|5,7,4/5,210566,4
4,4,21,567,0,1207,1,3,1,2,2,single-choice,spatial-relational,1|2,7,1/2,210567,1
4,4,21,568,1,1200,1,7,3,3,4,single-choice,spatial-relational,3|4,7,3/4,210568,3
4,4,21,569,1,1333,1,9,4,4,5,single-choice,spatial-relational,4|5,7,4/5,210569,4
4,4,21,570,1,2889,1,5,2,2,3,single-choice,spatial-relational,2|3,7,2/3,210570,2
4,4,21,571,0,51,1,11,5,6,6,single-choice,spatial-relational,5|6,7,5/6,210571,5
4,4,21,572,1,1609,1,13,6,6,7,single-choice,spatial-relational,6|7,7,6/7,210572,6
4,4,21,573,1,3841,1,5,2,2,3,single-choice,spatial-relational,2|3,7,2/3,210573,2
4,4,21,574,1,920,1,11,5,5,6,single-choice,spatial-relational,5|6,7,5/6,210574,5
4,4,21,575,1,2161,1,13,6,6,7,single-choice,spatial-relational,6|7,7,6/7,210575,6
4,4,21,576,0,18977,1,7,3,4,4,single-choice,spatial-relational,3|4,7,3/4,210576,3
4,4,21,577,0,2263,1,9,4,5,5,single-choice,spatial-relational,4|5,7,4/5,210577,4
4,4,21,578,1,1572,1,13,6,6,7,single-choice,spatial-relational,6|7,7,6/7,210578,6
4,4,21,579,0,1602,1,5,2,3,3,single-choice,spatial-relational,2|3,7,2/3,210579,2
4,4,21,580,1,2360,1,13,6,6,7,single-choice,spatial-relational,6|7,7,6/7,210580,6
4,4,21,581,1,2229,1,9,4,4,5,single-choice,spatial-relational,4|5,7,4/5,210581,4
4,4,21,582,1,847,1,3,1,1,2,single-choice,spatial-relational,1|2,7,1/2,210582,1
4,4,21,583,1,965,1,7,3,3,4,single-choice,spatial-relational,3|4,7,3/4,210583,3
4,4,21,584,1,1173,1,11,5,5,6,single-choice,spatial-relational,5|6,7,5/6,210584,5
4,4,21,585,1,2018,1,11,5,5,6,single-choice,spatial-relational,5|6,7,5/6,210585,5
4,4,21,586,1,1466,1,5,2,2,3,single-choice,spatial-relational,2|3,7,2/3,210586,2
4,4,21,587,0,759,1,3,1,2,2,single-choice,spatial-relational,1|2,7,1/2,210587,1
4,4,21,588,0,11,1,7,3,4,4,single-choice,spatial-relational,3|4,7,3/4,210588,3
4,4,21,589,1,1932,1,7,3,3,4,single-choice,spatial-relational,3|4,7,3/4,210589,3
4,4,21,590,0,874,1,3,1,2,2,single-choice,spatial-relational,1|2,7,1/2,210590,1
4,4,21,591,1,830,1,3,1,1,2,single-choice,spatial-relational,1|2,7,1/2,210591,1
4,4,21,592,1,1191,1,9,4,4,5,single-choice,spatial-relational,4|5,7,4/5,210592,4
4,4,21,593,1,1325,1,5,2,2,3,single-choice,spatial-relational,2|3,7,2/3,210593,2
4,4,21,594,1,1671,1,9,4,4,5,single-choice,spatial-relational,4|5,7,4/5,210594,4
4,4,21,595,1,1436,1,13,6,6,7,single-choice,spatial-relational,6|7,7,6/7,210595,6
4,4,21,596,1,2248,1,5,2,2,3,single-choice,spatial-relational,2|3,7,2/3,210596,2
4,4,21,597,1,1401,1,11,5,5,6,single-choice,spatial-relational,5|6,7,5/6,210597,5
4,4,21,598,1,13350,1,7,3,3,4,single-choice,spatial-relational,3|4,7,3/4,210598,3
4,4,21,599,1,906,1,11,5,5,6,single-choice,spatial-relational,5|6,7,5/6,210599,5
4,4,21,600,1,1120,1,13,6,6,7,single-choice,spatial-relational,6|7,7,6/7,210600,6
5,4,21,1,0,680,1,3,1,2,2,single-choice,spatial-relational,1|2,7,1/2,210001,1
5,4,21,2,1,763,1,9,4,4,5,single-choice,spatial-relational,4|5,7,4/5,210002,4
5,4,21,3,0,757,1,5,2,3,3,single-choice,spatial-relational,2|3,7,2/3,210003,2
5,4,21,4,1,678,1,3,1,1,2,single-choice,spatial-relational,1|2,7,1/2,210004,1
5,4,21,5,1,908,1,7,3,3,4,single-choice,spatial-relational,3|4,7,3/4,210005,3
5,4,21,6,1,929,1,13,6,6,7,single-choice,spatial-relational,6|7,7,6/7,210006,6
5,4,21,7,1,1591,1,11,5,5,6,single-choice,spatial-relational,5|6,7,5/6,210007,5
5,4,21,8,0,743,1,5,2,3,3,single-choice,spatial-relational,2|3,7,2/3,210008,2
5,4,21,9,0,992,1,7,3,4,4,single-choice,spatial-relational,3|4,7,3/4,210009,3
5,4,21,10,0,1032,1,9,4,5,5,single-choice,spatial-relational,4|5,7,4/5,210010,4
5,4,21,11,1,1153,1,13,6,6,7,single-choice,spatial-relational,6|7,7,6/7,210011,6
5,4,21,12,1,1067,1,11,5,5,6,single-choice,spatial-relational,5|6,7,5/6,210012,5
5,4,21,13,1,1083,1,9,4,4,5,single-choice,spatial-relational,4|5,7,4/5,210013,4
5,4,21,14,0,1414,1,9,4,5,5,single-choice,spatial-relational,4|5,7,4/5,210014,4
5,4,21,15,0,716,1,3,1,2,2,single-choice,spatial-relational,1|2,7,1/2,210015,1
5,4,21,16,1,940,1,11,5,5,6,single-choice,spatial-relational,5|6,7,5/6,210016,5
5,4,21,17,1,1125,1,5,2,2,3,single-choice,spatial-relational,2|3,7,2/3,210017,2
5,4,21,18,1,934,1,13,6,6,7,single-choice,spatial-relational,6|7,7,6/7,210018,6
5,4,21,19,1,2526,1,11,5,5,6,single-choice,spatial-relational,5|6,7,5/6,210019,5
5,4,21,20,1,1300,1,13,6,6,7,single-choice,spatial-relational,6|7,7,6/7,210020,6
5,4,21,21,1,1198,1,5,2,2,3,single-choice,spatial-relational,2|3,7,2/3,210021,2
5,4,21,22,1,1274,1,7,3,3,4,single-choice,spatial-relational,3|4,7,3/4,210022,3
5,4,21,23,1,1110,1,7,3,3,4,single-choice,spatial-relational,3|4,7,3/4,210023,3
5,4,21,24,0,1618,1,3,1,2,2,single-choice,spatial-relational,1|2,7,1/2,210024,1
5,4,21,25,1,892,1,7,3,3,4,single-choice,spatial-relational,3|4,7,3/4,210025,3
5,4,21,26,0,1491,1,7,3,4,4,single-choice,spatial-relational,3|4,7,3/4,210026,3
5,4,21,27,1,1402,1,9,4,4,5,single-choice,spatial-relational,4|5,7,4/5,210027,4
5,4,21,28,1,876,1,5,2,2,3,single-choice,spatial-relational,2|3,7,2/3,210028,2
5,4,21,29,1,1558,1,9,4,4,5,single-choice,spatial-relational,4|5,7,4/5,210029,4
5,4,21,30,0,1864,1,11,5,6,6,single-choice,spatial-relational,5|6,7,5/6,210030,5
5,4,21,31,0,624,1,13,6,7,7,single-choice,spatial-relational,6|7,7,6/7,210031,6
5,4,21,32,1,1186,1,3,1,1,2,single-choice,spatial-relational,1|2,7,1/2,210032,1
5,4,21,33,1,838,1,5,2,2,3,single-choice,spatial-relational,2|3,7,2/3,210033,2
5,4,21,34,0,1216,1,3,1,2,2,single-choice,spatial-relational,1|2,7,1/2,210034,1
5,4,21,35,1,1023,1,11,5,5,6,single-choice,spatial-relational,5|6,7,5/6,210035,5
5,4,21,36,1,969,1,13,6,6,7,single-choice,spatial-relational,6|7,7,6/7,210036,6
5,4,21,37,0,1632,1,9,4,5,5,single-choice,spatial-relational,4|5,7,4/5,210037,4
5,4,21,38,0,667,1,5,2,3,3,single-choice,spatial-relational,2|3,7,2/3,210038,2
5,4,21,39,1,919,1,11,5,5,6,single-choice,spatial-relational,5|6,7,5/6,210039,5
5,4,21,40,1,1067,1,5,2,2,3,single-choice,spatial-relational,2|3,7,2/3,210040,2
5,4,21,41,1,769,1,13,6,6,7,single-choice,spatial-relational,6|7,7,6/7,210041,6
5,4,21,42,1,2296,1,13,6,6,7,single-choice,spatial-relational,6|7,7,6/7,210042,6
5,4,21,43,0,1854,1,3,1,2,2,single-choice,spatial-relational,1|2,7,1/2,210043,1
5,4,21,44,1,2,1,9,4,4,5,single-choice,spatial-relational,4|5,7,4/5,210044,4
5,4,21,45,1,854,1,11,5,5,6,single-choice,spatial-relational,5|6,7,5/6,210045,5
5,4,21,46,1,1541,1,7,3,3,4,single-choice,spatial-relational,3|4,7,3/4,210046,3
5,4,21,47,0,1212,1,3,1,2,2,single-choice,spatial-relational,1|2,7,1/2,210047,1
5,4,21,48,1,1218,1,7,3,3,4,single-choice,spatial-relational,3|4,7,3/4,210048,3
5,4,21,49,1,1555,1,11,5,5,6,single-choice,spatial-relational,5|6,7,5/6,210049,5
5,4,21,50,1,1437,1,13,6,6,7,single-choice,spatial-relational,6|7,7,6/7,210050,6
5,4,21,51,1,2550,1,9,4,4,5,single-choice,spatial-relational,4|5,7,4/5,210051,4
5,4,21,52,1,1154,1,13,6,6,7,single-choice,spatial-relational,6|7,7,6/7,210052,6
5,4,21,53,1,2262,1,9,4,4,5,single-choice,spatial-relational,4|5,7,4/5,210053,4
5,4,21,54,1,2008,1,5,2,2,3,single-choice,spatial-relational,2|3,7,2/3,210054,2
5,4,21,55,1,1184,1,3,1,1,2,single-choice,spatial-relational,1|2,7,1/2,210055,1
5,4,21,56,0,635,1,11,5,6,6,single-choice,spatial-relational,5|6,7,5/6,210056,5
5,4,21,57,1,725,1,7,3,3,4,single-choice,spatial-relational,3|4,7,3/4,210057,3
5,4,21,58,0,620,1,3,1,2,2,single-choice,spatial-relational,1|2,7,1/2,210058,1
5,4,21,59,1,50,1,7,3,3,4,single-choice,spatial-relational,3|4,7,3/4,210059,3
5,4,21,60,0,521,1,5,2,3,3,single-choice,spatial-relational,2|3,7,2/3,210060,2
5,4,21,61,0,1012,1,5,2,3,3,single-choice,spatial-relational,2|3,7,2/3,210061,2
5,4,21,62,1,1,1,11,5,5,6,single-choice,spatial-relational,5|6,7,5/6,210062,5
5,4,21,63,1,881,1,13,6,6,7,single-choice,spatial-relational,6|7,7,6/7,210063,6
5,4,21,64,1,1619,1,9,4,4,5,single-choice,spatial-relational,4|5,7,4/5,210064,4
5,4,21,65,1,1516,1,7,3,3,4,single-choice,spatial-relational,3|4,7,3/4,210065,3
5,4,21,66,1,971,1,13,6,6,7,single-choice,spatial-relational,6|7,7,6/7,210066,6
5,4,21,67,1,1546,1,11,5,5,6,single-choice,spatial-relational,5|6,7,5/6,210067,5
5,4,21,68,0,1690,1,3,1,2,2,single-choice,spatial-relational,1|2,7,1/2,210068,1
5,4,21,69,1,773,1,7,3,3,4,single-choice,spatial-relational,3|4,7,3/4,210069,3
5,4,21,70,1,1303,1,3,1,1,2,single-choice,spatial-relational,1|2,7,1/2,210070,1
5,4,21,71,1,909,1,5,2,2,3,single-choice,spatial-relational,2|3,7,2/3,210071,2
5,4,21,72,1,1033,1,9,4,4,5,single-choice,spatial-relational,4|5,7,4/5,210072,4
5,4,21,73,1,1430,1,11,5,5,6,single-choice,spatial-relational,5|6,7,5/6,210073,5
5,4,21,74,1,1415,1,13,6,6,7,single-choice,spatial-relational,6|7,7,6/7,210074,6
5,4,21,75,1,1643,1,3,1,1,2,single-choice,spatial-relational,1|2,7,1/2,210075,1
5,4,21,76,1,962,1,9,4,4,5,single-choice,spatial-relational,4|5,7,4/5,210076,4
5,4,21,77,0,1575,1,7,3,4,4,single-choice,spatial-relational,3|4,7,3/4,210077,3
5,4,21,78,0,768,1,5,2,3,3,single-choice,spatial-relational,2|3,7,2/3,210078,2
5,4,21,79,1,1088,1,7,3,3,4,single-choice,spatial-relational,3|4,7,3/4,210079,3
5,4,21,80,1,855,1,11,5,5,6,single-choice,spatial-relational,5|6,7,5/6,210080,5
5,4,21,81,1,1253,1,5,2,2,3,single-choice,spatial-relational,2|3,7,2/3,210081,2
5,4,21,82,0,799,1,13,6,7,7,single-choice,spatial-relational,6|7,7,6/7,210082,6
5,4,21,83,1,1274,1,9,4,4,5,single-choice,spatial-relational,4|5,7,4/5,210083,4
5,4,21,84,1,1468,1,3,1,1,2,single-choice,spatial-relational,1|2,7,1/2,210084,1
5,4,21,85,1,975,1,7,3,3,4,single-choice,spatial-relational,3|4,7,3/4,210085,3
5,4,21,86,1,1452,1,3,1,1,2,single-choice,spatial-relational,1|2,7,1/2,210086,1
5,4,21,87,1,904,1,7,3,3,4,single-choice,spatial-relational,3|4,7,3/4,210087,3
5,4,21,88,1,1420,1,13,6,6,7,single-choice,spatial-relational,6|7,7,6/7,210088,6
5,4,21,89,1,2076,1,11,5,5,6,single-choice,spatial-relational,5|6,7,5/6,210089,5
5,4,21,90,1,2446,1,5,2,2,3,single-choice,spatial-relational,2|3,7,2/3,210090,2
5,4,21,91,1,1388,1,9,4,4,5,single-choice,spatial-relational,4|5,7,4/5,210091,4
5,4,21,92,1,1576,1,9,4,4,5,single-choice,spatial-relational,4|5,7,4/5,210092,4
5,4,21,93,1,1460,1,3,1,1,2,single-choice,spatial-relational,1|2,7,1/2,210093,1
5,4,21,94,1,1214,1,13,6,6,7,single-choice,spatial-relational,6|7,7,6/7,210094,6
5,4,21,95,1,1525,1,11,5,5,6,single-choice,spatial-relational,5|6,7,5/6,210095,5
5,4,21,96,1,1732,1,5,2,2,3,single-choice,spatial-relational,2|3,7,2/3,210096,2
5,4,21,97,1,1449,1,9,4,4,5,single-choice,spatial-relational,4|5,7,4/5,210097,4
5,4,21,98,0,1039,1,3,1,2,2,single-choice,spatial-relational,1|2,7,1/2,210098,1
5,4,21,99,1,841,1,7,3,3,4,single-choice,spatial-relational,3|4,7,3/4,210099,3
5,4,21,100,1,1302,1,13,6,6,7,single-choice,spatial-relational,6|7,7,6/7,210100,6
5,4,21,101,1,1742,1,5,2,2,3,single-choice,spatial-relational,2|3,7,2/3,210101,2
5,4,21,102,1,1133,1,11,5,5,6,single-choice,spatial-relational,5|6,7,5/6,210102,5
5,4,21,103,1,1615,1,7,3,3,4,single-choice,spatial-relational,3|4,7,3/4,210103,3
5,4,21,104,1,1397,1,11,5,5,6,single-choice,spatial-relational,5|6,7,5/6,210104,5
5,4,21,105,1,1663,1,13,6,6,7,single-choice,spatial-relational,6|7,7,6/7,210105,6
5,4,21,106,0,1578,1,3,1,2,2,single-choice,spatial-relational,1|2,7,1/2,210106,1
5,4,21,107,0,10,1,5,2,3,3,single-choice,spatial-relational,2|3,7,2/3,210107,2
5,4,21,108,1,799,1,9,4,4,5,single-choice,spatial-relational,4|5,7,4/5,210108,4
5,4,21,109,0,1342,1,3,1,2,2,single-choice,spatial-relational,1|2,7,1/2,210109,1
5,4,21,110,0,763,1,9,4,5,5,single-choice,spatial-relational,4|5,7,4/5,210110,4
5,4,21,111,1,920,1,7,3,3,4,single-choice,spatial-relational,3|4,7,3/4,210111,3
5,4,21,112,1,1150,1,7,3,3,4,single-choice,spatial-relational,3|4,7,3/4,210112,3
5,4,21,113,1,1316,1,13,6,6,7,single-choice,spatial-relational,6|7,7,6/7,210113,6
5,4,21,114,1,1296,1,11,5,5,6,single-choice,spatial-relational,5|6,7,5/6,210114,5
5,4,21,115,1,883,1,11,5,5,6,single-choice,spatial-relational,5|6,7,5/6,210115,5
5,4,21,116,1,1656,1,13,6,6,7,single-choice,spatial-relational,6|7,7,6/7,210116,6
5,4,21,117,1,2633,1,5,2,2,3,single-choice,spatial-relational,2|3,7,2/3,210117,2
5,4,21,118,1,1058,1,5,2,2,3,single-choice,spatial-relational,2|3,7,2/3,210118,2
5,4,21,119,1,1153,1,3,1,1,2,single-choice,spatial-relational,1|2,7,1/2,210119,1
5,4,21,120,1,732,1,9,4,4,5,single-choice,spatial-relational,4|5,7,4/5,210120,4
5,4,21,121,1,1309,1,3,1,1,2,single-choice,spatial-relational,1|2,7,1/2,210121,1
5,4,21,122,1,1026,1,5,2,2,3,single-choice,spatial-relational,2|3,7,2/3,210122,2
5,4,21,123,0,1067,1,7,3,4,4,single-choice,spatial-relational,3|4,7,3/4,210123,3
5,4,21,124,1,1036,1,3,1,1,2,single-choice,spatial-relational,1|2,7,1/2,210124,1
5,4,21,125,0,915,1,9,4,5,5,single-choice,spatial-relational,4|5,7,4/5,210125,4
5,4,21,126,1,1054,1,11,5,5,6,single-choice,spatial-relational,5|6,7,5/6,210126,5
5,4,21,127,1,1622,1,11,5,5,6,single-choice,spatial-relational,5|6,7,5/6,210127,5
5,4,21,128,1,2105,1,9,4,4,5,single-choice,spatial-relational,4|5,7,4/5,210128,4
5,4,21,129,0,871,1,5,2,3,3,single-choice,spatial-relational,2|3,7,2/3,210129,2
5,4,21,130,1,1056,1,13,6,6,7,single-choice,spatial-relational,6|7,7,6/7,210130,6
5,4,21,131,1,1432,1,7,3,3,4,single-choice,spatial-relational,3|4,7,3/4,210131,3
5,4,21,132,1,896,1,13,6,6,7,single-choice,spatial-relational,6|7,7,6/7,210132,6
5,4,21,133,1,1555,1,3,1,1,2,single-choice,spatial-relational,1|2,7,1/2,210133,1
5,4,21,134,1,1190,1,7,3,3,4,single-choice,spatial-relational,3|4,7,3/4,210134,3
5,4,21,135,1,970,1,13,6,6,7,single-choice,spatial-relational,6|7,7,6/7,210135,6
5,4,21,136,1,927,1,11,5,5,6,single-choice,spatial-relational,5|6,7,5/6,210136,5
5,4,21,137,1,1277,1,13,6,6,7,single-choice,spatial-relational,6|7,7,6/7,210137,6
5,4,21,138,0,782,1,9,4,5,5,single-choice,spatial-relational,4|5,7,4/5,210138,4
5,4,21,139,0,1055,1,9,4,5,5,single-choice,spatial-relational,4|5,7,4/5,210139,4
5,4,21,140,1,696,1,3,1,1,2,single-choice,spatial-relational,1|2,7,1/2,210140,1
5,4,21,141,1,753,1,11,5,5,6,single-choice,spatial-relational,5|6,7,5/6,210141,5
5,4,21,142,1,2020,1,5,2,2,3,single-choice,spatial-relational,2|3,7,2/3,210142,2
5,4,21,143,0,2016,1,5,2,3,3,single-choice,spatial-relational,2|3,7,2/3,210143,2
5,4,21,144,1,4,1,7,3,3,4,single-choice,spatial-relational,3|4,7,3/4,210144,3
5,4,21,145,1,803,1,13,6,6,7,single-choice,spatial-relational,6|7,7,6/7,210145,6
5,4,21,146,1,1214,1,11,5,5,6,single-choice,spatial-relational,5|6,7,5/6,210146,5
5,4,21,147,1,1133,1,11,5,5,6,single-choice,spatial-relational,5|6,7,5/6,210147,5
5,4,21,148,1,2118,1,7,3,3,4,single-choice,spatial-relational,3|4,7,3/4,210148,3
5,4,21,149,1,1109,1,3,1,1,2,single-choice,spatial-relational,1|2,7,1/2,210149,1
5,4,21,150,1,730,1,7,3,3,4,single-choice,spatial-relational,3|4,7,3/4,210150,3
5,4,21,151,1,1281,1,9,4,4,5,single-choice,spatial-relational,4|5,7,4/5,210151,4
5,4,21,152,0,725,1,5,2,3,3,single-choice,spatial-relational,2|3,7,2/3,210152,2
5,4,21,153,1,681,1,13,6,6,7,single-choice,spatial-relational,6|7,7,6/7,210153,6
5,4,21,154,0,2207,1,5,2,3,3,single-choice,spatial-relational,2|3,7,2/3,210154,2
5,4,21,155,0,668,1,3,1,2,2,single-choice,spatial-relational,1|2,7,1/2,210155,1
5,4,21,156,1,1357,1,9,4,4,5,single-choice,spatial-relational,4|5,7,4/5,210156,4
5,4,21,157,1,1079,1,13,6,6,7,single-choice,spatial-relational,6|7,7,6/7,210157,6
5,4,21,158,0,1030,1,3,1,2,2,single-choice,spatial-relational,1|2,7,1/2,210158,1
5,4,21,159,1,1602,1,7,3,3,4,single-choice,spatial-relational,3|4,7,3/4,210159,3
5,4,21,160,1,1699,1,9,4,4,5,single-choice,spatial-relational,4|5,7,4/5,210160,4
5,4,21,161,1,963,1,13,6,6,7,single-choice,spatial-relational,6|7,7,6/7,210161,6
5,4,21,162,0,1974,1,11,5,6,6,single-choice,spatial-relational,5|6,7,5/6,210162,5
5,4,21,163,1,1215,1,7,3,3,4,single-choice,spatial-relational,3|4,7,3/4,210163,3
5,4,21,164,1,992,1,5,2,2,3,single-choice,spatial-relational,2|3,7,2/3,210164,2
5,4,21,165,1,1230,1,5,2,2,3,single-choice,spatial-relational,2|3,7,2/3,210165,2
5,4,21,166,1,1139,1,11,5,5,6,single-choice,spatial-relational,5|6,7,5/6,210166,5
5,4,21,167,1,3329,1,9,4,4,5,single-choice,spatial-relational,4|5,7,4/5,210167,4
5,4,21,168,1,1119,1,3,1,1,2,single-choice,spatial-relational,1|2,7,1/2,210168,1
5,4,21,169,1,997,1,9,4,4,5,single-choice,spatial-relational,4|5,7,4/5,210169,4
5,4,21,170,1,1422,1,5,2,2,3,single-choice,spatial-relational,2|3,7,2/3,210170,2
5,4,21,171,1,1768,1,7,3,3,4,single-choice,spatial-relational,3|4,7,3/4,210171,3
5,4,21,172,1,1903,1,7,3,3,4,single-choice,spatial-relational,3|4,7,3/4,210172,3
5,4,21,173,0,1728,1,9,4,5,5,single-choice,spatial-relational,4|5,7,4/5,210173,4
5,4,21,174,1,1025,1,13,6,6,7,single-choice,spatial-relational,6|7,7,6/7,210174,6
5,4,21,175,1,915,1,11,5,5,6,single-choice,spatial-relational,5|6,7,5/6,210175,5
5,4,21,176,1,4602,1,3,1,1,2,single-choice,spatial-relational,1|2,7,1/2,210176,1
5,4,21,177,1,711,1,11,5,5,6,single-choice,spatial-relational,5|6,7,5/6,210177,5
5,4,21,178,1,2458,1,5,2,2,3,single-choice,spatial-relational,2|3,7,2/3,210178,2
5,4,21,179,0,1041,1,3,1,2,2,single-choice,spatial-relational,1|2,7,1/2,210179,1
5,4,21,180,1,746,1,13,6,6,7,single-choice,spatial-relational,6|7,7,6/7,210180,6
5,4,21,181,1,831,1,13,6,6,7,single-choice,spatial-relational,6|7,7,6/7,210181,6
5,4,21,182,1,1127,1,9,4,4,5,single-choice,spatial-relational,4|5,7,4/5,210182,4
5,4,21,183,1,982,1,13,6,6,7,single-choice,spatial-relational,6|7,7,6/7,210183,6
5,4,21,184,1,1715,1,5,2,2,3,single-choice,spatial-relational,2|3,7,2/3,210184,2
5,4,21,185,0,695,1,11,5,6,6,single-choice,spatial-relational,5|6,7,5/6,210185,5
5,4,21,186,1,944,1,5,2,2,3,single-choice,spatial-relational,2|3,7,2/3,210186,2
5,4,21,187,1,1250,1,9,4,4,5,single-choice,spatial-relational,4|5,7,4/5,210187,4
5,4,21,188,1,1450,1,3,1,1,2,single-choice,spatial-relational,1|2,7,1/2,210188,1
5,4,21,189,1,1066,1,3,1,1,2,single-choice,spatial-relational,1|2,7,1/2,210189,1
5,4,21,190,1,1046,1,11,5,5,6,single-choice,spatial-relational,5|6,7,5/6,210190,5
5,4,21,191,1,1285,1,7,3,3,4,single-choice,spatial-relational,3|4,7,3/4,210191,3
5,4,21,192,1,1638,1,7,3,3,4,single-choice,spatial-relational,3|4,7,3/4,210192,3
5,4,21,193,0,843,1,3,1,2,2,single-choice,spatial-relational,1|2,7,1/2,210193,1
5,4,21,194,1,917,1,7,3,3,4,single-choice,spatial-relational,3|4,7,3/4,210194,3
5,4,21,195,1,1212,1,5,2,2,3,single-choice,spatial-relational,2|3,7,2/3,210195,2
5,4,21,196,1,1491,1,9,4,4,5,single-choice,spatial-relational,4|5,7,4/5,210196,4
5,4,21,197,1,1120,1,11,5,5,6,single-choice,spatial-relational,5|6,7,5/6,210197,5
5,4,21,198,1,1412,1,11,5,5,6,single-choice,spatial-relational,5|6,7,5/6,210198,5
5,4,21,199,1,1728,1,13,6,6,7,single-choice,spatial-relational,6|7,7,6/7,210199,6
5,4,21,200,1,932,1,9,4,4,5,single-choice,spatial-relational,4|5,7,4/5,210200,4
5,4,21,201,1,2073,1,7,3,3,4,single-choice,spatial-relational,3|4,7,3/4,210201,3
5,4,21,202,1,1014,1,13,6,6,7,single-choice,spatial-relational,6|7,7,6/7,210202,6
5,4,21,203,0,1055,1,3,1,2,2,single-choice,spatial-relational,1|2,7,1/2,210203,1
5,4,21,204,1,906,1,5,2,2,3,single-choice,spatial-relational,2|3,7,2/3,210204,2
5,4,21,205,1,1045,1,7,3,3,4,single-choice,spatial-relational,3|4,7,3/4,210205,3
5,4,21,206,1,1175,1,11,5,5,6,single-choice,spatial-relational,5|6,7,5/6,210206,5
5,4,21,207,1,1345,1,5,2,2,3,single-choice,spatial-relational,2|3,7,2/3,210207,2
5,4,21,208,1,1116,1,3,1,1,2,single-choice,spatial-relational,1|2,7,1/2,210208,1
5,4,21,209,1,1425,1,5,2,2,3,single-choice,spatial-relational,2|3,7,2/3,210209,2
5,4,21,210,1,1295,1,9,4,4,5,single-choice,spatial-relational,4|5,7,4/5,210210,4
5,4,21,211,1,1717,1,9,4,4,5,single-choice,spatial-relational,4|5,7,4/5,210211,4
5,4,21,212,1,1227,1,11,5,5,6,single-choice,spatial-relational,5|6,7,5/6,210212,5
5,4,21,213,0,868,1,3,1,2,2,single-choice,spatial-relational,1|2,7,1/2,210213,1
5,4,21,214,1,892,1,13,6,6,7,single-choice,spatial-relational,6|7,7,6/7,210214,6
5,4,21,215,1,1199,1,13,6,6,7,single-choice,spatial-relational,6|7,7,6/7,210215,6
5,4,21,216,1,1736,1,7,3,3,4,single-choice,spatial-relational,3|4,7,3/4,210216,3
5,4,21,217,1,1052,1,13,6,6,7,single-choice,spatial-relational,6|7,7,6/7,210217,6
5,4,21,218,0,863,1,3,1,2,2,single-choice,spatial-relational,1|2,7,1/2,210218,1
5,4,21,219,1,932,1,5,2,2,3,single-choice,spatial-relational,2|3,7,2/3,210219,2
5,4,21,220,1,1666,1,9,4,4,5,single-choice,spatial-relational,4|5,7,4/5,210220,4
5,4,21,221,1,1641,1,9,4,4,5,single-choice,spatial-relational,4|5,7,4/5,210221,4
5,4,21,222,0,149,1,11,5,6,6,single-choice,spatial-relational,5|6,7,5/6,210222,5
5,4,21,223,1,81,1,7,3,3,4,single-choice,spatial-relational,3|4,7,3/4,210223,3
5,4,21,224,0,192,1,7,3,4,4,single-choice,spatial-relational,3|4,7,3/4,210224,3
5,4,21,225,1,79,1,5,2,2,3,single-choice,spatial-relational,2|3,7,2/3,210225,2
5,4,21,226,1,698,1,13,6,6,7,single-choice,spatial-relational,6|7,7,6/7,210226,6
5,4,21,227,1,606,1,11,5,5,6,single-choice,spatial-relational,5|6,7,5/6,210227,5
5,4,21,228,0,85,1,3,1,2,2,single-choice,spatial-relational,1|2,7,1/2,210228,1
5,4,21,229,1,59,1,11,5,5,6,single-choice,spatial-relational,5|6,7,5/6,210229,5
5,4,21,230,0,97,1,7,3,4,4,single-choice,spatial-relational,3|4,7,3/4,210230,3
5,4,21,231,0,213,1,11,5,6,6,single-choice,spatial-relational,5|6,7,5/6,210231,5
5,4,21,232,0,178,1,3,1,2,2,single-choice,spatial-relational,1|2,7,1/2,210232,1
5,4,21,233,1,94,1,3,1,1,2,single-choice,spatial-relational,1|2,7,1/2,210233,1
5,4,21,234,0,155,1,5,2,3,3,single-choice,spatial-relational,2|3,7,2/3,210234,2
5,4,21,235,1,553,1,5,2,2,3,single-choice,spatial-relational,2|3,7,2/3,210235,2
5,4,21,236,1,178,1,13,6,6,7,single-choice,spatial-relational,6|7,7,6/7,210236,6
5,4,21,237,1,138,1,9,4,4,5,single-choice,spatial-relational,4|5,7,4/5,210237,4
5,4,21,238,1,86,1,7,3,3,4,single-choice,spatial-relational,3|4,7,3/4,210238,3
5,4,21,239,1,64,1,9,4,4,5,single-choice,spatial-relational,4|5,7,4/5,210239,4
5,4,21,240,0,103,1,13,6,7,7,single-choice,spatial-relational,6|7,7,6/7,210240,6
5,4,21,241,1,130,1,7,3,3,4,single-choice,spatial-relational,3|4,7,3/4,210241,3
5,4,21,242,0,78,1,11,5,6,6,single-choice,spatial-relational,5|6,7,5/6,210242,5
5,4,21,243,1,105,1,11,5,5,6,single-choice,spatial-relational,5|6,7,5/6,210243,5
5,4,21,244,0,79,1,13,6,7,7,single-choice,spatial-relational,6|7,7,6/7,210244,6
5,4,21,245,1,1002,1,3,1,1,2,single-choice,spatial-relational,1|2,7,1/2,210245,1
5,4,21,246,0,439,1,5,2,3,3,single-choice,spatial-relational,2|3,7,2/3,210246,2
5,4,21,247,1,149,1,5,2,2,3,single-choice,spatial-relational,2|3,7,2/3,210247,2
5,4,21,248,0,88,1,9,4,5,5,single-choice,spatial-relational,4|5,7,4/5,210248,4
5,4,21,249,1,7,1,7,3,3,4,single-choice,spatial-relational,3|4,7,3/4,210249,3
5,4,21,250,1,3,1,3,1,1,2,single-choice,spatial-relational,1|2,7,1/2,210250,1
5,4,21,251,0,5,1,13,6,7,7,single-choice,spatial-relational,6|7,7,6/7,210251,6
5,4,21,252,1,54,1,9,4,4,5,single-choice,spatial-relational,4|5,7,4/5,210252,4
5,4,21,253,0,833,1,7,3,4,4,single-choice,spatial-relational,3|4,7,3/4,210253,3
5,4,21,254,0,1046,1,11,5,6,6,single-choice,spatial-relational,5|6,7,5/6,210254,5
5,4,21,255,1,872,1,3,1,1,2,single-choice,spatial-relational,1|2,7,1/2,210255,1
5,4,21,256,1,135,1,7,3,3,4,single-choice,spatial-relational,3|4,7,3/4,210256,3
5,4,21,257,1,968,1,9,4,4,5,single-choice,spatial-relational,4|5,7,4/5,210257,4
5,4,21,258,0,1029,1,3,1,2,2,single-choice,spatial-relational,1|2,7,1/2,210258,1
5,4,21,259,1,65,1,11,5,5,6,single-choice,spatial-relational,5|6,7,5/6,210259,5
5,4,21,260,0,685,1,13,6,7,7,single-choice,spatial-relational,6|7,7,6/7,210260,6
5,4,21,261,1,992,1,5,2,2,3,single-choice,spatial-relational,2|3,7,2/3,210261,2
5,4,21,262,0,458,1,9,4,5,5,single-choice,spatial-relational,4|5,7,4/5,210262,4
5,4,21,263,0,1236,1,5,2,3,3,single-choice,spatial-relational,2|3,7,2/3,210263,2
5,4,21,264,1,169,1,13,6,6,7,single-choice,spatial-relational,6|7,7,6/7,210264,6
5,4,21,265,1,1158,1,13,6,6,7,single-choice,spatial-relational,6|7,7,6/7,210265,6
5,4,21,266,1,1485,1,11,5,5,6,single-choice,spatial-relational,5|6,7,5/6,210266,5
5,4,21,267,0,456,1,7,3,4,4,single-choice,spatial-relational,3|4,7,3/4,210267,3
5,4,21,268,1,889,1,11,5,5,6,single-choice,spatial-relational,5|6,7,5/6,210268,5
5,4,21,269,1,980,1,9,4,4,5,single-choice,spatial-relational,4|5,7,4/5,210269,4
5,4,21,270,1,2238,1,3,1,1,2,single-choice,spatial-relational,1|2,7,1/2,210270,1
5,4,21,271,1,992,1,5,2,2,3,single-choice,spatial-relational,2|3,7,2/3,210271,2
5,4,21,272,1,99,1,7,3,3,4,single-choice,spatial-relational,3|4,7,3/4,210272,3
5,4,21,273,0,717,1,5,2,3,3,single-choice,spatial-relational,2|3,7,2/3,210273,2
5,4,21,274,0,595,1,13,6,7,7,single-choice,spatial-relational,6|7,7,6/7,210274,6
5,4,21,275,1,125,1,9,4,4,5,single-choice,spatial-relational,4|5,7,4/5,210275,4
5,4,21,276,1,898,1,3,1,1,2,single-choice,spatial-relational,1|2,7,1/2,210276,1
5,4,21,277,1,793,1,5,2,2,3,single-choice,spatial-relational,2|3,7,2/3,210277,2
5,4,21,278,0,552,1,7,3,4,4,single-choice,spatial-relational,3|4,7,3/4,210278,3
5,4,21,279,1,935,1,13,6,6,7,single-choice,spatial-relational,6|7,7,6/7,210279,6
5,4,21,280,1,67,1,13,6,6,7,single-choice,spatial-relational,6|7,7,6/7,210280,6
5,4,21,281,1,1508,1,5,2,2,3,single-choice,spatial-relational,2|3,7,2/3,210281,2
5,4,21,282,1,964,1,11,5,5,6,single-choice,spatial-relational,5|6,7,5/6,210282,5
5,4,21,283,1,1329,1,9,4,4,5,single-choice,spatial-relational,4|5,7,4/5,210283,4
5,4,21,284,1,2178,1,3,1,1,2,single-choice,spatial-relational,1|2,7,1/2,210284,1
5,4,21,285,1,1128,1,11,5,5,6,single-choice,spatial-relational,5|6,7,5/6,210285,5
5,4,21,286,0,858,1,9,4,5,5,single-choice,spatial-relational,4|5,7,4/5,210286,4
5,4,21,287,1,549,1,3,1,1,2,single-choice,spatial-relational,1|2,7,1/2,210287,1
5,4,21,288,1,1004,1,7,3,3,4,single-choice,spatial-relational,3|4,7,3/4,210288,3
5,4,21,289,1,1163,1,3,1,1,2,single-choice,spatial-relational,1|2,7,1/2,210289,1
5,4,21,290,1,1067,1,5,2,2,3,single-choice,spatial-relational,2|3,7,2/3,210290,2
5,4,21,291,1,120,1,13,6,6,7,single-choice,spatial-relational,6|7,7,6/7,210291,6
5,4,21,292,1,1183,1,9,4,4,5,single-choice,spatial-relational,4|5,7,4/5,210292,4
5,4,21,293,1,873,1,9,4,4,5,single-choice,spatial-relational,4|5,7,4/5,210293,4
5,4,21,294,1,1545,1,3,1,1,2,single-choice,spatial-relational,1|2,7,1/2,210294,1
5,4,21,295,1,978,1,5,2,2,3,single-choice,spatial-relational,2|3,7,2/3,210295,2
5,4,21,296,0,1507,1,7,3,4,4,single-choice,spatial-relational,3|4,7,3/4,210296,3
5,4,21,297,0,93,1,11,5,6,6,single-choice,spatial-relational,5|6,7,5/6,210297,5
5,4,21,298,1,1887,1,11,5,5,6,single-choice,spatial-relational,5|6,7,5/6,210298,5
5,4,21,299,1,1383,1,7,3,3,4,single-choice,spatial-relational,3|4,7,3/4,210299,3
5,4,21,300,0,591,1,13,6,7,7,single-choice,spatial-relational,6|7,7,6/7,210300,6
5,4,21,301,1,74,1,9,4,4,5,single-choice,spatial-relational,4|5,7,4/5,210301,4
5,4,21,302,1,861,1,7,3,3,4,single-choice,spatial-relational,3|4,7,3/4,210302,3
5,4,21,303,1,913,1,13,6,6,7,single-choice,spatial-relational,6|7,7,6/7,210303,6
5,4,21,304,1,2179,1,7,3,3,4,single-choice,spatial-relational,3|4,7,3/4,210304,3
5,4,21,305,1,86,1,3,1,1,2,single-choice,spatial-relational,1|2,7,1/2,210305,1
5,4,21,306,1,1042,1,11,5,5,6,single-choice,spatial-relational,5|6,7,5/6,210306,5
5,4,21,307,1,1241,1,5,2,2,3,single-choice,spatial-relational,2|3,7,2/3,210307,2
5,4,21,308,1,1348,1,5,2,2,3,single-choice,spatial-relational,2|3,7,2/3,210308,2
5,4,21,309,1,98,1,11,5,5,6,single-choice,spatial-relational,5|6,7,5/6,210309,5
5,4,21,310,1,1050,1,13,6,6,7,single-choice,spatial-relational,6|7,7,6/7,210310,6
5,4,21,311,1,1903,1,3,1,1,2,single-choice,spatial-relational,1|2,7,1/2,210311,1
5,4,21,312,1,953,1,9,4,4,5,single-choice,spatial-relational,4|5,7,4/5,210312,4
5,4,21,313,1,124,1,13,6,6,7,single-choice,spatial-relational,6|7,7,6/7,210313,6
5,4,21,314,1,1155,1,7,3,3,4,single-choice,spatial-relational,3|4,7,3/4,210314,3
5,4,21,315,1,983,1,13,6,6,7,single-choice,spatial-relational,6|7,7,6/7,210315,6
5,4,21,316,1,1682,1,9,4,4,5,single-choice,spatial-relational,4|5,7,4/5,210316,4
5,4,21,317,1,1143,1,5,2,2,3,single-choice,spatial-relational,2|3,7,2/3,210317,2
5,4,21,318,1,892,1,5,2,2,3,single-choice,spatial-relational,2|3,7,2/3,210318,2
5,4,21,319,0,692,1,3,1,2,2,single-choice,spatial-relational,1|2,7,1/2,210319,1
5,4,21,320,0,1450,1,7,3,4,4,single-choice,spatial-relational,3|4,7,3/4,210320,3
5,4,21,321,1,1344,1,3,1,1,2,single-choice,spatial-relational,1|2,7,1/2,210321,1
5,4,21,322,1,886,1,9,4,4,5,single-choice,spatial-relational,4|5,7,4/5,210322,4
5,4,21,323,1,1028,1,11,5,5,6,single-choice,spatial-relational,5|6,7,5/6,210323,5
5,4,21,324,1,1366,1,11,5,5,6,single-choice,spatial-relational,5|6,7,5/6,210324,5
5,4,21,325,1,1413,1,11,5,5,6,single-choice,spatial-relational,5|6,7,5/6,210325,5
5,4,21,326,1,1728,1,13,6,6,7,single-choice,spatial-relational,6|7,7,6/7,210326,6
5,4,21,327,1,2001,1,5,2,2,3,single-choice,spatial-relational,2|3,7,2/3,210327,2
5,4,21,328,1,817,1,11,5,5,6,single-choice,spatial-relational,5|6,7,5/6,210328,5
5,4,21,329,1,1346,1,9,4,4,5,single-choice,spatial-relational,4|5,7,4/5,210329,4
5,4,21,330,0,1191,1,5,2,3,3,single-choice,spatial-relational,2|3,7,2/3,210330,2
5,4,21,331,1,883,1,9,4,4,5,single-choice,spatial-relational,4|5,7,4/5,210331,4
5,4,21,332,0,886,1,3,1,2,2,single-choice,spatial-relational,1|2,7,1/2,210332,1
5,4,21,333,1,857,1,3,1,1,2,single-choice,spatial-relational,1|2,7,1/2,210333,1
5,4,21,334,1,112,1,7,3,3,4,single-choice,spatial-relational,3|4,7,3/4,210334,3
5,4,21,335,1,995,1,13,6,6,7,single-choice,spatial-relational,6|7,7,6/7,210335,6
5,4,21,336,0,1738,1,7,3,4,4,single-choice,spatial-relational,3|4,7,3/4,210336,3
5,4,21,337,0,125,1,3,1,2,2,single-choice,spatial-relational,1|2,7,1/2,210337,1
5,4,21,338,0,64,1,7,3,4,4,single-choice,spatial-relational,3|4,7,3/4,210338,3
5,4,21,339,1,45,1,9,4,4,5,single-choice,spatial-relational,4|5,7,4/5,210339,4
5,4,21,340,0,1414,1,5,2,3,3,single-choice,spatial-relational,2|3,7,2/3,210340,2
5,4,21,341,1,126,1,7,3,3,4,single-choice,spatial-relational,3|4,7,3/4,210341,3
5,4,21,342,1,1169,1,11,5,5,6,single-choice,spatial-relational,5|6,7,5/6,210342,5
5,4,21,343,1,512,1,13,6,6,7,single-choice,spatial-relational,6|7,7,6/7,210343,6
5,4,21,344,1,953,1,13,6,6,7,single-choice,spatial-relational,6|7,7,6/7,210344,6
5,4,21,345,1,1143,1,11,5,5,6,single-choice,spatial-relational,5|6,7,5/6,210345,5
5,4,21,346,1,1637,1,3,1,1,2,single-choice,spatial-relational,1|2,7,1/2,210346,1
5,4,21,347,1,968,1,9,4,4,5,single-choice,spatial-relational,4|5,7,4/5,210347,4
5,4,21,348,1,1427,1,5,2,2,3,single-choice,spatial-relational,2|3,7,2/3,210348,2
5,4,21,349,1,966,1,5,2,2,3,single-choice,spatial-relational,2|3,7,2/3,210349,2
5,4,21,350,1,1218,1,9,4,4,5,single-choice,spatial-relational,4|5,7,4/5,210350,4
5,4,21,351,1,130,1,9,4,4,5,single-choice,spatial-relational,4|5,7,4/5,210351,4
5,4,21,352,1,1500,1,7,3,3,4,single-choice,spatial-relational,3|4,7,3/4,210352,3
5,4,21,353,0,83,1,3,1,2,2,single-choice,spatial-relational,1|2,7,1/2,210353,1
5,4,21,354,1,772,1,13,6,6,7,single-choice,spatial-relational,6|7,7,6/7,210354,6
5,4,21,355,1,887,1,13,6,6,7,single-choice,spatial-relational,6|7,7,6/7,210355,6
5,4,21,356,1,1365,1,5,2,2,3,single-choice,spatial-relational,2|3,7,2/3,210356,2
5,4,21,357,1,959,1,11,5,5,6,single-choice,spatial-relational,5|6,7,5/6,210357,5
5,4,21,358,1,112,1,11,5,5,6,single-choice,spatial-relational,5|6,7,5/6,210358,5
5,4,21,359,1,86,1,3,1,1,2,single-choice,spatial-relational,1|2,7,1/2,210359,1
5,4,21,360,1,828,1,7,3,3,4,single-choice,spatial-relational,3|4,7,3/4,210360,3
5,4,21,361,1,1298,1,11,5,5,6,single-choice,spatial-relational,5|6,7,5/6,210361,5
5,4,21,362,1,1010,1,5,2,2,3,single-choice,spatial-relational,2|3,7,2/3,210362,2
5,4,21,363,0,96,1,5,2,3,3,single-choice,spatial-relational,2|3,7,2/3,210363,2
5,4,21,364,1,782,1,13,6,6,7,single-choice,spatial-relational,6|7,7,6/7,210364,6
5,4,21,365,1,4,1,13,6,6,7,single-choice,spatial-relational,6|7,7,6/7,210365,6
5,4,21,366,1,1394,1,3,1,1,2,single-choice,spatial-relational,1|2,7,1/2,210366,1
5,4,21,367,1,931,1,11,5,5,6,single-choice,spatial-relational,5|6,7,5/6,210367,5
5,4,21,368,1,1026,1,9,4,4,5,single-choice,spatial-relational,4|5,7,4/5,210368,4
5,4,21,369,0,2037,1,3,1,2,2,single-choice,spatial-relational,1|2,7,1/2,210369,1
5,4,21,370,0,142,1,7,3,4,4,single-choice,spatial-relational,3|4,7,3/4,210370,3
5,4,21,371,1,904,1,7,3,3,4,single-choice,spatial-relational,3|4,7,3/4,210371,3
5,4,21,372,1,67,1,9,4,4,5,single-choice,spatial-relational,4|5,7,4/5,210372,4
5,4,21,373,1,1069,1,3,1,1,2,single-choice,spatial-relational,1|2,7,1/2,210373,1
5,4,21,374,0,683,1,3,1,2,2,single-choice,spatial-relational,1|2,7,1/2,210374,1
5,4,21,375,1,7,1,7,3,3,4,single-choice,spatial-relational,3|4,7,3/4,210375,3
5,4,21,376,1,980,1,5,2,2,3,single-choice,spatial-relational,2|3,7,2/3,210376,2
5,4,21,377,1,93,1,9,4,4,5,single-choice,spatial-relational,4|5,7,4/5,210377,4
5,4,21,378,1,784,1,13,6,6,7,single-choice,spatial-relational,6|7,7,6/7,210378,6
5,4,21,379,0,64,1,11,5,6,6,single-choice,spatial-relational,5|6,7,5/6,210379,5
5,4,21,380,1,158,1,5,2,2,3,single-choice,spatial-relational,2|3,7,2/3,210380,2
5,4,21,381,1,1097,1,11,5,5,6,single-choice,spatial-relational,5|6,7,5/6,210381,5
5,4,21,382,0,91,1,9,4,5,5,single-choice,spatial-relational,4|5,7,4/5,210382,4
5,4,21,383,1,842,1,7,3,3,4,single-choice,spatial-relational,3|4,7,3/4,210383,3
5,4,21,384,0,80,1,13,6,7,7,single-choice,spatial-relational,6|7,7,6/7,210384,6
5,4,21,385,0,845,1,3,1,2,2,single-choice,spatial-relational,1|2,7,1/2,210385,1
5,4,21,386,0,250,1,7,3,4,4,single-choice,spatial-relational,3|4,7,3/4,210386,3
5,4,21,387,0,9,1,5,2,3,3,single-choice,spatial-relational,2|3,7,2/3,210387,2
5,4,21,388,1,74,1,9,4,4,5,single-choice,spatial-relational,4|5,7,4/5,210388,4
5,4,21,389,1,982,1,5,2,2,3,single-choice,spatial-relational,2|3,7,2/3,210389,2
5,4,21,390,1,925,1,7,3,3,4,single-choice,spatial-relational,3|4,7,3/4,210390,3
5,4,21,391,1,1120,1,11,5,5,6,single-choice,spatial-relational,5|6,7,5/6,210391,5
5,4,21,392,1,1043,1,13,6,6,7,single-choice,spatial-relational,6|7,7,6/7,210392,6
5,4,21,393,1,1122,1,9,4,4,5,single-choice,spatial-relational,4|5,7,4/5,210393,4
5,4,21,394,1,1218,1,11,5,5,6,single-choice,spatial-relational,5|6,7,5/6,210394,5
5,4,21,395,1,147,1,3,1,1,2,single-choice,spatial-relational,1|2,7,1/2,210395,1
5,4,21,396,1,95,1,13,6,6,7,single-choice,spatial-relational,6|7,7,6/7,210396,6
5,4,21,397,1,1980,1,3,1,1,2,single-choice,spatial-relational,1|2,7,1/2,210397,1
5,4,21,398,1,778,1,9,4,4,5,single-choice,spatial-relational,4|5,7,4/5,210398,4
5,4,21,399,0,922,1,3,1,2,2,single-choice,spatial-relational,1|2,7,1/2,210399,1
5,4,21,400,0,94,1,5,2,3,3,single-choice,spatial-relational,2|3,7,2/3,210400,2
5,4,21,401,1,1415,1,9,4,4,5,single-choice,spatial-relational,4|5,7,4/5,210401,4
5,4,21,402,1,903,1,13,6,6,7,single-choice,spatial-relational,6|7,7,6/7,210402,6
5,4,21,403,0,42,1,11,5,6,6,single-choice,spatial-relational,5|6,7,5/6,210403,5
5,4,21,404,1,116,1,7,3,3,4,single-choice,spatial-relational,3|4,7,3/4,210404,3
5,4,21,405,1,823,1,13,6,6,7,single-choice,spatial-relational,6|7,7,6/7,210405,6
5,4,21,406,1,718,1,11,5,5,6,single-choice,spatial-relational,5|6,7,5/6,210406,5
5,4,21,407,0,73,1,7,3,4,4,single-choice,spatial-relational,3|4,7,3/4,210407,3
5,4,21,408,0,1346,1,5,2,3,3,single-choice,spatial-relational,2|3,7,2/3,210408,2
5,4,21,409,0,706,1,3,1,2,2,single-choice,spatial-relational,1|2,7,1/2,210409,1
5,4,21,410,0,1447,1,5,2,3,3,single-choice,spatial-relational,2|3,7,2/3,210410,2
5,4,21,411,1,1078,1,11,5,5,6,single-choice,spatial-relational,5|6,7,5/6,210411,5
5,4,21,412,1,959,1,13,6,6,7,single-choice,spatial-relational,6|7,7,6/7,210412,6
5,4,21,413,1,81,1,7,3,3,4,single-choice,spatial-relational,3|4,7,3/4,210413,3
5,4,21,414,1,1042,1,7,3,3,4,single-choice,spatial-relational,3|4,7,3/4,210414,3
5,4,21,415,1,1367,1,9,4,4,5,single-choice,spatial-relational,4|5,7,4/5,210415,4
5,4,21,416,1,981,1,9,4,4,5,single-choice,spatial-relational,4|5,7,4/5,210416,4
5,4,21,417,1,1086,1,13,6,6,7,single-choice,spatial-relational,6|7,7,6/7,210417,6
5,4,21,418,1,1135,1,5,2,2,3,single-choice,spatial-relational,2|3,7,2/3,210418,2
5,4,21,419,1,1064,1,11,5,5,6,single-choice,spatial-relational,5|6,7,5/6,210419,5
5,4,21,420,1,54,1,3,1,1,2,single-choice,spatial-relational,1|2,7,1/2,210420,1
5,4,21,421,1,2129,1,13,6,6,7,single-choice,spatial-relational,6|7,7,6/7,210421,6
5,4,21,422,1,1159,1,7,3,3,4,single-choice,spatial-relational,3|4,7,3/4,210422,3
5,4,21,423,1,1181,1,5,2,2,3,single-choice,spatial-relational,2|3,7,2/3,210423,2
5,4,21,424,1,967,1,11,5,5,6,single-choice,spatial-relational,5|6,7,5/6,210424,5
5,4,21,425,1,1130,1,9,4,4,5,single-choice,spatial-relational,4|5,7,4/5,210425,4
5,4,21,426,0,1138,1,3,1,2,2,single-choice,spatial-relational,1|2,7,1/2,210426,1
5,4,21,427,0,33,1,3,1,2,2,single-choice,spatial-relational,1|2,7,1/2,210427,1
5,4,21,428,0,165,1,13,6,7,7,single-choice,spatial-relational,6|7,7,6/7,210428,6
5,4,21,429,0,39,1,11,5,6,6,single-choice,spatial-relational,5|6,7,5/6,210429,5
5,4,21,430,0,7,1,5,2,3,3,single-choice,spatial-relational,2|3,7,2/3,210430,2
5,4,21,431,0,1144,1,7,3,4,4,single-choice,spatial-relational,3|4,7,3/4,210431,3
5,4,21,432,0,8,1,9,4,5,5,single-choice,spatial-relational,4|5,7,4/5,210432,4
5,4,21,433,1,857,1,3,1,1,2,single-choice,spatial-relational,1|2,7,1/2,210433,1
5,4,21,434,1,91,1,11,5,5,6,single-choice,spatial-relational,5|6,7,5/6,210434,5
5,4,21,435,0,723,1,3,1,2,2,single-choice,spatial-relational,1|2,7,1/2,210435,1
5,4,21,436,1,79,1,13,6,6,7,single-choice,spatial-relational,6|7,7,6/7,210436,6
5,4,21,437,1,1039,1,11,5,5,6,single-choice,spatial-relational,5|6,7,5/6,210437,5
5,4,21,438,1,1064,1,5,2,2,3,single-choice,spatial-relational,2|3,7,2/3,210438,2
5,4,21,439,1,991,1,9,4,4,5,single-choice,spatial-relational,4|5,7,4/5,210439,4
5,4,21,440,1,1927,1,7,3,3,4,single-choice,spatial-relational,3|4,7,3/4,210440,3
5,4,21,441,1,824,1,13,6,6,7,single-choice,spatial-relational,6|7,7,6/7,210441,6
5,4,21,442,1,151,1,5,2,2,3,single-choice,spatial-relational,2|3,7,2/3,210442,2
5,4,21,443,1,93,1,7,3,3,4,single-choice,spatial-relational,3|4,7,3/4,210443,3
5,4,21,444,1,356,1,9,4,4,5,single-choice,spatial-relational,4|5,7,4/5,210444,4
5,4,21,445,0,61,1,7,3,4,4,single-choice,spatial-relational,3|4,7,3/4,210445,3
5,4,21,446,1,164,1,13,6,6,7,single-choice,spatial-relational,6|7,7,6/7,210446,6
5,4,21,447,1,96,1,7,3,3,4,single-choice,spatial-relational,3|4,7,3/4,210447,3
5,4,21,448,1,74,1,5,2,2,3,single-choice,spatial-relational,2|3,7,2/3,210448,2
5,4,21,449,0,168,1,5,2,3,3,single-choice,spatial-relational,2|3,7,2/3,210449,2
5,4,21,450,0,835,1,3,1,2,2,single-choice,spatial-relational,1|2,7,1/2,210450,1
5,4,21,451,0,194,1,9,4,5,5,single-choice,spatial-relational,4|5,7,4/5,210451,4
5,4,21,452,0,117,1,11,5,6,6,single-choice,spatial-relational,5|6,7,5/6,210452,5
5,4,21,453,1,92,1,11,5,5,6,single-choice,spatial-relational,5|6,7,5/6,210453,5
5,4,21,454,1,1001,1,3,1,1,2,single-choice,spatial-relational,1|2,7,1/2,210454,1
5,4,21,455,1,783,1,13,6,6,7,single-choice,spatial-relational,6|7,7,6/7,210455,6
5,4,21,456,1,1637,1,9,4,4,5,single-choice,spatial-relational,4|5,7,4/5,210456,4
5,4,21,457,0,64,1,3,1,2,2,single-choice,spatial-relational,1|2,7,1/2,210457,1
5,4,21,458,0,105,1,9,4,5,5,single-choice,spatial-relational,4|5,7,4/5,210458,4
5,4,21,459,0,182,1,11,5,6,6,single-choice,spatial-relational,5|6,7,5/6,210459,5
5,4,21,460,1,684,1,7,3,3,4,single-choice,spatial-relational,3|4,7,3/4,210460,3
5,4,21,461,1,65,1,11,5,5,6,single-choice,spatial-relational,5|6,7,5/6,210461,5
5,4,21,462,1,72,1,13,6,6,7,single-choice,spatial-relational,6|7,7,6/7,210462,6
5,4,21,463,0,384,1,7,3,4,4,single-choice,spatial-relational,3|4,7,3/4,210463,3
5,4,21,464,0,64,1,13,6,7,7,single-choice,spatial-relational,6|7,7,6/7,210464,6
5,4,21,465,1,165,1,9,4,4,5,single-choice,spatial-relational,4|5,7,4/5,210465,4
5,4,21,466,0,72,1,5,2,3,3,single-choice,spatial-relational,2|3,7,2/3,210466,2
5,4,21,467,1,93,1,3,1,1,2,single-choice,spatial-relational,1|2,7,1/2,210467,1
5,4,21,468,1,946,1,5,2,2,3,single-choice,spatial-relational,2|3,7,2/3,210468,2
5,4,21,469,0,113,1,7,3,4,4,single-choice,spatial-relational,3|4,7,3/4,210469,3
5,4,21,470,1,1085,1,13,6,6,7,single-choice,spatial-relational,6|7,7,6/7,210470,6
5,4,21,471,1,818,1,13,6,6,7,single-choice,spatial-relational,6|7,7,6/7,210471,6
5,4,21,472,0,83,1,9,4,5,5,single-choice,spatial-relational,4|5,7,4/5,210472,4
5,4,21,473,1,819,1,5,2,2,3,single-choice,spatial-relational,2|3,7,2/3,210473,2
5,4,21,474,1,1001,1,3,1,1,2,single-choice,spatial-relational,1|2,7,1/2,210474,1
5,4,21,475,1,74,1,11,5,5,6,single-choice,spatial-relational,5|6,7,5/6,210475,5
5,4,21,476,1,1182,1,5,2,2,3,single-choice,spatial-relational,2|3,7,2/3,210476,2
5,4,21,477,0,77,1,11,5,6,6,single-choice,spatial-relational,5|6,7,5/6,210477,5
5,4,21,478,1,1022,1,3,1,1,2,single-choice,spatial-relational,1|2,7,1/2,210478,1
5,4,21,479,1,82,1,7,3,3,4,single-choice,spatial-relational,3|4,7,3/4,210479,3
5,4,21,480,0,757,1,9,4,5,5,single-choice,spatial-relational,4|5,7,4/5,210480,4
5,4,21,481,1,111,1,3,1,1,2,single-choice,spatial-relational,1|2,7,1/2,210481,1
5,4,21,482,1,100,1,11,5,5,6,single-choice,spatial-relational,5|6,7,5/6,210482,5
5,4,21,483,1,96,1,9,4,4,5,single-choice,spatial-relational,4|5,7,4/5,210483,4
5,4,21,484,0,103,1,9,4,5,5,single-choice,spatial-relational,4|5,7,4/5,210484,4
5,4,21,485,0,70,1,3,1,2,2,single-choice,spatial-relational,1|2,7,1/2,210485,1
5,4,21,486,0,105,1,13,6,7,7,single-choice,spatial-relational,6|7,7,6/7,210486,6
5,4,21,487,0,145,1,5,2,3,3,single-choice,spatial-relational,2|3,7,2/3,210487,2
5,4,21,488,1,94,1,13,6,6,7,single-choice,spatial-relational,6|7,7,6/7,210488,6
5,4,21,489,0,1215,1,7,3,4,4,single-choice,spatial-relational,3|4,7,3/4,210489,3
5,4,21,490,0,92,1,11,5,6,6,single-choice,spatial-relational,5|6,7,5/6,210490,5
5,4,21,491,1,91,1,5,2,2,3,single-choice,spatial-relational,2|3,7,2/3,210491,2
5,4,21,492,1,6,1,7,3,3,4,single-choice,spatial-relational,3|4,7,3/4,210492,3
5,4,21,493,1,1533,1,9,4,4,5,single-choice,spatial-relational,4|5,7,4/5,210493,4
5,4,21,494,1,75,1,3,1,1,2,single-choice,spatial-relational,1|2,7,1/2,210494,1
5,4,21,495,1,834,1,11,5,5,6,single-choice,spatial-relational,5|6,7,5/6,210495,5
5,4,21,496,1,134,1,7,3,3,4,single-choice,spatial-relational,3|4,7,3/4,210496,3
5,4,21,497,0,67,1,11,5,6,6,single-choice,spatial-relational,5|6,7,5/6,210497,5
5,4,21,498,0,113,1,13,6,7,7,single-choice,spatial-relational,6|7,7,6/7,210498,6
5,4,21,499,0,122,1,3,1,2,2,single-choice,spatial-relational,1|2,7,1/2,210499,1
5,4,21,500,1,140,1,5,2,2,3,single-choice,spatial-relational,2|3,7,2/3,210500,2
5,4,21,501,0,98,1,9,4,5,5,single-choice,spatial-relational,4|5,7,4/5,210501,4
5,4,21,502,0,57,1,7,3,4,4,single-choice,spatial-relational,3|4,7,3/4,210502,3
5,4,21,503,1,4,1,5,2,2,3,single-choice,spatial-relational,2|3,7,2/3,210503,2
5,4,21,504,1,166,1,13,6,6,7,single-choice,spatial-relational,6|7,7,6/7,210504,6
5,4,21,505,1,149,1,7,3,3,4,single-choice,spatial-relational,3|4,7,3/4,210505,3
5,4,21,506,1,104,1,11,5,5,6,single-choice,spatial-relational,5|6,7,5/6,210506,5
5,4,21,507,0,68,1,5,2,3,3,single-choice,spatial-relational,2|3,7,2/3,210507,2
5,4,21,508,1,1531,1,9,4,4,5,single-choice,spatial-relational,4|5,7,4/5,210508,4
5,4,21,509,1,1356,1,13,6,6,7,single-choice,spatial-relational,6|7,7,6/7,210509,6
5,4,21,510,0,186,1,7,3,4,4,single-choice,spatial-relational,3|4,7,3/4,210510,3
5,4,21,511,0,67,1,13,6,7,7,single-choice,spatial-relational,6|7,7,6/7,210511,6
5,4,21,512,0,114,1,9,4,5,5,single-choice,spatial-relational,4|5,7,4/5,210512,4
5,4,21,513,0,67,1,11,5,6,6,single-choice,spatial-relational,5|6,7,5/6,210513,5
5,4,21,514,0,233,1,3,1,2,2,single-choice,spatial-relational,1|2,7,1/2,210514,1
5,4,21,515,1,310,1,5,2,2,3,single-choice,spatial-relational,2|3,7,2/3,210515,2
5,4,21,516,1,466,1,3,1,1,2,single-choice,spatial-relational,1|2,7,1/2,210516,1
5,4,21,517,1,251,1,11,5,5,6,single-choice,spatial-relational,5|6,7,5/6,210517,5
5,4,21,518,1,402,1,13,6,6,7,single-choice,spatial-relational,6|7,7,6/7,210518,6
5,4,21,519,1,97,1,9,4,4,5,single-choice,spatial-relational,4|5,7,4/5,210519,4
5,4,21,520,0,159,1,3,1,2,2,single-choice,spatial-relational,1|2,7,1/2,210520,1
5,4,21,521,1,191,1,7,3,3,4,single-choice,spatial-relational,3|4,7,3/4,210521,3
5,4,21,522,0,142,1,13,6,7,7,single-choice,spatial-relational,6|7,7,6/7,210522,6
5,4,21,523,0,74,1,7,3,4,4,single-choice,spatial-relational,3|4,7,3/4,210523,3
5,4,21,524,0,321,1,11,5,6,6,single-choice,spatial-relational,5|6,7,5/6,210524,5
5,4,21,525,1,141,1,5,2,2,3,single-choice,spatial-relational,2|3,7,2/3,210525,2
5,4,21,526,0,1286,1,5,2,3,3,single-choice,spatial-relational,2|3,7,2/3,210526,2
5,4,21,527,1,371,1,3,1,1,2,single-choice,spatial-relational,1|2,7,1/2,210527,1
5,4,21,528,0,188,1,9,4,5,5,single-choice,spatial-relational,4|5,7,4/5,210528,4
5,4,21,529,1,171,1,13,6,6,7,single-choice,spatial-relational,6|7,7,6/7,210529,6
5,4,21,530,0,119,1,13,6,7,7,single-choice,spatial-relational,6|7,7,6/7,210530,6
5,4,21,531,1,229,1,3,1,1,2,single-choice,spatial-relational,1|2,7,1/2,210531,1
5,4,21,532,0,284,1,3,1,2,2,single-choice,spatial-relational,1|2,7,1/2,210532,1
5,4,21,533,0,119,1,9,4,5,5,single-choice,spatial-relational,4|5,7,4/5,210533,4
5,4,21,534,1,104,1,7,3,3,4,single-choice,spatial-relational,3|4,7,3/4,210534,3
5,4,21,535,0,91,1,7,3,4,4,single-choice,spatial-relational,3|4,7,3/4,210535,3
5,4,21,536,0,119,1,5,2,3,3,single-choice,spatial-relational,2|3,7,2/3,210536,2
5,4,21,537,0,104,1,11,5,6,6,single-choice,spatial-relational,5|6,7,5/6,210537,5
5,4,21,538,1,169,1,5,2,2,3,single-choice,spatial-relational,2|3,7,2/3,210538,2
5,4,21,539,1,99,1,11,5,5,6,single-choice,spatial-relational,5|6,7,5/6,210539,5
5,4,21,540,1,127,1,9,4,4,5,single-choice,spatial-relational,4|5,7,4/5,210540,4
5,4,21,541,0,174,1,13,6,7,7,single-choice,spatial-relational,6|7,7,6/7,210541,6
5,4,21,542,1,100,1,11,5,5,6,single-choice,spatial-relational,5|6,7,5/6,210542,5
5,4,21,543,1,128,1,3,1,1,2,single-choice,spatial-relational,1|2,7,1/2,210543,1
5,4,21,544,1,133,1,9,4,4,5,single-choice,spatial-relational,4|5,7,4/5,210544,4
5,4,21,545,0,126,1,7,3,4,4,single-choice,spatial-relational,3|4,7,3/4,210545,3
5,4,21,546,0,114,1,5,2,3,3,single-choice,spatial-relational,2|3,7,2/3,210546,2
5,4,21,547,0,118,1,3,1,2,2,single-choice,spatial-relational,1|2,7,1/2,210547,1
5,4,21,548,1,346,1,7,3,3,4,single-choice,spatial-relational,3|4,7,3/4,210548,3
5,4,21,549,1,1265,1,5,2,2,3,single-choice,spatial-relational,2|3,7,2/3,210549,2
5,4,21,550,0,165,1,11,5,6,6,single-choice,spatial-relational,5|6,7,5/6,210550,5
5,4,21,551,0,83,1,9,4,5,5,single-choice,spatial-relational,4|5,7,4/5,210551,4
5,4,21,552,1,2030,1,13,6,6,7,single-choice,spatial-relational,6|7,7,6/7,210552,6
5,4,21,553,0,87,1,11,5,6,6,single-choice,spatial-relational,5|6,7,5/6,210553,5
5,4,21,554,1,103,1,13,6,6,7,single-choice,spatial-relational,6|7,7,6/7,210554,6
5,4,21,555,1,1806,1,9,4,4,5,single-choice,spatial-relational,4|5,7,4/5,210555,4
5,4,21,556,0,1439,1,7,3,4,4,single-choice,spatial-relational,3|4,7,3/4,210556,3
5,4,21,557,1,97,1,11,5,5,6,single-choice,spatial-relational,5|6,7,5/6,210557,5
5,4,21,558,0,162,1,3,1,2,2,single-choice,spatial-relational,1|2,7,1/2,210558,1
5,4,21,559,0,78,1,5,2,3,3,single-choice,spatial-relational,2|3,7,2/3,210559,2
5,4,21,560,1,161,1,3,1,1,2,single-choice,spatial-relational,1|2,7,1/2,210560,1
5,4,21,561,1,77,1,9,4,4,5,single-choice,spatial-relational,4|5,7,4/5,210561,4
5,4,21,562,1,167,1,5,2,2,3,single-choice,spatial-relational,2|3,7,2/3,210562,2
5,4,21,563,1,168,1,7,3,3,4,single-choice,spatial-relational,3|4,7,3/4,210563,3
5,4,21,564,0,146,1,13,6,7,7,single-choice,spatial-relational,6|7,7,6/7,210564,6
5,4,21,565,1,90,1,9,4,4,5,single-choice,spatial-relational,4|5,7,4/5,210565,4
5,4,21,566,0,87,1,7,3,4,4,single-choice,spatial-relational,3|4,7,3/4,210566,3
5,4,21,567,0,763,1,3,1,2,2,single-choice,spatial-relational,1|2,7,1/2,210567,1
5,4,21,568,1,110,1,13,6,6,7,single-choice,spatial-relational,6|7,7,6/7,210568,6
5,4,21,569,1,97,1,5,2,2,3,single-choice,spatial-relational,2|3,7,2/3,210569,2
5,4,21,570,1,96,1,7,3,3,4,single-choice,spatial-relational,3|4,7,3/4,210570,3
5,4,21,571,0,127,1,5,2,3,3,single-choice,spatial-relational,2|3,7,2/3,210571,2
5,4,21,572,1,1439,1,13,6,6,7,single-choice,spatial-relational,6|7,7,6/7,210572,6
5,4,21,573,1,926,1,3,1,1,2,single-choice,spatial-relational,1|2,7,1/2,210573,1
5,4,21,574,0,421,1,11,5,6,6,single-choice,spatial-relational,5|6,7,5/6,210574,5
5,4,21,575,1,1182,1,9,4,4,5,single-choice,spatial-relational,4|5,7,4/5,210575,4
5,4,21,576,1,102,1,11,5,5,6,single-choice,spatial-relational,5|6,7,5/6,210576,5
5,4,21,577,1,130,1,13,6,6,7,single-choice,spatial-relational,6|7,7,6/7,210577,6
5,4,21,578,0,102,1,3,1,2,2,single-choice,spatial-relational,1|2,7,1/2,210578,1
5,4,21,579,1,126,1,3,1,1,2,single-choice,spatial-relational,1|2,7,1/2,210579,1
5,4,21,580,0,152,1,11,5,6,6,single-choice,spatial-relational,5|6,7,5/6,210580,5
5,4,21,581,1,1114,1,9,4,4,5,single-choice,spatial-relational,4|5,7,4/5,210581,4
5,4,21,582,0,83,1,5,2,3,3,single-choice,spatial-relational,2|3,7,2/3,210582,2
5,4,21,583,0,80,1,7,3,4,4,single-choice,spatial-relational,3|4,7,3/4,210583,3
5,4,21,584,0,113,1,13,6,7,7,single-choice,spatial-relational,6|7,7,6/7,210584,6
5,4,21,585,1,150,1,5,2,2,3,single-choice,spatial-relational,2|3,7,2/3,210585,2
5,4,21,586,1,111,1,9,4,4,5,single-choice,spatial-relational,4|5,7,4/5,210586,4
5,4,21,587,1,1285,1,11,5,5,6,single-choice,spatial-relational,5|6,7,5/6,210587,5
5,4,21,588,1,162,1,7,3,3,4,single-choice,spatial-relational,3|4,7,3/4,210588,3
5,4,21,589,1,127,1,5,2,2,3,single-choice,spatial-relational,2|3,7,2/3,210589,2
5,4,21,590,1,1489,1,5,2,2,3,single-choice,spatial-relational,2|3,7,2/3,210590,2
5,4,21,591,1,128,1,9,4,4,5,single-choice,spatial-relational,4|5,7,4/5,210591,4
5,4,21,592,1,981,1,9,4,4,5,single-choice,spatial-relational,4|5,7,4/5,210592,4
5,4,21,593,1,1364,1,3,1,1,2,single-choice,spatial-relational,1|2,7,1/2,210593,1
5,4,21,594,1,966,1,7,3,3,4,single-choice,spatial-relational,3|4,7,3/4,210594,3
5,4,21,595,1,808,1,13,6,6,7,single-choice,spatial-relational,6|7,7,6/7,210595,6
5,4,21,596,1,74,1,13,6,6,7,single-choice,spatial-relational,6|7,7,6/7,210596,6
5,4,21,597,1,644,1,11,5,5,6,single-choice,spatial-relational,5|6,7,5/6,210597,5
5,4,21,598,0,1283,1,7,3,4,4,single-choice,spatial-relational,3|4,7,3/4,210598,3
5,4,21,599,0,127,1,11,5,6,6,single-choice,spatial-relational,5|6,7,5/6,210599,5
5,4,21,600,1,1243,1,3,1,1,2,single-choice,spatial-relational,1|2,7,1/2,210600,1
6,4,21,1,1,586,1,3,1,1,2,single-choice,spatial-relational,1|2,7,1/2,210001,1
6,4,21,2,0,682,1,7,3,4,4,single-choice,spatial-relational,3|4,7,3/4,210002,3
6,4,21,3,1,1152,1,13,6,6,7,single-choice,spatial-relational,6|7,7,6/7,210003,6
6,4,21,4,0,817,1,5,2,3,3,single-choice,spatial-relational,2|3,7,2/3,210004,2
6,4,21,5,1,791,1,11,5,5,6,single-choice,spatial-relational,5|6,7,5/6,210005,5
6,4,21,6,1,1564,1,9,4,4,5,single-choice,spatial-relational,4|5,7,4/5,210006,4
6,4,21,7,1,940,1,7,3,3,4,single-choice,spatial-relational,3|4,7,3/4,210007,3
6,4,21,8,0,1279,1,5,2,3,3,single-choice,spatial-relational,2|3,7,2/3,210008,2
6,4,21,9,0,631,1,3,1,2,2,single-choice,spatial-relational,1|2,7,1/2,210009,1
6,4,21,10,0,692,1,13,6,7,7,single-choice,spatial-relational,6|7,7,6/7,210010,6
6,4,21,11,1,1192,1,9,4,4,5,single-choice,spatial-relational,4|5,7,4/5,210011,4
6,4,21,12,1,1884,1,11,5,5,6,single-choice,spatial-relational,5|6,7,5/6,210012,5
6,4,21,13,1,848,1,9,4,4,5,single-choice,spatial-relational,4|5,7,4/5,210013,4
6,4,21,14,1,1249,1,9,4,4,5,single-choice,spatial-relational,4|5,7,4/5,210014,4
6,4,21,15,1,1779,1,3,1,1,2,single-choice,spatial-relational,1|2,7,1/2,210015,1
6,4,21,16,1,960,1,5,2,2,3,single-choice,spatial-relational,2|3,7,2/3,210016,2
6,4,21,17,1,1016,1,7,3,3,4,single-choice,spatial-relational,3|4,7,3/4,210017,3
6,4,21,18,1,1247,1,13,6,6,7,single-choice,spatial-relational,6|7,7,6/7,210018,6
6,4,21,19,1,1400,1,7,3,3,4,single-choice,spatial-relational,3|4,7,3/4,210019,3
6,4,21,20,1,1172,1,5,2,2,3,single-choice,spatial-relational,2|3,7,2/3,210020,2
6,4,21,21,1,1039,1,11,5,5,6,single-choice,spatial-relational,5|6,7,5/6,210021,5
6,4,21,22,1,1512,1,3,1,1,2,single-choice,spatial-relational,1|2,7,1/2,210022,1
6,4,21,23,1,713,1,11,5,5,6,single-choice,spatial-relational,5|6,7,5/6,210023,5
6,4,21,24,1,993,1,13,6,6,7,single-choice,spatial-relational,6|7,7,6/7,210024,6
6,4,21,25,1,913,1,13,6,6,7,single-choice,spatial-relational,6|7,7,6/7,210025,6
6,4,21,26,1,2452,1,7,3,3,4,single-choice,spatial-relational,3|4,7,3/4,210026,3
6,4,21,27,0,1154,1,5,2,3,3,single-choice,spatial-relational,2|3,7,2/3,210027,2
6,4,21,28,0,909,1,9,4,5,5,single-choice,spatial-relational,4|5,7,4/5,210028,4
6,4,21,29,1,753,1,11,5,5,6,single-choice,spatial-relational,5|6,7,5/6,210029,5
6,4,21,30,1,1002,1,9,4,4,5,single-choice,spatial-relational,4|5,7,4/5,210030,4
6,4,21,31,1,1556,1,7,3,3,4,single-choice,spatial-relational,3|4,7,3/4,210031,3
6,4,21,32,1,1469,1,13,6,6,7,single-choice,spatial-relational,6|7,7,6/7,210032,6
6,4,21,33,1,1074,1,5,2,2,3,single-choice,spatial-relational,2|3,7,2/3,210033,2
6,4,21,34,1,1508,1,3,1,1,2,single-choice,spatial-relational,1|2,7,1/2,210034,1
6,4,21,35,1,910,1,3,1,1,2,single-choice,spatial-relational,1|2,7,1/2,210035,1
6,4,21,36,1,658,1,11,5,5,6,single-choice,spatial-relational,5|6,7,5/6,210036,5
6,4,21,37,1,1744,1,9,4,4,5,single-choice,spatial-relational,4|5,7,4/5,210037,4
6,4,21,38,1,1059,1,11,5,5,6,single-choice,spatial-relational,5|6,7,5/6,210038,5
6,4,21,39,1,2211,1,7,3,3,4,single-choice,spatial-relational,3|4,7,3/4,210039,3
6,4,21,40,1,1215,1,5,2,2,3,single-choice,spatial-relational,2|3,7,2/3,210040,2
6,4,21,41,1,1000,1,5,2,2,3,single-choice,spatial-relational,2|3,7,2/3,210041,2
6,4,21,42,1,1011,1,3,1,1,2,single-choice,spatial-relational,1|2,7,1/2,210042,1
6,4,21,43,1,850,1,13,6,6,7,single-choice,spatial-relational,6|7,7,6/7,210043,6
6,4,21,44,1,932,1,11,5,5,6,single-choice,spatial-relational,5|6,7,5/6,210044,5
6,4,21,45,1,2267,1,7,3,3,4,single-choice,spatial-relational,3|4,7,3/4,210045,3
6,4,21,46,1,975,1,13,6,6,7,single-choice,spatial-relational,6|7,7,6/7,210046,6
6,4,21,47,0,1455,1,3,1,2,2,single-choice,spatial-relational,1|2,7,1/2,210047,1
6,4,21,48,0,1178,1,9,4,5,5,single-choice,spatial-relational,4|5,7,4/5,210048,4
6,4,21,49,1,11229,1,11,5,5,6,single-choice,spatial-relational,5|6,7,5/6,210049,5
6,4,21,50,1,1241,1,9,4,4,5,single-choice,spatial-relational,4|5,7,4/5,210050,4
6,4,21,51,1,897,1,5,2,2,3,single-choice,spatial-relational,2|3,7,2/3,210051,2
6,4,21,52,1,1039,1,3,1,1,2,single-choice,spatial-relational,1|2,7,1/2,210052,1
6,4,21,53,1,687,1,11,5,5,6,single-choice,spatial-relational,5|6,7,5/6,210053,5
6,4,21,54,0,1053,1,3,1,2,2,single-choice,spatial-relational,1|2,7,1/2,210054,1
6,4,21,55,1,909,1,7,3,3,4,single-choice,spatial-relational,3|4,7,3/4,210055,3
6,4,21,56,1,864,1,7,3,3,4,single-choice,spatial-relational,3|4,7,3/4,210056,3
6,4,21,57,1,1156,1,5,2,2,3,single-choice,spatial-relational,2|3,7,2/3,210057,2
6,4,21,58,1,989,1,13,6,6,7,single-choice,spatial-relational,6|7,7,6/7,210058,6
6,4,21,59,1,6248,1,13,6,6,7,single-choice,spatial-relational,6|7,7,6/7,210059,6
6,4,21,60,1,1530,1,9,4,4,5,single-choice,spatial-relational,4|5,7,4/5,210060,4
6,4,21,61,1,1071,1,13,6,6,7,single-choice,spatial-relational,6|7,7,6/7,210061,6
6,4,21,62,1,1123,1,11,5,5,6,single-choice,spatial-relational,5|6,7,5/6,210062,5
6,4,21,63,0,4222,1,3,1,2,2,single-choice,spatial-relational,1|2,7,1/2,210063,1
6,4,21,64,0,817,1,3,1,2,2,single-choice,spatial-relational,1|2,7,1/2,210064,1
6,4,21,65,1,1037,1,5,2,2,3,single-choice,spatial-relational,2|3,7,2/3,210065,2
6,4,21,66,1,830,1,5,2,2,3,single-choice,spatial-relational,2|3,7,2/3,210066,2
6,4,21,67,1,1766,1,7,3,3,4,single-choice,spatial-relational,3|4,7,3/4,210067,3
6,4,21,68,1,1095,1,7,3,3,4,single-choice,spatial-relational,3|4,7,3/4,210068,3
6,4,21,69,0,1022,1,9,4,5,5,single-choice,spatial-relational,4|5,7,4/5,210069,4
6,4,21,70,1,691,1,13,6,6,7,single-choice,spatial-relational,6|7,7,6/7,210070,6
6,4,21,71,1,1988,1,9,4,4,5,single-choice,spatial-relational,4|5,7,4/5,210071,4
6,4,21,72,0,1142,1,11,5,6,6,single-choice,spatial-relational,5|6,7,5/6,210072,5
6,4,21,73,1,655,1,13,6,6,7,single-choice,spatial-relational,6|7,7,6/7,210073,6
6,4,21,74,1,1186,1,5,2,2,3,single-choice,spatial-relational,2|3,7,2/3,210074,2
6,4,21,75,1,881,1,9,4,4,5,single-choice,spatial-relational,4|5,7,4/5,210075,4
6,4,21,76,1,1360,1,11,5,5,6,single-choice,spatial-relational,5|6,7,5/6,210076,5
6,4,21,77,1,1419,1,11,5,5,6,single-choice,spatial-relational,5|6,7,5/6,210077,5
6,4,21,78,1,1506,1,7,3,3,4,single-choice,spatial-relational,3|4,7,3/4,210078,3
6,4,21,79,1,1191,1,13,6,6,7,single-choice,spatial-relational,6|7,7,6/7,210079,6
6,4,21,80,0,854,1,3,1,2,2,single-choice,spatial-relational,1|2,7,1/2,210080,1
6,4,21,81,0,670,1,3,1,2,2,single-choice,spatial-relational,1|2,7,1/2,210081,1
6,4,21,82,0,756,1,9,4,5,5,single-choice,spatial-relational,4|5,7,4/5,210082,4
6,4,21,83,0,608,1,7,3,4,4,single-choice,spatial-relational,3|4,7,3/4,210083,3
6,4,21,84,0,912,1,5,2,3,3,single-choice,spatial-relational,2|3,7,2/3,210084,2
6,4,21,85,0,787,1,7,3,4,4,single-choice,spatial-relational,3|4,7,3/4,210085,3
6,4,21,86,1,933,1,13,6,6,7,single-choice,spatial-relational,6|7,7,6/7,210086,6
6,4,21,87,1,2352,1,3,1,1,2,single-choice,spatial-relational,1|2,7,1/2,210087,1
6,4,21,88,1,990,1,3,1,1,2,single-choice,spatial-relational,1|2,7,1/2,210088,1
6,4,21,89,1,1150,1,11,5,5,6,single-choice,spatial-relational,5|6,7,5/6,210089,5
6,4,21,90,1,1858,1,9,4,4,5,single-choice,spatial-relational,4|5,7,4/5,210090,4
6,4,21,91,1,1373,1,5,2,2,3,single-choice,spatial-relational,2|3,7,2/3,210091,2
6,4,21,92,1,1406,1,7,3,3,4,single-choice,spatial-relational,3|4,7,3/4,210092,3
6,4,21,93,1,1670,1,5,2,2,3,single-choice,spatial-relational,2|3,7,2/3,210093,2
6,4,21,94,1,736,1,13,6,6,7,single-choice,spatial-relational,6|7,7,6/7,210094,6
6,4,21,95,1,2271,1,9,4,4,5,single-choice,spatial-relational,4|5,7,4/5,210095,4
6,4,21,96,1,1548,1,11,5,5,6,single-choice,spatial-relational,5|6,7,5/6,210096,5
6,4,21,97,1,2128,1,7,3,3,4,single-choice,spatial-relational,3|4,7,3/4,210097,3
6,4,21,98,0,1396,1,9,4,5,5,single-choice,spatial-relational,4|5,7,4/5,210098,4
6,4,21,99,1,810,1,11,5,5,6,single-choice,spatial-relational,5|6,7,5/6,210099,5
6,4,21,100,1,1482,1,9,4,4,5,single-choice,spatial-relational,4|5,7,4/5,210100,4
6,4,21,101,1,1748,1,11,5,5,6,single-choice,spatial-relational,5|6,7,5/6,210101,5
6,4,21,102,1,1420,1,13,6,6,7,single-choice,spatial-relational,6|7,7,6/7,210102,6
6,4,21,103,0,2609,1,7,3,4,4,single-choice,spatial-relational,3|4,7,3/4,210103,3
6,4,21,104,1,941,1,13,6,6,7,single-choice,spatial-relational,6|7,7,6/7,210104,6
6,4,21,105,1,891,1,3,1,1,2,single-choice,spatial-relational,1|2,7,1/2,210105,1
6,4,21,106,1,983,1,3,1,1,2,single-choice,spatial-relational,1|2,7,1/2,210106,1
6,4,21,107,1,912,1,5,2,2,3,single-choice,spatial-relational,2|3,7,2/3,210107,2
6,4,21,108,1,1151,1,5,2,2,3,single-choice,spatial-relational,2|3,7,2/3,210108,2
6,4,21,109,1,1397,1,7,3,3,4,single-choice,spatial-relational,3|4,7,3/4,210109,3
6,4,21,110,1,1765,1,3,1,1,2,single-choice,spatial-relational,1|2,7,1/2,210110,1
6,4,21,111,1,1024,1,7,3,3,4,single-choice,spatial-relational,3|4,7,3/4,210111,3
6,4,21,112,1,2092,1,9,4,4,5,single-choice,spatial-relational,4|5,7,4/5,210112,4
6,4,21,113,1,1992,1,11,5,5,6,single-choice,spatial-relational,5|6,7,5/6,210113,5
6,4,21,114,1,1799,1,11,5,5,6,single-choice,spatial-relational,5|6,7,5/6,210114,5
6,4,21,115,0,1945,1,5,2,3,3,single-choice,spatial-relational,2|3,7,2/3,210115,2
6,4,21,116,1,964,1,13,6,6,7,single-choice,spatial-relational,6|7,7,6/7,210116,6
6,4,21,117,1,724,1,13,6,6,7,single-choice,spatial-relational,6|7,7,6/7,210117,6
6,4,21,118,1,2379,1,9,4,4,5,single-choice,spatial-relational,4|5,7,4/5,210118,4
6,4,21,119,0,1482,1,3,1,2,2,single-choice,spatial-relational,1|2,7,1/2,210119,1
6,4,21,120,0,610,1,5,2,3,3,single-choice,spatial-relational,2|3,7,2/3,210120,2
6,4,21,121,1,869,1,5,2,2,3,single-choice,spatial-relational,2|3,7,2/3,210121,2
6,4,21,122,1,901,1,13,6,6,7,single-choice,spatial-relational,6|7,7,6/7,210122,6
6,4,21,123,1,1306,1,5,2,2,3,single-choice,spatial-relational,2|3,7,2/3,210123,2
6,4,21,124,1,1071,1,9,4,4,5,single-choice,spatial-relational,4|5,7,4/5,210124,4
6,4,21,125,1,1434,1,13,6,6,7,single-choice,spatial-relational,6|7,7,6/7,210125,6
6,4,21,126,1,1515,1,7,3,3,4,single-choice,spatial-relational,3|4,7,3/4,210126,3
6,4,21,127,0,849,1,3,1,2,2,single-choice,spatial-relational,1|2,7,1/2,210127,1
6,4,21,128,0,576,1,3,1,2,2,single-choice,spatial-relational,1|2,7,1/2,210128,1
6,4,21,129,1,1032,1,9,4,4,5,single-choice,spatial-relational,4|5,7,4/5,210129,4
6,4,21,130,1,1629,1,7,3,3,4,single-choice,spatial-relational,3|4,7,3/4,210130,3
6,4,21,131,1,1116,1,11,5,5,6,single-choice,spatial-relational,5|6,7,5/6,210131,5
6,4,21,132,1,1315,1,11,5,5,6,single-choice,spatial-relational,5|6,7,5/6,210132,5
6,4,21,133,1,1335,1,7,3,3,4,single-choice,spatial-relational,3|4,7,3/4,210133,3
6,4,21,134,1,1483,1,3,1,1,2,single-choice,spatial-relational,1|2,7,1/2,210134,1
6,4,21,135,1,903,1,5,2,2,3,single-choice,spatial-relational,2|3,7,2/3,210135,2
6,4,21,136,1,890,1,11,5,5,6,single-choice,spatial-relational,5|6,7,5/6,210136,5
6,4,21,137,1,1047,1,13,6,6,7,single-choice,spatial-relational,6|7,7,6/7,210137,6
6,4,21,138,1,930,1,13,6,6,7,single-choice,spatial-relational,6|7,7,6/7,210138,6
6,4,21,139,0,1110,1,9,4,5,5,single-choice,spatial-relational,4|5,7,4/5,210139,4
6,4,21,140,1,1061,1,3,1,1,2,single-choice,spatial-relational,1|2,7,1/2,210140,1
6,4,21,141,1,923,1,5,2,2,3,single-choice,spatial-relational,2|3,7,2/3,210141,2
6,4,21,142,1,1404,1,11,5,5,6,single-choice,spatial-relational,5|6,7,5/6,210142,5
6,4,21,143,0,1054,1,7,3,4,4,single-choice,spatial-relational,3|4,7,3/4,210143,3
6,4,21,144,1,1089,1,9,4,4,5,single-choice,spatial-relational,4|5,7,4/5,210144,4
6,4,21,145,1,1090,1,3,1,1,2,single-choice,spatial-relational,1|2,7,1/2,210145,1
6,4,21,146,1,972,1,9,4,4,5,single-choice,spatial-relational,4|5,7,4/5,210146,4
6,4,21,147,1,1888,1,11,5,5,6,single-choice,spatial-relational,5|6,7,5/6,210147,5
6,4,21,148,0,2015,1,9,4,5,5,single-choice,spatial-relational,4|5,7,4/5,210148,4
6,4,21,149,1,847,1,13,6,6,7,single-choice,spatial-relational,6|7,7,6/7,210149,6
6,4,21,150,0,844,1,3,1,2,2,single-choice,spatial-relational,1|2,7,1/2,210150,1
6,4,21,151,1,819,1,11,5,5,6,single-choice,spatial-relational,5|6,7,5/6,210151,5
6,4,21,152,1,1103,1,13,6,6,7,single-choice,spatial-relational,6|7,7,6/7,210152,6
6,4,21,153,1,2730,1,7,3,3,4,single-choice,spatial-relational,3|4,7,3/4,210153,3
6,4,21,154,1,1590,1,7,3,3,4,single-choice,spatial-relational,3|4,7,3/4,210154,3
6,4,21,155,1,1224,1,5,2,2,3,single-choice,spatial-relational,2|3,7,2/3,210155,2
6,4,21,156,1,974,1,5,2,2,3,single-choice,spatial-relational,2|3,7,2/3,210156,2
6,4,21,157,0,1277,1,7,3,4,4,single-choice,spatial-relational,3|4,7,3/4,210157,3
6,4,21,158,1,981,1,9,4,4,5,single-choice,spatial-relational,4|5,7,4/5,210158,4
6,4,21,159,1,1291,1,5,2,2,3,single-choice,spatial-relational,2|3,7,2/3,210159,2
6,4,21,160,1,873,1,13,6,6,7,single-choice,spatial-relational,6|7,7,6/7,210160,6
6,4,21,161,0,1229,1,11,5,6,6,single-choice,spatial-relational,5|6,7,5/6,210161,5
6,4,21,162,1,781,1,3,1,1,2,single-choice,spatial-relational,1|2,7,1/2,210162,1
6,4,21,163,1,821,1,7,3,3,4,single-choice,spatial-relational,3|4,7,3/4,210163,3
6,4,21,164,1,1034,1,5,2,2,3,single-choice,spatial-relational,2|3,7,2/3,210164,2
6,4,21,165,1,1699,1,3,1,1,2,single-choice,spatial-relational,1|2,7,1/2,210165,1
6,4,21,166,1,952,1,9,4,4,5,single-choice,spatial-relational,4|5,7,4/5,210166,4
6,4,21,167,1,1097,1,13,6,6,7,single-choice,spatial-relational,6|7,7,6/7,210167,6
6,4,21,168,0,2223,1,11,5,6,6,single-choice,spatial-relational,5|6,7,5/6,210168,5
6,4,21,169,1,789,1,7,3,3,4,single-choice,spatial-relational,3|4,7,3/4,210169,3
6,4,21,170,1,1753,1,9,4,4,5,single-choice,spatial-relational,4|5,7,4/5,210170,4
6,4,21,171,1,1789,1,13,6,6,7,single-choice,spatial-relational,6|7,7,6/7,210171,6
6,4,21,172,0,934,1,3,1,2,2,single-choice,spatial-relational,1|2,7,1/2,210172,1
6,4,21,173,1,1070,1,11,5,5,6,single-choice,spatial-relational,5|6,7,5/6,210173,5
6,4,21,174,0,3099,1,3,1,2,2,single-choice,spatial-relational,1|2,7,1/2,210174,1
6,4,21,175,1,961,1,9,4,4,5,single-choice,spatial-relational,4|5,7,4/5,210175,4
6,4,21,176,0,878,1,5,2,3,3,single-choice,spatial-relational,2|3,7,2/3,210176,2
6,4,21,177,1,996,1,13,6,6,7,single-choice,spatial-relational,6|7,7,6/7,210177,6
6,4,21,178,1,1297,1,5,2,2,3,single-choice,spatial-relational,2|3,7,2/3,210178,2
6,4,21,179,1,1422,1,7,3,3,4,single-choice,spatial-relational,3|4,7,3/4,210179,3
6,4,21,180,1,1353,1,11,5,5,6,single-choice,spatial-relational,5|6,7,5/6,210180,5
6,4,21,181,1,1256,1,13,6,6,7,single-choice,spatial-relational,6|7,7,6/7,210181,6
6,4,21,182,1,2016,1,7,3,3,4,single-choice,spatial-relational,3|4,7,3/4,210182,3
6,4,21,183,1,1125,1,13,6,6,7,single-choice,spatial-relational,6|7,7,6/7,210183,6
6,4,21,184,1,1995,1,9,4,4,5,single-choice,spatial-relational,4|5,7,4/5,210184,4
6,4,21,185,0,1628,1,3,1,2,2,single-choice,spatial-relational,1|2,7,1/2,210185,1
6,4,21,186,0,1144,1,5,2,3,3,single-choice,spatial-relational,2|3,7,2/3,210186,2
6,4,21,187,1,1033,1,3,1,1,2,single-choice,spatial-relational,1|2,7,1/2,210187,1
6,4,21,188,1,1098,1,11,5,5,6,single-choice,spatial-relational,5|6,7,5/6,210188,5
6,4,21,189,1,1498,1,5,2,2,3,single-choice,spatial-relational,2|3,7,2/3,210189,2
6,4,21,190,1,1162,1,11,5,5,6,single-choice,spatial-relational,5|6,7,5/6,210190,5
6,4,21,191,1,2391,1,7,3,3,4,single-choice,spatial-relational,3|4,7,3/4,210191,3
6,4,21,192,1,1701,1,9,4,4,5,single-choice,spatial-relational,4|5,7,4/5,210192,4
6,4,21,193,1,1964,1,9,4,4,5,single-choice,spatial-relational,4|5,7,4/5,210193,4
6,4,21,194,1,1901,1,7,3,3,4,single-choice,spatial-relational,3|4,7,3/4,210194,3
6,4,21,195,1,942,1,13,6,6,7,single-choice,spatial-relational,6|7,7,6/7,210195,6
6,4,21,196,1,1093,1,13,6,6,7,single-choice,spatial-relational,6|7,7,6/7,210196,6
6,4,21,197,1,1997,1,11,5,5,6,single-choice,spatial-relational,5|6,7,5/6,210197,5
6,4,21,198,0,868,1,3,1,2,2,single-choice,spatial-relational,1|2,7,1/2,210198,1
6,4,21,199,0,1200,1,5,2,3,3,single-choice,spatial-relational,2|3,7,2/3,210199,2
6,4,21,200,0,1142,1,7,3,4,4,single-choice,spatial-relational,3|4,7,3/4,210200,3
6,4,21,201,0,758,1,3,1,2,2,single-choice,spatial-relational,1|2,7,1/2,210201,1
6,4,21,202,1,2209,1,5,2,2,3,single-choice,spatial-relational,2|3,7,2/3,210202,2
6,4,21,203,1,1290,1,11,5,5,6,single-choice,spatial-relational,5|6,7,5/6,210203,5
6,4,21,204,1,1689,1,9,4,4,5,single-choice,spatial-relational,4|5,7,4/5,210204,4
6,4,21,205,1,1620,1,9,4,4,5,single-choice,spatial-relational,4|5,7,4/5,210205,4
6,4,21,206,1,966,1,5,2,2,3,single-choice,spatial-relational,2|3,7,2/3,210206,2
6,4,21,207,1,1842,1,11,5,5,6,single-choice,spatial-relational,5|6,7,5/6,210207,5
6,4,21,208,0,929,1,3,1,2,2,single-choice,spatial-relational,1|2,7,1/2,210208,1
6,4,21,209,0,1048,1,7,3,4,4,single-choice,spatial-relational,3|4,7,3/4,210209,3
6,4,21,210,1,1044,1,11,5,5,6,single-choice,spatial-relational,5|6,7,5/6,210210,5
6,4,21,211,1,781,1,13,6,6,7,single-choice,spatial-relational,6|7,7,6/7,210211,6
6,4,21,212,1,1872,1,3,1,1,2,single-choice,spatial-relational,1|2,7,1/2,210212,1
6,4,21,213,1,832,1,13,6,6,7,single-choice,spatial-relational,6|7,7,6/7,210213,6
6,4,21,214,1,2443,1,7,3,3,4,single-choice,spatial-relational,3|4,7,3/4,210214,3
6,4,21,215,1,1431,1,9,4,4,5,single-choice,spatial-relational,4|5,7,4/5,210215,4
6,4,21,216,1,1286,1,5,2,2,3,single-choice,spatial-relational,2|3,7,2/3,210216,2
6,4,21,217,1,1087,1,9,4,4,5,single-choice,spatial-relational,4|5,7,4/5,210217,4
6,4,21,218,0,1380,1,11,5,6,6,single-choice,spatial-relational,5|6,7,5/6,210218,5
6,4,21,219,1,812,1,13,6,6,7,single-choice,spatial-relational,6|7,7,6/7,210219,6
6,4,21,220,1,1275,1,3,1,1,2,single-choice,spatial-relational,1|2,7,1/2,210220,1
6,4,21,221,1,1013,1,5,2,2,3,single-choice,spatial-relational,2|3,7,2/3,210221,2
6,4,21,222,0,1068,1,3,1,2,2,single-choice,spatial-relational,1|2,7,1/2,210222,1
6,4,21,223,0,1182,1,7,3,4,4,single-choice,spatial-relational,3|4,7,3/4,210223,3
6,4,21,224,1,750,1,11,5,5,6,single-choice,spatial-relational,5|6,7,5/6,210224,5
6,4,21,225,1,1453,1,13,6,6,7,single-choice,spatial-relational,6|7,7,6/7,210225,6
6,4,21,226,1,2550,1,7,3,3,4,single-choice,spatial-relational,3|4,7,3/4,210226,3
6,4,21,227,1,1222,1,5,2,2,3,single-choice,spatial-relational,2|3,7,2/3,210227,2
6,4,21,228,1,1339,1,9,4,4,5,single-choice,spatial-relational,4|5,7,4/5,210228,4
6,4,21,229,1,1338,1,11,5,5,6,single-choice,spatial-relational,5|6,7,5/6,210229,5
6,4,21,230,1,1925,1,11,5,5,6,single-choice,spatial-relational,5|6,7,5/6,210230,5
6,4,21,231,1,1431,1,13,6,6,7,single-choice,spatial-relational,6|7,7,6/7,210231,6
6,4,21,232,1,2719,1,9,4,4,5,single-choice,spatial-relational,4|5,7,4/5,210232,4
6,4,21,233,1,2268,1,3,1,1,2,single-choice,spatial-relational,1|2,7,1/2,210233,1
6,4,21,234,1,956,1,3,1,1,2,single-choice,spatial-relational,1|2,7,1/2,210234,1
6,4,21,235,1,621,1,13,6,6,7,single-choice,spatial-relational,6|7,7,6/7,210235,6
6,4,21,236,1,2006,1,5,2,2,3,single-choice,spatial-relational,2|3,7,2/3,210236,2
6,4,21,237,1,968,1,5,2,2,3,single-choice,spatial-relational,2|3,7,2/3,210237,2
6,4,21,238,1,1419,1,9,4,4,5,single-choice,spatial-relational,4|5,7,4/5,210238,4
6,4,21,239,1,2048,1,7,3,3,4,single-choice,spatial-relational,3|4,7,3/4,210239,3
6,4,21,240,1,1479,1,7,3,3,4,single-choice,spatial-relational,3|4,7,3/4,210240,3
6,4,21,241,1,1157,1,5,2,2,3,single-choice,spatial-relational,2|3,7,2/3,210241,2
6,4,21,242,1,1502,1,5,2,2,3,single-choice,spatial-relational,2|3,7,2/3,210242,2
6,4,21,243,1,1281,1,11,5,5,6,single-choice,spatial-relational,5|6,7,5/6,210243,5
6,4,21,244,1,2105,1,9,4,4,5,single-choice,spatial-relational,4|5,7,4/5,210244,4
6,4,21,245,0,1303,1,11,5,6,6,single-choice,spatial-relational,5|6,7,5/6,210245,5
6,4,21,246,1,1206,1,7,3,3,4,single-choice,spatial-relational,3|4,7,3/4,210246,3
6,4,21,247,1,930,1,13,6,6,7,single-choice,spatial-relational,6|7,7,6/7,210247,6
6,4,21,248,0,1786,1,3,1,2,2,single-choice,spatial-relational,1|2,7,1/2,210248,1
6,4,21,249,1,1143,1,7,3,3,4,single-choice,spatial-relational,3|4,7,3/4,210249,3
6,4,21,250,0,1191,1,9,4,5,5,single-choice,spatial-relational,4|5,7,4/5,210250,4
6,4,21,251,1,883,1,13,6,6,7,single-choice,spatial-relational,6|7,7,6/7,210251,6
6,4,21,252,0,1245,1,3,1,2,2,single-choice,spatial-relational,1|2,7,1/2,210252,1
6,4,21,253,1,942,1,5,2,2,3,single-choice,spatial-relational,2|3,7,2/3,210253,2
6,4,21,254,1,1354,1,9,4,4,5,single-choice,spatial-relational,4|5,7,4/5,210254,4
6,4,21,255,0,1453,1,3,1,2,2,single-choice,spatial-relational,1|2,7,1/2,210255,1
6,4,21,256,1,1141,1,13,6,6,7,single-choice,spatial-relational,6|7,7,6/7,210256,6
6,4,21,257,1,1030,1,7,3,3,4,single-choice,spatial-relational,3|4,7,3/4,210257,3
6,4,21,258,1,1854,1,7,3,3,4,single-choice,spatial-relational,3|4,7,3/4,210258,3
6,4,21,259,1,1133,1,13,6,6,7,single-choice,spatial-relational,6|7,7,6/7,210259,6
6,4,21,260,1,1650,1,11,5,5,6,single-choice,spatial-relational,5|6,7,5/6,210260,5
6,4,21,261,1,1771,1,3,1,1,2,single-choice,spatial-relational,1|2,7,1/2,210261,1
6,4,21,262,1,855,1,11,5,5,6,single-choice,spatial-relational,5|6,7,5/6,210262,5
6,4,21,263,1,1351,1,9,4,4,5,single-choice,spatial-relational,4|5,7,4/5,210263,4
6,4,21,264,1,3153,1,5,2,2,3,single-choice,spatial-relational,2|3,7,2/3,210264,2
6,4,21,265,1,870,1,11,5,5,6,single-choice,spatial-relational,5|6,7,5/6,210265,5
6,4,21,266,0,1210,1,7,3,4,4,single-choice,spatial-relational,3|4,7,3/4,210266,3
6,4,21,267,1,1080,1,13,6,6,7,single-choice,spatial-relational,6|7,7,6/7,210267,6
6,4,21,268,1,1658,1,3,1,1,2,single-choice,spatial-relational,1|2,7,1/2,210268,1
6,4,21,269,1,856,1,9,4,4,5,single-choice,spatial-relational,4|5,7,4/5,210269,4
6,4,21,270,1,1424,1,11,5,5,6,single-choice,spatial-relational,5|6,7,5/6,210270,5
6,4,21,271,1,1176,1,13,6,6,7,single-choice,spatial-relational,6|7,7,6/7,210271,6
6,4,21,272,1,1853,1,9,4,4,5,single-choice,spatial-relational,4|5,7,4/5,210272,4
6,4,21,273,1,2110,1,7,3,3,4,single-choice,spatial-relational,3|4,7,3/4,210273,3
6,4,21,274,1,1359,1,3,1,1,2,single-choice,spatial-relational,1|2,7,1/2,210274,1
6,4,21,275,1,1034,1,5,2,2,3,single-choice,spatial-relational,2|3,7,2/3,210275,2
6,4,21,276,1,1011,1,5,2,2,3,single-choice,spatial-relational,2|3,7,2/3,210276,2
6,4,21,277,1,923,1,13,6,6,7,single-choice,spatial-relational,6|7,7,6/7,210277,6
6,4,21,278,1,1441,1,11,5,5,6,single-choice,spatial-relational,5|6,7,5/6,210278,5
6,4,21,279,1,1150,1,5,2,2,3,single-choice,spatial-relational,2|3,7,2/3,210279,2
6,4,21,280,0,1010,1,9,4,5,5,single-choice,spatial-relational,4|5,7,4/5,210280,4
6,4,21,281,1,1796,1,9,4,4,5,single-choice,spatial-relational,4|5,7,4/5,210281,4
6,4,21,282,1,1326,1,13,6,6,7,single-choice,spatial-relational,6|7,7,6/7,210282,6
6,4,21,283,0,882,1,3,1,2,2,single-choice,spatial-relational,1|2,7,1/2,210283,1
6,4,21,284,0,1166,1,5,2,3,3,single-choice,spatial-relational,2|3,7,2/3,210284,2
6,4,21,285,1,915,1,7,3,3,4,single-choice,spatial-relational,3|4,7,3/4,210285,3
6,4,21,286,0,730,1,3,1,2,2,single-choice,spatial-relational,1|2,7,1/2,210286,1
6,4,21,287,0,1067,1,7,3,4,4,single-choice,spatial-relational,3|4,7,3/4,210287,3
6,4,21,288,1,862,1,11,5,5,6,single-choice,spatial-relational,5|6,7,5/6,210288,5
6,4,21,289,1,2236,1,11,5,5,6,single-choice,spatial-relational,5|6,7,5/6,210289,5
6,4,21,290,1,2285,1,9,4,4,5,single-choice,spatial-relational,4|5,7,4/5,210290,4
6,4,21,291,1,1872,1,9,4,4,5,single-choice,spatial-relational,4|5,7,4/5,210291,4
6,4,21,292,1,1390,1,5,2,2,3,single-choice,spatial-relational,2|3,7,2/3,210292,2
6,4,21,293,1,893,1,5,2,2,3,single-choice,spatial-relational,2|3,7,2/3,210293,2
6,4,21,294,1,1086,1,11,5,5,6,single-choice,spatial-relational,5|6,7,5/6,210294,5
6,4,21,295,1,974,1,13,6,6,7,single-choice,spatial-relational,6|7,7,6/7,210295,6
6,4,21,296,1,1952,1,7,3,3,4,single-choice,spatial-relational,3|4,7,3/4,210296,3
6,4,21,297,1,1656,1,7,3,3,4,single-choice,spatial-relational,3|4,7,3/4,210297,3
6,4,21,298,1,1947,1,3,1,1,2,single-choice,spatial-relational,1|2,7,1/2,210298,1
6,4,21,299,1,622,1,13,6,6,7,single-choice,spatial-relational,6|7,7,6/7,210299,6
6,4,21,300,0,840,1,3,1,2,2,single-choice,spatial-relational,1|2,7,1/2,210300,1
6,4,21,301,1,895,1,11,5,5,6,single-choice,spatial-relational,5|6,7,5/6,210301,5
6,4,21,302,1,1180,1,13,6,6,7,single-choice,spatial-relational,6|7,7,6/7,210302,6
6,4,21,303,1,640,1,13,6,6,7,single-choice,spatial-relational,6|7,7,6/7,210303,6
6,4,21,304,1,1357,1,7,3,3,4,single-choice,spatial-relational,3|4,7,3/4,210304,3
6,4,21,305,1,1811,1,3,1,1,2,single-choice,spatial-relational,1|2,7,1/2,210305,1
6,4,21,306,1,921,1,7,3,3,4,single-choice,spatial-relational,3|4,7,3/4,210306,3
6,4,21,307,1,1217,1,11,5,5,6,single-choice,spatial-relational,5|6,7,5/6,210307,5
6,4,21,308,1,1459,1,5,2,2,3,single-choice,spatial-relational,2|3,7,2/3,210308,2
6,4,21,309,1,853,1,5,2,2,3,single-choice,spatial-relational,2|3,7,2/3,210309,2
6,4,21,310,0,1051,1,9,4,5,5,single-choice,spatial-relational,4|5,7,4/5,210310,4
6,4,21,311,1,803,1,9,4,4,5,single-choice,spatial-relational,4|5,7,4/5,210311,4
6,4,21,312,1,1409,1,3,1,1,2,single-choice,spatial-relational,1|2,7,1/2,210312,1
6,4,21,313,1,1038,1,3,1,1,2,single-choice,spatial-relational,1|2,7,1/2,210313,1
6,4,21,314,1,1728,1,3,1,1,2,single-choice,spatial-relational,1|2,7,1/2,210314,1
6,4,21,315,1,726,1,13,6,6,7,single-choice,spatial-relational,6|7,7,6/7,210315,6
6,4,21,316,1,2197,1,11,5,5,6,single-choice,spatial-relational,5|6,7,5/6,210316,5
6,4,21,317,1,1427,1,7,3,3,4,single-choice,spatial-relational,3|4,7,3/4,210317,3
6,4,21,318,1,1765,1,9,4,4,5,single-choice,spatial-relational,4|5,7,4/5,210318,4
6,4,21,319,1,1612,1,5,2,2,3,single-choice,spatial-relational,2|3,7,2/3,210319,2
6,4,21,320,1,874,1,5,2,2,3,single-choice,spatial-relational,2|3,7,2/3,210320,2
6,4,21,321,1,1230,1,7,3,3,4,single-choice,spatial-relational,3|4,7,3/4,210321,3
6,4,21,322,0,1223,1,11,5,6,6,single-choice,spatial-relational,5|6,7,5/6,210322,5
6,4,21,323,1,1402,1,9,4,4,5,single-choice,spatial-relational,4|5,7,4/5,210323,4
6,4,21,324,1,981,1,13,6,6,7,single-choice,spatial-relational,6|7,7,6/7,210324,6
6,4,21,325,1,2002,1,5,2,2,3,single-choice,spatial-relational,2|3,7,2/3,210325,2
6,4,21,326,1,1320,1,3,1,1,2,single-choice,spatial-relational,1|2,7,1/2,210326,1
6,4,21,327,1,970,1,7,3,3,4,single-choice,spatial-relational,3|4,7,3/4,210327,3
6,4,21,328,1,1367,1,11,5,5,6,single-choice,spatial-relational,5|6,7,5/6,210328,5
6,4,21,329,1,1454,1,9,4,4,5,single-choice,spatial-relational,4|5,7,4/5,210329,4
6,4,21,330,1,1506,1,7,3,3,4,single-choice,spatial-relational,3|4,7,3/4,210330,3
6,4,21,331,0,2018,1,9,4,5,5,single-choice,spatial-relational,4|5,7,4/5,210331,4
6,4,21,332,1,1111,1,11,5,5,6,single-choice,spatial-relational,5|6,7,5/6,210332,5
6,4,21,333,1,1250,1,13,6,6,7,single-choice,spatial-relational,6|7,7,6/7,210333,6
6,4,21,334,1,1349,1,13,6,6,7,single-choice,spatial-relational,6|7,7,6/7,210334,6
6,4,21,335,0,895,1,3,1,2,2,single-choice,spatial-relational,1|2,7,1/2,210335,1
6,4,21,336,1,2094,1,5,2,2,3,single-choice,spatial-relational,2|3,7,2/3,210336,2
6,4,21,337,1,835,1,3,1,1,2,single-choice,spatial-relational,1|2,7,1/2,210337,1
6,4,21,338,0,827,1,7,3,4,4,single-choice,spatial-relational,3|4,7,3/4,210338,3
6,4,21,339,1,808,1,9,4,4,5,single-choice,spatial-relational,4|5,7,4/5,210339,4
6,4,21,340,0,1024,1,3,1,2,2,single-choice,spatial-relational,1|2,7,1/2,210340,1
6,4,21,341,1,830,1,9,4,4,5,single-choice,spatial-relational,4|5,7,4/5,210341,4
6,4,21,342,1,1752,1,7,3,3,4,single-choice,spatial-relational,3|4,7,3/4,210342,3
6,4,21,343,1,656,1,13,6,6,7,single-choice,spatial-relational,6|7,7,6/7,210343,6
6,4,21,344,1,1272,1,5,2,2,3,single-choice,spatial-relational,2|3,7,2/3,210344,2
6,4,21,345,1,917,1,5,2,2,3,single-choice,spatial-relational,2|3,7,2/3,210345,2
6,4,21,346,1,952,1,11,5,5,6,single-choice,spatial-relational,5|6,7,5/6,210346,5
6,4,21,347,1,1526,1,11,5,5,6,single-choice,spatial-relational,5|6,7,5/6,210347,5
6,4,21,348,1,1133,1,13,6,6,7,single-choice,spatial-relational,6|7,7,6/7,210348,6
6,4,21,349,1,1417,1,5,2,2,3,single-choice,spatial-relational,2|3,7,2/3,210349,2
6,4,21,350,1,1348,1,11,5,5,6,single-choice,spatial-relational,5|6,7,5/6,210350,5
6,4,21,351,1,1905,1,7,3,3,4,single-choice,spatial-relational,3|4,7,3/4,210351,3
6,4,21,352,1,1083,1,11,5,5,6,single-choice,spatial-relational,5|6,7,5/6,210352,5
6,4,21,353,1,1551,1,9,4,4,5,single-choice,spatial-relational,4|5,7,4/5,210353,4
6,4,21,354,1,1523,1,7,3,3,4,single-choice,spatial-relational,3|4,7,3/4,210354,3
6,4,21,355,0,1008,1,3,1,2,2,single-choice,spatial-relational,1|2,7,1/2,210355,1
6,4,21,356,1,929,1,5,2,2,3,single-choice,spatial-relational,2|3,7,2/3,210356,2
6,4,21,357,1,733,1,13,6,6,7,single-choice,spatial-relational,6|7,7,6/7,210357,6
6,4,21,358,1,1677,1,9,4,4,5,single-choice,spatial-relational,4|5,7,4/5,210358,4
6,4,21,359,1,985,1,13,6,6,7,single-choice,spatial-relational,6|7,7,6/7,210359,6
6,4,21,360,1,2270,1,3,1,1,2,single-choice,spatial-relational,1|2,7,1/2,210360,1
6,4,21,361,1,1033,1,11,5,5,6,single-choice,spatial-relational,5|6,7,5/6,210361,5
6,4,21,362,1,1548,1,9,4,4,5,single-choice,spatial-relational,4|5,7,4/5,210362,4
6,4,21,363,1,1430,1,3,1,1,2,single-choice,spatial-relational,1|2,7,1/2,210363,1
6,4,21,364,1,1286,1,9,4,4,5,single-choice,spatial-relational,4|5,7,4/5,210364,4
6,4,21,365,1,1346,1,7,3,3,4,single-choice,spatial-relational,3|4,7,3/4,210365,3
6,4,21,366,1,1248,1,11,5,5,6,single-choice,spatial-relational,5|6,7,5/6,210366,5
6,4,21,367,0,752,1,5,2,3,3,single-choice,spatial-relational,2|3,7,2/3,210367,2
6,4,21,368,1,1515,1,13,6,6,7,single-choice,spatial-relational,6|7,7,6/7,210368,6
6,4,21,369,1,802,1,13,6,6,7,single-choice,spatial-relational,6|7,7,6/7,210369,6
6,4,21,370,1,1624,1,5,2,2,3,single-choice,spatial-relational,2|3,7,2/3,210370,2
6,4,21,371,1,1070,1,3,1,1,2,single-choice,spatial-relational,1|2,7,1/2,210371,1
6,4,21,372,0,1393,1,7,3,4,4,single-choice,spatial-relational,3|4,7,3/4,210372,3
6,4,21,373,0,560,1,3,1,2,2,single-choice,spatial-relational,1|2,7,1/2,210373,1
6,4,21,374,1,1128,1,9,4,4,5,single-choice,spatial-relational,4|5,7,4/5,210374,4
6,4,21,375,1,823,1,9,4,4,5,single-choice,spatial-relational,4|5,7,4/5,210375,4
6,4,21,376,1,1041,1,13,6,6,7,single-choice,spatial-relational,6|7,7,6/7,210376,6
6,4,21,377,0,1387,1,7,3,4,4,single-choice,spatial-relational,3|4,7,3/4,210377,3
6,4,21,378,1,831,1,13,6,6,7,single-choice,spatial-relational,6|7,7,6/7,210378,6
6,4,21,379,1,1213,1,11,5,5,6,single-choice,spatial-relational,5|6,7,5/6,210379,5
6,4,21,380,1,1370,1,5,2,2,3,single-choice,spatial-relational,2|3,7,2/3,210380,2
6,4,21,381,1,918,1,3,1,1,2,single-choice,spatial-relational,1|2,7,1/2,210381,1
6,4,21,382,0,1743,1,5,2,3,3,single-choice,spatial-relational,2|3,7,2/3,210382,2
6,4,21,383,1,921,1,11,5,5,6,single-choice,spatial-relational,5|6,7,5/6,210383,5
6,4,21,384,0,1211,1,7,3,4,4,single-choice,spatial-relational,3|4,7,3/4,210384,3
6,4,21,385,1,864,1,7,3,3,4,single-choice,spatial-relational,3|4,7,3/4,210385,3
6,4,21,386,1,957,1,13,6,6,7,single-choice,spatial-relational,6|7,7,6/7,210386,6
6,4,21,387,0,919,1,3,1,2,2,single-choice,spatial-relational,1|2,7,1/2,210387,1
6,4,21,388,1,872,1,3,1,1,2,single-choice,spatial-relational,1|2,7,1/2,210388,1
6,4,21,389,1,773,1,11,5,5,6,single-choice,spatial-relational,5|6,7,5/6,210389,5
6,4,21,390,1,1060,1,9,4,4,5,single-choice,spatial-relational,4|5,7,4/5,210390,4
6,4,21,391,1,1744,1,9,4,4,5,single-choice,spatial-relational,4|5,7,4/5,210391,4
6,4,21,392,1,1751,1,5,2,2,3,single-choice,spatial-relational,2|3,7,2/3,210392,2
6,4,21,393,1,1135,1,7,3,3,4,single-choice,spatial-relational,3|4,7,3/4,210393,3
6,4,21,394,1,988,1,13,6,6,7,single-choice,spatial-relational,6|7,7,6/7,210394,6
6,4,21,395,1,2277,1,11,5,5,6,single-choice,spatial-relational,5|6,7,5/6,210395,5
6,4,21,396,1,1307,1,5,2,2,3,single-choice,spatial-relational,2|3,7,2/3,210396,2
6,4,21,397,1,1181,1,11,5,5,6,single-choice,spatial-relational,5|6,7,5/6,210397,5
6,4,21,398,1,978,1,13,6,6,7,single-choice,spatial-relational,6|7,7,6/7,210398,6
6,4,21,399,0,999,1,7,3,4,4,single-choice,spatial-relational,3|4,7,3/4,210399,3
6,4,21,400,0,7390,1,9,4,5,5,single-choice,spatial-relational,4|5,7,4/5,210400,4
6,4,21,401,1,1215,1,3,1,1,2,single-choice,spatial-relational,1|2,7,1/2,210401,1
6,4,21,402,1,957,1,7,3,3,4,single-choice,spatial-relational,3|4,7,3/4,210402,3
6,4,21,403,1,1054,1,5,2,2,3,single-choice,spatial-relational,2|3,7,2/3,210403,2
6,4,21,404,1,1105,1,9,4,4,5,single-choice,spatial-relational,4|5,7,4/5,210404,4
6,4,21,405,1,1359,1,5,2,2,3,single-choice,spatial-relational,2|3,7,2/3,210405,2
6,4,21,406,1,938,1,13,6,6,7,single-choice,spatial-relational,6|7,7,6/7,210406,6
6,4,21,407,1,2202,1,3,1,1,2,single-choice,spatial-relational,1|2,7,1/2,210407,1
6,4,21,408,1,851,1,11,5,5,6,single-choice,spatial-relational,5|6,7,5/6,210408,5
6,4,21,409,1,1630,1,9,4,4,5,single-choice,spatial-relational,4|5,7,4/5,210409,4
6,4,21,410,1,962,1,13,6,6,7,single-choice,spatial-relational,6|7,7,6/7,210410,6
6,4,21,411,1,1898,1,11,5,5,6,single-choice,spatial-relational,5|6,7,5/6,210411,5
6,4,21,412,0,1226,1,3,1,2,2,single-choice,spatial-relational,1|2,7,1/2,210412,1
6,4,21,413,1,733,1,11,5,5,6,single-choice,spatial-relational,5|6,7,5/6,210413,5
6,4,21,414,1,1233,1,5,2,2,3,single-choice,spatial-relational,2|3,7,2/3,210414,2
6,4,21,415,0,997,1,5,2,3,3,single-choice,spatial-relational,2|3,7,2/3,210415,2
6,4,21,416,0,773,1,9,4,5,5,single-choice,spatial-relational,4|5,7,4/5,210416,4
6,4,21,417,1,1028,1,7,3,3,4,single-choice,spatial-relational,3|4,7,3/4,210417,3
6,4,21,418,1,758,1,13,6,6,7,single-choice,spatial-relational,6|7,7,6/7,210418,6
6,4,21,419,0,1350,1,3,1,2,2,single-choice,spatial-relational,1|2,7,1/2,210419,1
6,4,21,420,1,2457,1,7,3,3,4,single-choice,spatial-relational,3|4,7,3/4,210420,3
6,4,21,421,1,1959,1,9,4,4,5,single-choice,spatial-relational,4|5,7,4/5,210421,4
6,4,21,422,0,993,1,11,5,6,6,single-choice,spatial-relational,5|6,7,5/6,210422,5
6,4,21,423,1,853,1,5,2,2,3,single-choice,spatial-relational,2|3,7,2/3,210423,2
6,4,21,424,1,1388,1,7,3,3,4,single-choice,spatial-relational,3|4,7,3/4,210424,3
6,4,21,425,1,1019,1,13,6,6,7,single-choice,spatial-relational,6|7,7,6/7,210425,6
6,4,21,426,1,1748,1,7,3,3,4,single-choice,spatial-relational,3|4,7,3/4,210426,3
6,4,21,427,1,1345,1,3,1,1,2,single-choice,spatial-relational,1|2,7,1/2,210427,1
6,4,21,428,0,932,1,3,1,2,2,single-choice,spatial-relational,1|2,7,1/2,210428,1
6,4,21,429,1,1042,1,11,5,5,6,single-choice,spatial-relational,5|6,7,5/6,210429,5
6,4,21,430,0,1427,1,5,2,3,3,single-choice,spatial-relational,2|3,7,2/3,210430,2
6,4,21,431,1,1126,1,9,4,4,5,single-choice,spatial-relational,4|5,7,4/5,210431,4
6,4,21,432,1,710,1,13,6,6,7,single-choice,spatial-relational,6|7,7,6/7,210432,6
6,4,21,433,1,1013,1,13,6,6,7,single-choice,spatial-relational,6|7,7,6/7,210433,6
6,4,21,434,1,1261,1,13,6,6,7,single-choice,spatial-relational,6|7,7,6/7,210434,6
6,4,21,435,1,1742,1,3,1,1,2,single-choice,spatial-relational,1|2,7,1/2,210435,1
6,4,21,436,1,1027,1,9,4,4,5,single-choice,spatial-relational,4|5,7,4/5,210436,4
6,4,21,437,1,1772,1,5,2,2,3,single-choice,spatial-relational,2|3,7,2/3,210437,2
6,4,21,438,0,1131,1,9,4,5,5,single-choice,spatial-relational,4|5,7,4/5,210438,4
6,4,21,439,1,1129,1,11,5,5,6,single-choice,spatial-relational,5|6,7,5/6,210439,5
6,4,21,440,1,1890,1,7,3,3,4,single-choice,spatial-relational,3|4,7,3/4,210440,3
6,4,21,441,1,1032,1,5,2,2,3,single-choice,spatial-relational,2|3,7,2/3,210441,2
6,4,21,442,1,1322,1,3,1,1,2,single-choice,spatial-relational,1|2,7,1/2,210442,1
6,4,21,443,1,883,1,11,5,5,6,single-choice,spatial-relational,5|6,7,5/6,210443,5
6,4,21,444,0,2299,1,7,3,4,4,single-choice,spatial-relational,3|4,7,3/4,210444,3
6,4,21,445,1,1033,1,3,1,1,2,single-choice,spatial-relational,1|2,7,1/2,210445,1
6,4,21,446,1,3574,1,3,1,1,2,single-choice,spatial-relational,1|2,7,1/2,210446,1
6,4,21,447,1,877,1,13,6,6,7,single-choice,spatial-relational,6|7,7,6/7,210447,6
6,4,21,448,1,1915,1,11,5,5,6,single-choice,spatial-relational,5|6,7,5/6,210448,5
6,4,21,449,0,2227,1,5,2,3,3,single-choice,spatial-relational,2|3,7,2/3,210449,2
6,4,21,450,1,1216,1,11,5,5,6,single-choice,spatial-relational,5|6,7,5/6,210450,5
6,4,21,451,1,905,1,7,3,3,4,single-choice,spatial-relational,3|4,7,3/4,210451,3
6,4,21,452,1,1700,1,9,4,4,5,single-choice,spatial-relational,4|5,7,4/5,210452,4
6,4,21,453,1,1441,1,7,3,3,4,single-choice,spatial-relational,3|4,7,3/4,210453,3
6,4,21,454,1,1094,1,5,2,2,3,single-choice,spatial-relational,2|3,7,2/3,210454,2
6,4,21,455,0,1006,1,9,4,5,5,single-choice,spatial-relational,4|5,7,4/5,210455,4
6,4,21,456,1,829,1,13,6,6,7,single-choice,spatial-relational,6|7,7,6/7,210456,6
6,4,21,457,1,1775,1,3,1,1,2,single-choice,spatial-relational,1|2,7,1/2,210457,1
6,4,21,458,1,1358,1,7,3,3,4,single-choice,spatial-relational,3|4,7,3/4,210458,3
6,4,21,459,0,2436,1,9,4,5,5,single-choice,spatial-relational,4|5,7,4/5,210459,4
6,4,21,460,1,3047,1,9,4,4,5,single-choice,spatial-relational,4|5,7,4/5,210460,4
6,4,21,461,1,988,1,3,1,1,2,single-choice,spatial-relational,1|2,7,1/2,210461,1
6,4,21,462,1,844,1,13,6,6,7,single-choice,spatial-relational,6|7,7,6/7,210462,6
6,4,21,463,1,1406,1,5,2,2,3,single-choice,spatial-relational,2|3,7,2/3,210463,2
6,4,21,464,0,1411,1,11,5,6,6,single-choice,spatial-relational,5|6,7,5/6,210464,5
6,4,21,465,1,1066,1,11,5,5,6,single-choice,spatial-relational,5|6,7,5/6,210465,5
6,4,21,466,1,961,1,7,3,3,4,single-choice,spatial-relational,3|4,7,3/4,210466,3
6,4,21,467,1,1088,1,13,6,6,7,single-choice,spatial-relational,6|7,7,6/7,210467,6
6,4,21,468,1,1563,1,5,2,2,3,single-choice,spatial-relational,2|3,7,2/3,210468,2
6,4,21,469,1,1338,1,9,4,4,5,single-choice,spatial-relational,4|5,7,4/5,210469,4
6,4,21,470,1,1320,1,9,4,4,5,single-choice,spatial-relational,4|5,7,4/5,210470,4
6,4,21,471,1,981,1,5,2,2,3,single-choice,spatial-relational,2|3,7,2/3,210471,2
6,4,21,472,1,1228,1,3,1,1,2,single-choice,spatial-relational,1|2,7,1/2,210472,1
6,4,21,473,1,882,1,11,5,5,6,single-choice,spatial-relational,5|6,7,5/6,210473,5
6,4,21,474,0,819,1,3,1,2,2,single-choice,spatial-relational,1|2,7,1/2,210474,1
6,4,21,475,1,985,1,13,6,6,7,single-choice,spatial-relational,6|7,7,6/7,210475,6
6,4,21,476,1,1130,1,13,6,6,7,single-choice,spatial-relational,6|7,7,6/7,210476,6
6,4,21,477,0,973,1,7,3,4,4,single-choice,spatial-relational,3|4,7,3/4,210477,3
6,4,21,478,1,1307,1,11,5,5,6,single-choice,spatial-relational,5|6,7,5/6,210478,5
6,4,21,479,0,812,1,7,3,4,4,single-choice,spatial-relational,3|4,7,3/4,210479,3
6,4,21,480,0,1300,1,5,2,3,3,single-choice,spatial-relational,2|3,7,2/3,210480,2
6,4,21,481,1,732,1,13,6,6,7,single-choice,spatial-relational,6|7,7,6/7,210481,6
6,4,21,482,1,2316,1,9,4,4,5,single-choice,spatial-relational,4|5,7,4/5,210482,4
6,4,21,483,1,1323,1,5,2,2,3,single-choice,spatial-relational,2|3,7,2/3,210483,2
6,4,21,484,1,1190,1,7,3,3,4,single-choice,spatial-relational,3|4,7,3/4,210484,3
6,4,21,485,1,1140,1,13,6,6,7,single-choice,spatial-relational,6|7,7,6/7,210485,6
6,4,21,486,0,1659,1,3,1,2,2,single-choice,spatial-relational,1|2,7,1/2,210486,1
6,4,21,487,1,1134,1,5,2,2,3,single-choice,spatial-relational,2|3,7,2/3,210487,2
6,4,21,488,1,940,1,7,3,3,4,single-choice,spatial-relational,3|4,7,3/4,210488,3
6,4,21,489,1,1110,1,11,5,5,6,single-choice,spatial-relational,5|6,7,5/6,210489,5
6,4,21,490,1,1227,1,3,1,1,2,single-choice,spatial-relational,1|2,7,1/2,210490,1
6,4,21,491,1,964,1,11,5,5,6,single-choice,spatial-relational,5|6,7,5/6,210491,5
6,4,21,492,1,2053,1,9,4,4,5,single-choice,spatial-relational,4|5,7,4/5,210492,4
6,4,21,493,1,2010,1,5,2,2,3,single-choice,spatial-relational,2|3,7,2/3,210493,2
6,4,21,494,1,796,1,13,6,6,7,single-choice,spatial-relational,6|7,7,6/7,210494,6
6,4,21,495,1,1223,1,7,3,3,4,single-choice,spatial-relational,3|4,7,3/4,210495,3
6,4,21,496,1,81975,1,11,5,5,6,single-choice,spatial-relational,5|6,7,5/6,210496,5
6,4,21,497,0,838,1,3,1,2,2,single-choice,spatial-relational,1|2,7,1/2,210497,1
6,4,21,498,1,1038,1,9,4,4,5,single-choice,spatial-relational,4|5,7,4/5,210498,4
6,4,21,499,1,1227,1,13,6,6,7,single-choice,spatial-relational,6|7,7,6/7,210499,6
6,4,21,500,1,1449,1,5,2,2,3,single-choice,spatial-relational,2|3,7,2/3,210500,2
6,4,21,501,0,797,1,3,1,2,2,single-choice,spatial-relational,1|2,7,1/2,210501,1
6,4,21,502,1,920,1,11,5,5,6,single-choice,spatial-relational,5|6,7,5/6,210502,5
6,4,21,503,0,863,1,7,3,4,4,single-choice,spatial-relational,3|4,7,3/4,210503,3
6,4,21,504,1,2956,1,9,4,4,5,single-choice,spatial-relational,4|5,7,4/5,210504,4
6,4,21,505,1,1211,1,7,3,3,4,single-choice,spatial-relational,3|4,7,3/4,210505,3
6,4,21,506,1,891,1,13,6,6,7,single-choice,spatial-relational,6|7,7,6/7,210506,6
6,4,21,507,1,1401,1,3,1,1,2,single-choice,spatial-relational,1|2,7,1/2,210507,1
6,4,21,508,1,1200,1,9,4,4,5,single-choice,spatial-relational,4|5,7,4/5,210508,4
6,4,21,509,0,1093,1,3,1,2,2,single-choice,spatial-relational,1|2,7,1/2,210509,1
6,4,21,510,1,979,1,5,2,2,3,single-choice,spatial-relational,2|3,7,2/3,210510,2
6,4,21,511,1,833,1,11,5,5,6,single-choice,spatial-relational,5|6,7,5/6,210511,5
6,4,21,512,1,1135,1,13,6,6,7,single-choice,spatial-relational,6|7,7,6/7,210512,6
6,4,21,513,1,1073,1,11,5,5,6,single-choice,spatial-relational,5|6,7,5/6,210513,5
6,4,21,514,1,1248,1,7,3,3,4,single-choice,spatial-relational,3|4,7,3/4,210514,3
6,4,21,515,0,950,1,9,4,5,5,single-choice,spatial-relational,4|5,7,4/5,210515,4
6,4,21,516,1,1078,1,5,2,2,3,single-choice,spatial-relational,2|3,7,2/3,210516,2
6,4,21,517,1,1026,1,3,1,1,2,single-choice,spatial-relational,1|2,7,1/2,210517,1
6,4,21,518,1,1441,1,7,3,3,4,single-choice,spatial-relational,3|4,7,3/4,210518,3
6,4,21,519,1,2001,1,7,3,3,4,single-choice,spatial-relational,3|4,7,3/4,210519,3
6,4,21,520,0,1033,1,9,4,5,5,single-choice,spatial-relational,4|5,7,4/5,210520,4
6,4,21,521,0,731,1,3,1,2,2,single-choice,spatial-relational,1|2,7,1/2,210521,1
6,4,21,522,1,1400,1,13,6,6,7,single-choice,spatial-relational,6|7,7,6/7,210522,6
6,4,21,523,1,945,1,11,5,5,6,single-choice,spatial-relational,5|6,7,5/6,210523,5
6,4,21,524,1,1036,1,9,4,4,5,single-choice,spatial-relational,4|5,7,4/5,210524,4
6,4,21,525,1,1920,1,5,2,2,3,single-choice,spatial-relational,2|3,7,2/3,210525,2
6,4,21,526,1,887,1,13,6,6,7,single-choice,spatial-relational,6|7,7,6/7,210526,6
6,4,21,527,1,1021,1,5,2,2,3,single-choice,spatial-relational,2|3,7,2/3,210527,2
6,4,21,528,1,838,1,11,5,5,6,single-choice,spatial-relational,5|6,7,5/6,210528,5
6,4,21,529,1,1541,1,11,5,5,6,single-choice,spatial-relational,5|6,7,5/6,210529,5
6,4,21,530,1,1804,1,9,4,4,5,single-choice,spatial-relational,4|5,7,4/5,210530,4
6,4,21,531,1,1560,1,9,4,4,5,single-choice,spatial-relational,4|5,7,4/5,210531,4
6,4,21,532,0,1303,1,7,3,4,4,single-choice,spatial-relational,3|4,7,3/4,210532,3
6,4,21,533,0,726,1,3,1,2,2,single-choice,spatial-relational,1|2,7,1/2,210533,1
6,4,21,534,1,915,1,5,2,2,3,single-choice,spatial-relational,2|3,7,2/3,210534,2
6,4,21,535,1,1121,1,13,6,6,7,single-choice,spatial-relational,6|7,7,6/7,210535,6
6,4,21,536,1,913,1,7,3,3,4,single-choice,spatial-relational,3|4,7,3/4,210536,3
6,4,21,537,1,1069,1,11,5,5,6,single-choice,spatial-relational,5|6,7,5/6,210537,5
6,4,21,538,1,1003,1,13,6,6,7,single-choice,spatial-relational,6|7,7,6/7,210538,6
6,4,21,539,1,1652,1,3,1,1,2,single-choice,spatial-relational,1|2,7,1/2,210539,1
6,4,21,540,1,1521,1,5,2,2,3,single-choice,spatial-relational,2|3,7,2/3,210540,2
6,4,21,541,1,1076,1,7,3,3,4,single-choice,spatial-relational,3|4,7,3/4,210541,3
6,4,21,542,0,1704,1,9,4,5,5,single-choice,spatial-relational,4|5,7,4/5,210542,4
6,4,21,543,1,1050,1,7,3,3,4,single-choice,spatial-relational,3|4,7,3/4,210543,3
6,4,21,544,1,1649,1,5,2,2,3,single-choice,spatial-relational,2|3,7,2/3,210544,2
6,4,21,545,1,1009,1,11,5,5,6,single-choice,spatial-relational,5|6,7,5/6,210545,5
6,4,21,546,1,934,1,13,6,6,7,single-choice,spatial-relational,6|7,7,6/7,210546,6
6,4,21,547,0,779,1,3,1,2,2,single-choice,spatial-relational,1|2,7,1/2,210547,1
6,4,21,548,1,930,1,3,1,1,2,single-choice,spatial-relational,1|2,7,1/2,210548,1
6,4,21,549,1,813,1,13,6,6,7,single-choice,spatial-relational,6|7,7,6/7,210549,6
6,4,21,550,1,1589,1,9,4,4,5,single-choice,spatial-relational,4|5,7,4/5,210550,4
6,4,21,551,1,1060,1,5,2,2,3,single-choice,spatial-relational,2|3,7,2/3,210551,2
6,4,21,552,1,1283,1,11,5,5,6,single-choice,spatial-relational,5|6,7,5/6,210552,5
6,4,21,553,1,1371,1,13,6,6,7,single-choice,spatial-relational,6|7,7,6/7,210553,6
6,4,21,554,1,1272,1,7,3,3,4,single-choice,spatial-relational,3|4,7,3/4,210554,3
6,4,21,555,1,1034,1,5,2,2,3,single-choice,spatial-relational,2|3,7,2/3,210555,2
6,4,21,556,0,1029,1,3,1,2,2,single-choice,spatial-relational,1|2,7,1/2,210556,1
6,4,21,557,1,795,1,11,5,5,6,single-choice,spatial-relational,5|6,7,5/6,210557,5
6,4,21,558,1,717,1,13,6,6,7,single-choice,spatial-relational,6|7,7,6/7,210558,6
6,4,21,559,1,1426,1,5,2,2,3,single-choice,spatial-relational,2|3,7,2/3,210559,2
6,4,21,560,1,1518,1,9,4,4,5,single-choice,spatial-relational,4|5,7,4/5,210560,4
6,4,21,561,1,1675,1,9,4,4,5,single-choice,spatial-relational,4|5,7,4/5,210561,4
6,4,21,562,1,1476,1,3,1,1,2,single-choice,spatial-relational,1|2,7,1/2,210562,1
6,4,21,563,1,889,1,7,3,3,4,single-choice,spatial-relational,3|4,7,3/4,210563,3
6,4,21,564,0,1015,1,11,5,6,6,single-choice,spatial-relational,5|6,7,5/6,210564,5
6,4,21,565,1,693,1,3,1,1,2,single-choice,spatial-relational,1|2,7,1/2,210565,1
6,4,21,566,1,905,1,11,5,5,6,single-choice,spatial-relational,5|6,7,5/6,210566,5
6,4,21,567,1,1257,1,3,1,1,2,single-choice,spatial-relational,1|2,7,1/2,210567,1
6,4,21,568,1,895,1,5,2,2,3,single-choice,spatial-relational,2|3,7,2/3,210568,2
6,4,21,569,1,904,1,13,6,6,7,single-choice,spatial-relational,6|7,7,6/7,210569,6
6,4,21,570,0,657,1,5,2,3,3,single-choice,spatial-relational,2|3,7,2/3,210570,2
6,4,21,571,1,1238,1,9,4,4,5,single-choice,spatial-relational,4|5,7,4/5,210571,4
6,4,21,572,1,3470,1,7,3,3,4,single-choice,spatial-relational,3|4,7,3/4,210572,3
6,4,21,573,0,1063,1,7,3,4,4,single-choice,spatial-relational,3|4,7,3/4,210573,3
6,4,21,574,0,1300,1,9,4,5,5,single-choice,spatial-relational,4|5,7,4/5,210574,4
6,4,21,575,1,1126,1,13,6,6,7,single-choice,spatial-relational,6|7,7,6/7,210575,6
6,4,21,576,1,818,1,11,5,5,6,single-choice,spatial-relational,5|6,7,5/6,210576,5
6,4,21,577,1,1402,1,3,1,1,2,single-choice,spatial-relational,1|2,7,1/2,210577,1
6,4,21,578,1,885,1,9,4,4,5,single-choice,spatial-relational,4|5,7,4/5,210578,4
6,4,21,579,1,1801,1,7,3,3,4,single-choice,spatial-relational,3|4,7,3/4,210579,3
6,4,21,580,1,1088,1,5,2,2,3,single-choice,spatial-relational,2|3,7,2/3,210580,2
6,4,21,581,1,999,1,11,5,5,6,single-choice,spatial-relational,5|6,7,5/6,210581,5
6,4,21,582,1,2080,1,9,4,4,5,single-choice,spatial-relational,4|5,7,4/5,210582,4
6,4,21,583,1,1221,1,11,5,5,6,single-choice,spatial-relational,5|6,7,5/6,210583,5
6,4,21,584,1,1787,1,5,2,2,3,single-choice,spatial-relational,2|3,7,2/3,210584,2
6,4,21,585,1,765,1,13,6,6,7,single-choice,spatial-relational,6|7,7,6/7,210585,6
6,4,21,586,1,1302,1,3,1,1,2,single-choice,spatial-relational,1|2,7,1/2,210586,1
6,4,21,587,1,902,1,7,3,3,4,single-choice,spatial-relational,3|4,7,3/4,210587,3
6,4,21,588,1,703,1,13,6,6,7,single-choice,spatial-relational,6|7,7,6/7,210588,6
6,4,21,589,1,2421,1,7,3,3,4,single-choice,spatial-relational,3|4,7,3/4,210589,3
6,4,21,590,1,1033,1,3,1,1,2,single-choice,spatial-relational,1|2,7,1/2,210590,1
6,4,21,591,1,644,1,13,6,6,7,single-choice,spatial-relational,6|7,7,6/7,210591,6
6,4,21,592,0,903,1,11,5,6,6,single-choice,spatial-relational,5|6,7,5/6,210592,5
6,4,21,593,1,989,1,5,2,2,3,single-choice,spatial-relational,2|3,7,2/3,210593,2
6,4,21,594,1,1232,1,9,4,4,5,single-choice,spatial-relational,4|5,7,4/5,210594,4
6,4,21,595,1,1151,1,3,1,1,2,single-choice,spatial-relational,1|2,7,1/2,210595,1
6,4,21,596,1,1007,1,7,3,3,4,single-choice,spatial-relational,3|4,7,3/4,210596,3
6,4,21,597,1,831,1,13,6,6,7,single-choice,spatial-relational,6|7,7,6/7,210597,6
6,4,21,598,1,2542,1,9,4,4,5,single-choice,spatial-relational,4|5,7,4/5,210598,4
6,4,21,599,1,1428,1,11,5,5,6,single-choice,spatial-relational,5|6,7,5/6,210599,5
6,4,21,600,1,977,1,5,2,2,3,single-choice,spatial-relational,2|3,7,2/3,210600,2
7,4,21,1,0,512,1,5,2,3,3,single-choice,spatial-relational,2|3,7,2/3,210001,2
7,4,21,2,1,16,1,7,3,3,4,single-choice,spatial-relational,3|4,7,3/4,210002,3
7,4,21,3,1,533,1,13,6,6,7,single-choice,spatial-relational,6|7,7,6/7,210003,6
7,4,21,4,0,642,1,9,4,5,5,single-choice,spatial-relational,4|5,7,4/5,210004,4
7,4,21,5,1,875,1,13,6,6,7,single-choice,spatial-relational,6|7,7,6/7,210005,6
7,4,21,6,0,804,1,5,2,3,3,single-choice,spatial-relational,2|3,7,2/3,210006,2
7,4,21,7,0,697,1,11,5,6,6,single-choice,spatial-relational,5|6,7,5/6,210007,5
7,4,21,8,0,777,1,3,1,2,2,single-choice,spatial-relational,1|2,7,1/2,210008,1
7,4,21,9,1,515,1,9,4,4,5,single-choice,spatial-relational,4|5,7,4/5,210009,4
7,4,21,10,0,718,1,11,5,6,6,single-choice,spatial-relational,5|6,7,5/6,210010,5
7,4,21,11,0,614,1,7,3,4,4,single-choice,spatial-relational,3|4,7,3/4,210011,3
7,4,21,12,0,796,1,3,1,2,2,single-choice,spatial-relational,1|2,7,1/2,210012,1
7,4,21,13,0,880,1,11,5,6,6,single-choice,spatial-relational,5|6,7,5/6,210013,5
7,4,21,14,0,1153,1,13,6,7,7,single-choice,spatial-relational,6|7,7,6/7,210014,6
7,4,21,15,0,626,1,11,5,6,6,single-choice,spatial-relational,5|6,7,5/6,210015,5
7,4,21,16,0,791,1,3,1,2,2,single-choice,spatial-relational,1|2,7,1/2,210016,1
7,4,21,17,1,1045,1,13,6,6,7,single-choice,spatial-relational,6|7,7,6/7,210017,6
7,4,21,18,0,760,1,5,2,3,3,single-choice,spatial-relational,2|3,7,2/3,210018,2
7,4,21,19,1,1046,1,9,4,4,5,single-choice,spatial-relational,4|5,7,4/5,210019,4
7,4,21,20,0,806,1,3,1,2,2,single-choice,spatial-relational,1|2,7,1/2,210020,1
7,4,21,21,1,1045,1,9,4,4,5,single-choice,spatial-relational,4|5,7,4/5,210021,4
7,4,21,22,0,833,1,7,3,4,4,single-choice,spatial-relational,3|4,7,3/4,210022,3
7,4,21,23,1,1143,1,5,2,2,3,single-choice,spatial-relational,2|3,7,2/3,210023,2
7,4,21,24,1,814,1,7,3,3,4,single-choice,spatial-relational,3|4,7,3/4,210024,3
7,4,21,25,1,789,1,9,4,4,5,single-choice,spatial-relational,4|5,7,4/5,210025,4
7,4,21,26,0,714,1,3,1,2,2,single-choice,spatial-relational,1|2,7,1/2,210026,1
7,4,21,27,1,991,1,11,5,5,6,single-choice,spatial-relational,5|6,7,5/6,210027,5
7,4,21,28,1,1138,1,5,2,2,3,single-choice,spatial-relational,2|3,7,2/3,210028,2
7,4,21,29,1,876,1,11,5,5,6,single-choice,spatial-relational,5|6,7,5/6,210029,5
7,4,21,30,1,1178,1,7,3,3,4,single-choice,spatial-relational,3|4,7,3/4,210030,3
7,4,21,31,1,785,1,7,3,3,4,single-choice,spatial-relational,3|4,7,3/4,210031,3
7,4,21,32,0,852,1,9,4,5,5,single-choice,spatial-relational,4|5,7,4/5,210032,4
7,4,21,33,1,933,1,13,6,6,7,single-choice,spatial-relational,6|7,7,6/7,210033,6
7,4,21,34,1,1152,1,13,6,6,7,single-choice,spatial-relational,6|7,7,6/7,210034,6
7,4,21,35,0,772,1,3,1,2,2,single-choice,spatial-relational,1|2,7,1/2,210035,1
7,4,21,36,0,1423,1,5,2,3,3,single-choice,spatial-relational,2|3,7,2/3,210036,2
7,4,21,37,0,715,1,3,1,2,2,single-choice,spatial-relational,1|2,7,1/2,210037,1
7,4,21,38,1,926,1,13,6,6,7,single-choice,spatial-relational,6|7,7,6/7,210038,6
7,4,21,39,0,800,1,7,3,4,4,single-choice,spatial-relational,3|4,7,3/4,210039,3
7,4,21,40,0,853,1,9,4,5,5,single-choice,spatial-relational,4|5,7,4/5,210040,4
7,4,21,41,0,1183,1,5,2,3,3,single-choice,spatial-relational,2|3,7,2/3,210041,2
7,4,21,42,1,1020,1,13,6,6,7,single-choice,spatial-relational,6|7,7,6/7,210042,6
7,4,21,43,1,929,1,3,1,1,2,single-choice,spatial-relational,1|2,7,1/2,210043,1
7,4,21,44,0,703,1,9,4,5,5,single-choice,spatial-relational,4|5,7,4/5,210044,4
7,4,21,45,1,12,1,7,3,3,4,single-choice,spatial-relational,3|4,7,3/4,210045,3
7,4,21,46,1,916,1,5,2,2,3,single-choice,spatial-relational,2|3,7,2/3,210046,2
7,4,21,47,0,985,1,11,5,6,6,single-choice,spatial-relational,5|6,7,5/6,210047,5
7,4,21,48,1,1330,1,11,5,5,6,single-choice,spatial-relational,5|6,7,5/6,210048,5
7,4,21,49,1,1256,1,11,5,5,6,single-choice,spatial-relational,5|6,7,5/6,210049,5
7,4,21,50,0,902,1,3,1,2,2,single-choice,spatial-relational,1|2,7,1/2,210050,1
7,4,21,51,1,1204,1,7,3,3,4,single-choice,spatial-relational,3|4,7,3/4,210051,3
7,4,21,52,1,890,1,9,4,4,5,single-choice,spatial-relational,4|5,7,4/5,210052,4
7,4,21,53,1,854,1,7,3,3,4,single-choice,spatial-relational,3|4,7,3/4,210053,3
7,4,21,54,0,785,1,9,4,5,5,single-choice,spatial-relational,4|5,7,4/5,210054,4
7,4,21,55,1,1039,1,3,1,1,2,single-choice,spatial-relational,1|2,7,1/2,210055,1
7,4,21,56,0,723,1,11,5,6,6,single-choice,spatial-relational,5|6,7,5/6,210056,5
7,4,21,57,1,749,1,5,2,2,3,single-choice,spatial-relational,2|3,7,2/3,210057,2
7,4,21,58,1,791,1,5,2,2,3,single-choice,spatial-relational,2|3,7,2/3,210058,2
7,4,21,59,1,796,1,13,6,6,7,single-choice,spatial-relational,6|7,7,6/7,210059,6
7,4,21,60,1,1123,1,13,6,6,7,single-choice,spatial-relational,6|7,7,6/7,210060,6
7,4,21,61,1,1469,1,9,4,4,5,single-choice,spatial-relational,4|5,7,4/5,210061,4
7,4,21,62,1,927,1,7,3,3,4,single-choice,spatial-relational,3|4,7,3/4,210062,3
7,4,21,63,0,1034,1,9,4,5,5,single-choice,spatial-relational,4|5,7,4/5,210063,4
7,4,21,64,0,687,1,5,2,3,3,single-choice,spatial-relational,2|3,7,2/3,210064,2
7,4,21,65,0,1198,1,11,5,6,6,single-choice,spatial-relational,5|6,7,5/6,210065,5
7,4,21,66,1,742,1,7,3,3,4,single-choice,spatial-relational,3|4,7,3/4,210066,3
7,4,21,67,1,762,1,3,1,1,2,single-choice,spatial-relational,1|2,7,1/2,210067,1
7,4,21,68,1,707,1,5,2,2,3,single-choice,spatial-relational,2|3,7,2/3,210068,2
7,4,21,69,0,674,1,3,1,2,2,single-choice,spatial-relational,1|2,7,1/2,210069,1
7,4,21,70,1,863,1,13,6,6,7,single-choice,spatial-relational,6|7,7,6/7,210070,6
7,4,21,71,1,1086,1,13,6,6,7,single-choice,spatial-relational,6|7,7,6/7,210071,6
7,4,21,72,1,1323,1,11,5,5,6,single-choice,spatial-relational,5|6,7,5/6,210072,5
7,4,21,73,1,1009,1,5,2,2,3,single-choice,spatial-relational,2|3,7,2/3,210073,2
7,4,21,74,0,766,1,3,1,2,2,single-choice,spatial-relational,1|2,7,1/2,210074,1
7,4,21,75,1,1241,1,7,3,3,4,single-choice,spatial-relational,3|4,7,3/4,210075,3
7,4,21,76,0,865,1,11,5,6,6,single-choice,spatial-relational,5|6,7,5/6,210076,5
7,4,21,77,1,1220,1,3,1,1,2,single-choice,spatial-relational,1|2,7,1/2,210077,1
7,4,21,78,1,790,1,5,2,2,3,single-choice,spatial-relational,2|3,7,2/3,210078,2
7,4,21,79,0,623,1,11,5,6,6,single-choice,spatial-relational,5|6,7,5/6,210079,5
7,4,21,80,1,803,1,7,3,3,4,single-choice,spatial-relational,3|4,7,3/4,210080,3
7,4,21,81,1,1134,1,9,4,4,5,single-choice,spatial-relational,4|5,7,4/5,210081,4
7,4,21,82,1,1242,1,13,6,6,7,single-choice,spatial-relational,6|7,7,6/7,210082,6
7,4,21,83,1,1236,1,9,4,4,5,single-choice,spatial-relational,4|5,7,4/5,210083,4
7,4,21,84,1,1220,1,13,6,6,7,single-choice,spatial-relational,6|7,7,6/7,210084,6
7,4,21,85,0,697,1,3,1,2,2,single-choice,spatial-relational,1|2,7,1/2,210085,1
7,4,21,86,0,892,1,9,4,5,5,single-choice,spatial-relational,4|5,7,4/5,210086,4
7,4,21,87,0,1112,1,7,3,4,4,single-choice,spatial-relational,3|4,7,3/4,210087,3
7,4,21,88,1,941,1,13,6,6,7,single-choice,spatial-relational,6|7,7,6/7,210088,6
7,4,21,89,1,874,1,7,3,3,4,single-choice,spatial-relational,3|4,7,3/4,210089,3
7,4,21,90,0,1132,1,11,5,6,6,single-choice,spatial-relational,5|6,7,5/6,210090,5
7,4,21,91,1,851,1,5,2,2,3,single-choice,spatial-relational,2|3,7,2/3,210091,2
7,4,21,92,0,1020,1,9,4,5,5,single-choice,spatial-relational,4|5,7,4/5,210092,4
7,4,21,93,0,751,1,5,2,3,3,single-choice,spatial-relational,2|3,7,2/3,210093,2
7,4,21,94,0,782,1,13,6,7,7,single-choice,spatial-relational,6|7,7,6/7,210094,6
7,4,21,95,1,896,1,3,1,1,2,single-choice,spatial-relational,1|2,7,1/2,210095,1
7,4,21,96,0,907,1,11,5,6,6,single-choice,spatial-relational,5|6,7,5/6,210096,5
7,4,21,97,1,934,1,13,6,6,7,single-choice,spatial-relational,6|7,7,6/7,210097,6
7,4,21,98,1,916,1,5,2,2,3,single-choice,spatial-relational,2|3,7,2/3,210098,2
7,4,21,99,1,727,1,11,5,5,6,single-choice,spatial-relational,5|6,7,5/6,210099,5
7,4,21,100,1,1143,1,11,5,5,6,single-choice,spatial-relational,5|6,7,5/6,210100,5
7,4,21,101,1,879,1,7,3,3,4,single-choice,spatial-relational,3|4,7,3/4,210101,3
7,4,21,102,1,921,1,9,4,4,5,single-choice,spatial-relational,4|5,7,4/5,210102,4
7,4,21,103,1,1174,1,5,2,2,3,single-choice,spatial-relational,2|3,7,2/3,210103,2
7,4,21,104,1,836,1,13,6,6,7,single-choice,spatial-relational,6|7,7,6/7,210104,6
7,4,21,105,0,664,1,3,1,2,2,single-choice,spatial-relational,1|2,7,1/2,210105,1
7,4,21,106,0,1273,1,7,3,4,4,single-choice,spatial-relational,3|4,7,3/4,210106,3
7,4,21,107,1,899,1,3,1,1,2,single-choice,spatial-relational,1|2,7,1/2,210107,1
7,4,21,108,1,839,1,9,4,4,5,single-choice,spatial-relational,4|5,7,4/5,210108,4
7,4,21,109,1,1326,1,13,6,6,7,single-choice,spatial-relational,6|7,7,6/7,210109,6
7,4,21,110,1,780,1,9,4,4,5,single-choice,spatial-relational,4|5,7,4/5,210110,4
7,4,21,111,1,1196,1,11,5,5,6,single-choice,spatial-relational,5|6,7,5/6,210111,5
7,4,21,112,1,801,1,11,5,5,6,single-choice,spatial-relational,5|6,7,5/6,210112,5
7,4,21,113,0,693,1,3,1,2,2,single-choice,spatial-relational,1|2,7,1/2,210113,1
7,4,21,114,0,1019,1,9,4,5,5,single-choice,spatial-relational,4|5,7,4/5,210114,4
7,4,21,115,1,967,1,3,1,1,2,single-choice,spatial-relational,1|2,7,1/2,210115,1
7,4,21,116,0,881,1,7,3,4,4,single-choice,spatial-relational,3|4,7,3/4,210116,3
7,4,21,117,1,1039,1,13,6,6,7,single-choice,spatial-relational,6|7,7,6/7,210117,6
7,4,21,118,1,878,1,5,2,2,3,single-choice,spatial-relational,2|3,7,2/3,210118,2
7,4,21,119,0,802,1,7,3,4,4,single-choice,spatial-relational,3|4,7,3/4,210119,3
7,4,21,120,1,874,1,5,2,2,3,single-choice,spatial-relational,2|3,7,2/3,210120,2
7,4,21,121,0,711,1,9,4,5,5,single-choice,spatial-relational,4|5,7,4/5,210121,4
7,4,21,122,1,864,1,3,1,1,2,single-choice,spatial-relational,1|2,7,1/2,210122,1
7,4,21,123,1,1447,1,7,3,3,4,single-choice,spatial-relational,3|4,7,3/4,210123,3
7,4,21,124,1,916,1,5,2,2,3,single-choice,spatial-relational,2|3,7,2/3,210124,2
7,4,21,125,0,802,1,11,5,6,6,single-choice,spatial-relational,5|6,7,5/6,210125,5
7,4,21,126,1,950,1,3,1,1,2,single-choice,spatial-relational,1|2,7,1/2,210126,1
7,4,21,127,0,807,1,13,6,7,7,single-choice,spatial-relational,6|7,7,6/7,210127,6
7,4,21,128,0,780,1,9,4,5,5,single-choice,spatial-relational,4|5,7,4/5,210128,4
7,4,21,129,1,1092,1,13,6,6,7,single-choice,spatial-relational,6|7,7,6/7,210129,6
7,4,21,130,1,1022,1,5,2,2,3,single-choice,spatial-relational,2|3,7,2/3,210130,2
7,4,21,131,0,631,1,11,5,6,6,single-choice,spatial-relational,5|6,7,5/6,210131,5
7,4,21,132,1,1263,1,7,3,3,4,single-choice,spatial-relational,3|4,7,3/4,210132,3
7,4,21,133,1,1239,1,13,6,6,7,single-choice,spatial-relational,6|7,7,6/7,210133,6
7,4,21,134,0,847,1,9,4,5,5,single-choice,spatial-relational,4|5,7,4/5,210134,4
7,4,21,135,0,1002,1,9,4,5,5,single-choice,spatial-relational,4|5,7,4/5,210135,4
7,4,21,136,1,945,1,3,1,1,2,single-choice,spatial-relational,1|2,7,1/2,210136,1
7,4,21,137,1,1264,1,7,3,3,4,single-choice,spatial-relational,3|4,7,3/4,210137,3
7,4,21,138,0,1151,1,5,2,3,3,single-choice,spatial-relational,2|3,7,2/3,210138,2
7,4,21,139,0,894,1,11,5,6,6,single-choice,spatial-relational,5|6,7,5/6,210139,5
7,4,21,140,0,1174,1,11,5,6,6,single-choice,spatial-relational,5|6,7,5/6,210140,5
7,4,21,141,1,945,1,5,2,2,3,single-choice,spatial-relational,2|3,7,2/3,210141,2
7,4,21,142,1,947,1,13,6,6,7,single-choice,spatial-relational,6|7,7,6/7,210142,6
7,4,21,143,0,1245,1,7,3,4,4,single-choice,spatial-relational,3|4,7,3/4,210143,3
7,4,21,144,1,975,1,3,1,1,2,single-choice,spatial-relational,1|2,7,1/2,210144,1
7,4,21,145,1,891,1,3,1,1,2,single-choice,spatial-relational,1|2,7,1/2,210145,1
7,4,21,146,0,1718,1,11,5,6,6,single-choice,spatial-relational,5|6,7,5/6,210146,5
7,4,21,147,1,817,1,3,1,1,2,single-choice,spatial-relational,1|2,7,1/2,210147,1
7,4,21,148,0,894,1,9,4,5,5,single-choice,spatial-relational,4|5,7,4/5,210148,4
7,4,21,149,0,851,1,13,6,7,7,single-choice,spatial-relational,6|7,7,6/7,210149,6
7,4,21,150,1,854,1,7,3,3,4,single-choice,spatial-relational,3|4,7,3/4,210150,3
7,4,21,151,1,1047,1,13,6,6,7,single-choice,spatial-relational,6|7,7,6/7,210151,6
7,4,21,152,1,795,1,5,2,2,3,single-choice,spatial-relational,2|3,7,2/3,210152,2
7,4,21,153,0,961,1,9,4,5,5,single-choice,spatial-relational,4|5,7,4/5,210153,4
7,4,21,154,1,1249,1,11,5,5,6,single-choice,spatial-relational,5|6,7,5/6,210154,5
7,4,21,155,1,1085,1,7,3,3,4,single-choice,spatial-relational,3|4,7,3/4,210155,3
7,4,21,156,1,724,1,5,2,2,3,single-choice,spatial-relational,2|3,7,2/3,210156,2
7,4,21,157,0,811,1,9,4,5,5,single-choice,spatial-relational,4|5,7,4/5,210157,4
7,4,21,158,0,914,1,13,6,7,7,single-choice,spatial-relational,6|7,7,6/7,210158,6
7,4,21,159,1,1014,1,11,5,5,6,single-choice,spatial-relational,5|6,7,5/6,210159,5
7,4,21,160,1,952,1,3,1,1,2,single-choice,spatial-relational,1|2,7,1/2,210160,1
7,4,21,161,1,869,1,5,2,2,3,single-choice,spatial-relational,2|3,7,2/3,210161,2
7,4,21,162,0,1294,1,7,3,4,4,single-choice,spatial-relational,3|4,7,3/4,210162,3
7,4,21,163,1,1293,1,7,3,3,4,single-choice,spatial-relational,3|4,7,3/4,210163,3
7,4,21,164,0,934,1,11,5,6,6,single-choice,spatial-relational,5|6,7,5/6,210164,5
7,4,21,165,1,1124,1,9,4,4,5,single-choice,spatial-relational,4|5,7,4/5,210165,4
7,4,21,166,1,1210,1,5,2,2,3,single-choice,spatial-relational,2|3,7,2/3,210166,2
7,4,21,167,1,888,1,13,6,6,7,single-choice,spatial-relational,6|7,7,6/7,210167,6
7,4,21,168,0,738,1,3,1,2,2,single-choice,spatial-relational,1|2,7,1/2,210168,1
7,4,21,169,1,903,1,7,3,3,4,single-choice,spatial-relational,3|4,7,3/4,210169,3
7,4,21,170,1,878,1,5,2,2,3,single-choice,spatial-relational,2|3,7,2/3,210170,2
7,4,21,171,1,817,1,13,6,6,7,single-choice,spatial-relational,6|7,7,6/7,210171,6
7,4,21,172,0,809,1,9,4,5,5,single-choice,spatial-relational,4|5,7,4/5,210172,4
7,4,21,173,1,1263,1,11,5,5,6,single-choice,spatial-relational,5|6,7,5/6,210173,5
7,4,21,174,1,1241,1,13,6,6,7,single-choice,spatial-relational,6|7,7,6/7,210174,6
7,4,21,175,1,1333,1,11,5,5,6,single-choice,spatial-relational,5|6,7,5/6,210175,5
7,4,21,176,0,1054,1,5,2,3,3,single-choice,spatial-relational,2|3,7,2/3,210176,2
7,4,21,177,0,906,1,9,4,5,5,single-choice,spatial-relational,4|5,7,4/5,210177,4
7,4,21,178,1,900,1,3,1,1,2,single-choice,spatial-relational,1|2,7,1/2,210178,1
7,4,21,179,1,706,1,3,1,1,2,single-choice,spatial-relational,1|2,7,1/2,210179,1
7,4,21,180,1,1048,1,7,3,3,4,single-choice,spatial-relational,3|4,7,3/4,210180,3
7,4,21,181,1,825,1,5,2,2,3,single-choice,spatial-relational,2|3,7,2/3,210181,2
7,4,21,182,0,1207,1,7,3,4,4,single-choice,spatial-relational,3|4,7,3/4,210182,3
7,4,21,183,1,1286,1,13,6,6,7,single-choice,spatial-relational,6|7,7,6/7,210183,6
7,4,21,184,1,1144,1,9,4,4,5,single-choice,spatial-relational,4|5,7,4/5,210184,4
7,4,21,185,1,828,1,3,1,1,2,single-choice,spatial-relational,1|2,7,1/2,210185,1
7,4,21,186,1,1065,1,13,6,6,7,single-choice,spatial-relational,6|7,7,6/7,210186,6
7,4,21,187,0,1141,1,9,4,5,5,single-choice,spatial-relational,4|5,7,4/5,210187,4
7,4,21,188,1,1306,1,11,5,5,6,single-choice,spatial-relational,5|6,7,5/6,210188,5
7,4,21,189,1,956,1,5,2,2,3,single-choice,spatial-relational,2|3,7,2/3,210189,2
7,4,21,190,1,812,1,11,5,5,6,single-choice,spatial-relational,5|6,7,5/6,210190,5
7,4,21,191,1,826,1,7,3,3,4,single-choice,spatial-relational,3|4,7,3/4,210191,3
7,4,21,192,0,735,1,3,1,2,2,single-choice,spatial-relational,1|2,7,1/2,210192,1
7,4,21,193,0,1311,1,5,2,3,3,single-choice,spatial-relational,2|3,7,2/3,210193,2
7,4,21,194,1,1009,1,7,3,3,4,single-choice,spatial-relational,3|4,7,3/4,210194,3
7,4,21,195,1,998,1,7,3,3,4,single-choice,spatial-relational,3|4,7,3/4,210195,3
7,4,21,196,1,1901,1,9,4,4,5,single-choice,spatial-relational,4|5,7,4/5,210196,4
7,4,21,197,0,1223,1,5,2,3,3,single-choice,spatial-relational,2|3,7,2/3,210197,2
7,4,21,198,0,1403,1,11,5,6,6,single-choice,spatial-relational,5|6,7,5/6,210198,5
7,4,21,199,1,979,1,9,4,4,5,single-choice,spatial-relational,4|5,7,4/5,210199,4
7,4,21,200,1,1238,1,13,6,6,7,single-choice,spatial-relational,6|7,7,6/7,210200,6
7,4,21,201,1,891,1,3,1,1,2,single-choice,spatial-relational,1|2,7,1/2,210201,1
7,4,21,202,0,770,1,11,5,6,6,single-choice,spatial-relational,5|6,7,5/6,210202,5
7,4,21,203,1,957,1,3,1,1,2,single-choice,spatial-relational,1|2,7,1/2,210203,1
7,4,21,204,1,784,1,13,6,6,7,single-choice,spatial-relational,6|7,7,6/7,210204,6
7,4,21,205,1,768,1,3,1,1,2,single-choice,spatial-relational,1|2,7,1/2,210205,1
7,4,21,206,1,860,1,7,3,3,4,single-choice,spatial-relational,3|4,7,3/4,210206,3
7,4,21,207,0,1476,1,11,5,6,6,single-choice,spatial-relational,5|6,7,5/6,210207,5
7,4,21,208,1,1121,1,13,6,6,7,single-choice,spatial-relational,6|7,7,6/7,210208,6
7,4,21,209,1,1014,1,5,2,2,3,single-choice,spatial-relational,2|3,7,2/3,210209,2
7,4,21,210,0,929,1,9,4,5,5,single-choice,spatial-relational,4|5,7,4/5,210210,4
7,4,21,211,1,822,1,3,1,1,2,single-choice,spatial-relational,1|2,7,1/2,210211,1
7,4,21,212,1,891,1,7,3,3,4,single-choice,spatial-relational,3|4,7,3/4,210212,3
7,4,21,213,0,760,1,9,4,5,5,single-choice,spatial-relational,4|5,7,4/5,210213,4
7,4,21,214,1,1926,1,13,6,6,7,single-choice,spatial-relational,6|7,7,6/7,210214,6
7,4,21,215,0,1706,1,11,5,6,6,single-choice,spatial-relational,5|6,7,5/6,210215,5
7,4,21,216,0,1255,1,5,2,3,3,single-choice,spatial-relational,2|3,7,2/3,210216,2
7,4,21,217,1,1428,1,9,4,4,5,single-choice,spatial-relational,4|5,7,4/5,210217,4
7,4,21,218,0,744,1,3,1,2,2,single-choice,spatial-relational,1|2,7,1/2,210218,1
7,4,21,219,0,1539,1,7,3,4,4,single-choice,spatial-relational,3|4,7,3/4,210219,3
7,4,21,220,1,886,1,5,2,2,3,single-choice,spatial-relational,2|3,7,2/3,210220,2
7,4,21,221,0,1702,1,11,5,6,6,single-choice,spatial-relational,5|6,7,5/6,210221,5
7,4,21,222,0,1018,1,11,5,6,6,single-choice,spatial-relational,5|6,7,5/6,210222,5
7,4,21,223,1,901,1,9,4,4,5,single-choice,spatial-relational,4|5,7,4/5,210223,4
7,4,21,224,1,1066,1,3,1,1,2,single-choice,spatial-relational,1|2,7,1/2,210224,1
7,4,21,225,1,830,1,5,2,2,3,single-choice,spatial-relational,2|3,7,2/3,210225,2
7,4,21,226,1,1202,1,13,6,6,7,single-choice,spatial-relational,6|7,7,6/7,210226,6
7,4,21,227,1,889,1,13,6,6,7,single-choice,spatial-relational,6|7,7,6/7,210227,6
7,4,21,228,1,1228,1,7,3,3,4,single-choice,spatial-relational,3|4,7,3/4,210228,3
7,4,21,229,1,1038,1,11,5,5,6,single-choice,spatial-relational,5|6,7,5/6,210229,5
7,4,21,230,1,1395,1,13,6,6,7,single-choice,spatial-relational,6|7,7,6/7,210230,6
7,4,21,231,0,876,1,5,2,3,3,single-choice,spatial-relational,2|3,7,2/3,210231,2
7,4,21,232,1,977,1,5,2,2,3,single-choice,spatial-relational,2|3,7,2/3,210232,2
7,4,21,233,1,1757,1,13,6,6,7,single-choice,spatial-relational,6|7,7,6/7,210233,6
7,4,21,234,1,1398,1,9,4,4,5,single-choice,spatial-relational,4|5,7,4/5,210234,4
7,4,21,235,1,1013,1,3,1,1,2,single-choice,spatial-relational,1|2,7,1/2,210235,1
7,4,21,236,1,661,1,3,1,1,2,single-choice,spatial-relational,1|2,7,1/2,210236,1
7,4,21,237,1,1156,1,7,3,3,4,single-choice,spatial-relational,3|4,7,3/4,210237,3
7,4,21,238,1,792,1,11,5,5,6,single-choice,spatial-relational,5|6,7,5/6,210238,5
7,4,21,239,0,836,1,9,4,5,5,single-choice,spatial-relational,4|5,7,4/5,210239,4
7,4,21,240,1,944,1,7,3,3,4,single-choice,spatial-relational,3|4,7,3/4,210240,3
7,4,21,241,1,1342,1,11,5,5,6,single-choice,spatial-relational,5|6,7,5/6,210241,5
7,4,21,242,0,1262,1,13,6,7,7,single-choice,spatial-relational,6|7,7,6/7,210242,6
7,4,21,243,1,1450,1,7,3,3,4,single-choice,spatial-relational,3|4,7,3/4,210243,3
7,4,21,244,0,774,1,3,1,2,2,single-choice,spatial-relational,1|2,7,1/2,210244,1
7,4,21,245,0,136,1,11,5,6,6,single-choice,spatial-relational,5|6,7,5/6,210245,5
7,4,21,246,1,1067,1,9,4,4,5,single-choice,spatial-relational,4|5,7,4/5,210246,4
7,4,21,247,1,1056,1,13,6,6,7,single-choice,spatial-relational,6|7,7,6/7,210247,6
7,4,21,248,1,1166,1,7,3,3,4,single-choice,spatial-relational,3|4,7,3/4,210248,3
7,4,21,249,0,2024,1,9,4,5,5,single-choice,spatial-relational,4|5,7,4/5,210249,4
7,4,21,250,0,670,1,5,2,3,3,single-choice,spatial-relational,2|3,7,2/3,210250,2
7,4,21,251,1,797,1,5,2,2,3,single-choice,spatial-relational,2|3,7,2/3,210251,2
7,4,21,252,1,825,1,3,1,1,2,single-choice,spatial-relational,1|2,7,1/2,210252,1
7,4,21,253,1,857,1,7,3,3,4,single-choice,spatial-relational,3|4,7,3/4,210253,3
7,4,21,254,1,907,1,5,2,2,3,single-choice,spatial-relational,2|3,7,2/3,210254,2
7,4,21,255,0,1158,1,9,4,5,5,single-choice,spatial-relational,4|5,7,4/5,210255,4
7,4,21,256,0,1083,1,11,5,6,6,single-choice,spatial-relational,5|6,7,5/6,210256,5
7,4,21,257,1,892,1,11,5,5,6,single-choice,spatial-relational,5|6,7,5/6,210257,5
7,4,21,258,0,831,1,7,3,4,4,single-choice,spatial-relational,3|4,7,3/4,210258,3
7,4,21,259,1,848,1,5,2,2,3,single-choice,spatial-relational,2|3,7,2/3,210259,2
7,4,21,260,0,868,1,9,4,5,5,single-choice,spatial-relational,4|5,7,4/5,210260,4
7,4,21,261,1,1114,1,13,6,6,7,single-choice,spatial-relational,6|7,7,6/7,210261,6
7,4,21,262,1,823,1,3,1,1,2,single-choice,spatial-relational,1|2,7,1/2,210262,1
7,4,21,263,1,690,1,3,1,1,2,single-choice,spatial-relational,1|2,7,1/2,210263,1
7,4,21,264,1,1109,1,13,6,6,7,single-choice,spatial-relational,6|7,7,6/7,210264,6
7,4,21,265,1,1274,1,13,6,6,7,single-choice,spatial-relational,6|7,7,6/7,210265,6
7,4,21,266,1,1109,1,13,6,6,7,single-choice,spatial-relational,6|7,7,6/7,210266,6
7,4,21,267,1,896,1,9,4,4,5,single-choice,spatial-relational,4|5,7,4/5,210267,4
7,4,21,268,1,1127,1,7,3,3,4,single-choice,spatial-relational,3|4,7,3/4,210268,3
7,4,21,269,1,828,1,11,5,5,6,single-choice,spatial-relational,5|6,7,5/6,210269,5
7,4,21,270,0,972,1,9,4,5,5,single-choice,spatial-relational,4|5,7,4/5,210270,4
7,4,21,271,1,859,1,5,2,2,3,single-choice,spatial-relational,2|3,7,2/3,210271,2
7,4,21,272,1,769,1,3,1,1,2,single-choice,spatial-relational,1|2,7,1/2,210272,1
7,4,21,273,1,772,1,7,3,3,4,single-choice,spatial-relational,3|4,7,3/4,210273,3
7,4,21,274,1,866,1,3,1,1,2,single-choice,spatial-relational,1|2,7,1/2,210274,1
7,4,21,275,0,833,1,11,5,6,6,single-choice,spatial-relational,5|6,7,5/6,210275,5
7,4,21,276,1,927,1,5,2,2,3,single-choice,spatial-relational,2|3,7,2/3,210276,2
7,4,21,277,1,834,1,5,2,2,3,single-choice,spatial-relational,2|3,7,2/3,210277,2
7,4,21,278,1,918,1,13,6,6,7,single-choice,spatial-relational,6|7,7,6/7,210278,6
7,4,21,279,1,1342,1,11,5,5,6,single-choice,spatial-relational,5|6,7,5/6,210279,5
7,4,21,280,1,1241,1,3,1,1,2,single-choice,spatial-relational,1|2,7,1/2,210280,1
7,4,21,281,1,829,1,7,3,3,4,single-choice,spatial-relational,3|4,7,3/4,210281,3
7,4,21,282,1,1204,1,3,1,1,2,single-choice,spatial-relational,1|2,7,1/2,210282,1
7,4,21,283,0,712,1,9,4,5,5,single-choice,spatial-relational,4|5,7,4/5,210283,4
7,4,21,284,1,1314,1,11,5,5,6,single-choice,spatial-relational,5|6,7,5/6,210284,5
7,4,21,285,1,1164,1,9,4,4,5,single-choice,spatial-relational,4|5,7,4/5,210285,4
7,4,21,286,1,805,1,7,3,3,4,single-choice,spatial-relational,3|4,7,3/4,210286,3
7,4,21,287,1,1055,1,13,6,6,7,single-choice,spatial-relational,6|7,7,6/7,210287,6
7,4,21,288,1,1050,1,5,2,2,3,single-choice,spatial-relational,2|3,7,2/3,210288,2
7,4,21,289,1,982,1,13,6,6,7,single-choice,spatial-relational,6|7,7,6/7,210289,6
7,4,21,290,1,1195,1,11,5,5,6,single-choice,spatial-relational,5|6,7,5/6,210290,5
7,4,21,291,1,886,1,7,3,3,4,single-choice,spatial-relational,3|4,7,3/4,210291,3
7,4,21,292,0,908,1,9,4,5,5,single-choice,spatial-relational,4|5,7,4/5,210292,4
7,4,21,293,0,942,1,9,4,5,5,single-choice,spatial-relational,4|5,7,4/5,210293,4
7,4,21,294,1,1087,1,13,6,6,7,single-choice,spatial-relational,6|7,7,6/7,210294,6
7,4,21,295,0,1270,1,5,2,3,3,single-choice,spatial-relational,2|3,7,2/3,210295,2
7,4,21,296,1,1103,1,5,2,2,3,single-choice,spatial-relational,2|3,7,2/3,210296,2
7,4,21,297,1,876,1,3,1,1,2,single-choice,spatial-relational,1|2,7,1/2,210297,1
7,4,21,298,0,1197,1,11,5,6,6,single-choice,spatial-relational,5|6,7,5/6,210298,5
7,4,21,299,1,1463,1,7,3,3,4,single-choice,spatial-relational,3|4,7,3/4,210299,3
7,4,21,300,0,889,1,3,1,2,2,single-choice,spatial-relational,1|2,7,1/2,210300,1
7,4,21,301,0,960,1,5,2,3,3,single-choice,spatial-relational,2|3,7,2/3,210301,2
7,4,21,302,1,915,1,7,3,3,4,single-choice,spatial-relational,3|4,7,3/4,210302,3
7,4,21,303,0,786,1,3,1,2,2,single-choice,spatial-relational,1|2,7,1/2,210303,1
7,4,21,304,1,1341,1,9,4,4,5,single-choice,spatial-relational,4|5,7,4/5,210304,4
7,4,21,305,0,991,1,5,2,3,3,single-choice,spatial-relational,2|3,7,2/3,210305,2
7,4,21,306,1,1130,1,13,6,6,7,single-choice,spatial-relational,6|7,7,6/7,210306,6
7,4,21,307,1,1161,1,13,6,6,7,single-choice,spatial-relational,6|7,7,6/7,210307,6
7,4,21,308,1,1381,1,3,1,1,2,single-choice,spatial-relational,1|2,7,1/2,210308,1
7,4,21,309,1,951,1,11,5,5,6,single-choice,spatial-relational,5|6,7,5/6,210309,5
7,4,21,310,1,1090,1,11,5,5,6,single-choice,spatial-relational,5|6,7,5/6,210310,5
7,4,21,311,1,1454,1,7,3,3,4,single-choice,spatial-relational,3|4,7,3/4,210311,3
7,4,21,312,1,1001,1,9,4,4,5,single-choice,spatial-relational,4|5,7,4/5,210312,4
7,4,21,313,1,788,1,11,5,5,6,single-choice,spatial-relational,5|6,7,5/6,210313,5
7,4,21,314,0,1170,1,7,3,4,4,single-choice,spatial-relational,3|4,7,3/4,210314,3
7,4,21,315,1,1169,1,3,1,1,2,single-choice,spatial-relational,1|2,7,1/2,210315,1
7,4,21,316,1,771,1,5,2,2,3,single-choice,spatial-relational,2|3,7,2/3,210316,2
7,4,21,317,1,872,1,13,6,6,7,single-choice,spatial-relational,6|7,7,6/7,210317,6
7,4,21,318,1,921,1,9,4,4,5,single-choice,spatial-relational,4|5,7,4/5,210318,4
7,4,21,319,0,906,1,11,5,6,6,single-choice,spatial-relational,5|6,7,5/6,210319,5
7,4,21,320,1,1149,1,13,6,6,7,single-choice,spatial-relational,6|7,7,6/7,210320,6
7,4,21,321,0,812,1,3,1,2,2,single-choice,spatial-relational,1|2,7,1/2,210321,1
7,4,21,322,1,1091,1,7,3,3,4,single-choice,spatial-relational,3|4,7,3/4,210322,3
7,4,21,323,1,893,1,5,2,2,3,single-choice,spatial-relational,2|3,7,2/3,210323,2
7,4,21,324,1,1357,1,9,4,4,5,single-choice,spatial-relational,4|5,7,4/5,210324,4
7,4,21,325,1,993,1,13,6,6,7,single-choice,spatial-relational,6|7,7,6/7,210325,6
7,4,21,326,0,1163,1,7,3,4,4,single-choice,spatial-relational,3|4,7,3/4,210326,3
7,4,21,327,1,974,1,5,2,2,3,single-choice,spatial-relational,2|3,7,2/3,210327,2
7,4,21,328,0,1039,1,9,4,5,5,single-choice,spatial-relational,4|5,7,4/5,210328,4
7,4,21,329,0,1529,1,11,5,6,6,single-choice,spatial-relational,5|6,7,5/6,210329,5
7,4,21,330,0,1261,1,11,5,6,6,single-choice,spatial-relational,5|6,7,5/6,210330,5
7,4,21,331,1,893,1,3,1,1,2,single-choice,spatial-relational,1|2,7,1/2,210331,1
7,4,21,332,1,935,1,5,2,2,3,single-choice,spatial-relational,2|3,7,2/3,210332,2
7,4,21,333,0,661,1,3,1,2,2,single-choice,spatial-relational,1|2,7,1/2,210333,1
7,4,21,334,1,1111,1,9,4,4,5,single-choice,spatial-relational,4|5,7,4/5,210334,4
7,4,21,335,1,916,1,7,3,3,4,single-choice,spatial-relational,3|4,7,3/4,210335,3
7,4,21,336,1,1117,1,13,6,6,7,single-choice,spatial-relational,6|7,7,6/7,210336,6
7,4,21,337,1,985,1,9,4,4,5,single-choice,spatial-relational,4|5,7,4/5,210337,4
7,4,21,338,1,1021,1,3,1,1,2,single-choice,spatial-relational,1|2,7,1/2,210338,1
7,4,21,339,1,915,1,13,6,6,7,single-choice,spatial-relational,6|7,7,6/7,210339,6
7,4,21,340,0,1013,1,9,4,5,5,single-choice,spatial-relational,4|5,7,4/5,210340,4
7,4,21,341,1,1128,1,3,1,1,2,single-choice,spatial-relational,1|2,7,1/2,210341,1
7,4,21,342,1,1261,1,13,6,6,7,single-choice,spatial-relational,6|7,7,6/7,210342,6
7,4,21,343,1,1109,1,11,5,5,6,single-choice,spatial-relational,5|6,7,5/6,210343,5
7,4,21,344,1,1274,1,5,2,2,3,single-choice,spatial-relational,2|3,7,2/3,210344,2
7,4,21,345,1,1162,1,7,3,3,4,single-choice,spatial-relational,3|4,7,3/4,210345,3
7,4,21,346,1,1031,1,5,2,2,3,single-choice,spatial-relational,2|3,7,2/3,210346,2
7,4,21,347,1,1227,1,11,5,5,6,single-choice,spatial-relational,5|6,7,5/6,210347,5
7,4,21,348,0,1198,1,7,3,4,4,single-choice,spatial-relational,3|4,7,3/4,210348,3
7,4,21,349,1,1334,1,13,6,6,7,single-choice,spatial-relational,6|7,7,6/7,210349,6
7,4,21,350,1,975,1,3,1,1,2,single-choice,spatial-relational,1|2,7,1/2,210350,1
7,4,21,351,0,1015,1,9,4,5,5,single-choice,spatial-relational,4|5,7,4/5,210351,4
7,4,21,352,1,959,1,11,5,5,6,single-choice,spatial-relational,5|6,7,5/6,210352,5
7,4,21,353,1,1182,1,7,3,3,4,single-choice,spatial-relational,3|4,7,3/4,210353,3
7,4,21,354,0,1094,1,5,2,3,3,single-choice,spatial-relational,2|3,7,2/3,210354,2
7,4,21,355,0,1079,1,9,4,5,5,single-choice,spatial-relational,4|5,7,4/5,210355,4
7,4,21,356,0,1201,1,11,5,6,6,single-choice,spatial-relational,5|6,7,5/6,210356,5
7,4,21,357,1,946,1,3,1,1,2,single-choice,spatial-relational,1|2,7,1/2,210357,1
7,4,21,358,1,1129,1,7,3,3,4,single-choice,spatial-relational,3|4,7,3/4,210358,3
7,4,21,359,1,1092,1,13,6,6,7,single-choice,spatial-relational,6|7,7,6/7,210359,6
7,4,21,360,1,1176,1,5,2,2,3,single-choice,spatial-relational,2|3,7,2/3,210360,2
7,4,21,361,0,891,1,9,4,5,5,single-choice,spatial-relational,4|5,7,4/5,210361,4
7,4,21,362,1,965,1,3,1,1,2,single-choice,spatial-relational,1|2,7,1/2,210362,1
7,4,21,363,1,1210,1,13,6,6,7,single-choice,spatial-relational,6|7,7,6/7,210363,6
7,4,21,364,1,1257,1,11,5,5,6,single-choice,spatial-relational,5|6,7,5/6,210364,5
7,4,21,365,1,809,1,5,2,2,3,single-choice,spatial-relational,2|3,7,2/3,210365,2
7,4,21,366,0,1758,1,7,3,4,4,single-choice,spatial-relational,3|4,7,3/4,210366,3
7,4,21,367,1,1140,1,13,6,6,7,single-choice,spatial-relational,6|7,7,6/7,210367,6
7,4,21,368,1,1466,1,11,5,5,6,single-choice,spatial-relational,5|6,7,5/6,210368,5
7,4,21,369,0,774,1,3,1,2,2,single-choice,spatial-relational,1|2,7,1/2,210369,1
7,4,21,370,1,939,1,7,3,3,4,single-choice,spatial-relational,3|4,7,3/4,210370,3
7,4,21,371,1,901,1,5,2,2,3,single-choice,spatial-relational,2|3,7,2/3,210371,2
7,4,21,372,0,1159,1,9,4,5,5,single-choice,spatial-relational,4|5,7,4/5,210372,4
7,4,21,373,1,843,1,7,3,3,4,single-choice,spatial-relational,3|4,7,3/4,210373,3
7,4,21,374,1,1217,1,11,5,5,6,single-choice,spatial-relational,5|6,7,5/6,210374,5
7,4,21,375,1,955,1,5,2,2,3,single-choice,spatial-relational,2|3,7,2/3,210375,2
7,4,21,376,1,1135,1,13,6,6,7,single-choice,spatial-relational,6|7,7,6/7,210376,6
7,4,21,377,0,759,1,3,1,2,2,single-choice,spatial-relational,1|2,7,1/2,210377,1
7,4,21,378,0,930,1,9,4,5,5,single-choice,spatial-relational,4|5,7,4/5,210378,4
7,4,21,379,1,1129,1,7,3,3,4,single-choice,spatial-relational,3|4,7,3/4,210379,3
7,4,21,380,1,1258,1,9,4,4,5,single-choice,spatial-relational,4|5,7,4/5,210380,4
7,4,21,381,1,1572,1,5,2,2,3,single-choice,spatial-relational,2|3,7,2/3,210381,2
7,4,21,382,1,827,1,3,1,1,2,single-choice,spatial-relational,1|2,7,1/2,210382,1
7,4,21,383,1,1144,1,13,6,6,7,single-choice,spatial-relational,6|7,7,6/7,210383,6
7,4,21,384,0,870,1,11,5,6,6,single-choice,spatial-relational,5|6,7,5/6,210384,5
7,4,21,385,1,986,1,3,1,1,2,single-choice,spatial-relational,1|2,7,1/2,210385,1
7,4,21,386,1,802,1,7,3,3,4,single-choice,spatial-relational,3|4,7,3/4,210386,3
7,4,21,387,0,708,1,3,1,2,2,single-choice,spatial-relational,1|2,7,1/2,210387,1
7,4,21,388,1,1245,1,13,6,6,7,single-choice,spatial-relational,6|7,7,6/7,210388,6
7,4,21,389,0,1346,1,11,5,6,6,single-choice,spatial-relational,5|6,7,5/6,210389,5
7,4,21,390,1,1059,1,9,4,4,5,single-choice,spatial-relational,4|5,7,4/5,210390,4
7,4,21,391,0,1223,1,5,2,3,3,single-choice,spatial-relational,2|3,7,2/3,210391,2
7,4,21,392,1,141,1,7,3,3,4,single-choice,spatial-relational,3|4,7,3/4,210392,3
7,4,21,393,1,1232,1,9,4,4,5,single-choice,spatial-relational,4|5,7,4/5,210393,4
7,4,21,394,1,1200,1,13,6,6,7,single-choice,spatial-relational,6|7,7,6/7,210394,6
7,4,21,395,0,1729,1,11,5,6,6,single-choice,spatial-relational,5|6,7,5/6,210395,5
7,4,21,396,1,851,1,5,2,2,3,single-choice,spatial-relational,2|3,7,2/3,210396,2
7,4,21,397,1,960,1,5,2,2,3,single-choice,spatial-relational,2|3,7,2/3,210397,2
7,4,21,398,1,1594,1,7,3,3,4,single-choice,spatial-relational,3|4,7,3/4,210398,3
7,4,21,399,1,853,1,3,1,1,2,single-choice,spatial-relational,1|2,7,1/2,210399,1
7,4,21,400,1,1013,1,13,6,6,7,single-choice,spatial-relational,6|7,7,6/7,210400,6
7,4,21,401,0,962,1,9,4,5,5,single-choice,spatial-relational,4|5,7,4/5,210401,4
7,4,21,402,1,1576,1,13,6,6,7,single-choice,spatial-relational,6|7,7,6/7,210402,6
7,4,21,403,1,1485,1,11,5,5,6,single-choice,spatial-relational,5|6,7,5/6,210403,5
7,4,21,404,1,849,1,9,4,4,5,single-choice,spatial-relational,4|5,7,4/5,210404,4
7,4,21,405,1,873,1,3,1,1,2,single-choice,spatial-relational,1|2,7,1/2,210405,1
7,4,21,406,0,634,1,5,2,3,3,single-choice,spatial-relational,2|3,7,2/3,210406,2
7,4,21,407,1,906,1,7,3,3,4,single-choice,spatial-relational,3|4,7,3/4,210407,3
7,4,21,408,1,1033,1,11,5,5,6,single-choice,spatial-relational,5|6,7,5/6,210408,5
7,4,21,409,1,1636,1,11,5,5,6,single-choice,spatial-relational,5|6,7,5/6,210409,5
7,4,21,410,1,1153,1,7,3,3,4,single-choice,spatial-relational,3|4,7,3/4,210410,3
7,4,21,411,1,808,1,7,3,3,4,single-choice,spatial-relational,3|4,7,3/4,210411,3
7,4,21,412,1,1099,1,13,6,6,7,single-choice,spatial-relational,6|7,7,6/7,210412,6
7,4,21,413,1,1181,1,3,1,1,2,single-choice,spatial-relational,1|2,7,1/2,210413,1
7,4,21,414,1,1558,1,9,4,4,5,single-choice,spatial-relational,4|5,7,4/5,210414,4
7,4,21,415,0,783,1,3,1,2,2,single-choice,spatial-relational,1|2,7,1/2,210415,1
7,4,21,416,1,1152,1,13,6,6,7,single-choice,spatial-relational,6|7,7,6/7,210416,6
7,4,21,417,0,1239,1,9,4,5,5,single-choice,spatial-relational,4|5,7,4/5,210417,4
7,4,21,418,1,987,1,5,2,2,3,single-choice,spatial-relational,2|3,7,2/3,210418,2
7,4,21,419,0,1900,1,11,5,6,6,single-choice,spatial-relational,5|6,7,5/6,210419,5
7,4,21,420,1,789,1,5,2,2,3,single-choice,spatial-relational,2|3,7,2/3,210420,2
7,4,21,421,1,1061,1,11,5,5,6,single-choice,spatial-relational,5|6,7,5/6,210421,5
7,4,21,422,1,944,1,3,1,1,2,single-choice,spatial-relational,1|2,7,1/2,210422,1
7,4,21,423,1,1284,1,5,2,2,3,single-choice,spatial-relational,2|3,7,2/3,210423,2
7,4,21,424,0,1133,1,7,3,4,4,single-choice,spatial-relational,3|4,7,3/4,210424,3
7,4,21,425,1,1091,1,13,6,6,7,single-choice,spatial-relational,6|7,7,6/7,210425,6
7,4,21,426,1,1091,1,7,3,3,4,single-choice,spatial-relational,3|4,7,3/4,210426,3
7,4,21,427,1,692,1,3,1,1,2,single-choice,spatial-relational,1|2,7,1/2,210427,1
7,4,21,428,1,895,1,5,2,2,3,single-choice,spatial-relational,2|3,7,2/3,210428,2
7,4,21,429,1,934,1,13,6,6,7,single-choice,spatial-relational,6|7,7,6/7,210429,6
7,4,21,430,1,988,1,9,4,4,5,single-choice,spatial-relational,4|5,7,4/5,210430,4
7,4,21,431,1,730,1,11,5,5,6,single-choice,spatial-relational,5|6,7,5/6,210431,5
7,4,21,432,0,1598,1,9,4,5,5,single-choice,spatial-relational,4|5,7,4/5,210432,4
7,4,21,433,0,825,1,5,2,3,3,single-choice,spatial-relational,2|3,7,2/3,210433,2
7,4,21,434,0,1307,1,13,6,7,7,single-choice,spatial-relational,6|7,7,6/7,210434,6
7,4,21,435,1,975,1,3,1,1,2,single-choice,spatial-relational,1|2,7,1/2,210435,1
7,4,21,436,1,1546,1,13,6,6,7,single-choice,spatial-relational,6|7,7,6/7,210436,6
7,4,21,437,1,1158,1,5,2,2,3,single-choice,spatial-relational,2|3,7,2/3,210437,2
7,4,21,438,1,906,1,7,3,3,4,single-choice,spatial-relational,3|4,7,3/4,210438,3
7,4,21,439,1,1337,1,11,5,5,6,single-choice,spatial-relational,5|6,7,5/6,210439,5
7,4,21,440,1,1265,1,11,5,5,6,single-choice,spatial-relational,5|6,7,5/6,210440,5
7,4,21,441,1,1112,1,7,3,3,4,single-choice,spatial-relational,3|4,7,3/4,210441,3
7,4,21,442,1,732,1,3,1,1,2,single-choice,spatial-relational,1|2,7,1/2,210442,1
7,4,21,443,1,1380,1,9,4,4,5,single-choice,spatial-relational,4|5,7,4/5,210443,4
7,4,21,444,0,1245,1,9,4,5,5,single-choice,spatial-relational,4|5,7,4/5,210444,4
7,4,21,445,1,1026,1,7,3,3,4,single-choice,spatial-relational,3|4,7,3/4,210445,3
7,4,21,446,0,797,1,13,6,7,7,single-choice,spatial-relational,6|7,7,6/7,210446,6
7,4,21,447,0,1310,1,11,5,6,6,single-choice,spatial-relational,5|6,7,5/6,210447,5
7,4,21,448,1,819,1,3,1,1,2,single-choice,spatial-relational,1|2,7,1/2,210448,1
7,4,21,449,1,8,1,9,4,4,5,single-choice,spatial-relational,4|5,7,4/5,210449,4
7,4,21,450,1,1024,1,3,1,1,2,single-choice,spatial-relational,1|2,7,1/2,210450,1
7,4,21,451,1,772,1,5,2,2,3,single-choice,spatial-relational,2|3,7,2/3,210451,2
7,4,21,452,1,1108,1,11,5,5,6,single-choice,spatial-relational,5|6,7,5/6,210452,5
7,4,21,453,0,754,1,5,2,3,3,single-choice,spatial-relational,2|3,7,2/3,210453,2
7,4,21,454,1,1027,1,9,4,4,5,single-choice,spatial-relational,4|5,7,4/5,210454,4
7,4,21,455,1,1234,1,7,3,3,4,single-choice,spatial-relational,3|4,7,3/4,210455,3
7,4,21,456,1,1561,1,13,6,6,7,single-choice,spatial-relational,6|7,7,6/7,210456,6
7,4,21,457,1,1075,1,3,1,1,2,single-choice,spatial-relational,1|2,7,1/2,210457,1
7,4,21,458,0,909,1,9,4,5,5,single-choice,spatial-relational,4|5,7,4/5,210458,4
7,4,21,459,1,1734,1,13,6,6,7,single-choice,spatial-relational,6|7,7,6/7,210459,6
7,4,21,460,1,1094,1,9,4,4,5,single-choice,spatial-relational,4|5,7,4/5,210460,4
7,4,21,461,1,885,1,11,5,5,6,single-choice,spatial-relational,5|6,7,5/6,210461,5
7,4,21,462,0,919,1,5,2,3,3,single-choice,spatial-relational,2|3,7,2/3,210462,2
7,4,21,463,1,809,1,3,1,1,2,single-choice,spatial-relational,1|2,7,1/2,210463,1
7,4,21,464,0,1021,1,7,3,4,4,single-choice,spatial-relational,3|4,7,3/4,210464,3
7,4,21,465,1,877,1,5,2,2,3,single-choice,spatial-relational,2|3,7,2/3,210465,2
7,4,21,466,1,1085,1,13,6,6,7,single-choice,spatial-relational,6|7,7,6/7,210466,6
7,4,21,467,1,1451,1,11,5,5,6,single-choice,spatial-relational,5|6,7,5/6,210467,5
7,4,21,468,1,1207,1,7,3,3,4,single-choice,spatial-relational,3|4,7,3/4,210468,3
7,4,21,469,1,909,1,13,6,6,7,single-choice,spatial-relational,6|7,7,6/7,210469,6
7,4,21,470,1,1347,1,9,4,4,5,single-choice,spatial-relational,4|5,7,4/5,210470,4
7,4,21,471,1,826,1,5,2,2,3,single-choice,spatial-relational,2|3,7,2/3,210471,2
7,4,21,472,1,2169,1,11,5,5,6,single-choice,spatial-relational,5|6,7,5/6,210472,5
7,4,21,473,1,742,1,5,2,2,3,single-choice,spatial-relational,2|3,7,2/3,210473,2
7,4,21,474,1,840,1,7,3,3,4,single-choice,spatial-relational,3|4,7,3/4,210474,3
7,4,21,475,1,915,1,7,3,3,4,single-choice,spatial-relational,3|4,7,3/4,210475,3
7,4,21,476,0,813,1,3,1,2,2,single-choice,spatial-relational,1|2,7,1/2,210476,1
7,4,21,477,1,1426,1,9,4,4,5,single-choice,spatial-relational,4|5,7,4/5,210477,4
7,4,21,478,1,1259,1,13,6,6,7,single-choice,spatial-relational,6|7,7,6/7,210478,6
7,4,21,479,1,1451,1,3,1,1,2,single-choice,spatial-relational,1|2,7,1/2,210479,1
7,4,21,480,0,1304,1,11,5,6,6,single-choice,spatial-relational,5|6,7,5/6,210480,5
7,4,21,481,1,1015,1,7,3,3,4,single-choice,spatial-relational,3|4,7,3/4,210481,3
7,4,21,482,0,1307,1,13,6,7,7,single-choice,spatial-relational,6|7,7,6/7,210482,6
7,4,21,483,1,1025,1,9,4,4,5,single-choice,spatial-relational,4|5,7,4/5,210483,4
7,4,21,484,1,874,1,3,1,1,2,single-choice,spatial-relational,1|2,7,1/2,210484,1
7,4,21,485,1,1060,1,9,4,4,5,single-choice,spatial-relational,4|5,7,4/5,210485,4
7,4,21,486,0,1407,1,11,5,6,6,single-choice,spatial-relational,5|6,7,5/6,210486,5
7,4,21,487,1,974,1,5,2,2,3,single-choice,spatial-relational,2|3,7,2/3,210487,2
7,4,21,488,0,1329,1,11,5,6,6,single-choice,spatial-relational,5|6,7,5/6,210488,5
7,4,21,489,1,880,1,5,2,2,3,single-choice,spatial-relational,2|3,7,2/3,210489,2
7,4,21,490,1,1048,1,13,6,6,7,single-choice,spatial-relational,6|7,7,6/7,210490,6
7,4,21,491,1,980,1,7,3,3,4,single-choice,spatial-relational,3|4,7,3/4,210491,3
7,4,21,492,1,835,1,3,1,1,2,single-choice,spatial-relational,1|2,7,1/2,210492,1
7,4,21,493,1,610,1,7,3,3,4,single-choice,spatial-relational,3|4,7,3/4,210493,3
7,4,21,494,1,1119,1,11,5,5,6,single-choice,spatial-relational,5|6,7,5/6,210494,5
7,4,21,495,0,1069,1,7,3,4,4,single-choice,spatial-relational,3|4,7,3/4,210495,3
7,4,21,496,1,1368,1,13,6,6,7,single-choice,spatial-relational,6|7,7,6/7,210496,6
7,4,21,497,0,1556,1,9,4,5,5,single-choice,spatial-relational,4|5,7,4/5,210497,4
7,4,21,498,1,833,1,3,1,1,2,single-choice,spatial-relational,1|2,7,1/2,210498,1
7,4,21,499,1,1392,1,13,6,6,7,single-choice,spatial-relational,6|7,7,6/7,210499,6
7,4,21,500,1,795,1,3,1,1,2,single-choice,spatial-relational,1|2,7,1/2,210500,1
7,4,21,501,1,660,1,5,2,2,3,single-choice,spatial-relational,2|3,7,2/3,210501,2
7,4,21,502,1,852,1,9,4,4,5,single-choice,spatial-relational,4|5,7,4/5,210502,4
7,4,21,503,0,679,1,5,2,3,3,single-choice,spatial-relational,2|3,7,2/3,210503,2
7,4,21,504,0,1696,1,11,5,6,6,single-choice,spatial-relational,5|6,7,5/6,210504,5
7,4,21,505,1,891,1,9,4,4,5,single-choice,spatial-relational,4|5,7,4/5,210505,4
7,4,21,506,0,1023,1,7,3,4,4,single-choice,spatial-relational,3|4,7,3/4,210506,3
7,4,21,507,1,1156,1,13,6,6,7,single-choice,spatial-relational,6|7,7,6/7,210507,6
7,4,21,508,1,903,1,3,1,1,2,single-choice,spatial-relational,1|2,7,1/2,210508,1
7,4,21,509,0,1144,1,5,2,3,3,single-choice,spatial-relational,2|3,7,2/3,210509,2
7,4,21,510,1,1466,1,9,4,4,5,single-choice,spatial-relational,4|5,7,4/5,210510,4
7,4,21,511,1,1119,1,3,1,1,2,single-choice,spatial-relational,1|2,7,1/2,210511,1
7,4,21,512,1,967,1,7,3,3,4,single-choice,spatial-relational,3|4,7,3/4,210512,3
7,4,21,513,0,2126,1,11,5,6,6,single-choice,spatial-relational,5|6,7,5/6,210513,5
7,4,21,514,0,1136,1,5,2,3,3,single-choice,spatial-relational,2|3,7,2/3,210514,2
7,4,21,515,0,1090,1,11,5,6,6,single-choice,spatial-relational,5|6,7,5/6,210515,5
7,4,21,516,1,3396,1,13,6,6,7,single-choice,spatial-relational,6|7,7,6/7,210516,6
7,4,21,517,1,1276,1,11,5,5,6,single-choice,spatial-relational,5|6,7,5/6,210517,5
7,4,21,518,1,974,1,11,5,5,6,single-choice,spatial-relational,5|6,7,5/6,210518,5
7,4,21,519,1,1342,1,13,6,6,7,single-choice,spatial-relational,6|7,7,6/7,210519,6
7,4,21,520,1,922,1,5,2,2,3,single-choice,spatial-relational,2|3,7,2/3,210520,2
7,4,21,521,1,1252,1,9,4,4,5,single-choice,spatial-relational,4|5,7,4/5,210521,4
7,4,21,522,1,817,1,5,2,2,3,single-choice,spatial-relational,2|3,7,2/3,210522,2
7,4,21,523,1,1491,1,13,6,6,7,single-choice,spatial-relational,6|7,7,6/7,210523,6
7,4,21,524,0,703,1,7,3,4,4,single-choice,spatial-relational,3|4,7,3/4,210524,3
7,4,21,525,1,847,1,3,1,1,2,single-choice,spatial-relational,1|2,7,1/2,210525,1
7,4,21,526,0,1083,1,9,4,5,5,single-choice,spatial-relational,4|5,7,4/5,210526,4
7,4,21,527,1,877,1,3,1,1,2,single-choice,spatial-relational,1|2,7,1/2,210527,1
7,4,21,528,1,1004,1,7,3,3,4,single-choice,spatial-relational,3|4,7,3/4,210528,3
7,4,21,529,0,862,1,9,4,5,5,single-choice,spatial-relational,4|5,7,4/5,210529,4
7,4,21,530,1,1533,1,13,6,6,7,single-choice,spatial-relational,6|7,7,6/7,210530,6
7,4,21,531,1,1284,1,11,5,5,6,single-choice,spatial-relational,5|6,7,5/6,210531,5
7,4,21,532,0,811,1,3,1,2,2,single-choice,spatial-relational,1|2,7,1/2,210532,1
7,4,21,533,1,1637,1,7,3,3,4,single-choice,spatial-relational,3|4,7,3/4,210533,3
7,4,21,534,1,994,1,9,4,4,5,single-choice,spatial-relational,4|5,7,4/5,210534,4
7,4,21,535,1,1263,1,11,5,5,6,single-choice,spatial-relational,5|6,7,5/6,210535,5
7,4,21,536,1,809,1,5,2,2,3,single-choice,spatial-relational,2|3,7,2/3,210536,2
7,4,21,537,1,877,1,7,3,3,4,single-choice,spatial-relational,3|4,7,3/4,210537,3
7,4,21,538,1,1055,1,13,6,6,7,single-choice,spatial-relational,6|7,7,6/7,210538,6
7,4,21,539,1,944,1,5,2,2,3,single-choice,spatial-relational,2|3,7,2/3,210539,2
7,4,21,540,1,831,1,3,1,1,2,single-choice,spatial-relational,1|2,7,1/2,210540,1
7,4,21,541,1,776,1,5,2,2,3,single-choice,spatial-relational,2|3,7,2/3,210541,2
7,4,21,542,0,1303,1,11,5,6,6,single-choice,spatial-relational,5|6,7,5/6,210542,5
7,4,21,543,1,1334,1,9,4,4,5,single-choice,spatial-relational,4|5,7,4/5,210543,4
7,4,21,544,1,1199,1,13,6,6,7,single-choice,spatial-relational,6|7,7,6/7,210544,6
7,4,21,545,1,915,1,9,4,4,5,single-choice,spatial-relational,4|5,7,4/5,210545,4
7,4,21,546,1,718,1,7,3,3,4,single-choice,spatial-relational,3|4,7,3/4,210546,3
7,4,21,547,1,900,1,7,3,3,4,single-choice,spatial-relational,3|4,7,3/4,210547,3
7,4,21,548,1,663,1,13,6,6,7,single-choice,spatial-relational,6|7,7,6/7,210548,6
7,4,21,549,1,1034,1,5,2,2,3,single-choice,spatial-relational,2|3,7,2/3,210549,2
7,4,21,550,1,908,1,3,1,1,2,single-choice,spatial-relational,1|2,7,1/2,210550,1
7,4,21,551,1,1535,1,11,5,5,6,single-choice,spatial-relational,5|6,7,5/6,210551,5
7,4,21,552,1,1226,1,3,1,1,2,single-choice,spatial-relational,1|2,7,1/2,210552,1
7,4,21,553,1,815,1,5,2,2,3,single-choice,spatial-relational,2|3,7,2/3,210553,2
7,4,21,554,1,979,1,11,5,5,6,single-choice,spatial-relational,5|6,7,5/6,210554,5
7,4,21,555,0,869,1,13,6,7,7,single-choice,spatial-relational,6|7,7,6/7,210555,6
7,4,21,556,1,1175,1,13,6,6,7,single-choice,spatial-relational,6|7,7,6/7,210556,6
7,4,21,557,0,697,1,3,1,2,2,single-choice,spatial-relational,1|2,7,1/2,210557,1
7,4,21,558,1,2151,1,11,5,5,6,single-choice,spatial-relational,5|6,7,5/6,210558,5
7,4,21,559,0,934,1,7,3,4,4,single-choice,spatial-relational,3|4,7,3/4,210559,3
7,4,21,560,0,1027,1,9,4,5,5,single-choice,spatial-relational,4|5,7,4/5,210560,4
7,4,21,561,1,1551,1,7,3,3,4,single-choice,spatial-relational,3|4,7,3/4,210561,3
7,4,21,562,1,838,1,5,2,2,3,single-choice,spatial-relational,2|3,7,2/3,210562,2
7,4,21,563,1,986,1,3,1,1,2,single-choice,spatial-relational,1|2,7,1/2,210563,1
7,4,21,564,1,1675,1,9,4,4,5,single-choice,spatial-relational,4|5,7,4/5,210564,4
7,4,21,565,1,1118,1,11,5,5,6,single-choice,spatial-relational,5|6,7,5/6,210565,5
7,4,21,566,1,859,1,3,1,1,2,single-choice,spatial-relational,1|2,7,1/2,210566,1
7,4,21,567,1,664,1,3,1,1,2,single-choice,spatial-relational,1|2,7,1/2,210567,1
7,4,21,568,1,1297,1,7,3,3,4,single-choice,spatial-relational,3|4,7,3/4,210568,3
7,4,21,569,1,755,1,5,2,2,3,single-choice,spatial-relational,2|3,7,2/3,210569,2
7,4,21,570,1,718,1,9,4,4,5,single-choice,spatial-relational,4|5,7,4/5,210570,4
7,4,21,571,1,723,1,9,4,4,5,single-choice,spatial-relational,4|5,7,4/5,210571,4
7,4,21,572,0,89,1,5,2,3,3,single-choice,spatial-relational,2|3,7,2/3,210572,2
7,4,21,573,1,946,1,7,3,3,4,single-choice,spatial-relational,3|4,7,3/4,210573,3
7,4,21,574,1,1688,1,11,5,5,6,single-choice,spatial-relational,5|6,7,5/6,210574,5
7,4,21,575,1,1410,1,13,6,6,7,single-choice,spatial-relational,6|7,7,6/7,210575,6
7,4,21,576,1,1528,1,13,6,6,7,single-choice,spatial-relational,6|7,7,6/7,210576,6
7,4,21,577,1,938,1,3,1,1,2,single-choice,spatial-relational,1|2,7,1/2,210577,1
7,4,21,578,1,976,1,13,6,6,7,single-choice,spatial-relational,6|7,7,6/7,210578,6
7,4,21,579,1,906,1,7,3,3,4,single-choice,spatial-relational,3|4,7,3/4,210579,3
7,4,21,580,1,670,1,13,6,6,7,single-choice,spatial-relational,6|7,7,6/7,210580,6
7,4,21,581,1,892,1,3,1,1,2,single-choice,spatial-relational,1|2,7,1/2,210581,1
7,4,21,582,1,685,1,5,2,2,3,single-choice,spatial-relational,2|3,7,2/3,210582,2
7,4,21,583,1,713,1,5,2,2,3,single-choice,spatial-relational,2|3,7,2/3,210583,2
7,4,21,584,1,798,1,9,4,4,5,single-choice,spatial-relational,4|5,7,4/5,210584,4
7,4,21,585,1,1153,1,11,5,5,6,single-choice,spatial-relational,5|6,7,5/6,210585,5
7,4,21,586,1,732,1,9,4,4,5,single-choice,spatial-relational,4|5,7,4/5,210586,4
7,4,21,587,1,1439,1,11,5,5,6,single-choice,spatial-relational,5|6,7,5/6,210587,5
7,4,21,588,0,958,1,7,3,4,4,single-choice,spatial-relational,3|4,7,3/4,210588,3
7,4,21,589,0,1208,1,13,6,7,7,single-choice,spatial-relational,6|7,7,6/7,210589,6
7,4,21,590,1,941,1,9,4,4,5,single-choice,spatial-relational,4|5,7,4/5,210590,4
7,4,21,591,1,1151,1,11,5,5,6,single-choice,spatial-relational,5|6,7,5/6,210591,5
7,4,21,592,1,994,1,9,4,4,5,single-choice,spatial-relational,4|5,7,4/5,210592,4
7,4,21,593,1,791,1,3,1,1,2,single-choice,spatial-relational,1|2,7,1/2,210593,1
7,4,21,594,1,824,1,7,3,3,4,single-choice,spatial-relational,3|4,7,3/4,210594,3
7,4,21,595,0,1811,1,7,3,4,4,single-choice,spatial-relational,3|4,7,3/4,210595,3
7,4,21,596,1,1032,1,5,2,2,3,single-choice,spatial-relational,2|3,7,2/3,210596,2
7,4,21,597,1,721,1,5,2,2,3,single-choice,spatial-relational,2|3,7,2/3,210597,2
7,4,21,598,1,1079,1,13,6,6,7,single-choice,spatial-relational,6|7,7,6/7,210598,6
7,4,21,599,1,1128,1,11,5,5,6,single-choice,spatial-relational,5|6,7,5/6,210599,5
7,4,21,600,1,881,1,3,1,1,2,single-choice,spatial-relational,1|2,7,1/2,210600,1
1,4,22,1,1,1083,2,4,1,1,3,single-choice,spatial-relational,1|3,7,1/3,220001,1
1,4,22,2,1,863,5,9,2,2,7,single-choice,spatial-relational,2|7,7,2/7,220002,2
1,4,22,3,1,827,3,11,4,4,7,single-choice,spatial-relational,4|7,7,4/7,220003,4
1,4,22,4,0,717,4,8,2,6,6,single-choice,spatial-relational,2|6,7,2/6,220004,2
1,4,22,5,1,1294,4,10,3,3,7,single-choice,spatial-relational,3|7,7,3/7,220005,3
1,4,22,6,1,970,4,10,3,3,7,single-choice,spatial-relational,3|7,7,3/7,220006,3
1,4,22,7,1,835,4,6,1,1,5,single-choice,spatial-relational,1|5,7,1/5,220007,1
1,4,22,8,1,1064,1,9,4,4,5,single-choice,spatial-relational,4|5,7,4/5,220008,4
1,4,22,9,0,1045,1,11,5,6,6,single-choice,spatial-relational,5|6,7,5/6,220009,5
1,4,22,10,1,953,3,9,3,3,6,single-choice,spatial-relational,3|6,7,3/6,220010,3
1,4,22,11,1,1004,1,5,2,2,3,single-choice,spatial-relational,2|3,7,2/3,220011,2
1,4,22,12,0,812,1,3,1,2,2,single-choice,spatial-relational,1|2,7,1/2,220012,1
1,4,22,13,1,802,1,9,4,4,5,single-choice,spatial-relational,4|5,7,4/5,220013,4
1,4,22,14,1,1201,3,11,4,4,7,single-choice,spatial-relational,4|7,7,4/7,220014,4
1,4,22,15,1,1125,3,5,1,1,4,single-choice,spatial-relational,1|4,7,1/4,220015,1
1,4,22,16,0,823,4,6,1,5,5,single-choice,spatial-relational,1|5,7,1/5,220016,1
1,4,22,17,1,1431,5,9,2,2,7,single-choice,spatial-relational,2|7,7,2/7,220017,2
1,4,22,18,0,1740,1,5,2,3,3,single-choice,spatial-relational,2|3,7,2/3,220018,2
1,4,22,19,0,490,3,7,2,5,5,single-choice,spatial-relational,2|5,7,2/5,220019,2
1,4,22,20,0,913,3,9,3,6,6,single-choice,spatial-relational,3|6,7,3/6,220020,3
1,4,22,21,1,970,2,12,5,5,7,single-choice,spatial-relational,5|7,7,5/7,220021,5
1,4,22,22,1,1049,1,3,1,1,2,single-choice,spatial-relational,1|2,7,1/2,220022,1
1,4,22,23,1,1569,2,6,2,2,4,single-choice,spatial-relational,2|4,7,2/4,220023,2
1,4,22,24,0,1075,4,8,2,6,6,single-choice,spatial-relational,2|6,7,2/6,220024,2
1,4,22,25,0,696,3,5,1,4,4,single-choice,spatial-relational,1|4,7,1/4,220025,1
1,4,22,26,1,1133,6,8,1,1,7,single-choice,spatial-relational,1|7,7,1/7,220026,1
1,4,22,27,1,846,2,12,5,5,7,single-choice,spatial-relational,5|7,7,5/7,220027,5
1,4,22,28,1,888,6,8,1,1,7,single-choice,spatial-relational,1|7,7,1/7,220028,1
1,4,22,29,1,837,1,13,6,6,7,single-choice,spatial-relational,6|7,7,6/7,220029,6
1,4,22,30,1,600,1,13,6,6,7,single-choice,spatial-relational,6|7,7,6/7,220030,6
1,4,22,31,1,1087,2,10,4,4,6,single-choice,spatial-relational,4|6,7,4/6,220031,4
1,4,22,32,1,1297,2,8,3,3,5,single-choice,spatial-relational,3|5,7,3/5,220032,3
1,4,22,33,1,833,1,7,3,3,4,single-choice,spatial-relational,3|4,7,3/4,220033,3
1,4,22,34,1,870,3,7,2,2,5,single-choice,spatial-relational,2|5,7,2/5,220034,2
1,4,22,35,1,1088,5,7,1,1,6,single-choice,spatial-relational,1|6,7,1/6,220035,1
1,4,22,36,1,1205,2,4,1,1,3,single-choice,spatial-relational,1|3,7,1/3,220036,1
1,4,22,37,1,1394,2,10,4,4,6,single-choice,spatial-relational,4|6,7,4/6,220037,4
1,4,22,38,1,1295,1,7,3,3,4,single-choice,spatial-relational,3|4,7,3/4,220038,3
1,4,22,39,1,1222,1,11,5,5,6,single-choice,spatial-relational,5|6,7,5/6,220039,5
1,4,22,40,1,1233,2,8,3,3,5,single-choice,spatial-relational,3|5,7,3/5,220040,3
1,4,22,41,1,1310,5,7,1,1,6,single-choice,spatial-relational,1|6,7,1/6,220041,1
1,4,22,42,1,765,2,6,2,2,4,single-choice,spatial-relational,2|4,7,2/4,220042,2
1,4,22,43,1,988,5,9,2,2,7,single-choice,spatial-relational,2|7,7,2/7,220043,2
1,4,22,44,1,1380,1,11,5,5,6,single-choice,spatial-relational,5|6,7,5/6,220044,5
1,4,22,45,1,1295,3,5,1,1,4,single-choice,spatial-relational,1|4,7,1/4,220045,1
1,4,22,46,1,1285,3,7,2,2,5,single-choice,spatial-relational,2|5,7,2/5,220046,2
1,4,22,47,1,1098,5,7,1,1,6,single-choice,spatial-relational,1|6,7,1/6,220047,1
1,4,22,48,1,1044,2,8,3,3,5,single-choice,spatial-relational,3|5,7,3/5,220048,3
1,4,22,49,1,1125,1,5,2,2,3,single-choice,spatial-relational,2|3,7,2/3,220049,2
1,4,22,50,1,1242,2,10,4,4,6,single-choice,spatial-relational,4|6,7,4/6,220050,4
1,4,22,51,1,2411,3,9,3,3,6,single-choice,spatial-relational,3|6,7,3/6,220051,3
1,4,22,52,1,1646,4,10,3,3,7,single-choice,spatial-relational,3|7,7,3/7,220052,3
1,4,22,53,1,1556,3,9,3,3,6,single-choice,spatial-relational,3|6,7,3/6,220053,3
1,4,22,54,1,966,1,13,6,6,7,single-choice,spatial-relational,6|7,7,6/7,220054,6
1,4,22,55,1,779,3,7,2,2,5,single-choice,spatial-relational,2|5,7,2/5,220055,2
1,4,22,56,1,955,3,11,4,4,7,single-choice,spatial-relational,4|7,7,4/7,220056,4
1,4,22,57,1,1862,2,10,4,4,6,single-choice,spatial-relational,4|6,7,4/6,220057,4
1,4,22,58,1,1409,1,11,5,5,6,single-choice,spatial-relational,5|6,7,5/6,220058,5
1,4,22,59,1,1432,6,8,1,1,7,single-choice,spatial-relational,1|7,7,1/7,220059,1
1,4,22,60,1,1406,1,7,3,3,4,single-choice,spatial-relational,3|4,7,3/4,220060,3
1,4,22,61,1,1084,2,12,5,5,7,single-choice,spatial-relational,5|7,7,5/7,220061,5
1,4,22,62,1,747,2,6,2,2,4,single-choice,spatial-relational,2|4,7,2/4,220062,2
1,4,22,63,1,1152,4,8,2,2,6,single-choice,spatial-relational,2|6,7,2/6,220063,2
1,4,22,64,1,721,4,8,2,2,6,single-choice,spatial-relational,2|6,7,2/6,220064,2
1,4,22,65,1,2030,1,9,4,4,5,single-choice,spatial-relational,4|5,7,4/5,220065,4
1,4,22,66,1,1074,1,13,6,6,7,single-choice,spatial-relational,6|7,7,6/7,220066,6
1,4,22,67,0,879,4,6,1,5,5,single-choice,spatial-relational,1|5,7,1/5,220067,1
1,4,22,68,0,1389,6,8,1,7,7,single-choice,spatial-relational,1|7,7,1/7,220068,1
1,4,22,69,0,1088,2,6,2,4,4,single-choice,spatial-relational,2|4,7,2/4,220069,2
1,4,22,70,0,3521,1,7,3,4,4,single-choice,spatial-relational,3|4,7,3/4,220070,3
1,4,22,71,1,1548,2,4,1,1,3,single-choice,spatial-relational,1|3,7,1/3,220071,1
1,4,22,72,0,699,3,5,1,4,4,single-choice,spatial-relational,1|4,7,1/4,220072,1
1,4,22,73,1,1369,2,8,3,3,5,single-choice,spatial-relational,3|5,7,3/5,220073,3
1,4,22,74,0,1228,1,3,1,2,2,single-choice,spatial-relational,1|2,7,1/2,220074,1
1,4,22,75,1,858,1,3,1,1,2,single-choice,spatial-relational,1|2,7,1/2,220075,1
1,4,22,76,1,889,5,9,2,2,7,single-choice,spatial-relational,2|7,7,2/7,220076,2
1,4,22,77,1,1147,2,4,1,1,3,single-choice,spatial-relational,1|3,7,1/3,220077,1
1,4,22,78,1,941,1,9,4,4,5,single-choice,spatial-relational,4|5,7,4/5,220078,4
1,4,22,79,1,649,1,5,2,2,3,single-choice,spatial-relational,2|3,7,2/3,220079,2
1,4,22,80,1,1141,4,10,3,3,7,single-choice,spatial-relational,3|7,7,3/7,220080,3
1,4,22,81,0,915,4,6,1,5,5,single-choice,spatial-relational,1|5,7,1/5,220081,1
1,4,22,82,1,788,2,12,5,5,7,single-choice,spatial-relational,5|7,7,5/7,220082,5
1,4,22,83,1,1549,3,11,4,4,7,single-choice,spatial-relational,4|7,7,4/7,220083,4
1,4,22,84,0,810,5,7,1,6,6,single-choice,spatial-relational,1|6,7,1/6,220084,1
1,4,22,85,1,937,1,7,3,3,4,single-choice,spatial-relational,3|4,7,3/4,220085,3
1,4,22,86,1,1418,3,5,1,1,4,single-choice,spatial-relational,1|4,7,1/4,220086,1
1,4,22,87,1,1294,4,6,1,1,5,single-choice,spatial-relational,1|5,7,1/5,220087,1
1,4,22,88,1,867,1,13,6,6,7,single-choice,spatial-relational,6|7,7,6/7,220088,6
1,4,22,89,1,1099,3,11,4,4,7,single-choice,spatial-relational,4|7,7,4/7,220089,4
1,4,22,90,1,1845,1,9,4,4,5,single-choice,spatial-relational,4|5,7,4/5,220090,4
1,4,22,91,1,1223,1,3,1,1,2,single-choice,spatial-relational,1|2,7,1/2,220091,1
1,4,22,92,0,921,2,6,2,4,4,single-choice,spatial-relational,2|4,7,2/4,220092,2
1,4,22,93,1,1517,2,8,3,3,5,single-choice,spatial-relational,3|5,7,3/5,220093,3
1,4,22,94,1,930,2,12,5,5,7,single-choice,spatial-relational,5|7,7,5/7,220094,5
1,4,22,95,0,732,5,7,1,6,6,single-choice,spatial-relational,1|6,7,1/6,220095,1
1,4,22,96,1,963,5,9,2,2,7,single-choice,spatial-relational,2|7,7,2/7,220096,2
1,4,22,97,1,1693,3,11,4,4,7,single-choice,spatial-relational,4|7,7,4/7,220097,4
1,4,22,98,1,933,1,13,6,6,7,single-choice,spatial-relational,6|7,7,6/7,220098,6
1,4,22,99,0,1071,2,4,1,3,3,single-choice,spatial-relational,1|3,7,1/3,220099,1
1,4,22,100,1,713,1,5,2,2,3,single-choice,spatial-relational,2|3,7,2/3,220100,2
1,4,22,101,1,1310,1,3,1,1,2,single-choice,spatial-relational,1|2,7,1/2,220101,1
1,4,22,102,1,1077,5,9,2,2,7,single-choice,spatial-relational,2|7,7,2/7,220102,2
1,4,22,103,1,2128,4,10,3,3,7,single-choice,spatial-relational,3|7,7,3/7,220103,3
1,4,22,104,1,1373,1,11,5,5,6,single-choice,spatial-relational,5|6,7,5/6,220104,5
1,4,22,105,0,841,3,9,3,6,6,single-choice,spatial-relational,3|6,7,3/6,220105,3
1,4,22,106,1,1372,6,8,1,1,7,single-choice,spatial-relational,1|7,7,1/7,220106,1
1,4,22,107,1,820,1,7,3,3,4,single-choice,spatial-relational,3|4,7,3/4,220107,3
1,4,22,108,1,1047,1,5,2,2,3,single-choice,spatial-relational,2|3,7,2/3,220108,2
1,4,22,109,1,1061,6,8,1,1,7,single-choice,spatial-relational,1|7,7,1/7,220109,1
1,4,22,110,1,926,2,12,5,5,7,single-choice,spatial-relational,5|7,7,5/7,220110,5
1,4,22,111,1,1434,2,4,1,1,3,single-choice,spatial-relational,1|3,7,1/3,220111,1
1,4,22,112,0,760,5,7,1,6,6,single-choice,spatial-relational,1|6,7,1/6,220112,1
1,4,22,113,0,807,4,6,1,5,5,single-choice,spatial-relational,1|5,7,1/5,220113,1
1,4,22,114,1,1021,3,7,2,2,5,single-choice,spatial-relational,2|5,7,2/5,220114,2
1,4,22,115,1,1792,4,10,3,3,7,single-choice,spatial-relational,3|7,7,3/7,220115,3
1,4,22,116,1,1222,4,8,2,2,6,single-choice,spatial-relational,2|6,7,2/6,220116,2
1,4,22,117,1,1903,2,10,4,4,6,single-choice,spatial-relational,4|6,7,4/6,220117,4
1,4,22,118,1,1731,4,8,2,2,6,single-choice,spatial-relational,2|6,7,2/6,220118,2
1,4,22,119,0,1071,3,7,2,5,5,single-choice,spatial-relational,2|5,7,2/5,220119,2
1,4,22,120,0,667,3,5,1,4,4,single-choice,spatial-relational,1|4,7,1/4,220120,1
1,4,22,121,0,2,3,9,3,6,6,single-choice,spatial-relational,3|6,7,3/6,220121,3
1,4,22,122,1,1596,2,10,4,4,6,single-choice,spatial-relational,4|6,7,4/6,220122,4
1,4,22,123,1,1443,1,9,4,4,5,single-choice,spatial-relational,4|5,7,4/5,220123,4
1,4,22,124,1,1438,1,11,5,5,6,single-choice,spatial-relational,5|6,7,5/6,220124,5
1,4,22,125,1,1244,2,8,3,3,5,single-choice,spatial-relational,3|5,7,3/5,220125,3
1,4,22,126,1,837,2,6,2,2,4,single-choice,spatial-relational,2|4,7,2/4,220126,2
1,4,22,127,1,914,5,9,2,2,7,single-choice,spatial-relational,2|7,7,2/7,220127,2
1,4,22,128,0,1852,2,4,1,3,3,single-choice,spatial-relational,1|3,7,1/3,220128,1
1,4,22,129,1,1272,3,9,3,3,6,single-choice,spatial-relational,3|6,7,3/6,220129,3
1,4,22,130,0,980,2,6,2,4,4,single-choice,spatial-relational,2|4,7,2/4,220130,2
1,4,22,131,1,876,2,12,5,5,7,single-choice,spatial-relational,5|7,7,5/7,220131,5
1,4,22,132,0,916,3,9,3,6,6,single-choice,spatial-relational,3|6,7,3/6,220132,3
1,4,22,133,1,983,4,6,1,1,5,single-choice,spatial-relational,1|5,7,1/5,220133,1
1,4,22,134,1,1612,3,5,1,1,4,single-choice,spatial-relational,1|4,7,1/4,220134,1
1,4,22,135,1,741,1,5,2,2,3,single-choice,spatial-relational,2|3,7,2/3,220135,2
1,4,22,136,1,1267,5,7,1,1,6,single-choice,spatial-relational,1|6,7,1/6,220136,1
1,4,22,137,1,7,4,8,2,2,6,single-choice,spatial-relational,2|6,7,2/6,220137,2
1,4,22,138,1,1124,2,6,2,2,4,single-choice,spatial-relational,2|4,7,2/4,220138,2
1,4,22,139,1,1469,2,8,3,3,5,single-choice,spatial-relational,3|5,7,3/5,220139,3
1,4,22,140,1,1689,1,13,6,6,7,single-choice,spatial-relational,6|7,7,6/7,220140,6
1,4,22,141,1,1245,4,10,3,3,7,single-choice,spatial-relational,3|7,7,3/7,220141,3
1,4,22,142,1,1291,3,11,4,4,7,single-choice,spatial-relational,4|7,7,4/7,220142,4
1,4,22,143,1,180,2,8,3,3,5,single-choice,spatial-relational,3|5,7,3/5,220143,3
1,4,22,144,1,934,3,11,4,4,7,single-choice,spatial-relational,4|7,7,4/7,220144,4
1,4,22,145,1,1536,3,5,1,1,4,single-choice,spatial-relational,1|4,7,1/4,220145,1
1,4,22,146,0,926,6,8,1,7,7,single-choice,spatial-relational,1|7,7,1/7,220146,1
1,4,22,147,1,799,4,10,3,3,7,single-choice,spatial-relational,3|7,7,3/7,220147,3
1,4,22,148,0,2282,1,3,1,2,2,single-choice,spatial-relational,1|2,7,1/2,220148,1
1,4,22,149,0,649,4,8,2,6,6,single-choice,spatial-relational,2|6,7,2/6,220149,2
1,4,22,150,1,802,1,5,2,2,3,single-choice,spatial-relational,2|3,7,2/3,220150,2
1,4,22,151,1,1034,6,8,1,1,7,single-choice,spatial-relational,1|7,7,1/7,220151,1
1,4,22,152,0,718,5,7,1,6,6,single-choice,spatial-relational,1|6,7,1/6,220152,1
1,4,22,153,0,33,2,10,4,6,6,single-choice,spatial-relational,4|6,7,4/6,220153,4
1,4,22,154,0,937,2,4,1,3,3,single-choice,spatial-relational,1|3,7,1/3,220154,1
1,4,22,155,1,1253,1,7,3,3,4,single-choice,spatial-relational,3|4,7,3/4,220155,3
1,4,22,156,1,1029,3,7,2,2,5,single-choice,spatial-relational,2|5,7,2/5,220156,2
1,4,22,157,0,2485,1,7,3,4,4,single-choice,spatial-relational,3|4,7,3/4,220157,3
1,4,22,158,0,2,1,9,4,5,5,single-choice,spatial-relational,4|5,7,4/5,220158,4
1,4,22,159,1,1140,1,9,4,4,5,single-choice,spatial-relational,4|5,7,4/5,220159,4
1,4,22,160,1,1677,2,12,5,5,7,single-choice,spatial-relational,5|7,7,5/7,220160,5
1,4,22,161,1,2096,2,10,4,4,6,single-choice,spatial-relational,4|6,7,4/6,220161,4
1,4,22,162,1,1006,5,9,2,2,7,single-choice,spatial-relational,2|7,7,2/7,220162,2
1,4,22,163,1,1631,1,11,5,5,6,single-choice,spatial-relational,5|6,7,5/6,220163,5
1,4,22,164,1,1402,1,3,1,1,2,single-choice,spatial-relational,1|2,7,1/2,220164,1
1,4,22,165,1,955,1,11,5,5,6,single-choice,spatial-relational,5|6,7,5/6,220165,5
1,4,22,166,1,1121,4,6,1,1,5,single-choice,spatial-relational,1|5,7,1/5,220166,1
1,4,22,167,1,930,3,7,2,2,5,single-choice,spatial-relational,2|5,7,2/5,220167,2
1,4,22,168,1,1002,1,13,6,6,7,single-choice,spatial-relational,6|7,7,6/7,220168,6
1,4,22,169,0,1507,5,7,1,6,6,single-choice,spatial-relational,1|6,7,1/6,220169,1
1,4,22,170,1,1161,4,10,3,3,7,single-choice,spatial-relational,3|7,7,3/7,220170,3
1,4,22,171,0,7,2,6,2,4,4,single-choice,spatial-relational,2|4,7,2/4,220171,2
1,4,22,172,0,1178,4,6,1,5,5,single-choice,spatial-relational,1|5,7,1/5,220172,1
1,4,22,173,0,2,1,7,3,4,4,single-choice,spatial-relational,3|4,7,3/4,220173,3
1,4,22,174,1,1406,3,5,1,1,4,single-choice,spatial-relational,1|4,7,1/4,220174,1
1,4,22,175,1,1197,4,6,1,1,5,single-choice,spatial-relational,1|5,7,1/5,220175,1
1,4,22,176,1,908,2,12,5,5,7,single-choice,spatial-relational,5|7,7,5/7,220176,5
1,4,22,177,1,1753,4,10,3,3,7,single-choice,spatial-relational,3|7,7,3/7,220177,3
1,4,22,178,1,1577,2,10,4,4,6,single-choice,spatial-relational,4|6,7,4/6,220178,4
1,4,22,179,1,1155,4,8,2,2,6,single-choice,spatial-relational,2|6,7,2/6,220179,2
1,4,22,180,1,882,2,4,1,1,3,single-choice,spatial-relational,1|3,7,1/3,220180,1
1,4,22,181,0,969,1,3,1,2,2,single-choice,spatial-relational,1|2,7,1/2,220181,1
1,4,22,182,1,740,5,9,2,2,7,single-choice,spatial-relational,2|7,7,2/7,220182,2
1,4,22,183,1,1058,3,5,1,1,4,single-choice,spatial-relational,1|4,7,1/4,220183,1
1,4,22,184,1,1602,3,7,2,2,5,single-choice,spatial-relational,2|5,7,2/5,220184,2
1,4,22,185,1,1044,1,5,2,2,3,single-choice,spatial-relational,2|3,7,2/3,220185,2
1,4,22,186,1,1167,2,4,1,1,3,single-choice,spatial-relational,1|3,7,1/3,220186,1
1,4,22,187,1,1202,1,11,5,5,6,single-choice,spatial-relational,5|6,7,5/6,220187,5
1,4,22,188,1,956,1,9,4,4,5,single-choice,spatial-relational,4|5,7,4/5,220188,4
1,4,22,189,1,927,4,8,2,2,6,single-choice,spatial-relational,2|6,7,2/6,220189,2
1,4,22,190,1,1176,6,8,1,1,7,single-choice,spatial-relational,1|7,7,1/7,220190,1
1,4,22,191,1,886,3,11,4,4,7,single-choice,spatial-relational,4|7,7,4/7,220191,4
1,4,22,192,1,1015,5,9,2,2,7,single-choice,spatial-relational,2|7,7,2/7,220192,2
1,4,22,193,1,1709,6,8,1,1,7,single-choice,spatial-relational,1|7,7,1/7,220193,1
1,4,22,194,1,2160,2,8,3,3,5,single-choice,spatial-relational,3|5,7,3/5,220194,3
1,4,22,195,1,778,1,13,6,6,7,single-choice,spatial-relational,6|7,7,6/7,220195,6
1,4,22,196,0,847,1,3,1,2,2,single-choice,spatial-relational,1|2,7,1/2,220196,1
1,4,22,197,1,3817,1,11,5,5,6,single-choice,spatial-relational,5|6,7,5/6,220197,5
1,4,22,198,1,1222,3,7,2,2,5,single-choice,spatial-relational,2|5,7,2/5,220198,2
1,4,22,199,1,1054,3,11,4,4,7,single-choice,spatial-relational,4|7,7,4/7,220199,4
1,4,22,200,1,769,1,13,6,6,7,single-choice,spatial-relational,6|7,7,6/7,220200,6
1,4,22,201,1,1043,5,7,1,1,6,single-choice,spatial-relational,1|6,7,1/6,220201,1
1,4,22,202,1,1558,2,10,4,4,6,single-choice,spatial-relational,4|6,7,4/6,220202,4
1,4,22,203,1,1803,1,5,2,2,3,single-choice,spatial-relational,2|3,7,2/3,220203,2
1,4,22,204,0,996,2,8,3,5,5,single-choice,spatial-relational,3|5,7,3/5,220204,3
1,4,22,205,1,2421,1,7,3,3,4,single-choice,spatial-relational,3|4,7,3/4,220205,3
1,4,22,206,1,982,1,9,4,4,5,single-choice,spatial-relational,4|5,7,4/5,220206,4
1,4,22,207,0,1526,2,6,2,4,4,single-choice,spatial-relational,2|4,7,2/4,220207,2
1,4,22,208,1,733,3,9,3,3,6,single-choice,spatial-relational,3|6,7,3/6,220208,3
1,4,22,209,1,2374,3,9,3,3,6,single-choice,spatial-relational,3|6,7,3/6,220209,3
1,4,22,210,1,1499,2,12,5,5,7,single-choice,spatial-relational,5|7,7,5/7,220210,5
1,4,22,211,1,1315,4,10,3,3,7,single-choice,spatial-relational,3|7,7,3/7,220211,3
1,4,22,212,0,1891,3,7,2,5,5,single-choice,spatial-relational,2|5,7,2/5,220212,2
1,4,22,213,0,732,3,5,1,4,4,single-choice,spatial-relational,1|4,7,1/4,220213,1
1,4,22,214,1,972,2,10,4,4,6,single-choice,spatial-relational,4|6,7,4/6,220214,4
1,4,22,215,1,1711,5,7,1,1,6,single-choice,spatial-relational,1|6,7,1/6,220215,1
1,4,22,216,1,1395,2,10,4,4,6,single-choice,spatial-relational,4|6,7,4/6,220216,4
1,4,22,217,1,2118,2,6,2,2,4,single-choice,spatial-relational,2|4,7,2/4,220217,2
1,4,22,218,1,1101,1,3,1,1,2,single-choice,spatial-relational,1|2,7,1/2,220218,1
1,4,22,219,1,899,3,11,4,4,7,single-choice,spatial-relational,4|7,7,4/7,220219,4
1,4,22,220,1,1076,4,10,3,3,7,single-choice,spatial-relational,3|7,7,3/7,220220,3
1,4,22,221,0,1894,3,9,3,6,6,single-choice,spatial-relational,3|6,7,3/6,220221,3
1,4,22,222,1,829,1,5,2,2,3,single-choice,spatial-relational,2|3,7,2/3,220222,2
1,4,22,223,1,1249,4,8,2,2,6,single-choice,spatial-relational,2|6,7,2/6,220223,2
1,4,22,224,1,958,4,6,1,1,5,single-choice,spatial-relational,1|5,7,1/5,220224,1
1,4,22,225,1,1658,1,11,5,5,6,single-choice,spatial-relational,5|6,7,5/6,220225,5
1,4,22,226,0,664,1,3,1,2,2,single-choice,spatial-relational,1|2,7,1/2,220226,1
1,4,22,227,1,1013,3,9,3,3,6,single-choice,spatial-relational,3|6,7,3/6,220227,3
1,4,22,228,1,902,5,9,2,2,7,single-choice,spatial-relational,2|7,7,2/7,220228,2
1,4,22,229,1,1030,1,7,3,3,4,single-choice,spatial-relational,3|4,7,3/4,220229,3
1,4,22,230,1,680,1,5,2,2,3,single-choice,spatial-relational,2|3,7,2/3,220230,2
1,4,22,231,1,1033,1,11,5,5,6,single-choice,spatial-relational,5|6,7,5/6,220231,5
1,4,22,232,1,2214,2,8,3,3,5,single-choice,spatial-relational,3|5,7,3/5,220232,3
1,4,22,233,1,1328,1,9,4,4,5,single-choice,spatial-relational,4|5,7,4/5,220233,4
1,4,22,234,1,1264,6,8,1,1,7,single-choice,spatial-relational,1|7,7,1/7,220234,1
1,4,22,235,1,1591,2,8,3,3,5,single-choice,spatial-relational,3|5,7,3/5,220235,3
1,4,22,236,1,1167,6,8,1,1,7,single-choice,spatial-relational,1|7,7,1/7,220236,1
1,4,22,237,1,889,1,13,6,6,7,single-choice,spatial-relational,6|7,7,6/7,220237,6
1,4,22,238,0,666,2,4,1,3,3,single-choice,spatial-relational,1|3,7,1/3,220238,1
1,4,22,239,0,944,4,8,2,6,6,single-choice,spatial-relational,2|6,7,2/6,220239,2
1,4,22,240,0,1262,2,6,2,4,4,single-choice,spatial-relational,2|4,7,2/4,220240,2
1,4,22,241,1,1690,5,7,1,1,6,single-choice,spatial-relational,1|6,7,1/6,220241,1
1,4,22,242,1,1077,2,12,5,5,7,single-choice,spatial-relational,5|7,7,5/7,220242,5
1,4,22,243,1,1162,4,6,1,1,5,single-choice,spatial-relational,1|5,7,1/5,220243,1
1,4,22,244,1,688,1,13,6,6,7,single-choice,spatial-relational,6|7,7,6/7,220244,6
1,4,22,245,1,1158,3,11,4,4,7,single-choice,spatial-relational,4|7,7,4/7,220245,4
1,4,22,246,1,904,2,12,5,5,7,single-choice,spatial-relational,5|7,7,5/7,220246,5
1,4,22,247,1,1202,3,7,2,2,5,single-choice,spatial-relational,2|5,7,2/5,220247,2
1,4,22,248,1,915,5,9,2,2,7,single-choice,spatial-relational,2|7,7,2/7,220248,2
1,4,22,249,1,1088,2,4,1,1,3,single-choice,spatial-relational,1|3,7,1/3,220249,1
1,4,22,250,1,1004,1,9,4,4,5,single-choice,spatial-relational,4|5,7,4/5,220250,4
1,4,22,251,0,726,3,5,1,4,4,single-choice,spatial-relational,1|4,7,1/4,220251,1
1,4,22,252,1,831,1,7,3,3,4,single-choice,spatial-relational,3|4,7,3/4,220252,3
1,4,22,253,1,911,4,8,2,2,6,single-choice,spatial-relational,2|6,7,2/6,220253,2
1,4,22,254,1,895,3,11,4,4,7,single-choice,spatial-relational,4|7,7,4/7,220254,4
1,4,22,255,0,132,2,12,5,7,7,single-choice,spatial-relational,5|7,7,5/7,220255,5
1,4,22,256,0,1159,2,6,2,4,4,single-choice,spatial-relational,2|4,7,2/4,220256,2
1,4,22,257,1,899,1,7,3,3,4,single-choice,spatial-relational,3|4,7,3/4,220257,3
1,4,22,258,1,958,5,7,1,1,6,single-choice,spatial-relational,1|6,7,1/6,220258,1
1,4,22,259,1,884,2,10,4,4,6,single-choice,spatial-relational,4|6,7,4/6,220259,4
1,4,22,260,1,2388,3,7,2,2,5,single-choice,spatial-relational,2|5,7,2/5,220260,2
1,4,22,261,1,718,5,9,2,2,7,single-choice,spatial-relational,2|7,7,2/7,220261,2
1,4,22,262,1,1050,1,11,5,5,6,single-choice,spatial-relational,5|6,7,5/6,220262,5
1,4,22,263,1,1441,1,5,2,2,3,single-choice,spatial-relational,2|3,7,2/3,220263,2
1,4,22,264,1,1340,1,3,1,1,2,single-choice,spatial-relational,1|2,7,1/2,220264,1
1,4,22,265,0,2101,6,8,1,7,7,single-choice,spatial-relational,1|7,7,1/7,220265,1
1,4,22,266,1,822,4,6,1,1,5,single-choice,spatial-relational,1|5,7,1/5,220266,1
1,4,22,267,1,842,1,11,5,5,6,single-choice,spatial-relational,5|6,7,5/6,220267,5
1,4,22,268,1,1327,1,3,1,1,2,single-choice,spatial-relational,1|2,7,1/2,220268,1
1,4,22,269,1,953,3,7,2,2,5,single-choice,spatial-relational,2|5,7,2/5,220269,2
1,4,22,270,1,1286,1,7,3,3,4,single-choice,spatial-relational,3|4,7,3/4,220270,3
1,4,22,271,1,1056,3,11,4,4,7,single-choice,spatial-relational,4|7,7,4/7,220271,4
1,4,22,272,1,1083,3,5,1,1,4,single-choice,spatial-relational,1|4,7,1/4,220272,1
1,4,22,273,1,908,2,8,3,3,5,single-choice,spatial-relational,3|5,7,3/5,220273,3
1,4,22,274,1,1011,4,10,3,3,7,single-choice,spatial-relational,3|7,7,3/7,220274,3
1,4,22,275,0,962,3,9,3,6,6,single-choice,spatial-relational,3|6,7,3/6,220275,3
1,4,22,276,1,1129,2,4,1,1,3,single-choice,spatial-relational,1|3,7,1/3,220276,1
1,4,22,277,1,1033,3,5,1,1,4,single-choice,spatial-relational,1|4,7,1/4,220277,1
1,4,22,278,1,962,4,10,3,3,7,single-choice,spatial-relational,3|7,7,3/7,220278,3
1,4,22,279,0,899,5,7,1,6,6,single-choice,spatial-relational,1|6,7,1/6,220279,1
1,4,22,280,1,1001,4,8,2,2,6,single-choice,spatial-relational,2|6,7,2/6,220280,2
1,4,22,281,1,853,1,13,6,6,7,single-choice,spatial-relational,6|7,7,6/7,220281,6
1,4,22,282,1,1473,6,8,1,1,7,single-choice,spatial-relational,1|7,7,1/7,220282,1
1,4,22,283,1,939,5,9,2,2,7,single-choice,spatial-relational,2|7,7,2/7,220283,2
1,4,22,284,1,1304,2,8,3,3,5,single-choice,spatial-relational,3|5,7,3/5,220284,3
1,4,22,285,1,1053,2,10,4,4,6,single-choice,spatial-relational,4|6,7,4/6,220285,4
1,4,22,286,1,1449,2,6,2,2,4,single-choice,spatial-relational,2|4,7,2/4,220286,2
1,4,22,287,1,1062,2,12,5,5,7,single-choice,spatial-relational,5|7,7,5/7,220287,5
1,4,22,288,1,1443,1,9,4,4,5,single-choice,spatial-relational,4|5,7,4/5,220288,4
1,4,22,289,1,953,2,4,1,1,3,single-choice,spatial-relational,1|3,7,1/3,220289,1
1,4,22,290,1,1136,4,6,1,1,5,single-choice,spatial-relational,1|5,7,1/5,220290,1
1,4,22,291,1,752,1,5,2,2,3,single-choice,spatial-relational,2|3,7,2/3,220291,2
1,4,22,292,1,1160,1,9,4,4,5,single-choice,spatial-relational,4|5,7,4/5,220292,4
1,4,22,293,1,961,1,13,6,6,7,single-choice,spatial-relational,6|7,7,6/7,220293,6
1,4,22,294,1,1528,3,9,3,3,6,single-choice,spatial-relational,3|6,7,3/6,220294,3
1,4,22,295,1,1592,3,5,1,1,4,single-choice,spatial-relational,1|4,7,1/4,220295,1
1,4,22,296,1,1001,1,11,5,5,6,single-choice,spatial-relational,5|6,7,5/6,220296,5
1,4,22,297,1,1299,1,9,4,4,5,single-choice,spatial-relational,4|5,7,4/5,220297,4
1,4,22,298,0,1090,3,9,3,6,6,single-choice,spatial-relational,3|6,7,3/6,220298,3
1,4,22,299,0,979,4,6,1,5,5,single-choice,spatial-relational,1|5,7,1/5,220299,1
1,4,22,300,1,4444,1,11,5,5,6,single-choice,spatial-relational,5|6,7,5/6,220300,5
1,4,22,301,0,1448,3,7,2,5,5,single-choice,spatial-relational,2|5,7,2/5,220301,2
1,4,22,302,1,1217,2,8,3,3,5,single-choice,spatial-relational,3|5,7,3/5,220302,3
1,4,22,303,1,1776,4,10,3,3,7,single-choice,spatial-relational,3|7,7,3/7,220303,3
1,4,22,304,0,1384,5,7,1,6,6,single-choice,spatial-relational,1|6,7,1/6,220304,1
1,4,22,305,1,784,1,13,6,6,7,single-choice,spatial-relational,6|7,7,6/7,220305,6
1,4,22,306,1,2034,2,6,2,2,4,single-choice,spatial-relational,2|4,7,2/4,220306,2
1,4,22,307,1,1293,5,7,1,1,6,single-choice,spatial-relational,1|6,7,1/6,220307,1
1,4,22,308,1,1135,1,9,4,4,5,single-choice,spatial-relational,4|5,7,4/5,220308,4
1,4,22,309,1,2009,1,7,3,3,4,single-choice,spatial-relational,3|4,7,3/4,220309,3
1,4,22,310,1,1101,4,6,1,1,5,single-choice,spatial-relational,1|5,7,1/5,220310,1
1,4,22,311,0,1119,1,3,1,2,2,single-choice,spatial-relational,1|2,7,1/2,220311,1
1,4,22,312,1,1758,6,8,1,1,7,single-choice,spatial-relational,1|7,7,1/7,220312,1
1,4,22,313,0,1446,3,5,1,4,4,single-choice,spatial-relational,1|4,7,1/4,220313,1
1,4,22,314,1,1219,4,8,2,2,6,single-choice,spatial-relational,2|6,7,2/6,220314,2
1,4,22,315,1,926,2,4,1,1,3,single-choice,spatial-relational,1|3,7,1/3,220315,1
1,4,22,316,1,538,1,13,6,6,7,single-choice,spatial-relational,6|7,7,6/7,220316,6
1,4,22,317,1,1060,6,8,1,1,7,single-choice,spatial-relational,1|7,7,1/7,220317,1
1,4,22,318,1,1698,4,10,3,3,7,single-choice,spatial-relational,3|7,7,3/7,220318,3
1,4,22,319,1,1264,1,7,3,3,4,single-choice,spatial-relational,3|4,7,3/4,220319,3
1,4,22,320,1,1148,2,6,2,2,4,single-choice,spatial-relational,2|4,7,2/4,220320,2
1,4,22,321,0,595,3,9,3,6,6,single-choice,spatial-relational,3|6,7,3/6,220321,3
1,4,22,322,1,734,2,12,5,5,7,single-choice,spatial-relational,5|7,7,5/7,220322,5
1,4,22,323,1,1467,2,10,4,4,6,single-choice,spatial-relational,4|6,7,4/6,220323,4
1,4,22,324,1,1083,5,9,2,2,7,single-choice,spatial-relational,2|7,7,2/7,220324,2
1,4,22,325,1,1631,2,8,3,3,5,single-choice,spatial-relational,3|5,7,3/5,220325,3
1,4,22,326,1,1102,2,10,4,4,6,single-choice,spatial-relational,4|6,7,4/6,220326,4
1,4,22,327,1,951,1,5,2,2,3,single-choice,spatial-relational,2|3,7,2/3,220327,2
1,4,22,328,1,1083,5,9,2,2,7,single-choice,spatial-relational,2|7,7,2/7,220328,2
1,4,22,329,1,1565,4,8,2,2,6,single-choice,spatial-relational,2|6,7,2/6,220329,2
1,4,22,330,1,1384,1,5,2,2,3,single-choice,spatial-relational,2|3,7,2/3,220330,2
1,4,22,331,1,1167,1,3,1,1,2,single-choice,spatial-relational,1|2,7,1/2,220331,1
1,4,22,332,1,789,2,12,5,5,7,single-choice,spatial-relational,5|7,7,5/7,220332,5
1,4,22,333,0,8,3,11,4,7,7,single-choice,spatial-relational,4|7,7,4/7,220333,4
1,4,22,334,0,428,3,7,2,5,5,single-choice,spatial-relational,2|5,7,2/5,220334,2
1,4,22,335,1,864,3,11,4,4,7,single-choice,spatial-relational,4|7,7,4/7,220335,4
1,4,22,336,0,1216,2,4,1,3,3,single-choice,spatial-relational,1|3,7,1/3,220336,1
1,4,22,337,1,794,5,9,2,2,7,single-choice,spatial-relational,2|7,7,2/7,220337,2
1,4,22,338,1,5,3,7,2,2,5,single-choice,spatial-relational,2|5,7,2/5,220338,2
1,4,22,339,1,3419,3,9,3,3,6,single-choice,spatial-relational,3|6,7,3/6,220339,3
1,4,22,340,1,976,4,8,2,2,6,single-choice,spatial-relational,2|6,7,2/6,220340,2
1,4,22,341,1,1059,3,11,4,4,7,single-choice,spatial-relational,4|7,7,4/7,220341,4
1,4,22,342,1,896,3,11,4,4,7,single-choice,spatial-relational,4|7,7,4/7,220342,4
1,4,22,343,1,1585,1,9,4,4,5,single-choice,spatial-relational,4|5,7,4/5,220343,4
1,4,22,344,1,1077,5,9,2,2,7,single-choice,spatial-relational,2|7,7,2/7,220344,2
1,4,22,345,1,984,1,3,1,1,2,single-choice,spatial-relational,1|2,7,1/2,220345,1
1,4,22,346,0,935,3,9,3,6,6,single-choice,spatial-relational,3|6,7,3/6,220346,3
1,4,22,347,0,2615,4,10,3,7,7,single-choice,spatial-relational,3|7,7,3/7,220347,3
1,4,22,348,1,2159,2,10,4,4,6,single-choice,spatial-relational,4|6,7,4/6,220348,4
1,4,22,349,1,1116,1,13,6,6,7,single-choice,spatial-relational,6|7,7,6/7,220349,6
1,4,22,350,1,2059,2,6,2,2,4,single-choice,spatial-relational,2|4,7,2/4,220350,2
1,4,22,351,1,1166,5,7,1,1,6,single-choice,spatial-relational,1|6,7,1/6,220351,1
1,4,22,352,1,1614,3,7,2,2,5,single-choice,spatial-relational,2|5,7,2/5,220352,2
1,4,22,353,1,1657,1,7,3,3,4,single-choice,spatial-relational,3|4,7,3/4,220353,3
1,4,22,354,1,1176,1,11,5,5,6,single-choice,spatial-relational,5|6,7,5/6,220354,5
1,4,22,355,1,994,2,10,4,4,6,single-choice,spatial-relational,4|6,7,4/6,220355,4
1,4,22,356,1,1092,2,4,1,1,3,single-choice,spatial-relational,1|3,7,1/3,220356,1
1,4,22,357,1,1896,3,5,1,1,4,single-choice,spatial-relational,1|4,7,1/4,220357,1
1,4,22,358,1,1494,6,8,1,1,7,single-choice,spatial-relational,1|7,7,1/7,220358,1
1,4,22,359,1,994,4,10,3,3,7,single-choice,spatial-relational,3|7,7,3/7,220359,3
1,4,22,360,0,1033,5,7,1,6,6,single-choice,spatial-relational,1|6,7,1/6,220360,1
1,4,22,361,1,1750,2,8,3,3,5,single-choice,spatial-relational,3|5,7,3/5,220361,3
1,4,22,362,0,1598,1,3,1,2,2,single-choice,spatial-relational,1|2,7,1/2,220362,1
1,4,22,363,1,1005,1,9,4,4,5,single-choice,spatial-relational,4|5,7,4/5,220363,4
1,4,22,364,1,904,1,5,2,2,3,single-choice,spatial-relational,2|3,7,2/3,220364,2
1,4,22,365,1,1154,4,6,1,1,5,single-choice,spatial-relational,1|5,7,1/5,220365,1
1,4,22,366,1,1056,3,5,1,1,4,single-choice,spatial-relational,1|4,7,1/4,220366,1
1,4,22,367,1,1061,6,8,1,1,7,single-choice,spatial-relational,1|7,7,1/7,220367,1
1,4,22,368,1,954,2,12,5,5,7,single-choice,spatial-relational,5|7,7,5/7,220368,5
1,4,22,369,1,842,1,5,2,2,3,single-choice,spatial-relational,2|3,7,2/3,220369,2
1,4,22,370,1,998,4,6,1,1,5,single-choice,spatial-relational,1|5,7,1/5,220370,1
1,4,22,371,1,1186,2,4,1,1,3,single-choice,spatial-relational,1|3,7,1/3,220371,1
1,4,22,372,0,1586,1,7,3,4,4,single-choice,spatial-relational,3|4,7,3/4,220372,3
1,4,22,373,0,721,4,8,2,6,6,single-choice,spatial-relational,2|6,7,2/6,220373,2
1,4,22,374,1,823,1,11,5,5,6,single-choice,spatial-relational,5|6,7,5/6,220374,5
1,4,22,375,1,1576,2,12,5,5,7,single-choice,spatial-relational,5|7,7,5/7,220375,5
1,4,22,376,1,2283,2,8,3,3,5,single-choice,spatial-relational,3|5,7,3/5,220376,3
1,4,22,377,1,956,2,6,2,2,4,single-choice,spatial-relational,2|4,7,2/4,220377,2
1,4,22,378,1,843,1,13,6,6,7,single-choice,spatial-relational,6|7,7,6/7,220378,6
1,4,22,379,1,775,1,5,2,2,3,single-choice,spatial-relational,2|3,7,2/3,220379,2
1,4,22,380,1,2025,2,6,2,2,4,single-choice,spatial-relational,2|4,7,2/4,220380,2
1,4,22,381,1,960,1,7,3,3,4,single-choice,spatial-relational,3|4,7,3/4,220381,3
1,4,22,382,1,1198,4,6,1,1,5,single-choice,spatial-relational,1|5,7,1/5,220382,1
1,4,22,383,0,732,5,7,1,6,6,single-choice,spatial-relational,1|6,7,1/6,220383,1
1,4,22,384,1,1745,5,9,2,2,7,single-choice,spatial-relational,2|7,7,2/7,220384,2
1,4,22,385,1,1035,2,10,4,4,6,single-choice,spatial-relational,4|6,7,4/6,220385,4
1,4,22,386,1,924,2,6,2,2,4,single-choice,spatial-relational,2|4,7,2/4,220386,2
1,4,22,387,1,1241,4,10,3,3,7,single-choice,spatial-relational,3|7,7,3/7,220387,3
1,4,22,388,1,1252,1,9,4,4,5,single-choice,spatial-relational,4|5,7,4/5,220388,4
1,4,22,389,1,1038,4,6,1,1,5,single-choice,spatial-relational,1|5,7,1/5,220389,1
1,4,22,390,1,869,4,10,3,3,7,single-choice,spatial-relational,3|7,7,3/7,220390,3
1,4,22,391,1,1809,1,9,4,4,5,single-choice,spatial-relational,4|5,7,4/5,220391,4
1,4,22,392,1,1141,2,8,3,3,5,single-choice,spatial-relational,3|5,7,3/5,220392,3
1,4,22,393,1,2366,2,4,1,1,3,single-choice,spatial-relational,1|3,7,1/3,220393,1
1,4,22,394,1,627,5,9,2,2,7,single-choice,spatial-relational,2|7,7,2/7,220394,2
1,4,22,395,1,969,1,13,6,6,7,single-choice,spatial-relational,6|7,7,6/7,220395,6
1,4,22,396,1,1060,3,11,4,4,7,single-choice,spatial-relational,4|7,7,4/7,220396,4
1,4,22,397,1,950,1,7,3,3,4,single-choice,spatial-relational,3|4,7,3/4,220397,3
1,4,22,398,1,1999,3,9,3,3,6,single-choice,spatial-relational,3|6,7,3/6,220398,3
1,4,22,399,1,1078,3,7,2,2,5,single-choice,spatial-relational,2|5,7,2/5,220399,2
1,4,22,400,1,1195,4,8,2,2,6,single-choice,spatial-relational,2|6,7,2/6,220400,2
1,4,22,401,1,1065,1,11,5,5,6,single-choice,spatial-relational,5|6,7,5/6,220401,5
1,4,22,402,0,924,3,7,2,5,5,single-choice,spatial-relational,2|5,7,2/5,220402,2
1,4,22,403,1,967,2,12,5,5,7,single-choice,spatial-relational,5|7,7,5/7,220403,5
1,4,22,404,0,862,3,5,1,4,4,single-choice,spatial-relational,1|4,7,1/4,220404,1
1,4,22,405,0,696,1,3,1,2,2,single-choice,spatial-relational,1|2,7,1/2,220405,1
1,4,22,406,0,713,3,9,3,6,6,single-choice,spatial-relational,3|6,7,3/6,220406,3
1,4,22,407,1,887,2,10,4,4,6,single-choice,spatial-relational,4|6,7,4/6,220407,4
1,4,22,408,1,1094,1,5,2,2,3,single-choice,spatial-relational,2|3,7,2/3,220408,2
1,4,22,409,0,1031,3,5,1,4,4,single-choice,spatial-relational,1|4,7,1/4,220409,1
1,4,22,410,1,2069,6,8,1,1,7,single-choice,spatial-relational,1|7,7,1/7,220410,1
1,4,22,411,1,955,4,8,2,2,6,single-choice,spatial-relational,2|6,7,2/6,220411,2
1,4,22,412,1,1177,1,11,5,5,6,single-choice,spatial-relational,5|6,7,5/6,220412,5
1,4,22,413,1,1036,1,3,1,1,2,single-choice,spatial-relational,1|2,7,1/2,220413,1
1,4,22,414,1,678,1,13,6,6,7,single-choice,spatial-relational,6|7,7,6/7,220414,6
1,4,22,415,1,1305,6,8,1,1,7,single-choice,spatial-relational,1|7,7,1/7,220415,1
1,4,22,416,1,879,3,11,4,4,7,single-choice,spatial-relational,4|7,7,4/7,220416,4
1,4,22,417,0,661,5,7,1,6,6,single-choice,spatial-relational,1|6,7,1/6,220417,1
1,4,22,418,0,1756,2,4,1,3,3,single-choice,spatial-relational,1|3,7,1/3,220418,1
1,4,22,419,0,1245,2,8,3,5,5,single-choice,spatial-relational,3|5,7,3/5,220419,3
1,4,22,420,1,1225,2,12,5,5,7,single-choice,spatial-relational,5|7,7,5/7,220420,5
1,4,22,421,1,1522,1,7,3,3,4,single-choice,spatial-relational,3|4,7,3/4,220421,3
1,4,22,422,0,995,3,9,3,6,6,single-choice,spatial-relational,3|6,7,3/6,220422,3
1,4,22,423,1,1137,3,7,2,2,5,single-choice,spatial-relational,2|5,7,2/5,220423,2
1,4,22,424,0,1049,4,8,2,6,6,single-choice,spatial-relational,2|6,7,2/6,220424,2
1,4,22,425,0,1582,1,5,2,3,3,single-choice,spatial-relational,2|3,7,2/3,220425,2
1,4,22,426,0,621,4,8,2,6,6,single-choice,spatial-relational,2|6,7,2/6,220426,2
1,4,22,427,1,1321,1,3,1,1,2,single-choice,spatial-relational,1|2,7,1/2,220427,1
1,4,22,428,1,1063,4,10,3,3,7,single-choice,spatial-relational,3|7,7,3/7,220428,3
1,4,22,429,1,2003,1,11,5,5,6,single-choice,spatial-relational,5|6,7,5/6,220429,5
1,4,22,430,1,910,1,9,4,4,5,single-choice,spatial-relational,4|5,7,4/5,220430,4
1,4,22,431,1,618,1,13,6,6,7,single-choice,spatial-relational,6|7,7,6/7,220431,6
1,4,22,432,1,1263,4,6,1,1,5,single-choice,spatial-relational,1|5,7,1/5,220432,1
1,4,22,433,1,1132,1,7,3,3,4,single-choice,spatial-relational,3|4,7,3/4,220433,3
1,4,22,434,1,1410,3,5,1,1,4,single-choice,spatial-relational,1|4,7,1/4,220434,1
1,4,22,435,1,1007,2,4,1,1,3,single-choice,spatial-relational,1|3,7,1/3,220435,1
1,4,22,436,1,914,1,5,2,2,3,single-choice,spatial-relational,2|3,7,2/3,220436,2
1,4,22,437,1,843,1,13,6,6,7,single-choice,spatial-relational,6|7,7,6/7,220437,6
1,4,22,438,1,816,2,6,2,2,4,single-choice,spatial-relational,2|4,7,2/4,220438,2
1,4,22,439,1,875,3,11,4,4,7,single-choice,spatial-relational,4|7,7,4/7,220439,4
1,4,22,440,1,1268,5,9,2,2,7,single-choice,spatial-relational,2|7,7,2/7,220440,2
1,4,22,441,0,736,5,7,1,6,6,single-choice,spatial-relational,1|6,7,1/6,220441,1
1,4,22,442,1,1479,4,6,1,1,5,single-choice,spatial-relational,1|5,7,1/5,220442,1
1,4,22,443,0,741,5,7,1,6,6,single-choice,spatial-relational,1|6,7,1/6,220443,1
1,4,22,444,0,2317,6,8,1,7,7,single-choice,spatial-relational,1|7,7,1/7,220444,1
1,4,22,445,0,1135,2,8,3,5,5,single-choice,spatial-relational,3|5,7,3/5,220445,3
1,4,22,446,1,820,2,10,4,4,6,single-choice,spatial-relational,4|6,7,4/6,220446,4
1,4,22,447,1,1311,2,10,4,4,6,single-choice,spatial-relational,4|6,7,4/6,220447,4
1,4,22,448,1,879,2,8,3,3,5,single-choice,spatial-relational,3|5,7,3/5,220448,3
1,4,22,449,1,1202,6,8,1,1,7,single-choice,spatial-relational,1|7,7,1/7,220449,1
1,4,22,450,1,1374,2,12,5,5,7,single-choice,spatial-relational,5|7,7,5/7,220450,5
1,4,22,451,1,868,5,9,2,2,7,single-choice,spatial-relational,2|7,7,2/7,220451,2
1,4,22,452,1,1502,3,9,3,3,6,single-choice,spatial-relational,3|6,7,3/6,220452,3
1,4,22,453,1,1112,3,7,2,2,5,single-choice,spatial-relational,2|5,7,2/5,220453,2
1,4,22,454,1,852,4,10,3,3,7,single-choice,spatial-relational,3|7,7,3/7,220454,3
1,4,22,455,0,910,2,6,2,4,4,single-choice,spatial-relational,2|4,7,2/4,220455,2
1,4,22,456,1,1111,1,3,1,1,2,single-choice,spatial-relational,1|2,7,1/2,220456,1
1,4,22,457,1,1086,1,9,4,4,5,single-choice,spatial-relational,4|5,7,4/5,220457,4
1,4,22,458,1,1018,2,4,1,1,3,single-choice,spatial-relational,1|3,7,1/3,220458,1
1,4,22,459,1,749,3,11,4,4,7,single-choice,spatial-relational,4|7,7,4/7,220459,4
1,4,22,460,1,1110,3,5,1,1,4,single-choice,spatial-relational,1|4,7,1/4,220460,1
1,4,22,461,1,943,1,11,5,5,6,single-choice,spatial-relational,5|6,7,5/6,220461,5
1,4,22,462,1,927,2,12,5,5,7,single-choice,spatial-relational,5|7,7,5/7,220462,5
1,4,22,463,1,1246,3,5,1,1,4,single-choice,spatial-relational,1|4,7,1/4,220463,1
1,4,22,464,1,1061,3,7,2,2,5,single-choice,spatial-relational,2|5,7,2/5,220464,2
1,4,22,465,1,976,1,13,6,6,7,single-choice,spatial-relational,6|7,7,6/7,220465,6
1,4,22,466,1,956,2,6,2,2,4,single-choice,spatial-relational,2|4,7,2/4,220466,2
1,4,22,467,1,805,3,9,3,3,6,single-choice,spatial-relational,3|6,7,3/6,220467,3
1,4,22,468,0,882,3,5,1,4,4,single-choice,spatial-relational,1|4,7,1/4,220468,1
1,4,22,469,1,895,5,9,2,2,7,single-choice,spatial-relational,2|7,7,2/7,220469,2
1,4,22,470,1,1057,2,4,1,1,3,single-choice,spatial-relational,1|3,7,1/3,220470,1
1,4,22,471,1,933,2,12,5,5,7,single-choice,spatial-relational,5|7,7,5/7,220471,5
1,4,22,472,1,1002,3,11,4,4,7,single-choice,spatial-relational,4|7,7,4/7,220472,4
1,4,22,473,1,1223,4,8,2,2,6,single-choice,spatial-relational,2|6,7,2/6,220473,2
1,4,22,474,1,964,1,3,1,1,2,single-choice,spatial-relational,1|2,7,1/2,220474,1
1,4,22,475,1,1131,4,6,1,1,5,single-choice,spatial-relational,1|5,7,1/5,220475,1
1,4,22,476,1,787,1,5,2,2,3,single-choice,spatial-relational,2|3,7,2/3,220476,2
1,4,22,477,1,1016,1,13,6,6,7,single-choice,spatial-relational,6|7,7,6/7,220477,6
1,4,22,478,1,864,1,11,5,5,6,single-choice,spatial-relational,5|6,7,5/6,220478,5
1,4,22,479,1,914,6,8,1,1,7,single-choice,spatial-relational,1|7,7,1/7,220479,1
1,4,22,480,1,992,2,10,4,4,6,single-choice,spatial-relational,4|6,7,4/6,220480,4
1,4,22,481,1,1125,3,11,4,4,7,single-choice,spatial-relational,4|7,7,4/7,220481,4
1,4,22,482,1,863,4,10,3,3,7,single-choice,spatial-relational,3|7,7,3/7,220482,3
1,4,22,483,1,1232,2,6,2,2,4,single-choice,spatial-relational,2|4,7,2/4,220483,2
1,4,22,484,1,598,5,9,2,2,7,single-choice,spatial-relational,2|7,7,2/7,220484,2
1,4,22,485,1,1201,4,6,1,1,5,single-choice,spatial-relational,1|5,7,1/5,220485,1
1,4,22,486,1,976,2,8,3,3,5,single-choice,spatial-relational,3|5,7,3/5,220486,3
1,4,22,487,1,945,4,8,2,2,6,single-choice,spatial-relational,2|6,7,2/6,220487,2
1,4,22,488,1,940,4,10,3,3,7,single-choice,spatial-relational,3|7,7,3/7,220488,3
1,4,22,489,0,1738,1,3,1,2,2,single-choice,spatial-relational,1|2,7,1/2,220489,1
1,4,22,490,0,1007,5,7,1,6,6,single-choice,spatial-relational,1|6,7,1/6,220490,1
1,4,22,491,1,1604,3,9,3,3,6,single-choice,spatial-relational,3|6,7,3/6,220491,3
1,4,22,492,0,1425,1,7,3,4,4,single-choice,spatial-relational,3|4,7,3/4,220492,3
1,4,22,493,1,1070,2,10,4,4,6,single-choice,spatial-relational,4|6,7,4/6,220493,4
1,4,22,494,1,1158,5,7,1,1,6,single-choice,spatial-relational,1|6,7,1/6,220494,1
1,4,22,495,1,850,1,7,3,3,4,single-choice,spatial-relational,3|4,7,3/4,220495,3
1,4,22,496,1,1281,2,4,1,1,3,single-choice,spatial-relational,1|3,7,1/3,220496,1
1,4,22,497,1,1100,6,8,1,1,7,single-choice,spatial-relational,1|7,7,1/7,220497,1
1,4,22,498,1,1077,1,5,2,2,3,single-choice,spatial-relational,2|3,7,2/3,220498,2
1,4,22,499,0,1334,2,8,3,5,5,single-choice,spatial-relational,3|5,7,3/5,220499,3
1,4,22,500,1,1116,1,9,4,4,5,single-choice,spatial-relational,4|5,7,4/5,220500,4
1,4,22,501,1,704,1,11,5,5,6,single-choice,spatial-relational,5|6,7,5/6,220501,5
1,4,22,502,1,1131,1,9,4,4,5,single-choice,spatial-relational,4|5,7,4/5,220502,4
1,4,22,503,1,896,2,12,5,5,7,single-choice,spatial-relational,5|7,7,5/7,220503,5
1,4,22,504,1,834,3,7,2,2,5,single-choice,spatial-relational,2|5,7,2/5,220504,2
1,4,22,505,1,1215,2,8,3,3,5,single-choice,spatial-relational,3|5,7,3/5,220505,3
1,4,22,506,1,999,1,13,6,6,7,single-choice,spatial-relational,6|7,7,6/7,220506,6
1,4,22,507,0,1075,1,7,3,4,4,single-choice,spatial-relational,3|4,7,3/4,220507,3
1,4,22,508,1,1069,1,3,1,1,2,single-choice,spatial-relational,1|2,7,1/2,220508,1
1,4,22,509,1,1573,2,8,3,3,5,single-choice,spatial-relational,3|5,7,3/5,220509,3
1,4,22,510,1,1022,3,7,2,2,5,single-choice,spatial-relational,2|5,7,2/5,220510,2
1,4,22,511,0,2071,3,9,3,6,6,single-choice,spatial-relational,3|6,7,3/6,220511,3
1,4,22,512,1,967,1,5,2,2,3,single-choice,spatial-relational,2|3,7,2/3,220512,2
1,4,22,513,1,1038,6,8,1,1,7,single-choice,spatial-relational,1|7,7,1/7,220513,1
1,4,22,514,1,817,3,11,4,4,7,single-choice,spatial-relational,4|7,7,4/7,220514,4
1,4,22,515,1,1110,4,6,1,1,5,single-choice,spatial-relational,1|5,7,1/5,220515,1
1,4,22,516,1,916,1,7,3,3,4,single-choice,spatial-relational,3|4,7,3/4,220516,3
1,4,22,517,1,2011,1,9,4,4,5,single-choice,spatial-relational,4|5,7,4/5,220517,4
1,4,22,518,1,947,4,8,2,2,6,single-choice,spatial-relational,2|6,7,2/6,220518,2
1,4,22,519,1,1060,4,10,3,3,7,single-choice,spatial-relational,3|7,7,3/7,220519,3
1,4,22,520,1,1361,3,9,3,3,6,single-choice,spatial-relational,3|6,7,3/6,220520,3
1,4,22,521,1,832,3,11,4,4,7,single-choice,spatial-relational,4|7,7,4/7,220521,4
1,4,22,522,1,1628,2,12,5,5,7,single-choice,spatial-relational,5|7,7,5/7,220522,5
1,4,22,523,1,953,2,12,5,5,7,single-choice,spatial-relational,5|7,7,5/7,220523,5
1,4,22,524,1,1001,1,9,4,4,5,single-choice,spatial-relational,4|5,7,4/5,220524,4
1,4,22,525,1,1207,5,7,1,1,6,single-choice,spatial-relational,1|6,7,1/6,220525,1
1,4,22,526,1,961,1,11,5,5,6,single-choice,spatial-relational,5|6,7,5/6,220526,5
1,4,22,527,1,1602,2,6,2,2,4,single-choice,spatial-relational,2|4,7,2/4,220527,2
1,4,22,528,1,1082,1,11,5,5,6,single-choice,spatial-relational,5|6,7,5/6,220528,5
1,4,22,529,1,1459,4,10,3,3,7,single-choice,spatial-relational,3|7,7,3/7,220529,3
1,4,22,530,1,1123,3,5,1,1,4,single-choice,spatial-relational,1|4,7,1/4,220530,1
1,4,22,531,1,1003,5,9,2,2,7,single-choice,spatial-relational,2|7,7,2/7,220531,2
1,4,22,532,1,850,2,10,4,4,6,single-choice,spatial-relational,4|6,7,4/6,220532,4
1,4,22,533,1,783,5,9,2,2,7,single-choice,spatial-relational,2|7,7,2/7,220533,2
1,4,22,534,1,825,3,7,2,2,5,single-choice,spatial-relational,2|5,7,2/5,220534,2
1,4,22,535,1,1160,2,4,1,1,3,single-choice,spatial-relational,1|3,7,1/3,220535,1
1,4,22,536,1,1138,5,7,1,1,6,single-choice,spatial-relational,1|6,7,1/6,220536,1
1,4,22,537,0,1237,2,6,2,4,4,single-choice,spatial-relational,2|4,7,2/4,220537,2
1,4,22,538,1,1513,2,4,1,1,3,single-choice,spatial-relational,1|3,7,1/3,220538,1
1,4,22,539,1,876,3,5,1,1,4,single-choice,spatial-relational,1|4,7,1/4,220539,1
1,4,22,540,0,802,4,6,1,5,5,single-choice,spatial-relational,1|5,7,1/5,220540,1
1,4,22,541,1,1115,1,13,6,6,7,single-choice,spatial-relational,6|7,7,6/7,220541,6
1,4,22,542,1,925,1,5,2,2,3,single-choice,spatial-relational,2|3,7,2/3,220542,2
1,4,22,543,1,1098,4,8,2,2,6,single-choice,spatial-relational,2|6,7,2/6,220543,2
1,4,22,544,1,1008,2,10,4,4,6,single-choice,spatial-relational,4|6,7,4/6,220544,4
1,4,22,545,1,1349,1,3,1,1,2,single-choice,spatial-relational,1|2,7,1/2,220545,1
1,4,22,546,1,1264,6,8,1,1,7,single-choice,spatial-relational,1|7,7,1/7,220546,1
1,4,22,547,1,1217,4,6,1,1,5,single-choice,spatial-relational,1|5,7,1/5,220547,1
1,4,22,548,1,883,1,11,5,5,6,single-choice,spatial-relational,5|6,7,5/6,220548,5
1,4,22,549,1,1692,2,4,1,1,3,single-choice,spatial-relational,1|3,7,1/3,220549,1
1,4,22,550,0,1182,1,3,1,2,2,single-choice,spatial-relational,1|2,7,1/2,220550,1
1,4,22,551,1,887,3,11,4,4,7,single-choice,spatial-relational,4|7,7,4/7,220551,4
1,4,22,552,1,653,1,13,6,6,7,single-choice,spatial-relational,6|7,7,6/7,220552,6
1,4,22,553,1,1004,2,6,2,2,4,single-choice,spatial-relational,2|4,7,2/4,220553,2
1,4,22,554,1,802,2,12,5,5,7,single-choice,spatial-relational,5|7,7,5/7,220554,5
1,4,22,555,1,1389,1,11,5,5,6,single-choice,spatial-relational,5|6,7,5/6,220555,5
1,4,22,556,1,1600,3,7,2,2,5,single-choice,spatial-relational,2|5,7,2/5,220556,2
1,4,22,557,1,872,2,10,4,4,6,single-choice,spatial-relational,4|6,7,4/6,220557,4
1,4,22,558,1,962,5,9,2,2,7,single-choice,spatial-relational,2|7,7,2/7,220558,2
1,4,22,559,1,672,3,11,4,4,7,single-choice,spatial-relational,4|7,7,4/7,220559,4
1,4,22,560,1,1925,1,5,2,2,3,single-choice,spatial-relational,2|3,7,2/3,220560,2
1,4,22,561,0,212,2,6,2,4,4,single-choice,spatial-relational,2|4,7,2/4,220561,2
1,4,22,562,0,1537,3,5,1,4,4,single-choice,spatial-relational,1|4,7,1/4,220562,1
1,4,22,563,1,2558,4,8,2,2,6,single-choice,spatial-relational,2|6,7,2/6,220563,2
1,4,22,564,1,1025,2,4,1,1,3,single-choice,spatial-relational,1|3,7,1/3,220564,1
1,4,22,565,1,1088,1,5,2,2,3,single-choice,spatial-relational,2|3,7,2/3,220565,2
1,4,22,566,1,1105,2,12,5,5,7,single-choice,spatial-relational,5|7,7,5/7,220566,5
1,4,22,567,1,1251,3,5,1,1,4,single-choice,spatial-relational,1|4,7,1/4,220567,1
1,4,22,568,1,1185,1,3,1,1,2,single-choice,spatial-relational,1|2,7,1/2,220568,1
1,4,22,569,1,911,5,7,1,1,6,single-choice,spatial-relational,1|6,7,1/6,220569,1
1,4,22,570,1,847,3,9,3,3,6,single-choice,spatial-relational,3|6,7,3/6,220570,3
1,4,22,571,1,1073,5,7,1,1,6,single-choice,spatial-relational,1|6,7,1/6,220571,1
1,4,22,572,1,1125,4,6,1,1,5,single-choice,spatial-relational,1|5,7,1/5,220572,1
1,4,22,573,1,857,3,7,2,2,5,single-choice,spatial-relational,2|5,7,2/5,220573,2
1,4,22,574,1,1214,1,13,6,6,7,single-choice,spatial-relational,6|7,7,6/7,220574,6
1,4,22,575,1,879,5,9,2,2,7,single-choice,spatial-relational,2|7,7,2/7,220575,2
1,4,22,576,0,1129,1,7,3,4,4,single-choice,spatial-relational,3|4,7,3/4,220576,3
1,4,22,577,1,1141,4,10,3,3,7,single-choice,spatial-relational,3|7,7,3/7,220577,3
1,4,22,578,1,1339,6,8,1,1,7,single-choice,spatial-relational,1|7,7,1/7,220578,1
1,4,22,579,1,1132,4,8,2,2,6,single-choice,spatial-relational,2|6,7,2/6,220579,2
1,4,22,580,1,947,4,10,3,3,7,single-choice,spatial-relational,3|7,7,3/7,220580,3
1,4,22,581,1,966,2,10,4,4,6,single-choice,spatial-relational,4|6,7,4/6,220581,4
1,4,22,582,1,1130,2,8,3,3,5,single-choice,spatial-relational,3|5,7,3/5,220582,3
1,4,22,583,1,69,2,8,3,3,5,single-choice,spatial-relational,3|5,7,3/5,220583,3
1,4,22,584,1,1125,1,7,3,3,4,single-choice,spatial-relational,3|4,7,3/4,220584,3
1,4,22,585,1,1046,1,9,4,4,5,single-choice,spatial-relational,4|5,7,4/5,220585,4
1,4,22,586,1,1318,6,8,1,1,7,single-choice,spatial-relational,1|7,7,1/7,220586,1
1,4,22,587,1,809,1,9,4,4,5,single-choice,spatial-relational,4|5,7,4/5,220587,4
1,4,22,588,1,1247,3,9,3,3,6,single-choice,spatial-relational,3|6,7,3/6,220588,3
1,4,22,589,1,686,3,11,4,4,7,single-choice,spatial-relational,4|7,7,4/7,220589,4
1,4,22,590,0,17,1,5,2,3,3,single-choice,spatial-relational,2|3,7,2/3,220590,2
1,4,22,591,1,837,2,4,1,1,3,single-choice,spatial-relational,1|3,7,1/3,220591,1
1,4,22,592,1,1055,2,6,2,2,4,single-choice,spatial-relational,2|4,7,2/4,220592,2
1,4,22,593,1,1117,1,11,5,5,6,single-choice,spatial-relational,5|6,7,5/6,220593,5
1,4,22,594,1,833,5,9,2,2,7,single-choice,spatial-relational,2|7,7,2/7,220594,2
1,4,22,595,1,1126,2,8,3,3,5,single-choice,spatial-relational,3|5,7,3/5,220595,3
1,4,22,596,0,496,2,4,1,3,3,single-choice,spatial-relational,1|3,7,1/3,220596,1
1,4,22,597,0,1039,4,8,2,6,6,single-choice,spatial-relational,2|6,7,2/6,220597,2
1,4,22,598,1,799,1,5,2,2,3,single-choice,spatial-relational,2|3,7,2/3,220598,2
1,4,22,599,1,988,5,9,2,2,7,single-choice,spatial-relational,2|7,7,2/7,220599,2
1,4,22,600,0,894,2,6,2,4,4,single-choice,spatial-relational,2|4,7,2/4,220600,2
2,4,22,1,1,1376,3,5,1,1,4,single-choice,spatial-relational,1|4,7,1/4,220001,1
2,4,22,2,1,610,1,13,6,6,7,single-choice,spatial-relational,6|7,7,6/7,220002,6
2,4,22,3,1,1119,2,12,5,5,7,single-choice,spatial-relational,5|7,7,5/7,220003,5
2,4,22,4,1,1069,1,11,5,5,6,single-choice,spatial-relational,5|6,7,5/6,220004,5
2,4,22,5,1,956,2,8,3,3,5,single-choice,spatial-relational,3|5,7,3/5,220005,3
2,4,22,6,0,930,1,3,1,2,2,single-choice,spatial-relational,1|2,7,1/2,220006,1
2,4,22,7,1,865,6,8,1,1,7,single-choice,spatial-relational,1|7,7,1/7,220007,1
2,4,22,8,1,710,4,10,3,3,7,single-choice,spatial-relational,3|7,7,3/7,220008,3
2,4,22,9,1,1373,3,9,3,3,6,single-choice,spatial-relational,3|6,7,3/6,220009,3
2,4,22,10,1,736,2,10,4,4,6,single-choice,spatial-relational,4|6,7,4/6,220010,4
2,4,22,11,1,864,3,11,4,4,7,single-choice,spatial-relational,4|7,7,4/7,220011,4
2,4,22,12,1,921,1,9,4,4,5,single-choice,spatial-relational,4|5,7,4/5,220012,4
2,4,22,13,1,739,4,8,2,2,6,single-choice,spatial-relational,2|6,7,2/6,220013,2
2,4,22,14,1,842,3,7,2,2,5,single-choice,spatial-relational,2|5,7,2/5,220014,2
2,4,22,15,1,1548,1,5,2,2,3,single-choice,spatial-relational,2|3,7,2/3,220015,2
2,4,22,16,1,966,2,12,5,5,7,single-choice,spatial-relational,5|7,7,5/7,220016,5
2,4,22,17,0,737,2,6,2,4,4,single-choice,spatial-relational,2|4,7,2/4,220017,2
2,4,22,18,1,780,4,10,3,3,7,single-choice,spatial-relational,3|7,7,3/7,220018,3
2,4,22,19,1,830,4,8,2,2,6,single-choice,spatial-relational,2|6,7,2/6,220019,2
2,4,22,20,0,1979,1,7,3,4,4,single-choice,spatial-relational,3|4,7,3/4,220020,3
2,4,22,21,1,852,1,7,3,3,4,single-choice,spatial-relational,3|4,7,3/4,220021,3
2,4,22,22,1,1040,3,5,1,1,4,single-choice,spatial-relational,1|4,7,1/4,220022,1
2,4,22,23,1,571,2,6,2,2,4,single-choice,spatial-relational,2|4,7,2/4,220023,2
2,4,22,24,1,866,4,6,1,1,5,single-choice,spatial-relational,1|5,7,1/5,220024,1
2,4,22,25,1,1569,3,9,3,3,6,single-choice,spatial-relational,3|6,7,3/6,220025,3
2,4,22,26,0,1152,2,8,3,5,5,single-choice,spatial-relational,3|5,7,3/5,220026,3
2,4,22,27,1,544,3,11,4,4,7,single-choice,spatial-relational,4|7,7,4/7,220027,4
2,4,22,28,1,1101,6,8,1,1,7,single-choice,spatial-relational,1|7,7,1/7,220028,1
2,4,22,29,1,897,1,13,6,6,7,single-choice,spatial-relational,6|7,7,6/7,220029,6
2,4,22,30,1,542,1,5,2,2,3,single-choice,spatial-relational,2|3,7,2/3,220030,2
2,4,22,31,1,897,5,7,1,1,6,single-choice,spatial-relational,1|6,7,1/6,220031,1
2,4,22,32,0,1182,1,3,1,2,2,single-choice,spatial-relational,1|2,7,1/2,220032,1
2,4,22,33,1,922,2,4,1,1,3,single-choice,spatial-relational,1|3,7,1/3,220033,1
2,4,22,34,1,798,2,4,1,1,3,single-choice,spatial-relational,1|3,7,1/3,220034,1
2,4,22,35,1,5,1,9,4,4,5,single-choice,spatial-relational,4|5,7,4/5,220035,4
2,4,22,36,1,840,3,7,2,2,5,single-choice,spatial-relational,2|5,7,2/5,220036,2
2,4,22,37,1,679,5,9,2,2,7,single-choice,spatial-relational,2|7,7,2/7,220037,2
2,4,22,38,1,950,2,10,4,4,6,single-choice,spatial-relational,4|6,7,4/6,220038,4
2,4,22,39,1,920,5,9,2,2,7,single-choice,spatial-relational,2|7,7,2/7,220039,2
2,4,22,40,1,1094,1,11,5,5,6,single-choice,spatial-relational,5|6,7,5/6,220040,5
2,4,22,41,1,1147,4,6,1,1,5,single-choice,spatial-relational,1|5,7,1/5,220041,1
2,4,22,42,1,870,5,7,1,1,6,single-choice,spatial-relational,1|6,7,1/6,220042,1
2,4,22,43,1,1058,6,8,1,1,7,single-choice,spatial-relational,1|7,7,1/7,220043,1
2,4,22,44,1,1245,2,8,3,3,5,single-choice,spatial-relational,3|5,7,3/5,220044,3
2,4,22,45,1,936,1,13,6,6,7,single-choice,spatial-relational,6|7,7,6/7,220045,6
2,4,22,46,1,291,6,8,1,1,7,single-choice,spatial-relational,1|7,7,1/7,220046,1
2,4,22,47,1,910,1,3,1,1,2,single-choice,spatial-relational,1|2,7,1/2,220047,1
2,4,22,48,1,1226,3,9,3,3,6,single-choice,spatial-relational,3|6,7,3/6,220048,3
2,4,22,49,1,842,3,7,2,2,5,single-choice,spatial-relational,2|5,7,2/5,220049,2
2,4,22,50,1,1153,2,4,1,1,3,single-choice,spatial-relational,1|3,7,1/3,220050,1
2,4,22,51,0,1501,1,3,1,2,2,single-choice,spatial-relational,1|2,7,1/2,220051,1
2,4,22,52,0,3,2,6,2,4,4,single-choice,spatial-relational,2|4,7,2/4,220052,2
2,4,22,53,1,806,1,11,5,5,6,single-choice,spatial-relational,5|6,7,5/6,220053,5
2,4,22,54,1,1385,4,8,2,2,6,single-choice,spatial-relational,2|6,7,2/6,220054,2
2,4,22,55,1,891,4,6,1,1,5,single-choice,spatial-relational,1|5,7,1/5,220055,1
2,4,22,56,1,1083,4,10,3,3,7,single-choice,spatial-relational,3|7,7,3/7,220056,3
2,4,22,57,1,850,1,9,4,4,5,single-choice,spatial-relational,4|5,7,4/5,220057,4
2,4,22,58,1,1228,3,5,1,1,4,single-choice,spatial-relational,1|4,7,1/4,220058,1
2,4,22,59,1,985,4,8,2,2,6,single-choice,spatial-relational,2|6,7,2/6,220059,2
2,4,22,60,1,2055,1,7,3,3,4,single-choice,spatial-relational,3|4,7,3/4,220060,3
2,4,22,61,1,734,5,9,2,2,7,single-choice,spatial-relational,2|7,7,2/7,220061,2
2,4,22,62,1,607,1,5,2,2,3,single-choice,spatial-relational,2|3,7,2/3,220062,2
2,4,22,63,1,963,2,10,4,4,6,single-choice,spatial-relational,4|6,7,4/6,220063,4
2,4,22,64,1,1492,4,6,1,1,5,single-choice,spatial-relational,1|5,7,1/5,220064,1
2,4,22,65,1,934,3,11,4,4,7,single-choice,spatial-relational,4|7,7,4/7,220065,4
2,4,22,66,1,924,1,11,5,5,6,single-choice,spatial-relational,5|6,7,5/6,220066,5
2,4,22,67,1,642,3,7,2,2,5,single-choice,spatial-relational,2|5,7,2/5,220067,2
2,4,22,68,1,1074,1,5,2,2,3,single-choice,spatial-relational,2|3,7,2/3,220068,2
2,4,22,69,1,1089,3,5,1,1,4,single-choice,spatial-relational,1|4,7,1/4,220069,1
2,4,22,70,1,1147,2,6,2,2,4,single-choice,spatial-relational,2|4,7,2/4,220070,2
2,4,22,71,1,1446,5,7,1,1,6,single-choice,spatial-relational,1|6,7,1/6,220071,1
2,4,22,72,1,1094,2,12,5,5,7,single-choice,spatial-relational,5|7,7,5/7,220072,5
2,4,22,73,1,3157,2,4,1,1,3,single-choice,spatial-relational,1|3,7,1/3,220073,1
2,4,22,74,0,1494,3,9,3,6,6,single-choice,spatial-relational,3|6,7,3/6,220074,3
2,4,22,75,1,664,3,11,4,4,7,single-choice,spatial-relational,4|7,7,4/7,220075,4
2,4,22,76,1,1049,5,9,2,2,7,single-choice,spatial-relational,2|7,7,2/7,220076,2
2,4,22,77,1,1195,2,10,4,4,6,single-choice,spatial-relational,4|6,7,4/6,220077,4
2,4,22,78,1,1296,5,7,1,1,6,single-choice,spatial-relational,1|6,7,1/6,220078,1
2,4,22,79,1,1643,1,7,3,3,4,single-choice,spatial-relational,3|4,7,3/4,220079,3
2,4,22,80,1,1145,4,10,3,3,7,single-choice,spatial-relational,3|7,7,3/7,220080,3
2,4,22,81,1,555,1,13,6,6,7,single-choice,spatial-relational,6|7,7,6/7,220081,6
2,4,22,82,1,1133,2,8,3,3,5,single-choice,spatial-relational,3|5,7,3/5,220082,3
2,4,22,83,1,868,1,9,4,4,5,single-choice,spatial-relational,4|5,7,4/5,220083,4
2,4,22,84,1,1122,2,12,5,5,7,single-choice,spatial-relational,5|7,7,5/7,220084,5
2,4,22,85,1,1137,5,7,1,1,6,single-choice,spatial-relational,1|6,7,1/6,220085,1
2,4,22,86,1,1475,2,6,2,2,4,single-choice,spatial-relational,2|4,7,2/4,220086,2
2,4,22,87,1,915,5,9,2,2,7,single-choice,spatial-relational,2|7,7,2/7,220087,2
2,4,22,88,0,529,1,7,3,4,4,single-choice,spatial-relational,3|4,7,3/4,220088,3
2,4,22,89,1,945,2,12,5,5,7,single-choice,spatial-relational,5|7,7,5/7,220089,5
2,4,22,90,1,887,2,12,5,5,7,single-choice,spatial-relational,5|7,7,5/7,220090,5
2,4,22,91,1,1197,2,4,1,1,3,single-choice,spatial-relational,1|3,7,1/3,220091,1
2,4,22,92,1,1098,2,10,4,4,6,single-choice,spatial-relational,4|6,7,4/6,220092,4
2,4,22,93,1,1428,1,7,3,3,4,single-choice,spatial-relational,3|4,7,3/4,220093,3
2,4,22,94,1,1166,3,11,4,4,7,single-choice,spatial-relational,4|7,7,4/7,220094,4
2,4,22,95,1,998,4,8,2,2,6,single-choice,spatial-relational,2|6,7,2/6,220095,2
2,4,22,96,1,1019,2,8,3,3,5,single-choice,spatial-relational,3|5,7,3/5,220096,3
2,4,22,97,0,1279,3,5,1,4,4,single-choice,spatial-relational,1|4,7,1/4,220097,1
2,4,22,98,1,1362,5,7,1,1,6,single-choice,spatial-relational,1|6,7,1/6,220098,1
2,4,22,99,1,836,3,9,3,3,6,single-choice,spatial-relational,3|6,7,3/6,220099,3
2,4,22,100,1,742,5,9,2,2,7,single-choice,spatial-relational,2|7,7,2/7,220100,2
2,4,22,101,1,836,1,5,2,2,3,single-choice,spatial-relational,2|3,7,2/3,220101,2
2,4,22,102,1,1750,4,10,3,3,7,single-choice,spatial-relational,3|7,7,3/7,220102,3
2,4,22,103,1,1124,6,8,1,1,7,single-choice,spatial-relational,1|7,7,1/7,220103,1
2,4,22,104,1,900,1,3,1,1,2,single-choice,spatial-relational,1|2,7,1/2,220104,1
2,4,22,105,1,718,1,13,6,6,7,single-choice,spatial-relational,6|7,7,6/7,220105,6
2,4,22,106,0,624,1,3,1,2,2,single-choice,spatial-relational,1|2,7,1/2,220106,1
2,4,22,107,1,973,1,9,4,4,5,single-choice,spatial-relational,4|5,7,4/5,220107,4
2,4,22,108,1,1129,3,7,2,2,5,single-choice,spatial-relational,2|5,7,2/5,220108,2
2,4,22,109,1,1619,2,10,4,4,6,single-choice,spatial-relational,4|6,7,4/6,220109,4
2,4,22,110,1,963,4,6,1,1,5,single-choice,spatial-relational,1|5,7,1/5,220110,1
2,4,22,111,1,1025,4,10,3,3,7,single-choice,spatial-relational,3|7,7,3/7,220111,3
2,4,22,112,1,766,2,6,2,2,4,single-choice,spatial-relational,2|4,7,2/4,220112,2
2,4,22,113,1,1294,4,8,2,2,6,single-choice,spatial-relational,2|6,7,2/6,220113,2
2,4,22,114,1,990,1,11,5,5,6,single-choice,spatial-relational,5|6,7,5/6,220114,5
2,4,22,115,1,1236,3,5,1,1,4,single-choice,spatial-relational,1|4,7,1/4,220115,1
2,4,22,116,1,1282,3,11,4,4,7,single-choice,spatial-relational,4|7,7,4/7,220116,4
2,4,22,117,1,1026,2,4,1,1,3,single-choice,spatial-relational,1|3,7,1/3,220117,1
2,4,22,118,1,685,1,13,6,6,7,single-choice,spatial-relational,6|7,7,6/7,220118,6
2,4,22,119,1,1037,6,8,1,1,7,single-choice,spatial-relational,1|7,7,1/7,220119,1
2,4,22,120,1,1024,1,11,5,5,6,single-choice,spatial-relational,5|6,7,5/6,220120,5
2,4,22,121,1,1104,4,6,1,1,5,single-choice,spatial-relational,1|5,7,1/5,220121,1
2,4,22,122,1,988,3,9,3,3,6,single-choice,spatial-relational,3|6,7,3/6,220122,3
2,4,22,123,0,1835,2,8,3,5,5,single-choice,spatial-relational,3|5,7,3/5,220123,3
2,4,22,124,1,921,3,7,2,2,5,single-choice,spatial-relational,2|5,7,2/5,220124,2
2,4,22,125,1,1495,1,9,4,4,5,single-choice,spatial-relational,4|5,7,4/5,220125,4
2,4,22,126,1,1184,1,5,2,2,3,single-choice,spatial-relational,2|3,7,2/3,220126,2
2,4,22,127,1,1701,1,5,2,2,3,single-choice,spatial-relational,2|3,7,2/3,220127,2
2,4,22,128,0,615,5,7,1,6,6,single-choice,spatial-relational,1|6,7,1/6,220128,1
2,4,22,129,1,1388,1,7,3,3,4,single-choice,spatial-relational,3|4,7,3/4,220129,3
2,4,22,130,1,747,1,13,6,6,7,single-choice,spatial-relational,6|7,7,6/7,220130,6
2,4,22,131,1,1001,1,9,4,4,5,single-choice,spatial-relational,4|5,7,4/5,220131,4
2,4,22,132,1,616,5,9,2,2,7,single-choice,spatial-relational,2|7,7,2/7,220132,2
2,4,22,133,1,1015,3,11,4,4,7,single-choice,spatial-relational,4|7,7,4/7,220133,4
2,4,22,134,1,1918,4,10,3,3,7,single-choice,spatial-relational,3|7,7,3/7,220134,3
2,4,22,135,1,1205,5,7,1,1,6,single-choice,spatial-relational,1|6,7,1/6,220135,1
2,4,22,136,1,693,4,8,2,2,6,single-choice,spatial-relational,2|6,7,2/6,220136,2
2,4,22,137,1,1670,2,4,1,1,3,single-choice,spatial-relational,1|3,7,1/3,220137,1
2,4,22,138,1,1053,6,8,1,1,7,single-choice,spatial-relational,1|7,7,1/7,220138,1
2,4,22,139,1,2093,3,5,1,1,4,single-choice,spatial-relational,1|4,7,1/4,220139,1
2,4,22,140,1,671,2,12,5,5,7,single-choice,spatial-relational,5|7,7,5/7,220140,5
2,4,22,141,1,958,1,11,5,5,6,single-choice,spatial-relational,5|6,7,5/6,220141,5
2,4,22,142,1,1427,4,8,2,2,6,single-choice,spatial-relational,2|6,7,2/6,220142,2
2,4,22,143,1,1227,2,8,3,3,5,single-choice,spatial-relational,3|5,7,3/5,220143,3
2,4,22,144,1,985,5,9,2,2,7,single-choice,spatial-relational,2|7,7,2/7,220144,2
2,4,22,145,1,858,2,6,2,2,4,single-choice,spatial-relational,2|4,7,2/4,220145,2
2,4,22,146,1,982,1,13,6,6,7,single-choice,spatial-relational,6|7,7,6/7,220146,6
2,4,22,147,1,662,1,5,2,2,3,single-choice,spatial-relational,2|3,7,2/3,220147,2
2,4,22,148,0,905,2,6,2,4,4,single-choice,spatial-relational,2|4,7,2/4,220148,2
2,4,22,149,0,538,2,4,1,3,3,single-choice,spatial-relational,1|3,7,1/3,220149,1
2,4,22,150,1,1049,2,8,3,3,5,single-choice,spatial-relational,3|5,7,3/5,220150,3
2,4,22,151,1,959,2,10,4,4,6,single-choice,spatial-relational,4|6,7,4/6,220151,4
2,4,22,152,0,861,3,9,3,6,6,single-choice,spatial-relational,3|6,7,3/6,220152,3
2,4,22,153,1,963,2,10,4,4,6,single-choice,spatial-relational,4|6,7,4/6,220153,4
2,4,22,154,1,1381,3,5,1,1,4,single-choice,spatial-relational,1|4,7,1/4,220154,1
2,4,22,155,1,898,6,8,1,1,7,single-choice,spatial-relational,1|7,7,1/7,220155,1
2,4,22,156,0,825,3,9,3,6,6,single-choice,spatial-relational,3|6,7,3/6,220156,3
2,4,22,157,1,1085,4,6,1,1,5,single-choice,spatial-relational,1|5,7,1/5,220157,1
2,4,22,158,1,813,3,7,2,2,5,single-choice,spatial-relational,2|5,7,2/5,220158,2
2,4,22,159,1,853,1,9,4,4,5,single-choice,spatial-relational,4|5,7,4/5,220159,4
2,4,22,160,1,1341,2,12,5,5,7,single-choice,spatial-relational,5|7,7,5/7,220160,5
2,4,22,161,1,962,4,10,3,3,7,single-choice,spatial-relational,3|7,7,3/7,220161,3
2,4,22,162,1,664,3,7,2,2,5,single-choice,spatial-relational,2|5,7,2/5,220162,2
2,4,22,163,0,1761,1,7,3,4,4,single-choice,spatial-relational,3|4,7,3/4,220163,3
2,4,22,164,1,981,1,3,1,1,2,single-choice,spatial-relational,1|2,7,1/2,220164,1
2,4,22,165,1,925,3,11,4,4,7,single-choice,spatial-relational,4|7,7,4/7,220165,4
2,4,22,166,1,1664,1,11,5,5,6,single-choice,spatial-relational,5|6,7,5/6,220166,5
2,4,22,167,1,915,4,6,1,1,5,single-choice,spatial-relational,1|5,7,1/5,220167,1
2,4,22,168,1,1515,1,3,1,1,2,single-choice,spatial-relational,1|2,7,1/2,220168,1
2,4,22,169,1,1143,2,8,3,3,5,single-choice,spatial-relational,3|5,7,3/5,220169,3
2,4,22,170,1,979,3,5,1,1,4,single-choice,spatial-relational,1|4,7,1/4,220170,1
2,4,22,171,1,1215,1,5,2,2,3,single-choice,spatial-relational,2|3,7,2/3,220171,2
2,4,22,172,1,536,3,9,3,3,6,single-choice,spatial-relational,3|6,7,3/6,220172,3
2,4,22,173,1,1416,5,7,1,1,6,single-choice,spatial-relational,1|6,7,1/6,220173,1
2,4,22,174,1,600,1,13,6,6,7,single-choice,spatial-relational,6|7,7,6/7,220174,6
2,4,22,175,1,721,2,10,4,4,6,single-choice,spatial-relational,4|6,7,4/6,220175,4
2,4,22,176,1,1045,3,7,2,2,5,single-choice,spatial-relational,2|5,7,2/5,220176,2
2,4,22,177,1,923,2,8,3,3,5,single-choice,spatial-relational,3|5,7,3/5,220177,3
2,4,22,178,1,903,6,8,1,1,7,single-choice,spatial-relational,1|7,7,1/7,220178,1
2,4,22,179,1,1034,4,10,3,3,7,single-choice,spatial-relational,3|7,7,3/7,220179,3
2,4,22,180,1,1176,5,7,1,1,6,single-choice,spatial-relational,1|6,7,1/6,220180,1
2,4,22,181,1,1110,1,7,3,3,4,single-choice,spatial-relational,3|4,7,3/4,220181,3
2,4,22,182,1,1095,4,6,1,1,5,single-choice,spatial-relational,1|5,7,1/5,220182,1
2,4,22,183,1,955,4,10,3,3,7,single-choice,spatial-relational,3|7,7,3/7,220183,3
2,4,22,184,1,813,2,4,1,1,3,single-choice,spatial-relational,1|3,7,1/3,220184,1
2,4,22,185,1,961,1,9,4,4,5,single-choice,spatial-relational,4|5,7,4/5,220185,4
2,4,22,186,1,888,2,10,4,4,6,single-choice,spatial-relational,4|6,7,4/6,220186,4
2,4,22,187,1,878,1,5,2,2,3,single-choice,spatial-relational,2|3,7,2/3,220187,2
2,4,22,188,0,520,1,9,4,5,5,single-choice,spatial-relational,4|5,7,4/5,220188,4
2,4,22,189,1,667,3,11,4,4,7,single-choice,spatial-relational,4|7,7,4/7,220189,4
2,4,22,190,1,701,1,13,6,6,7,single-choice,spatial-relational,6|7,7,6/7,220190,6
2,4,22,191,1,1645,4,8,2,2,6,single-choice,spatial-relational,2|6,7,2/6,220191,2
2,4,22,192,1,760,2,6,2,2,4,single-choice,spatial-relational,2|4,7,2/4,220192,2
2,4,22,193,1,1232,3,5,1,1,4,single-choice,spatial-relational,1|4,7,1/4,220193,1
2,4,22,194,1,1252,3,9,3,3,6,single-choice,spatial-relational,3|6,7,3/6,220194,3
2,4,22,195,1,1183,6,8,1,1,7,single-choice,spatial-relational,1|7,7,1/7,220195,1
2,4,22,196,1,933,5,9,2,2,7,single-choice,spatial-relational,2|7,7,2/7,220196,2
2,4,22,197,1,638,3,7,2,2,5,single-choice,spatial-relational,2|5,7,2/5,220197,2
2,4,22,198,1,1312,1,3,1,1,2,single-choice,spatial-relational,1|2,7,1/2,220198,1
2,4,22,199,0,598,1,11,5,6,6,single-choice,spatial-relational,5|6,7,5/6,220199,5
2,4,22,200,1,822,2,12,5,5,7,single-choice,spatial-relational,5|7,7,5/7,220200,5
2,4,22,201,1,1053,4,6,1,1,5,single-choice,spatial-relational,1|5,7,1/5,220201,1
2,4,22,202,1,913,2,12,5,5,7,single-choice,spatial-relational,5|7,7,5/7,220202,5
2,4,22,203,1,794,5,9,2,2,7,single-choice,spatial-relational,2|7,7,2/7,220203,2
2,4,22,204,1,1302,1,11,5,5,6,single-choice,spatial-relational,5|6,7,5/6,220204,5
2,4,22,205,1,1085,2,4,1,1,3,single-choice,spatial-relational,1|3,7,1/3,220205,1
2,4,22,206,1,822,1,3,1,1,2,single-choice,spatial-relational,1|2,7,1/2,220206,1
2,4,22,207,1,806,4,8,2,2,6,single-choice,spatial-relational,2|6,7,2/6,220207,2
2,4,22,208,1,1050,2,6,2,2,4,single-choice,spatial-relational,2|4,7,2/4,220208,2
2,4,22,209,1,659,3,11,4,4,7,single-choice,spatial-relational,4|7,7,4/7,220209,4
2,4,22,210,1,1621,1,7,3,3,4,single-choice,spatial-relational,3|4,7,3/4,220210,3
2,4,22,211,0,709,2,4,1,3,3,single-choice,spatial-relational,1|3,7,1/3,220211,1
2,4,22,212,0,734,4,6,1,5,5,single-choice,spatial-relational,1|5,7,1/5,220212,1
2,4,22,213,0,2052,2,6,2,4,4,single-choice,spatial-relational,2|4,7,2/4,220213,2
2,4,22,214,0,908,2,4,1,3,3,single-choice,spatial-relational,1|3,7,1/3,220214,1
2,4,22,215,1,909,1,13,6,6,7,single-choice,spatial-relational,6|7,7,6/7,220215,6
2,4,22,216,1,1072,3,7,2,2,5,single-choice,spatial-relational,2|5,7,2/5,220216,2
2,4,22,217,1,1040,3,5,1,1,4,single-choice,spatial-relational,1|4,7,1/4,220217,1
2,4,22,218,1,1008,1,11,5,5,6,single-choice,spatial-relational,5|6,7,5/6,220218,5
2,4,22,219,1,1361,4,10,3,3,7,single-choice,spatial-relational,3|7,7,3/7,220219,3
2,4,22,220,1,996,2,12,5,5,7,single-choice,spatial-relational,5|7,7,5/7,220220,5
2,4,22,221,1,940,2,12,5,5,7,single-choice,spatial-relational,5|7,7,5/7,220221,5
2,4,22,222,1,1086,2,8,3,3,5,single-choice,spatial-relational,3|5,7,3/5,220222,3
2,4,22,223,0,622,1,3,1,2,2,single-choice,spatial-relational,1|2,7,1/2,220223,1
2,4,22,224,1,766,1,9,4,4,5,single-choice,spatial-relational,4|5,7,4/5,220224,4
2,4,22,225,1,1348,3,9,3,3,6,single-choice,spatial-relational,3|6,7,3/6,220225,3
2,4,22,226,1,1438,1,13,6,6,7,single-choice,spatial-relational,6|7,7,6/7,220226,6
2,4,22,227,1,749,5,9,2,2,7,single-choice,spatial-relational,2|7,7,2/7,220227,2
2,4,22,228,1,966,2,10,4,4,6,single-choice,spatial-relational,4|6,7,4/6,220228,4
2,4,22,229,1,1204,3,9,3,3,6,single-choice,spatial-relational,3|6,7,3/6,220229,3
2,4,22,230,1,712,1,5,2,2,3,single-choice,spatial-relational,2|3,7,2/3,220230,2
2,4,22,231,1,1271,3,7,2,2,5,single-choice,spatial-relational,2|5,7,2/5,220231,2
2,4,22,232,1,1453,6,8,1,1,7,single-choice,spatial-relational,1|7,7,1/7,220232,1
2,4,22,233,1,1727,2,8,3,3,5,single-choice,spatial-relational,3|5,7,3/5,220233,3
2,4,22,234,1,1022,1,11,5,5,6,single-choice,spatial-relational,5|6,7,5/6,220234,5
2,4,22,235,1,1786,2,10,4,4,6,single-choice,spatial-relational,4|6,7,4/6,220235,4
2,4,22,236,1,1907,6,8,1,1,7,single-choice,spatial-relational,1|7,7,1/7,220236,1
2,4,22,237,1,1530,4,10,3,3,7,single-choice,spatial-relational,3|7,7,3/7,220237,3
2,4,22,238,1,955,3,11,4,4,7,single-choice,spatial-relational,4|7,7,4/7,220238,4
2,4,22,239,1,1355,1,5,2,2,3,single-choice,spatial-relational,2|3,7,2/3,220239,2
2,4,22,240,1,695,3,11,4,4,7,single-choice,spatial-relational,4|7,7,4/7,220240,4
2,4,22,241,1,1190,5,7,1,1,6,single-choice,spatial-relational,1|6,7,1/6,220241,1
2,4,22,242,1,903,4,8,2,2,6,single-choice,spatial-relational,2|6,7,2/6,220242,2
2,4,22,243,1,1394,1,7,3,3,4,single-choice,spatial-relational,3|4,7,3/4,220243,3
2,4,22,244,1,3100,1,7,3,3,4,single-choice,spatial-relational,3|4,7,3/4,220244,3
2,4,22,245,1,1317,5,7,1,1,6,single-choice,spatial-relational,1|6,7,1/6,220245,1
2,4,22,246,1,1255,3,5,1,1,4,single-choice,spatial-relational,1|4,7,1/4,220246,1
2,4,22,247,1,917,4,6,1,1,5,single-choice,spatial-relational,1|5,7,1/5,220247,1
2,4,22,248,1,852,5,9,2,2,7,single-choice,spatial-relational,2|7,7,2/7,220248,2
2,4,22,249,1,1228,4,8,2,2,6,single-choice,spatial-relational,2|6,7,2/6,220249,2
2,4,22,250,1,1568,1,9,4,4,5,single-choice,spatial-relational,4|5,7,4/5,220250,4
2,4,22,251,1,882,2,6,2,2,4,single-choice,spatial-relational,2|4,7,2/4,220251,2
2,4,22,252,1,1085,1,3,1,1,2,single-choice,spatial-relational,1|2,7,1/2,220252,1
2,4,22,253,1,1158,3,5,1,1,4,single-choice,spatial-relational,1|4,7,1/4,220253,1
2,4,22,254,0,872,2,4,1,3,3,single-choice,spatial-relational,1|3,7,1/3,220254,1
2,4,22,255,1,845,1,13,6,6,7,single-choice,spatial-relational,6|7,7,6/7,220255,6
2,4,22,256,1,3,4,6,1,1,5,single-choice,spatial-relational,1|5,7,1/5,220256,1
2,4,22,257,1,1021,1,3,1,1,2,single-choice,spatial-relational,1|2,7,1/2,220257,1
2,4,22,258,1,686,4,10,3,3,7,single-choice,spatial-relational,3|7,7,3/7,220258,3
2,4,22,259,1,1007,4,10,3,3,7,single-choice,spatial-relational,3|7,7,3/7,220259,3
2,4,22,260,1,1134,1,11,5,5,6,single-choice,spatial-relational,5|6,7,5/6,220260,5
2,4,22,261,1,963,1,9,4,4,5,single-choice,spatial-relational,4|5,7,4/5,220261,4
2,4,22,262,1,961,4,8,2,2,6,single-choice,spatial-relational,2|6,7,2/6,220262,2
2,4,22,263,1,892,2,10,4,4,6,single-choice,spatial-relational,4|6,7,4/6,220263,4
2,4,22,264,1,1305,1,3,1,1,2,single-choice,spatial-relational,1|2,7,1/2,220264,1
2,4,22,265,1,1070,3,9,3,3,6,single-choice,spatial-relational,3|6,7,3/6,220265,3
2,4,22,266,1,1459,6,8,1,1,7,single-choice,spatial-relational,1|7,7,1/7,220266,1
2,4,22,267,1,889,1,11,5,5,6,single-choice,spatial-relational,5|6,7,5/6,220267,5
2,4,22,268,1,962,1,13,6,6,7,single-choice,spatial-relational,6|7,7,6/7,220268,6
2,4,22,269,1,988,2,12,5,5,7,single-choice,spatial-relational,5|7,7,5/7,220269,5
2,4,22,270,1,910,4,6,1,1,5,single-choice,spatial-relational,1|5,7,1/5,220270,1
2,4,22,271,1,822,2,8,3,3,5,single-choice,spatial-relational,3|5,7,3/5,220271,3
2,4,22,272,1,1035,2,6,2,2,4,single-choice,spatial-relational,2|4,7,2/4,220272,2
2,4,22,273,1,1000,1,5,2,2,3,single-choice,spatial-relational,2|3,7,2/3,220273,2
2,4,22,274,1,778,5,9,2,2,7,single-choice,spatial-relational,2|7,7,2/7,220274,2
2,4,22,275,0,660,2,10,4,6,6,single-choice,spatial-relational,4|6,7,4/6,220275,4
2,4,22,276,1,967,6,8,1,1,7,single-choice,spatial-relational,1|7,7,1/7,220276,1
2,4,22,277,1,1131,1,7,3,3,4,single-choice,spatial-relational,3|4,7,3/4,220277,3
2,4,22,278,1,836,3,7,2,2,5,single-choice,spatial-relational,2|5,7,2/5,220278,2
2,4,22,279,1,1001,3,11,4,4,7,single-choice,spatial-relational,4|7,7,4/7,220279,4
2,4,22,280,1,1061,3,9,3,3,6,single-choice,spatial-relational,3|6,7,3/6,220280,3
2,4,22,281,1,882,5,7,1,1,6,single-choice,spatial-relational,1|6,7,1/6,220281,1
2,4,22,282,0,1237,1,9,4,5,5,single-choice,spatial-relational,4|5,7,4/5,220282,4
2,4,22,283,1,738,3,11,4,4,7,single-choice,spatial-relational,4|7,7,4/7,220283,4
2,4,22,284,1,1064,3,7,2,2,5,single-choice,spatial-relational,2|5,7,2/5,220284,2
2,4,22,285,1,604,5,9,2,2,7,single-choice,spatial-relational,2|7,7,2/7,220285,2
2,4,22,286,1,1218,2,4,1,1,3,single-choice,spatial-relational,1|3,7,1/3,220286,1
2,4,22,287,1,1615,1,7,3,3,4,single-choice,spatial-relational,3|4,7,3/4,220287,3
2,4,22,288,1,1058,2,8,3,3,5,single-choice,spatial-relational,3|5,7,3/5,220288,3
2,4,22,289,1,734,4,8,2,2,6,single-choice,spatial-relational,2|6,7,2/6,220289,2
2,4,22,290,1,1052,1,5,2,2,3,single-choice,spatial-relational,2|3,7,2/3,220290,2
2,4,22,291,1,774,2,12,5,5,7,single-choice,spatial-relational,5|7,7,5/7,220291,5
2,4,22,292,0,748,2,6,2,4,4,single-choice,spatial-relational,2|4,7,2/4,220292,2
2,4,22,293,0,727,5,7,1,6,6,single-choice,spatial-relational,1|6,7,1/6,220293,1
2,4,22,294,1,1073,3,5,1,1,4,single-choice,spatial-relational,1|4,7,1/4,220294,1
2,4,22,295,1,568,1,13,6,6,7,single-choice,spatial-relational,6|7,7,6/7,220295,6
2,4,22,296,1,1092,2,4,1,1,3,single-choice,spatial-relational,1|3,7,1/3,220296,1
2,4,22,297,1,1068,1,9,4,4,5,single-choice,spatial-relational,4|5,7,4/5,220297,4
2,4,22,298,1,1312,5,7,1,1,6,single-choice,spatial-relational,1|6,7,1/6,220298,1
2,4,22,299,1,1013,3,5,1,1,4,single-choice,spatial-relational,1|4,7,1/4,220299,1
2,4,22,300,1,842,4,10,3,3,7,single-choice,spatial-relational,3|7,7,3/7,220300,3
2,4,22,301,1,1047,4,6,1,1,5,single-choice,spatial-relational,1|5,7,1/5,220301,1
2,4,22,302,1,976,1,7,3,3,4,single-choice,spatial-relational,3|4,7,3/4,220302,3
2,4,22,303,1,1125,2,6,2,2,4,single-choice,spatial-relational,2|4,7,2/4,220303,2
2,4,22,304,1,1065,3,9,3,3,6,single-choice,spatial-relational,3|6,7,3/6,220304,3
2,4,22,305,1,661,3,11,4,4,7,single-choice,spatial-relational,4|7,7,4/7,220305,4
2,4,22,306,1,974,1,13,6,6,7,single-choice,spatial-relational,6|7,7,6/7,220306,6
2,4,22,307,1,933,2,12,5,5,7,single-choice,spatial-relational,5|7,7,5/7,220307,5
2,4,22,308,1,746,2,6,2,2,4,single-choice,spatial-relational,2|4,7,2/4,220308,2
2,4,22,309,1,1233,2,10,4,4,6,single-choice,spatial-relational,4|6,7,4/6,220309,4
2,4,22,310,1,996,1,5,2,2,3,single-choice,spatial-relational,2|3,7,2/3,220310,2
2,4,22,311,1,939,4,10,3,3,7,single-choice,spatial-relational,3|7,7,3/7,220311,3
2,4,22,312,1,1012,2,8,3,3,5,single-choice,spatial-relational,3|5,7,3/5,220312,3
2,4,22,313,1,882,2,12,5,5,7,single-choice,spatial-relational,5|7,7,5/7,220313,5
2,4,22,314,1,722,1,9,4,4,5,single-choice,spatial-relational,4|5,7,4/5,220314,4
2,4,22,315,1,778,4,8,2,2,6,single-choice,spatial-relational,2|6,7,2/6,220315,2
2,4,22,316,0,957,1,11,5,6,6,single-choice,spatial-relational,5|6,7,5/6,220316,5
2,4,22,317,0,740,4,6,1,5,5,single-choice,spatial-relational,1|5,7,1/5,220317,1
2,4,22,318,1,1065,1,11,5,5,6,single-choice,spatial-relational,5|6,7,5/6,220318,5
2,4,22,319,1,1050,3,9,3,3,6,single-choice,spatial-relational,3|6,7,3/6,220319,3
2,4,22,320,1,788,3,11,4,4,7,single-choice,spatial-relational,4|7,7,4/7,220320,4
2,4,22,321,1,1011,4,8,2,2,6,single-choice,spatial-relational,2|6,7,2/6,220321,2
2,4,22,322,1,971,6,8,1,1,7,single-choice,spatial-relational,1|7,7,1/7,220322,1
2,4,22,323,0,1044,5,7,1,6,6,single-choice,spatial-relational,1|6,7,1/6,220323,1
2,4,22,324,1,1342,2,8,3,3,5,single-choice,spatial-relational,3|5,7,3/5,220324,3
2,4,22,325,1,1020,1,3,1,1,2,single-choice,spatial-relational,1|2,7,1/2,220325,1
2,4,22,326,1,740,2,10,4,4,6,single-choice,spatial-relational,4|6,7,4/6,220326,4
2,4,22,327,1,1134,6,8,1,1,7,single-choice,spatial-relational,1|7,7,1/7,220327,1
2,4,22,328,1,774,3,7,2,2,5,single-choice,spatial-relational,2|5,7,2/5,220328,2
2,4,22,329,1,973,5,9,2,2,7,single-choice,spatial-relational,2|7,7,2/7,220329,2
2,4,22,330,1,1542,3,7,2,2,5,single-choice,spatial-relational,2|5,7,2/5,220330,2
2,4,22,331,0,925,1,7,3,4,4,single-choice,spatial-relational,3|4,7,3/4,220331,3
2,4,22,332,1,1289,1,5,2,2,3,single-choice,spatial-relational,2|3,7,2/3,220332,2
2,4,22,333,1,654,5,9,2,2,7,single-choice,spatial-relational,2|7,7,2/7,220333,2
2,4,22,334,1,1004,2,4,1,1,3,single-choice,spatial-relational,1|3,7,1/3,220334,1
2,4,22,335,0,800,3,5,1,4,4,single-choice,spatial-relational,1|4,7,1/4,220335,1
2,4,22,336,1,930,1,3,1,1,2,single-choice,spatial-relational,1|2,7,1/2,220336,1
2,4,22,337,0,643,4,8,2,6,6,single-choice,spatial-relational,2|6,7,2/6,220337,2
2,4,22,338,1,675,1,13,6,6,7,single-choice,spatial-relational,6|7,7,6/7,220338,6
2,4,22,339,1,890,3,11,4,4,7,single-choice,spatial-relational,4|7,7,4/7,220339,4
2,4,22,340,1,2772,1,11,5,5,6,single-choice,spatial-relational,5|6,7,5/6,220340,5
2,4,22,341,1,1152,2,6,2,2,4,single-choice,spatial-relational,2|4,7,2/4,220341,2
2,4,22,342,1,2130,3,7,2,2,5,single-choice,spatial-relational,2|5,7,2/5,220342,2
2,4,22,343,1,1721,4,8,2,2,6,single-choice,spatial-relational,2|6,7,2/6,220343,2
2,4,22,344,1,1269,1,5,2,2,3,single-choice,spatial-relational,2|3,7,2/3,220344,2
2,4,22,345,1,1219,2,4,1,1,3,single-choice,spatial-relational,1|3,7,1/3,220345,1
2,4,22,346,1,837,2,4,1,1,3,single-choice,spatial-relational,1|3,7,1/3,220346,1
2,4,22,347,1,557,1,13,6,6,7,single-choice,spatial-relational,6|7,7,6/7,220347,6
2,4,22,348,1,943,4,10,3,3,7,single-choice,spatial-relational,3|7,7,3/7,220348,3
2,4,22,349,0,503,3,9,3,6,6,single-choice,spatial-relational,3|6,7,3/6,220349,3
2,4,22,350,1,1031,3,5,1,1,4,single-choice,spatial-relational,1|4,7,1/4,220350,1
2,4,22,351,0,660,5,7,1,6,6,single-choice,spatial-relational,1|6,7,1/6,220351,1
2,4,22,352,1,935,1,9,4,4,5,single-choice,spatial-relational,4|5,7,4/5,220352,4
2,4,22,353,0,939,6,8,1,7,7,single-choice,spatial-relational,1|7,7,1/7,220353,1
2,4,22,354,1,832,1,7,3,3,4,single-choice,spatial-relational,3|4,7,3/4,220354,3
2,4,22,355,1,767,1,9,4,4,5,single-choice,spatial-relational,4|5,7,4/5,220355,4
2,4,22,356,1,1278,2,12,5,5,7,single-choice,spatial-relational,5|7,7,5/7,220356,5
2,4,22,357,1,893,4,6,1,1,5,single-choice,spatial-relational,1|5,7,1/5,220357,1
2,4,22,358,1,1032,2,8,3,3,5,single-choice,spatial-relational,3|5,7,3/5,220358,3
2,4,22,359,1,1286,1,7,3,3,4,single-choice,spatial-relational,3|4,7,3/4,220359,3
2,4,22,360,1,757,5,9,2,2,7,single-choice,spatial-relational,2|7,7,2/7,220360,2
2,4,22,361,1,821,2,6,2,2,4,single-choice,spatial-relational,2|4,7,2/4,220361,2
2,4,22,362,1,1067,5,7,1,1,6,single-choice,spatial-relational,1|6,7,1/6,220362,1
2,4,22,363,1,1085,2,12,5,5,7,single-choice,spatial-relational,5|7,7,5/7,220363,5
2,4,22,364,1,899,6,8,1,1,7,single-choice,spatial-relational,1|7,7,1/7,220364,1
2,4,22,365,1,1055,3,7,2,2,5,single-choice,spatial-relational,2|5,7,2/5,220365,2
2,4,22,366,1,1290,1,3,1,1,2,single-choice,spatial-relational,1|2,7,1/2,220366,1
2,4,22,367,1,921,2,10,4,4,6,single-choice,spatial-relational,4|6,7,4/6,220367,4
2,4,22,368,1,1020,2,8,3,3,5,single-choice,spatial-relational,3|5,7,3/5,220368,3
2,4,22,369,1,1011,1,11,5,5,6,single-choice,spatial-relational,5|6,7,5/6,220369,5
2,4,22,370,1,925,1,3,1,1,2,single-choice,spatial-relational,1|2,7,1/2,220370,1
2,4,22,371,1,798,1,5,2,2,3,single-choice,spatial-relational,2|3,7,2/3,220371,2
2,4,22,372,1,1107,4,6,1,1,5,single-choice,spatial-relational,1|5,7,1/5,220372,1
2,4,22,373,1,691,2,10,4,4,6,single-choice,spatial-relational,4|6,7,4/6,220373,4
2,4,22,374,1,675,3,11,4,4,7,single-choice,spatial-relational,4|7,7,4/7,220374,4
2,4,22,375,1,1189,3,5,1,1,4,single-choice,spatial-relational,1|4,7,1/4,220375,1
2,4,22,376,1,814,5,9,2,2,7,single-choice,spatial-relational,2|7,7,2/7,220376,2
2,4,22,377,1,957,4,10,3,3,7,single-choice,spatial-relational,3|7,7,3/7,220377,3
2,4,22,378,0,1803,3,9,3,6,6,single-choice,spatial-relational,3|6,7,3/6,220378,3
2,4,22,379,1,875,1,13,6,6,7,single-choice,spatial-relational,6|7,7,6/7,220379,6
2,4,22,380,1,1785,6,8,1,1,7,single-choice,spatial-relational,1|7,7,1/7,220380,1
2,4,22,381,1,670,1,13,6,6,7,single-choice,spatial-relational,6|7,7,6/7,220381,6
2,4,22,382,1,1149,3,9,3,3,6,single-choice,spatial-relational,3|6,7,3/6,220382,3
2,4,22,383,1,670,2,10,4,4,6,single-choice,spatial-relational,4|6,7,4/6,220383,4
2,4,22,384,1,862,3,7,2,2,5,single-choice,spatial-relational,2|5,7,2/5,220384,2
2,4,22,385,1,613,3,11,4,4,7,single-choice,spatial-relational,4|7,7,4/7,220385,4
2,4,22,386,1,997,1,7,3,3,4,single-choice,spatial-relational,3|4,7,3/4,220386,3
2,4,22,387,1,1178,2,6,2,2,4,single-choice,spatial-relational,2|4,7,2/4,220387,2
2,4,22,388,1,969,3,11,4,4,7,single-choice,spatial-relational,4|7,7,4/7,220388,4
2,4,22,389,0,866,3,7,2,5,5,single-choice,spatial-relational,2|5,7,2/5,220389,2
2,4,22,390,1,880,3,9,3,3,6,single-choice,spatial-relational,3|6,7,3/6,220390,3
2,4,22,391,1,965,1,9,4,4,5,single-choice,spatial-relational,4|5,7,4/5,220391,4
2,4,22,392,1,837,4,8,2,2,6,single-choice,spatial-relational,2|6,7,2/6,220392,2
2,4,22,393,1,1745,4,10,3,3,7,single-choice,spatial-relational,3|7,7,3/7,220393,3
2,4,22,394,1,1211,4,6,1,1,5,single-choice,spatial-relational,1|5,7,1/5,220394,1
2,4,22,395,1,1145,5,7,1,1,6,single-choice,spatial-relational,1|6,7,1/6,220395,1
2,4,22,396,1,1202,3,5,1,1,4,single-choice,spatial-relational,1|4,7,1/4,220396,1
2,4,22,397,1,812,2,6,2,2,4,single-choice,spatial-relational,2|4,7,2/4,220397,2
2,4,22,398,1,1236,1,5,2,2,3,single-choice,spatial-relational,2|3,7,2/3,220398,2
2,4,22,399,1,914,1,9,4,4,5,single-choice,spatial-relational,4|5,7,4/5,220399,4
2,4,22,400,0,689,2,4,1,3,3,single-choice,spatial-relational,1|3,7,1/3,220400,1
2,4,22,401,1,818,1,3,1,1,2,single-choice,spatial-relational,1|2,7,1/2,220401,1
2,4,22,402,1,1004,2,8,3,3,5,single-choice,spatial-relational,3|5,7,3/5,220402,3
2,4,22,403,1,928,1,11,5,5,6,single-choice,spatial-relational,5|6,7,5/6,220403,5
2,4,22,404,1,926,2,10,4,4,6,single-choice,spatial-relational,4|6,7,4/6,220404,4
2,4,22,405,1,1217,4,8,2,2,6,single-choice,spatial-relational,2|6,7,2/6,220405,2
2,4,22,406,1,927,3,5,1,1,4,single-choice,spatial-relational,1|4,7,1/4,220406,1
2,4,22,407,1,890,2,12,5,5,7,single-choice,spatial-relational,5|7,7,5/7,220407,5
2,4,22,408,1,1629,4,6,1,1,5,single-choice,spatial-relational,1|5,7,1/5,220408,1
2,4,22,409,1,662,5,9,2,2,7,single-choice,spatial-relational,2|7,7,2/7,220409,2
2,4,22,410,1,1003,4,10,3,3,7,single-choice,spatial-relational,3|7,7,3/7,220410,3
2,4,22,411,1,949,5,9,2,2,7,single-choice,spatial-relational,2|7,7,2/7,220411,2
2,4,22,412,1,597,1,5,2,2,3,single-choice,spatial-relational,2|3,7,2/3,220412,2
2,4,22,413,1,1258,1,7,3,3,4,single-choice,spatial-relational,3|4,7,3/4,220413,3
2,4,22,414,1,1364,5,7,1,1,6,single-choice,spatial-relational,1|6,7,1/6,220414,1
2,4,22,415,1,1458,1,11,5,5,6,single-choice,spatial-relational,5|6,7,5/6,220415,5
2,4,22,416,1,1078,6,8,1,1,7,single-choice,spatial-relational,1|7,7,1/7,220416,1
2,4,22,417,1,864,2,12,5,5,7,single-choice,spatial-relational,5|7,7,5/7,220417,5
2,4,22,418,1,1603,2,8,3,3,5,single-choice,spatial-relational,3|5,7,3/5,220418,3
2,4,22,419,0,678,1,3,1,2,2,single-choice,spatial-relational,1|2,7,1/2,220419,1
2,4,22,420,0,1184,2,4,1,3,3,single-choice,spatial-relational,1|3,7,1/3,220420,1
2,4,22,421,0,807,3,5,1,4,4,single-choice,spatial-relational,1|4,7,1/4,220421,1
2,4,22,422,1,820,3,7,2,2,5,single-choice,spatial-relational,2|5,7,2/5,220422,2
2,4,22,423,1,1227,5,7,1,1,6,single-choice,spatial-relational,1|6,7,1/6,220423,1
2,4,22,424,1,851,2,10,4,4,6,single-choice,spatial-relational,4|6,7,4/6,220424,4
2,4,22,425,1,801,2,8,3,3,5,single-choice,spatial-relational,3|5,7,3/5,220425,3
2,4,22,426,1,965,1,13,6,6,7,single-choice,spatial-relational,6|7,7,6/7,220426,6
2,4,22,427,1,900,1,3,1,1,2,single-choice,spatial-relational,1|2,7,1/2,220427,1
2,4,22,428,0,794,1,3,1,2,2,single-choice,spatial-relational,1|2,7,1/2,220428,1
2,4,22,429,1,730,6,8,1,1,7,single-choice,spatial-relational,1|7,7,1/7,220429,1
2,4,22,430,1,671,5,9,2,2,7,single-choice,spatial-relational,2|7,7,2/7,220430,2
2,4,22,431,1,877,2,10,4,4,6,single-choice,spatial-relational,4|6,7,4/6,220431,4
2,4,22,432,1,915,3,11,4,4,7,single-choice,spatial-relational,4|7,7,4/7,220432,4
2,4,22,433,1,907,4,6,1,1,5,single-choice,spatial-relational,1|5,7,1/5,220433,1
2,4,22,434,1,1076,3,9,3,3,6,single-choice,spatial-relational,3|6,7,3/6,220434,3
2,4,22,435,1,1480,1,7,3,3,4,single-choice,spatial-relational,3|4,7,3/4,220435,3
2,4,22,436,1,706,3,11,4,4,7,single-choice,spatial-relational,4|7,7,4/7,220436,4
2,4,22,437,1,974,2,6,2,2,4,single-choice,spatial-relational,2|4,7,2/4,220437,2
2,4,22,438,1,1519,2,8,3,3,5,single-choice,spatial-relational,3|5,7,3/5,220438,3
2,4,22,439,1,624,1,5,2,2,3,single-choice,spatial-relational,2|3,7,2/3,220439,2
2,4,22,440,1,1185,1,9,4,4,5,single-choice,spatial-relational,4|5,7,4/5,220440,4
2,4,22,441,1,1176,2,4,1,1,3,single-choice,spatial-relational,1|3,7,1/3,220441,1
2,4,22,442,1,977,1,11,5,5,6,single-choice,spatial-relational,5|6,7,5/6,220442,5
2,4,22,443,1,1089,1,7,3,3,4,single-choice,spatial-relational,3|4,7,3/4,220443,3
2,4,22,444,0,1232,4,10,3,7,7,single-choice,spatial-relational,3|7,7,3/7,220444,3
2,4,22,445,0,677,3,5,1,4,4,single-choice,spatial-relational,1|4,7,1/4,220445,1
2,4,22,446,1,1043,2,4,1,1,3,single-choice,spatial-relational,1|3,7,1/3,220446,1
2,4,22,447,1,944,1,5,2,2,3,single-choice,spatial-relational,2|3,7,2/3,220447,2
2,4,22,448,1,898,1,9,4,4,5,single-choice,spatial-relational,4|5,7,4/5,220448,4
2,4,22,449,1,875,4,10,3,3,7,single-choice,spatial-relational,3|7,7,3/7,220449,3
2,4,22,450,1,904,2,12,5,5,7,single-choice,spatial-relational,5|7,7,5/7,220450,5
2,4,22,451,1,680,2,6,2,2,4,single-choice,spatial-relational,2|4,7,2/4,220451,2
2,4,22,452,1,1111,3,9,3,3,6,single-choice,spatial-relational,3|6,7,3/6,220452,3
2,4,22,453,1,642,2,12,5,5,7,single-choice,spatial-relational,5|7,7,5/7,220453,5
2,4,22,454,1,924,3,7,2,2,5,single-choice,spatial-relational,2|5,7,2/5,220454,2
2,4,22,455,1,928,5,7,1,1,6,single-choice,spatial-relational,1|6,7,1/6,220455,1
2,4,22,456,0,4,1,11,5,6,6,single-choice,spatial-relational,5|6,7,5/6,220456,5
2,4,22,457,1,1773,6,8,1,1,7,single-choice,spatial-relational,1|7,7,1/7,220457,1
2,4,22,458,1,585,1,13,6,6,7,single-choice,spatial-relational,6|7,7,6/7,220458,6
2,4,22,459,1,894,4,8,2,2,6,single-choice,spatial-relational,2|6,7,2/6,220459,2
2,4,22,460,1,1124,4,6,1,1,5,single-choice,spatial-relational,1|5,7,1/5,220460,1
2,4,22,461,1,782,4,8,2,2,6,single-choice,spatial-relational,2|6,7,2/6,220461,2
2,4,22,462,1,699,5,9,2,2,7,single-choice,spatial-relational,2|7,7,2/7,220462,2
2,4,22,463,1,930,3,11,4,4,7,single-choice,spatial-relational,4|7,7,4/7,220463,4
2,4,22,464,1,1004,1,11,5,5,6,single-choice,spatial-relational,5|6,7,5/6,220464,5
2,4,22,465,1,1218,2,4,1,1,3,single-choice,spatial-relational,1|3,7,1/3,220465,1
2,4,22,466,1,989,2,10,4,4,6,single-choice,spatial-relational,4|6,7,4/6,220466,4
2,4,22,467,1,1097,5,7,1,1,6,single-choice,spatial-relational,1|6,7,1/6,220467,1
2,4,22,468,1,884,6,8,1,1,7,single-choice,spatial-relational,1|7,7,1/7,220468,1
2,4,22,469,1,18,1,7,3,3,4,single-choice,spatial-relational,3|4,7,3/4,220469,3
2,4,22,470,0,610,3,5,1,4,4,single-choice,spatial-relational,1|4,7,1/4,220470,1
2,4,22,471,0,832,2,8,3,5,5,single-choice,spatial-relational,3|5,7,3/5,220471,3
2,4,22,472,1,615,2,12,5,5,7,single-choice,spatial-relational,5|7,7,5/7,220472,5
2,4,22,473,1,955,5,9,2,2,7,single-choice,spatial-relational,2|7,7,2/7,220473,2
2,4,22,474,1,1268,3,7,2,2,5,single-choice,spatial-relational,2|5,7,2/5,220474,2
2,4,22,475,1,571,1,5,2,2,3,single-choice,spatial-relational,2|3,7,2/3,220475,2
2,4,22,476,1,501,2,4,1,1,3,single-choice,spatial-relational,1|3,7,1/3,220476,1
2,4,22,477,1,813,1,13,6,6,7,single-choice,spatial-relational,6|7,7,6/7,220477,6
2,4,22,478,1,2,4,10,3,3,7,single-choice,spatial-relational,3|7,7,3/7,220478,3
2,4,22,479,0,806,1,3,1,2,2,single-choice,spatial-relational,1|2,7,1/2,220479,1
2,4,22,480,1,864,2,12,5,5,7,single-choice,spatial-relational,5|7,7,5/7,220480,5
2,4,22,481,1,1554,3,9,3,3,6,single-choice,spatial-relational,3|6,7,3/6,220481,3
2,4,22,482,1,819,1,9,4,4,5,single-choice,spatial-relational,4|5,7,4/5,220482,4
2,4,22,483,1,668,5,9,2,2,7,single-choice,spatial-relational,2|7,7,2/7,220483,2
2,4,22,484,1,914,1,3,1,1,2,single-choice,spatial-relational,1|2,7,1/2,220484,1
2,4,22,485,0,685,5,7,1,6,6,single-choice,spatial-relational,1|6,7,1/6,220485,1
2,4,22,486,1,670,3,9,3,3,6,single-choice,spatial-relational,3|6,7,3/6,220486,3
2,4,22,487,1,1022,1,5,2,2,3,single-choice,spatial-relational,2|3,7,2/3,220487,2
2,4,22,488,1,1090,6,8,1,1,7,single-choice,spatial-relational,1|7,7,1/7,220488,1
2,4,22,489,0,1404,2,6,2,4,4,single-choice,spatial-relational,2|4,7,2/4,220489,2
2,4,22,490,1,976,4,6,1,1,5,single-choice,spatial-relational,1|5,7,1/5,220490,1
2,4,22,491,1,881,1,7,3,3,4,single-choice,spatial-relational,3|4,7,3/4,220491,3
2,4,22,492,1,1282,4,6,1,1,5,single-choice,spatial-relational,1|5,7,1/5,220492,1
2,4,22,493,1,851,1,9,4,4,5,single-choice,spatial-relational,4|5,7,4/5,220493,4
2,4,22,494,1,1053,2,10,4,4,6,single-choice,spatial-relational,4|6,7,4/6,220494,4
2,4,22,495,1,738,3,11,4,4,7,single-choice,spatial-relational,4|7,7,4/7,220495,4
2,4,22,496,1,955,4,10,3,3,7,single-choice,spatial-relational,3|7,7,3/7,220496,3
2,4,22,497,1,1344,2,8,3,3,5,single-choice,spatial-relational,3|5,7,3/5,220497,3
2,4,22,498,1,797,4,8,2,2,6,single-choice,spatial-relational,2|6,7,2/6,220498,2
2,4,22,499,0,17,1,11,5,6,6,single-choice,spatial-relational,5|6,7,5/6,220499,5
2,4,22,500,1,1382,3,7,2,2,5,single-choice,spatial-relational,2|5,7,2/5,220500,2
2,4,22,501,1,1406,2,6,2,2,4,single-choice,spatial-relational,2|4,7,2/4,220501,2
2,4,22,502,1,973,3,5,1,1,4,single-choice,spatial-relational,1|4,7,1/4,220502,1
2,4,22,503,1,795,1,13,6,6,7,single-choice,spatial-relational,6|7,7,6/7,220503,6
2,4,22,504,1,1188,4,8,2,2,6,single-choice,spatial-relational,2|6,7,2/6,220504,2
2,4,22,505,0,1504,2,8,3,5,5,single-choice,spatial-relational,3|5,7,3/5,220505,3
2,4,22,506,1,861,5,9,2,2,7,single-choice,spatial-relational,2|7,7,2/7,220506,2
2,4,22,507,1,850,1,11,5,5,6,single-choice,spatial-relational,5|6,7,5/6,220507,5
2,4,22,508,1,1490,1,7,3,3,4,single-choice,spatial-relational,3|4,7,3/4,220508,3
2,4,22,509,1,660,3,11,4,4,7,single-choice,spatial-relational,4|7,7,4/7,220509,4
2,4,22,510,1,888,4,8,2,2,6,single-choice,spatial-relational,2|6,7,2/6,220510,2
2,4,22,511,0,829,5,7,1,6,6,single-choice,spatial-relational,1|6,7,1/6,220511,1
2,4,22,512,1,990,1,13,6,6,7,single-choice,spatial-relational,6|7,7,6/7,220512,6
2,4,22,513,0,1241,1,3,1,2,2,single-choice,spatial-relational,1|2,7,1/2,220513,1
2,4,22,514,0,884,4,6,1,5,5,single-choice,spatial-relational,1|5,7,1/5,220514,1
2,4,22,515,1,1161,4,8,2,2,6,single-choice,spatial-relational,2|6,7,2/6,220515,2
2,4,22,516,1,1413,1,13,6,6,7,single-choice,spatial-relational,6|7,7,6/7,220516,6
2,4,22,517,0,1030,3,5,1,4,4,single-choice,spatial-relational,1|4,7,1/4,220517,1
2,4,22,518,1,36,1,5,2,2,3,single-choice,spatial-relational,2|3,7,2/3,220518,2
2,4,22,519,1,1078,2,8,3,3,5,single-choice,spatial-relational,3|5,7,3/5,220519,3
2,4,22,520,1,1126,2,6,2,2,4,single-choice,spatial-relational,2|4,7,2/4,220520,2
2,4,22,521,1,1050,2,10,4,4,6,single-choice,spatial-relational,4|6,7,4/6,220521,4
2,4,22,522,1,800,2,6,2,2,4,single-choice,spatial-relational,2|4,7,2/4,220522,2
2,4,22,523,1,1206,1,11,5,5,6,single-choice,spatial-relational,5|6,7,5/6,220523,5
2,4,22,524,1,1044,2,4,1,1,3,single-choice,spatial-relational,1|3,7,1/3,220524,1
2,4,22,525,1,690,3,7,2,2,5,single-choice,spatial-relational,2|5,7,2/5,220525,2
2,4,22,526,1,1088,5,7,1,1,6,single-choice,spatial-relational,1|6,7,1/6,220526,1
2,4,22,527,0,718,1,3,1,2,2,single-choice,spatial-relational,1|2,7,1/2,220527,1
2,4,22,528,0,822,2,4,1,3,3,single-choice,spatial-relational,1|3,7,1/3,220528,1
2,4,22,529,1,980,3,9,3,3,6,single-choice,spatial-relational,3|6,7,3/6,220529,3
2,4,22,530,1,872,2,10,4,4,6,single-choice,spatial-relational,4|6,7,4/6,220530,4
2,4,22,531,0,565,4,6,1,5,5,single-choice,spatial-relational,1|5,7,1/5,220531,1
2,4,22,532,1,779,6,8,1,1,7,single-choice,spatial-relational,1|7,7,1/7,220532,1
2,4,22,533,1,891,3,11,4,4,7,single-choice,spatial-relational,4|7,7,4/7,220533,4
2,4,22,534,1,1008,3,5,1,1,4,single-choice,spatial-relational,1|4,7,1/4,220534,1
2,4,22,535,1,940,6,8,1,1,7,single-choice,spatial-relational,1|7,7,1/7,220535,1
2,4,22,536,1,921,4,10,3,3,7,single-choice,spatial-relational,3|7,7,3/7,220536,3
2,4,22,537,1,707,1,9,4,4,5,single-choice,spatial-relational,4|5,7,4/5,220537,4
2,4,22,538,1,943,1,9,4,4,5,single-choice,spatial-relational,4|5,7,4/5,220538,4
2,4,22,539,1,1266,2,12,5,5,7,single-choice,spatial-relational,5|7,7,5/7,220539,5
2,4,22,540,1,910,3,7,2,2,5,single-choice,spatial-relational,2|5,7,2/5,220540,2
2,4,22,541,1,954,3,9,3,3,6,single-choice,spatial-relational,3|6,7,3/6,220541,3
2,4,22,542,0,6675,1,5,2,3,3,single-choice,spatial-relational,2|3,7,2/3,220542,2
2,4,22,543,1,856,1,7,3,3,4,single-choice,spatial-relational,3|4,7,3/4,220543,3
2,4,22,544,1,791,5,9,2,2,7,single-choice,spatial-relational,2|7,7,2/7,220544,2
2,4,22,545,1,1007,4,10,3,3,7,single-choice,spatial-relational,3|7,7,3/7,220545,3
2,4,22,546,1,906,2,12,5,5,7,single-choice,spatial-relational,5|7,7,5/7,220546,5
2,4,22,547,1,800,1,9,4,4,5,single-choice,spatial-relational,4|5,7,4/5,220547,4
2,4,22,548,1,834,2,10,4,4,6,single-choice,spatial-relational,4|6,7,4/6,220548,4
2,4,22,549,1,1148,2,12,5,5,7,single-choice,spatial-relational,5|7,7,5/7,220549,5
2,4,22,550,1,1245,5,7,1,1,6,single-choice,spatial-relational,1|6,7,1/6,220550,1
2,4,22,551,1,966,1,7,3,3,4,single-choice,spatial-relational,3|4,7,3/4,220551,3
2,4,22,552,0,2406,4,6,1,5,5,single-choice,spatial-relational,1|5,7,1/5,220552,1
2,4,22,553,0,2,5,9,2,7,7,single-choice,spatial-relational,2|7,7,2/7,220553,2
2,4,22,554,1,858,3,9,3,3,6,single-choice,spatial-relational,3|6,7,3/6,220554,3
2,4,22,555,0,783,1,3,1,2,2,single-choice,spatial-relational,1|2,7,1/2,220555,1
2,4,22,556,1,1057,1,5,2,2,3,single-choice,spatial-relational,2|3,7,2/3,220556,2
2,4,22,557,1,716,4,10,3,3,7,single-choice,spatial-relational,3|7,7,3/7,220557,3
2,4,22,558,1,730,3,11,4,4,7,single-choice,spatial-relational,4|7,7,4/7,220558,4
2,4,22,559,1,819,4,10,3,3,7,single-choice,spatial-relational,3|7,7,3/7,220559,3
2,4,22,560,1,803,4,8,2,2,6,single-choice,spatial-relational,2|6,7,2/6,220560,2
2,4,22,561,0,775,2,6,2,4,4,single-choice,spatial-relational,2|4,7,2/4,220561,2
2,4,22,562,0,947,1,7,3,4,4,single-choice,spatial-relational,3|4,7,3/4,220562,3
2,4,22,563,1,875,1,5,2,2,3,single-choice,spatial-relational,2|3,7,2/3,220563,2
2,4,22,564,1,995,3,5,1,1,4,single-choice,spatial-relational,1|4,7,1/4,220564,1
2,4,22,565,1,773,5,7,1,1,6,single-choice,spatial-relational,1|6,7,1/6,220565,1
2,4,22,566,1,654,1,13,6,6,7,single-choice,spatial-relational,6|7,7,6/7,220566,6
2,4,22,567,1,845,3,7,2,2,5,single-choice,spatial-relational,2|5,7,2/5,220567,2
2,4,22,568,1,802,4,8,2,2,6,single-choice,spatial-relational,2|6,7,2/6,220568,2
2,4,22,569,1,996,5,9,2,2,7,single-choice,spatial-relational,2|7,7,2/7,220569,2
2,4,22,570,1,853,3,5,1,1,4,single-choice,spatial-relational,1|4,7,1/4,220570,1
2,4,22,571,1,641,1,13,6,6,7,single-choice,spatial-relational,6|7,7,6/7,220571,6
2,4,22,572,1,834,1,11,5,5,6,single-choice,spatial-relational,5|6,7,5/6,220572,5
2,4,22,573,1,954,2,6,2,2,4,single-choice,spatial-relational,2|4,7,2/4,220573,2
2,4,22,574,1,886,4,6,1,1,5,single-choice,spatial-relational,1|5,7,1/5,220574,1
2,4,22,575,1,699,3,11,4,4,7,single-choice,spatial-relational,4|7,7,4/7,220575,4
2,4,22,576,1,15,6,8,1,1,7,single-choice,spatial-relational,1|7,7,1/7,220576,1
2,4,22,577,1,722,2,10,4,4,6,single-choice,spatial-relational,4|6,7,4/6,220577,4
2,4,22,578,1,1172,2,4,1,1,3,single-choice,spatial-relational,1|3,7,1/3,220578,1
2,4,22,579,1,913,3,9,3,3,6,single-choice,spatial-relational,3|6,7,3/6,220579,3
2,4,22,580,1,805,2,8,3,3,5,single-choice,spatial-relational,3|5,7,3/5,220580,3
2,4,22,581,1,1018,1,3,1,1,2,single-choice,spatial-relational,1|2,7,1/2,220581,1
2,4,22,582,1,921,2,12,5,5,7,single-choice,spatial-relational,5|7,7,5/7,220582,5
2,4,22,583,1,1010,2,8,3,3,5,single-choice,spatial-relational,3|5,7,3/5,220583,3
2,4,22,584,1,1003,6,8,1,1,7,single-choice,spatial-relational,1|7,7,1/7,220584,1
2,4,22,585,1,1113,1,11,5,5,6,single-choice,spatial-relational,5|6,7,5/6,220585,5
2,4,22,586,1,836,3,7,2,2,5,single-choice,spatial-relational,2|5,7,2/5,220586,2
2,4,22,587,1,931,2,4,1,1,3,single-choice,spatial-relational,1|3,7,1/3,220587,1
2,4,22,588,1,927,1,9,4,4,5,single-choice,spatial-relational,4|5,7,4/5,220588,4
2,4,22,589,1,880,4,8,2,2,6,single-choice,spatial-relational,2|6,7,2/6,220589,2
2,4,22,590,1,700,1,5,2,2,3,single-choice,spatial-relational,2|3,7,2/3,220590,2
2,4,22,591,1,1143,1,3,1,1,2,single-choice,spatial-relational,1|2,7,1/2,220591,1
2,4,22,592,1,739,2,12,5,5,7,single-choice,spatial-relational,5|7,7,5/7,220592,5
2,4,22,593,1,896,2,8,3,3,5,single-choice,spatial-relational,3|5,7,3/5,220593,3
2,4,22,594,0,26,2,6,2,4,4,single-choice,spatial-relational,2|4,7,2/4,220594,2
2,4,22,595,0,745,5,7,1,6,6,single-choice,spatial-relational,1|6,7,1/6,220595,1
2,4,22,596,1,1002,3,5,1,1,4,single-choice,spatial-relational,1|4,7,1/4,220596,1
2,4,22,597,1,813,6,8,1,1,7,single-choice,spatial-relational,1|7,7,1/7,220597,1
2,4,22,598,1,825,3,7,2,2,5,single-choice,spatial-relational,2|5,7,2/5,220598,2
2,4,22,599,1,682,1,13,6,6,7,single-choice,spatial-relational,6|7,7,6/7,220599,6
2,4,22,600,1,1154,3,11,4,4,7,single-choice,spatial-relational,4|7,7,4/7,220600,4
3,4,22,1,0,1249,3,7,2,5,5,single-choice,spatial-relational,2|5,7,2/5,220001,2
3,4,22,2,1,721,5,7,1,1,6,single-choice,spatial-relational,1|6,7,1/6,220002,1
3,4,22,3,1,772,2,10,4,4,6,single-choice,spatial-relational,4|6,7,4/6,220003,4
3,4,22,4,1,913,2,8,3,3,5,single-choice,spatial-relational,3|5,7,3/5,220004,3
3,4,22,5,1,1050,2,6,2,2,4,single-choice,spatial-relational,2|4,7,2/4,220005,2
3,4,22,6,1,1322,2,8,3,3,5,single-choice,spatial-relational,3|5,7,3/5,220006,3
3,4,22,7,1,1685,1,9,4,4,5,single-choice,spatial-relational,4|5,7,4/5,220007,4
3,4,22,8,1,1598,3,9,3,3,6,single-choice,spatial-relational,3|6,7,3/6,220008,3
3,4,22,9,1,942,4,8,2,2,6,single-choice,spatial-relational,2|6,7,2/6,220009,2
3,4,22,10,1,989,3,5,1,1,4,single-choice,spatial-relational,1|4,7,1/4,220010,1
3,4,22,11,1,982,3,5,1,1,4,single-choice,spatial-relational,1|4,7,1/4,220011,1
3,4,22,12,1,989,1,7,3,3,4,single-choice,spatial-relational,3|4,7,3/4,220012,3
3,4,22,13,1,926,3,9,3,3,6,single-choice,spatial-relational,3|6,7,3/6,220013,3
3,4,22,14,1,1173,1,9,4,4,5,single-choice,spatial-relational,4|5,7,4/5,220014,4
3,4,22,15,1,773,1,11,5,5,6,single-choice,spatial-relational,5|6,7,5/6,220015,5
3,4,22,16,1,1036,6,8,1,1,7,single-choice,spatial-relational,1|7,7,1/7,220016,1
3,4,22,17,1,962,4,10,3,3,7,single-choice,spatial-relational,3|7,7,3/7,220017,3
3,4,22,18,1,1182,3,11,4,4,7,single-choice,spatial-relational,4|7,7,4/7,220018,4
3,4,22,19,1,731,4,6,1,1,5,single-choice,spatial-relational,1|5,7,1/5,220019,1
3,4,22,20,1,672,4,8,2,2,6,single-choice,spatial-relational,2|6,7,2/6,220020,2
3,4,22,21,1,735,5,9,2,2,7,single-choice,spatial-relational,2|7,7,2/7,220021,2
3,4,22,22,1,688,3,11,4,4,7,single-choice,spatial-relational,4|7,7,4/7,220022,4
3,4,22,23,1,824,2,4,1,1,3,single-choice,spatial-relational,1|3,7,1/3,220023,1
3,4,22,24,1,1022,1,11,5,5,6,single-choice,spatial-relational,5|6,7,5/6,220024,5
3,4,22,25,1,783,2,12,5,5,7,single-choice,spatial-relational,5|7,7,5/7,220025,5
3,4,22,26,1,1313,1,5,2,2,3,single-choice,spatial-relational,2|3,7,2/3,220026,2
3,4,22,27,1,553,5,9,2,2,7,single-choice,spatial-relational,2|7,7,2/7,220027,2
3,4,22,28,1,975,2,10,4,4,6,single-choice,spatial-relational,4|6,7,4/6,220028,4
3,4,22,29,0,585,1,3,1,2,2,single-choice,spatial-relational,1|2,7,1/2,220029,1
3,4,22,30,1,700,1,3,1,1,2,single-choice,spatial-relational,1|2,7,1/2,220030,1
3,4,22,31,1,580,1,5,2,2,3,single-choice,spatial-relational,2|3,7,2/3,220031,2
3,4,22,32,0,1097,1,13,6,7,7,single-choice,spatial-relational,6|7,7,6/7,220032,6
3,4,22,33,1,661,4,10,3,3,7,single-choice,spatial-relational,3|7,7,3/7,220033,3
3,4,22,34,1,941,2,12,5,5,7,single-choice,spatial-relational,5|7,7,5/7,220034,5
3,4,22,35,1,1128,1,7,3,3,4,single-choice,spatial-relational,3|4,7,3/4,220035,3
3,4,22,36,1,725,2,6,2,2,4,single-choice,spatial-relational,2|4,7,2/4,220036,2
3,4,22,37,1,937,6,8,1,1,7,single-choice,spatial-relational,1|7,7,1/7,220037,1
3,4,22,38,1,1237,2,4,1,1,3,single-choice,spatial-relational,1|3,7,1/3,220038,1
3,4,22,39,1,901,5,7,1,1,6,single-choice,spatial-relational,1|6,7,1/6,220039,1
3,4,22,40,1,946,1,13,6,6,7,single-choice,spatial-relational,6|7,7,6/7,220040,6
3,4,22,41,0,1283,4,6,1,5,5,single-choice,spatial-relational,1|5,7,1/5,220041,1
3,4,22,42,1,932,3,7,2,2,5,single-choice,spatial-relational,2|5,7,2/5,220042,2
3,4,22,43,1,769,1,7,3,3,4,single-choice,spatial-relational,3|4,7,3/4,220043,3
3,4,22,44,1,854,5,7,1,1,6,single-choice,spatial-relational,1|6,7,1/6,220044,1
3,4,22,45,1,923,1,7,3,3,4,single-choice,spatial-relational,3|4,7,3/4,220045,3
3,4,22,46,1,541,1,13,6,6,7,single-choice,spatial-relational,6|7,7,6/7,220046,6
3,4,22,47,1,678,4,8,2,2,6,single-choice,spatial-relational,2|6,7,2/6,220047,2
3,4,22,48,1,889,2,4,1,1,3,single-choice,spatial-relational,1|3,7,1/3,220048,1
3,4,22,49,1,904,6,8,1,1,7,single-choice,spatial-relational,1|7,7,1/7,220049,1
3,4,22,50,0,1386,2,6,2,4,4,single-choice,spatial-relational,2|4,7,2/4,220050,2
3,4,22,51,1,1090,6,8,1,1,7,single-choice,spatial-relational,1|7,7,1/7,220051,1
3,4,22,52,1,770,1,9,4,4,5,single-choice,spatial-relational,4|5,7,4/5,220052,4
3,4,22,53,1,1175,3,5,1,1,4,single-choice,spatial-relational,1|4,7,1/4,220053,1
3,4,22,54,1,746,3,7,2,2,5,single-choice,spatial-relational,2|5,7,2/5,220054,2
3,4,22,55,1,889,4,10,3,3,7,single-choice,spatial-relational,3|7,7,3/7,220055,3
3,4,22,56,1,943,1,5,2,2,3,single-choice,spatial-relational,2|3,7,2/3,220056,2
3,4,22,57,1,1128,1,11,5,5,6,single-choice,spatial-relational,5|6,7,5/6,220057,5
3,4,22,58,1,1204,4,6,1,1,5,single-choice,spatial-relational,1|5,7,1/5,220058,1
3,4,22,59,1,977,2,12,5,5,7,single-choice,spatial-relational,5|7,7,5/7,220059,5
3,4,22,60,1,806,3,9,3,3,6,single-choice,spatial-relational,3|6,7,3/6,220060,3
3,4,22,61,1,2568,3,5,1,1,4,single-choice,spatial-relational,1|4,7,1/4,220061,1
3,4,22,62,1,1142,4,10,3,3,7,single-choice,spatial-relational,3|7,7,3/7,220062,3
3,4,22,63,1,829,1,11,5,5,6,single-choice,spatial-relational,5|6,7,5/6,220063,5
3,4,22,64,1,909,4,8,2,2,6,single-choice,spatial-relational,2|6,7,2/6,220064,2
3,4,22,65,1,793,3,11,4,4,7,single-choice,spatial-relational,4|7,7,4/7,220065,4
3,4,22,66,1,1002,1,9,4,4,5,single-choice,spatial-relational,4|5,7,4/5,220066,4
3,4,22,67,1,862,2,10,4,4,6,single-choice,spatial-relational,4|6,7,4/6,220067,4
3,4,22,68,1,758,1,5,2,2,3,single-choice,spatial-relational,2|3,7,2/3,220068,2
3,4,22,69,1,996,2,4,1,1,3,single-choice,spatial-relational,1|3,7,1/3,220069,1
3,4,22,70,1,20714,1,3,1,1,2,single-choice,spatial-relational,1|2,7,1/2,220070,1
3,4,22,71,1,969,2,8,3,3,5,single-choice,spatial-relational,3|5,7,3/5,220071,3
3,4,22,72,1,1345,5,7,1,1,6,single-choice,spatial-relational,1|6,7,1/6,220072,1
3,4,22,73,1,779,2,12,5,5,7,single-choice,spatial-relational,5|7,7,5/7,220073,5
3,4,22,74,1,1021,3,7,2,2,5,single-choice,spatial-relational,2|5,7,2/5,220074,2
3,4,22,75,1,855,3,9,3,3,6,single-choice,spatial-relational,3|6,7,3/6,220075,3
3,4,22,76,1,771,3,11,4,4,7,single-choice,spatial-relational,4|7,7,4/7,220076,4
3,4,22,77,1,962,1,13,6,6,7,single-choice,spatial-relational,6|7,7,6/7,220077,6
3,4,22,78,1,850,5,9,2,2,7,single-choice,spatial-relational,2|7,7,2/7,220078,2
3,4,22,79,1,616,2,10,4,4,6,single-choice,spatial-relational,4|6,7,4/6,220079,4
3,4,22,80,1,791,2,6,2,2,4,single-choice,spatial-relational,2|4,7,2/4,220080,2
3,4,22,81,1,907,2,8,3,3,5,single-choice,spatial-relational,3|5,7,3/5,220081,3
3,4,22,82,1,616,5,9,2,2,7,single-choice,spatial-relational,2|7,7,2/7,220082,2
3,4,22,83,1,1096,4,6,1,1,5,single-choice,spatial-relational,1|5,7,1/5,220083,1
3,4,22,84,1,1045,1,3,1,1,2,single-choice,spatial-relational,1|2,7,1/2,220084,1
3,4,22,85,0,665,4,8,2,6,6,single-choice,spatial-relational,2|6,7,2/6,220085,2
3,4,22,86,1,1063,1,7,3,3,4,single-choice,spatial-relational,3|4,7,3/4,220086,3
3,4,22,87,1,1048,3,5,1,1,4,single-choice,spatial-relational,1|4,7,1/4,220087,1
3,4,22,88,1,749,3,9,3,3,6,single-choice,spatial-relational,3|6,7,3/6,220088,3
3,4,22,89,1,887,1,11,5,5,6,single-choice,spatial-relational,5|6,7,5/6,220089,5
3,4,22,90,1,890,5,7,1,1,6,single-choice,spatial-relational,1|6,7,1/6,220090,1
3,4,22,91,1,876,2,6,2,2,4,single-choice,spatial-relational,2|4,7,2/4,220091,2
3,4,22,92,1,49540,2,4,1,1,3,single-choice,spatial-relational,1|3,7,1/3,220092,1
3,4,22,93,1,928,3,11,4,4,7,single-choice,spatial-relational,4|7,7,4/7,220093,4
3,4,22,94,1,854,3,11,4,4,7,single-choice,spatial-relational,4|7,7,4/7,220094,4
3,4,22,95,1,807,1,9,4,4,5,single-choice,spatial-relational,4|5,7,4/5,220095,4
3,4,22,96,1,873,1,13,6,6,7,single-choice,spatial-relational,6|7,7,6/7,220096,6
3,4,22,97,1,834,3,7,2,2,5,single-choice,spatial-relational,2|5,7,2/5,220097,2
3,4,22,98,1,733,4,10,3,3,7,single-choice,spatial-relational,3|7,7,3/7,220098,3
3,4,22,99,1,918,1,9,4,4,5,single-choice,spatial-relational,4|5,7,4/5,220099,4
3,4,22,100,1,936,2,6,2,2,4,single-choice,spatial-relational,2|4,7,2/4,220100,2
3,4,22,101,1,1103,2,4,1,1,3,single-choice,spatial-relational,1|3,7,1/3,220101,1
3,4,22,102,1,6438,4,10,3,3,7,single-choice,spatial-relational,3|7,7,3/7,220102,3
3,4,22,103,1,762,2,10,4,4,6,single-choice,spatial-relational,4|6,7,4/6,220103,4
3,4,22,104,0,945,1,7,3,4,4,single-choice,spatial-relational,3|4,7,3/4,220104,3
3,4,22,105,1,960,2,8,3,3,5,single-choice,spatial-relational,3|5,7,3/5,220105,3
3,4,22,106,0,3094,1,3,1,2,2,single-choice,spatial-relational,1|2,7,1/2,220106,1
3,4,22,107,1,719,1,3,1,1,2,single-choice,spatial-relational,1|2,7,1/2,220107,1
3,4,22,108,1,810,1,5,2,2,3,single-choice,spatial-relational,2|3,7,2/3,220108,2
3,4,22,109,0,2122,4,6,1,5,5,single-choice,spatial-relational,1|5,7,1/5,220109,1
3,4,22,110,1,919,5,9,2,2,7,single-choice,spatial-relational,2|7,7,2/7,220110,2
3,4,22,111,1,655,1,13,6,6,7,single-choice,spatial-relational,6|7,7,6/7,220111,6
3,4,22,112,1,793,1,11,5,5,6,single-choice,spatial-relational,5|6,7,5/6,220112,5
3,4,22,113,1,900,3,7,2,2,5,single-choice,spatial-relational,2|5,7,2/5,220113,2
3,4,22,114,1,1825,3,9,3,3,6,single-choice,spatial-relational,3|6,7,3/6,220114,3
3,4,22,115,1,1191,4,6,1,1,5,single-choice,spatial-relational,1|5,7,1/5,220115,1
3,4,22,116,1,1509,6,8,1,1,7,single-choice,spatial-relational,1|7,7,1/7,220116,1
3,4,22,117,1,729,5,9,2,2,7,single-choice,spatial-relational,2|7,7,2/7,220117,2
3,4,22,118,0,2130,3,5,1,4,4,single-choice,spatial-relational,1|4,7,1/4,220118,1
3,4,22,119,1,794,6,8,1,1,7,single-choice,spatial-relational,1|7,7,1/7,220119,1
3,4,22,120,1,736,2,12,5,5,7,single-choice,spatial-relational,5|7,7,5/7,220120,5
3,4,22,121,1,729,2,8,3,3,5,single-choice,spatial-relational,3|5,7,3/5,220121,3
3,4,22,122,1,752,1,5,2,2,3,single-choice,spatial-relational,2|3,7,2/3,220122,2
3,4,22,123,1,1199,2,10,4,4,6,single-choice,spatial-relational,4|6,7,4/6,220123,4
3,4,22,124,1,880,4,8,2,2,6,single-choice,spatial-relational,2|6,7,2/6,220124,2
3,4,22,125,1,907,5,7,1,1,6,single-choice,spatial-relational,1|6,7,1/6,220125,1
3,4,22,126,1,1078,2,12,5,5,7,single-choice,spatial-relational,5|7,7,5/7,220126,5
3,4,22,127,1,896,4,6,1,1,5,single-choice,spatial-relational,1|5,7,1/5,220127,1
3,4,22,128,1,795,2,10,4,4,6,single-choice,spatial-relational,4|6,7,4/6,220128,4
3,4,22,129,1,976,3,9,3,3,6,single-choice,spatial-relational,3|6,7,3/6,220129,3
3,4,22,130,1,1024,3,9,3,3,6,single-choice,spatial-relational,3|6,7,3/6,220130,3
3,4,22,131,1,758,2,4,1,1,3,single-choice,spatial-relational,1|3,7,1/3,220131,1
3,4,22,132,1,599,1,13,6,6,7,single-choice,spatial-relational,6|7,7,6/7,220132,6
3,4,22,133,1,1451,2,8,3,3,5,single-choice,spatial-relational,3|5,7,3/5,220133,3
3,4,22,134,1,840,3,7,2,2,5,single-choice,spatial-relational,2|5,7,2/5,220134,2
3,4,22,135,1,756,3,7,2,2,5,single-choice,spatial-relational,2|5,7,2/5,220135,2
3,4,22,136,1,785,2,12,5,5,7,single-choice,spatial-relational,5|7,7,5/7,220136,5
3,4,22,137,1,1111,3,5,1,1,4,single-choice,spatial-relational,1|4,7,1/4,220137,1
3,4,22,138,1,804,1,9,4,4,5,single-choice,spatial-relational,4|5,7,4/5,220138,4
3,4,22,139,1,583,1,5,2,2,3,single-choice,spatial-relational,2|3,7,2/3,220139,2
3,4,22,140,1,807,5,9,2,2,7,single-choice,spatial-relational,2|7,7,2/7,220140,2
3,4,22,141,1,981,2,12,5,5,7,single-choice,spatial-relational,5|7,7,5/7,220141,5
3,4,22,142,1,1499,1,11,5,5,6,single-choice,spatial-relational,5|6,7,5/6,220142,5
3,4,22,143,1,1942,1,5,2,2,3,single-choice,spatial-relational,2|3,7,2/3,220143,2
3,4,22,144,1,1244,2,8,3,3,5,single-choice,spatial-relational,3|5,7,3/5,220144,3
3,4,22,145,1,1230,1,11,5,5,6,single-choice,spatial-relational,5|6,7,5/6,220145,5
3,4,22,146,1,584,3,11,4,4,7,single-choice,spatial-relational,4|7,7,4/7,220146,4
3,4,22,147,1,679,2,10,4,4,6,single-choice,spatial-relational,4|6,7,4/6,220147,4
3,4,22,148,1,1063,2,4,1,1,3,single-choice,spatial-relational,1|3,7,1/3,220148,1
3,4,22,149,1,819,3,11,4,4,7,single-choice,spatial-relational,4|7,7,4/7,220149,4
3,4,22,150,1,1295,1,9,4,4,5,single-choice,spatial-relational,4|5,7,4/5,220150,4
3,4,22,151,1,1063,2,6,2,2,4,single-choice,spatial-relational,2|4,7,2/4,220151,2
3,4,22,152,1,1107,1,7,3,3,4,single-choice,spatial-relational,3|4,7,3/4,220152,3
3,4,22,153,1,935,6,8,1,1,7,single-choice,spatial-relational,1|7,7,1/7,220153,1
3,4,22,154,1,1001,1,3,1,1,2,single-choice,spatial-relational,1|2,7,1/2,220154,1
3,4,22,155,1,5939,4,6,1,1,5,single-choice,spatial-relational,1|5,7,1/5,220155,1
3,4,22,156,1,1053,2,6,2,2,4,single-choice,spatial-relational,2|4,7,2/4,220156,2
3,4,22,157,0,799,5,7,1,6,6,single-choice,spatial-relational,1|6,7,1/6,220157,1
3,4,22,158,1,763,4,10,3,3,7,single-choice,spatial-relational,3|7,7,3/7,220158,3
3,4,22,159,1,1064,1,7,3,3,4,single-choice,spatial-relational,3|4,7,3/4,220159,3
3,4,22,160,1,1021,1,13,6,6,7,single-choice,spatial-relational,6|7,7,6/7,220160,6
3,4,22,161,1,628,4,8,2,2,6,single-choice,spatial-relational,2|6,7,2/6,220161,2
3,4,22,162,1,574,5,9,2,2,7,single-choice,spatial-relational,2|7,7,2/7,220162,2
3,4,22,163,1,1129,1,3,1,1,2,single-choice,spatial-relational,1|2,7,1/2,220163,1
3,4,22,164,1,812,6,8,1,1,7,single-choice,spatial-relational,1|7,7,1/7,220164,1
3,4,22,165,1,5771,4,10,3,3,7,single-choice,spatial-relational,3|7,7,3/7,220165,3
3,4,22,166,0,647,3,5,1,4,4,single-choice,spatial-relational,1|4,7,1/4,220166,1
3,4,22,167,0,758,5,7,1,6,6,single-choice,spatial-relational,1|6,7,1/6,220167,1
3,4,22,168,1,1722,4,8,2,2,6,single-choice,spatial-relational,2|6,7,2/6,220168,2
3,4,22,169,1,938,4,8,2,2,6,single-choice,spatial-relational,2|6,7,2/6,220169,2
3,4,22,170,1,1471,3,9,3,3,6,single-choice,spatial-relational,3|6,7,3/6,220170,3
3,4,22,171,1,1076,2,4,1,1,3,single-choice,spatial-relational,1|3,7,1/3,220171,1
3,4,22,172,0,739,3,5,1,4,4,single-choice,spatial-relational,1|4,7,1/4,220172,1
3,4,22,173,0,938,3,7,2,5,5,single-choice,spatial-relational,2|5,7,2/5,220173,2
3,4,22,174,1,762,6,8,1,1,7,single-choice,spatial-relational,1|7,7,1/7,220174,1
3,4,22,175,1,1533,2,6,2,2,4,single-choice,spatial-relational,2|4,7,2/4,220175,2
3,4,22,176,1,1455,4,10,3,3,7,single-choice,spatial-relational,3|7,7,3/7,220176,3
3,4,22,177,1,3149,6,8,1,1,7,single-choice,spatial-relational,1|7,7,1/7,220177,1
3,4,22,178,1,1286,5,9,2,2,7,single-choice,spatial-relational,2|7,7,2/7,220178,2
3,4,22,179,1,879,5,7,1,1,6,single-choice,spatial-relational,1|6,7,1/6,220179,1
3,4,22,180,1,703,5,7,1,1,6,single-choice,spatial-relational,1|6,7,1/6,220180,1
3,4,22,181,1,571,1,13,6,6,7,single-choice,spatial-relational,6|7,7,6/7,220181,6
3,4,22,182,1,2036,2,8,3,3,5,single-choice,spatial-relational,3|5,7,3/5,220182,3
3,4,22,183,1,721,3,11,4,4,7,single-choice,spatial-relational,4|7,7,4/7,220183,4
3,4,22,184,1,778,2,8,3,3,5,single-choice,spatial-relational,3|5,7,3/5,220184,3
3,4,22,185,1,985,1,3,1,1,2,single-choice,spatial-relational,1|2,7,1/2,220185,1
3,4,22,186,1,898,3,5,1,1,4,single-choice,spatial-relational,1|4,7,1/4,220186,1
3,4,22,187,1,1297,1,5,2,2,3,single-choice,spatial-relational,2|3,7,2/3,220187,2
3,4,22,188,1,833,2,4,1,1,3,single-choice,spatial-relational,1|3,7,1/3,220188,1
3,4,22,189,1,952,2,10,4,4,6,single-choice,spatial-relational,4|6,7,4/6,220189,4
3,4,22,190,1,814,3,11,4,4,7,single-choice,spatial-relational,4|7,7,4/7,220190,4
3,4,22,191,1,672,1,5,2,2,3,single-choice,spatial-relational,2|3,7,2/3,220191,2
3,4,22,192,1,939,1,13,6,6,7,single-choice,spatial-relational,6|7,7,6/7,220192,6
3,4,22,193,1,753,1,9,4,4,5,single-choice,spatial-relational,4|5,7,4/5,220193,4
3,4,22,194,1,784,2,10,4,4,6,single-choice,spatial-relational,4|6,7,4/6,220194,4
3,4,22,195,1,1188,4,6,1,1,5,single-choice,spatial-relational,1|5,7,1/5,220195,1
3,4,22,196,1,870,4,8,2,2,6,single-choice,spatial-relational,2|6,7,2/6,220196,2
3,4,22,197,1,919,1,11,5,5,6,single-choice,spatial-relational,5|6,7,5/6,220197,5
3,4,22,198,1,887,2,12,5,5,7,single-choice,spatial-relational,5|7,7,5/7,220198,5
3,4,22,199,1,827,3,7,2,2,5,single-choice,spatial-relational,2|5,7,2/5,220199,2
3,4,22,200,1,942,1,11,5,5,6,single-choice,spatial-relational,5|6,7,5/6,220200,5
3,4,22,201,1,816,1,9,4,4,5,single-choice,spatial-relational,4|5,7,4/5,220201,4
3,4,22,202,1,1080,2,12,5,5,7,single-choice,spatial-relational,5|7,7,5/7,220202,5
3,4,22,203,1,554,4,10,3,3,7,single-choice,spatial-relational,3|7,7,3/7,220203,3
3,4,22,204,1,1363,1,7,3,3,4,single-choice,spatial-relational,3|4,7,3/4,220204,3
3,4,22,205,0,1158,1,7,3,4,4,single-choice,spatial-relational,3|4,7,3/4,220205,3
3,4,22,206,1,1441,1,3,1,1,2,single-choice,spatial-relational,1|2,7,1/2,220206,1
3,4,22,207,1,823,3,9,3,3,6,single-choice,spatial-relational,3|6,7,3/6,220207,3
3,4,22,208,1,528,5,9,2,2,7,single-choice,spatial-relational,2|7,7,2/7,220208,2
3,4,22,209,1,921,4,6,1,1,5,single-choice,spatial-relational,1|5,7,1/5,220209,1
3,4,22,210,1,1069,2,6,2,2,4,single-choice,spatial-relational,2|4,7,2/4,220210,2
3,4,22,211,1,719,4,10,3,3,7,single-choice,spatial-relational,3|7,7,3/7,220211,3
3,4,22,212,0,1601,2,4,1,3,3,single-choice,spatial-relational,1|3,7,1/3,220212,1
3,4,22,213,1,1153,5,7,1,1,6,single-choice,spatial-relational,1|6,7,1/6,220213,1
3,4,22,214,1,852,3,5,1,1,4,single-choice,spatial-relational,1|4,7,1/4,220214,1
3,4,22,215,1,670,3,11,4,4,7,single-choice,spatial-relational,4|7,7,4/7,220215,4
3,4,22,216,1,893,1,3,1,1,2,single-choice,spatial-relational,1|2,7,1/2,220216,1
3,4,22,217,1,579,5,9,2,2,7,single-choice,spatial-relational,2|7,7,2/7,220217,2
3,4,22,218,1,829,2,10,4,4,6,single-choice,spatial-relational,4|6,7,4/6,220218,4
3,4,22,219,1,708,1,9,4,4,5,single-choice,spatial-relational,4|5,7,4/5,220219,4
3,4,22,220,1,873,2,6,2,2,4,single-choice,spatial-relational,2|4,7,2/4,220220,2
3,4,22,221,1,771,3,9,3,3,6,single-choice,spatial-relational,3|6,7,3/6,220221,3
3,4,22,222,1,753,3,11,4,4,7,single-choice,spatial-relational,4|7,7,4/7,220222,4
3,4,22,223,1,1279,6,8,1,1,7,single-choice,spatial-relational,1|7,7,1/7,220223,1
3,4,22,224,1,756,2,10,4,4,6,single-choice,spatial-relational,4|6,7,4/6,220224,4
3,4,22,225,1,799,1,5,2,2,3,single-choice,spatial-relational,2|3,7,2/3,220225,2
3,4,22,226,1,824,4,6,1,1,5,single-choice,spatial-relational,1|5,7,1/5,220226,1
3,4,22,227,1,1103,3,7,2,2,5,single-choice,spatial-relational,2|5,7,2/5,220227,2
3,4,22,228,1,1128,2,12,5,5,7,single-choice,spatial-relational,5|7,7,5/7,220228,5
3,4,22,229,1,1657,1,11,5,5,6,single-choice,spatial-relational,5|6,7,5/6,220229,5
3,4,22,230,1,688,3,7,2,2,5,single-choice,spatial-relational,2|5,7,2/5,220230,2
3,4,22,231,1,915,1,13,6,6,7,single-choice,spatial-relational,6|7,7,6/7,220231,6
3,4,22,232,1,524,6,8,1,1,7,single-choice,spatial-relational,1|7,7,1/7,220232,1
3,4,22,233,1,745,2,8,3,3,5,single-choice,spatial-relational,3|5,7,3/5,220233,3
3,4,22,234,1,536,1,13,6,6,7,single-choice,spatial-relational,6|7,7,6/7,220234,6
3,4,22,235,0,571,4,6,1,5,5,single-choice,spatial-relational,1|5,7,1/5,220235,1
3,4,22,236,1,1615,3,5,1,1,4,single-choice,spatial-relational,1|4,7,1/4,220236,1
3,4,22,237,1,965,1,11,5,5,6,single-choice,spatial-relational,5|6,7,5/6,220237,5
3,4,22,238,0,4094,1,3,1,2,2,single-choice,spatial-relational,1|2,7,1/2,220238,1
3,4,22,239,0,879,5,7,1,6,6,single-choice,spatial-relational,1|6,7,1/6,220239,1
3,4,22,240,1,938,5,9,2,2,7,single-choice,spatial-relational,2|7,7,2/7,220240,2
3,4,22,241,0,1138,1,7,3,4,4,single-choice,spatial-relational,3|4,7,3/4,220241,3
3,4,22,242,1,932,2,12,5,5,7,single-choice,spatial-relational,5|7,7,5/7,220242,5
3,4,22,243,1,145,2,8,3,3,5,single-choice,spatial-relational,3|5,7,3/5,220243,3
3,4,22,244,1,836,4,10,3,3,7,single-choice,spatial-relational,3|7,7,3/7,220244,3
3,4,22,245,1,1128,1,5,2,2,3,single-choice,spatial-relational,2|3,7,2/3,220245,2
3,4,22,246,1,997,4,8,2,2,6,single-choice,spatial-relational,2|6,7,2/6,220246,2
3,4,22,247,1,779,4,8,2,2,6,single-choice,spatial-relational,2|6,7,2/6,220247,2
3,4,22,248,0,664,2,6,2,4,4,single-choice,spatial-relational,2|4,7,2/4,220248,2
3,4,22,249,1,1676,2,4,1,1,3,single-choice,spatial-relational,1|3,7,1/3,220249,1
3,4,22,250,1,655,1,9,4,4,5,single-choice,spatial-relational,4|5,7,4/5,220250,4
3,4,22,251,1,1005,1,7,3,3,4,single-choice,spatial-relational,3|4,7,3/4,220251,3
3,4,22,252,1,888,3,9,3,3,6,single-choice,spatial-relational,3|6,7,3/6,220252,3
3,4,22,253,1,840,2,4,1,1,3,single-choice,spatial-relational,1|3,7,1/3,220253,1
3,4,22,254,1,833,2,12,5,5,7,single-choice,spatial-relational,5|7,7,5/7,220254,5
3,4,22,255,1,856,1,11,5,5,6,single-choice,spatial-relational,5|6,7,5/6,220255,5
3,4,22,256,1,1009,6,8,1,1,7,single-choice,spatial-relational,1|7,7,1/7,220256,1
3,4,22,257,1,738,3,11,4,4,7,single-choice,spatial-relational,4|7,7,4/7,220257,4
3,4,22,258,1,944,3,9,3,3,6,single-choice,spatial-relational,3|6,7,3/6,220258,3
3,4,22,259,1,999,2,8,3,3,5,single-choice,spatial-relational,3|5,7,3/5,220259,3
3,4,22,260,0,5,4,10,3,7,7,single-choice,spatial-relational,3|7,7,3/7,220260,3
3,4,22,261,0,818,2,6,2,4,4,single-choice,spatial-relational,2|4,7,2/4,220261,2
3,4,22,262,1,851,1,11,5,5,6,single-choice,spatial-relational,5|6,7,5/6,220262,5
3,4,22,263,1,751,1,5,2,2,3,single-choice,spatial-relational,2|3,7,2/3,220263,2
3,4,22,264,1,535,1,13,6,6,7,single-choice,spatial-relational,6|7,7,6/7,220264,6
3,4,22,265,1,879,5,9,2,2,7,single-choice,spatial-relational,2|7,7,2/7,220265,2
3,4,22,266,1,608,5,9,2,2,7,single-choice,spatial-relational,2|7,7,2/7,220266,2
3,4,22,267,1,921,4,10,3,3,7,single-choice,spatial-relational,3|7,7,3/7,220267,3
3,4,22,268,1,1501,3,11,4,4,7,single-choice,spatial-relational,4|7,7,4/7,220268,4
3,4,22,269,1,991,4,8,2,2,6,single-choice,spatial-relational,2|6,7,2/6,220269,2
3,4,22,270,1,1333,3,5,1,1,4,single-choice,spatial-relational,1|4,7,1/4,220270,1
3,4,22,271,1,1611,2,8,3,3,5,single-choice,spatial-relational,3|5,7,3/5,220271,3
3,4,22,272,1,1061,1,3,1,1,2,single-choice,spatial-relational,1|2,7,1/2,220272,1
3,4,22,273,1,1123,1,7,3,3,4,single-choice,spatial-relational,3|4,7,3/4,220273,3
3,4,22,274,0,862,3,5,1,4,4,single-choice,spatial-relational,1|4,7,1/4,220274,1
3,4,22,275,1,1121,4,6,1,1,5,single-choice,spatial-relational,1|5,7,1/5,220275,1
3,4,22,276,0,836,2,6,2,4,4,single-choice,spatial-relational,2|4,7,2/4,220276,2
3,4,22,277,1,722,1,13,6,6,7,single-choice,spatial-relational,6|7,7,6/7,220277,6
3,4,22,278,1,932,4,8,2,2,6,single-choice,spatial-relational,2|6,7,2/6,220278,2
3,4,22,279,1,1470,2,10,4,4,6,single-choice,spatial-relational,4|6,7,4/6,220279,4
3,4,22,280,1,998,5,7,1,1,6,single-choice,spatial-relational,1|6,7,1/6,220280,1
3,4,22,281,1,861,2,10,4,4,6,single-choice,spatial-relational,4|6,7,4/6,220281,4
3,4,22,282,1,818,1,3,1,1,2,single-choice,spatial-relational,1|2,7,1/2,220282,1
3,4,22,283,1,756,6,8,1,1,7,single-choice,spatial-relational,1|7,7,1/7,220283,1
3,4,22,284,1,829,3,7,2,2,5,single-choice,spatial-relational,2|5,7,2/5,220284,2
3,4,22,285,1,1469,1,9,4,4,5,single-choice,spatial-relational,4|5,7,4/5,220285,4
3,4,22,286,1,945,3,9,3,3,6,single-choice,spatial-relational,3|6,7,3/6,220286,3
3,4,22,287,1,1051,2,12,5,5,7,single-choice,spatial-relational,5|7,7,5/7,220287,5
3,4,22,288,1,1086,2,4,1,1,3,single-choice,spatial-relational,1|3,7,1/3,220288,1
3,4,22,289,0,745,1,7,3,4,4,single-choice,spatial-relational,3|4,7,3/4,220289,3
3,4,22,290,0,49,4,6,1,5,5,single-choice,spatial-relational,1|5,7,1/5,220290,1
3,4,22,291,1,1574,5,7,1,1,6,single-choice,spatial-relational,1|6,7,1/6,220291,1
3,4,22,292,1,957,3,7,2,2,5,single-choice,spatial-relational,2|5,7,2/5,220292,2
3,4,22,293,0,1435,1,5,2,3,3,single-choice,spatial-relational,2|3,7,2/3,220293,2
3,4,22,294,1,730,1,9,4,4,5,single-choice,spatial-relational,4|5,7,4/5,220294,4
3,4,22,295,1,1360,1,13,6,6,7,single-choice,spatial-relational,6|7,7,6/7,220295,6
3,4,22,296,1,1618,1,5,2,2,3,single-choice,spatial-relational,2|3,7,2/3,220296,2
3,4,22,297,1,878,1,9,4,4,5,single-choice,spatial-relational,4|5,7,4/5,220297,4
3,4,22,298,1,626,3,7,2,2,5,single-choice,spatial-relational,2|5,7,2/5,220298,2
3,4,22,299,1,952,4,6,1,1,5,single-choice,spatial-relational,1|5,7,1/5,220299,1
3,4,22,300,1,1028,4,10,3,3,7,single-choice,spatial-relational,3|7,7,3/7,220300,3
3,4,22,301,1,1178,1,7,3,3,4,single-choice,spatial-relational,3|4,7,3/4,220301,3
3,4,22,302,1,1291,6,8,1,1,7,single-choice,spatial-relational,1|7,7,1/7,220302,1
3,4,22,303,1,1027,1,5,2,2,3,single-choice,spatial-relational,2|3,7,2/3,220303,2
3,4,22,304,1,823,3,9,3,3,6,single-choice,spatial-relational,3|6,7,3/6,220304,3
3,4,22,305,1,1314,1,7,3,3,4,single-choice,spatial-relational,3|4,7,3/4,220305,3
3,4,22,306,1,2045,3,7,2,2,5,single-choice,spatial-relational,2|5,7,2/5,220306,2
3,4,22,307,1,579,3,11,4,4,7,single-choice,spatial-relational,4|7,7,4/7,220307,4
3,4,22,308,1,838,1,3,1,1,2,single-choice,spatial-relational,1|2,7,1/2,220308,1
3,4,22,309,1,1032,2,4,1,1,3,single-choice,spatial-relational,1|3,7,1/3,220309,1
3,4,22,310,1,737,4,8,2,2,6,single-choice,spatial-relational,2|6,7,2/6,220310,2
3,4,22,311,1,948,3,5,1,1,4,single-choice,spatial-relational,1|4,7,1/4,220311,1
3,4,22,312,1,920,6,8,1,1,7,single-choice,spatial-relational,1|7,7,1/7,220312,1
3,4,22,313,1,967,3,9,3,3,6,single-choice,spatial-relational,3|6,7,3/6,220313,3
3,4,22,314,1,1028,5,7,1,1,6,single-choice,spatial-relational,1|6,7,1/6,220314,1
3,4,22,315,1,835,2,8,3,3,5,single-choice,spatial-relational,3|5,7,3/5,220315,3
3,4,22,316,1,1141,2,12,5,5,7,single-choice,spatial-relational,5|7,7,5/7,220316,5
3,4,22,317,1,1198,1,11,5,5,6,single-choice,spatial-relational,5|6,7,5/6,220317,5
3,4,22,318,1,864,2,4,1,1,3,single-choice,spatial-relational,1|3,7,1/3,220318,1
3,4,22,319,0,608,3,5,1,4,4,single-choice,spatial-relational,1|4,7,1/4,220319,1
3,4,22,320,1,980,2,12,5,5,7,single-choice,spatial-relational,5|7,7,5/7,220320,5
3,4,22,321,1,1089,4,6,1,1,5,single-choice,spatial-relational,1|5,7,1/5,220321,1
3,4,22,322,1,848,3,11,4,4,7,single-choice,spatial-relational,4|7,7,4/7,220322,4
3,4,22,323,0,49859,2,6,2,4,4,single-choice,spatial-relational,2|4,7,2/4,220323,2
3,4,22,324,0,2,1,11,5,6,6,single-choice,spatial-relational,5|6,7,5/6,220324,5
3,4,22,325,1,53,4,10,3,3,7,single-choice,spatial-relational,3|7,7,3/7,220325,3
3,4,22,326,1,809,5,9,2,2,7,single-choice,spatial-relational,2|7,7,2/7,220326,2
3,4,22,327,1,1168,4,8,2,2,6,single-choice,spatial-relational,2|6,7,2/6,220327,2
3,4,22,328,1,617,2,10,4,4,6,single-choice,spatial-relational,4|6,7,4/6,220328,4
3,4,22,329,1,711,1,9,4,4,5,single-choice,spatial-relational,4|5,7,4/5,220329,4
3,4,22,330,1,988,2,8,3,3,5,single-choice,spatial-relational,3|5,7,3/5,220330,3
3,4,22,331,1,899,2,10,4,4,6,single-choice,spatial-relational,4|6,7,4/6,220331,4
3,4,22,332,1,684,5,9,2,2,7,single-choice,spatial-relational,2|7,7,2/7,220332,2
3,4,22,333,1,1044,2,6,2,2,4,single-choice,spatial-relational,2|4,7,2/4,220333,2
3,4,22,334,1,1082,1,3,1,1,2,single-choice,spatial-relational,1|2,7,1/2,220334,1
3,4,22,335,1,10,5,7,1,1,6,single-choice,spatial-relational,1|6,7,1/6,220335,1
3,4,22,336,1,668,1,13,6,6,7,single-choice,spatial-relational,6|7,7,6/7,220336,6
3,4,22,337,1,859,2,8,3,3,5,single-choice,spatial-relational,3|5,7,3/5,220337,3
3,4,22,338,1,1009,1,11,5,5,6,single-choice,spatial-relational,5|6,7,5/6,220338,5
3,4,22,339,1,784,3,9,3,3,6,single-choice,spatial-relational,3|6,7,3/6,220339,3
3,4,22,340,1,745,2,12,5,5,7,single-choice,spatial-relational,5|7,7,5/7,220340,5
3,4,22,341,1,960,1,7,3,3,4,single-choice,spatial-relational,3|4,7,3/4,220341,3
3,4,22,342,1,937,3,9,3,3,6,single-choice,spatial-relational,3|6,7,3/6,220342,3
3,4,22,343,1,1383,1,5,2,2,3,single-choice,spatial-relational,2|3,7,2/3,220343,2
3,4,22,344,1,874,4,8,2,2,6,single-choice,spatial-relational,2|6,7,2/6,220344,2
3,4,22,345,0,994,1,13,6,7,7,single-choice,spatial-relational,6|7,7,6/7,220345,6
3,4,22,346,1,954,5,9,2,2,7,single-choice,spatial-relational,2|7,7,2/7,220346,2
3,4,22,347,1,1267,2,4,1,1,3,single-choice,spatial-relational,1|3,7,1/3,220347,1
3,4,22,348,1,1412,2,4,1,1,3,single-choice,spatial-relational,1|3,7,1/3,220348,1
3,4,22,349,1,1065,3,5,1,1,4,single-choice,spatial-relational,1|4,7,1/4,220349,1
3,4,22,350,1,670,1,5,2,2,3,single-choice,spatial-relational,2|3,7,2/3,220350,2
3,4,22,351,1,821,4,8,2,2,6,single-choice,spatial-relational,2|6,7,2/6,220351,2
3,4,22,352,1,980,1,9,4,4,5,single-choice,spatial-relational,4|5,7,4/5,220352,4
3,4,22,353,1,1178,1,7,3,3,4,single-choice,spatial-relational,3|4,7,3/4,220353,3
3,4,22,354,1,952,1,11,5,5,6,single-choice,spatial-relational,5|6,7,5/6,220354,5
3,4,22,355,1,919,1,13,6,6,7,single-choice,spatial-relational,6|7,7,6/7,220355,6
3,4,22,356,1,726,2,12,5,5,7,single-choice,spatial-relational,5|7,7,5/7,220356,5
3,4,22,357,1,1596,3,5,1,1,4,single-choice,spatial-relational,1|4,7,1/4,220357,1
3,4,22,358,1,1001,5,7,1,1,6,single-choice,spatial-relational,1|6,7,1/6,220358,1
3,4,22,359,1,608,4,10,3,3,7,single-choice,spatial-relational,3|7,7,3/7,220359,3
3,4,22,360,1,1017,6,8,1,1,7,single-choice,spatial-relational,1|7,7,1/7,220360,1
3,4,22,361,1,804,2,8,3,3,5,single-choice,spatial-relational,3|5,7,3/5,220361,3
3,4,22,362,1,730,5,9,2,2,7,single-choice,spatial-relational,2|7,7,2/7,220362,2
3,4,22,363,1,938,5,7,1,1,6,single-choice,spatial-relational,1|6,7,1/6,220363,1
3,4,22,364,0,407,4,6,1,5,5,single-choice,spatial-relational,1|5,7,1/5,220364,1
3,4,22,365,1,483,3,7,2,2,5,single-choice,spatial-relational,2|5,7,2/5,220365,2
3,4,22,366,1,838,3,11,4,4,7,single-choice,spatial-relational,4|7,7,4/7,220366,4
3,4,22,367,1,775,2,10,4,4,6,single-choice,spatial-relational,4|6,7,4/6,220367,4
3,4,22,368,0,1387,2,6,2,4,4,single-choice,spatial-relational,2|4,7,2/4,220368,2
3,4,22,369,1,853,2,6,2,2,4,single-choice,spatial-relational,2|4,7,2/4,220369,2
3,4,22,370,1,819,1,3,1,1,2,single-choice,spatial-relational,1|2,7,1/2,220370,1
3,4,22,371,1,923,1,3,1,1,2,single-choice,spatial-relational,1|2,7,1/2,220371,1
3,4,22,372,1,863,6,8,1,1,7,single-choice,spatial-relational,1|7,7,1/7,220372,1
3,4,22,373,1,1256,3,7,2,2,5,single-choice,spatial-relational,2|5,7,2/5,220373,2
3,4,22,374,1,1050,1,9,4,4,5,single-choice,spatial-relational,4|5,7,4/5,220374,4
3,4,22,375,1,771,4,6,1,1,5,single-choice,spatial-relational,1|5,7,1/5,220375,1
3,4,22,376,1,657,3,11,4,4,7,single-choice,spatial-relational,4|7,7,4/7,220376,4
3,4,22,377,1,868,4,10,3,3,7,single-choice,spatial-relational,3|7,7,3/7,220377,3
3,4,22,378,1,898,2,10,4,4,6,single-choice,spatial-relational,4|6,7,4/6,220378,4
3,4,22,379,1,1778,2,6,2,2,4,single-choice,spatial-relational,2|4,7,2/4,220379,2
3,4,22,380,1,814,5,7,1,1,6,single-choice,spatial-relational,1|6,7,1/6,220380,1
3,4,22,381,1,689,1,9,4,4,5,single-choice,spatial-relational,4|5,7,4/5,220381,4
3,4,22,382,1,987,2,12,5,5,7,single-choice,spatial-relational,5|7,7,5/7,220382,5
3,4,22,383,0,669,1,3,1,2,2,single-choice,spatial-relational,1|2,7,1/2,220383,1
3,4,22,384,1,879,1,13,6,6,7,single-choice,spatial-relational,6|7,7,6/7,220384,6
3,4,22,385,1,870,2,10,4,4,6,single-choice,spatial-relational,4|6,7,4/6,220385,4
3,4,22,386,1,627,4,8,2,2,6,single-choice,spatial-relational,2|6,7,2/6,220386,2
3,4,22,387,1,850,2,4,1,1,3,single-choice,spatial-relational,1|3,7,1/3,220387,1
3,4,22,388,1,609,1,13,6,6,7,single-choice,spatial-relational,6|7,7,6/7,220388,6
3,4,22,389,1,2772,1,3,1,1,2,single-choice,spatial-relational,1|2,7,1/2,220389,1
3,4,22,390,1,1007,2,4,1,1,3,single-choice,spatial-relational,1|3,7,1/3,220390,1
3,4,22,391,1,565,5,9,2,2,7,single-choice,spatial-relational,2|7,7,2/7,220391,2
3,4,22,392,1,982,3,5,1,1,4,single-choice,spatial-relational,1|4,7,1/4,220392,1
3,4,22,393,1,586,4,10,3,3,7,single-choice,spatial-relational,3|7,7,3/7,220393,3
3,4,22,394,1,923,4,8,2,2,6,single-choice,spatial-relational,2|6,7,2/6,220394,2
3,4,22,395,1,762,1,5,2,2,3,single-choice,spatial-relational,2|3,7,2/3,220395,2
3,4,22,396,1,836,5,9,2,2,7,single-choice,spatial-relational,2|7,7,2/7,220396,2
3,4,22,397,1,974,3,7,2,2,5,single-choice,spatial-relational,2|5,7,2/5,220397,2
3,4,22,398,1,625,3,9,3,3,6,single-choice,spatial-relational,3|6,7,3/6,220398,3
3,4,22,399,1,821,1,11,5,5,6,single-choice,spatial-relational,5|6,7,5/6,220399,5
3,4,22,400,1,732,2,10,4,4,6,single-choice,spatial-relational,4|6,7,4/6,220400,4
3,4,22,401,1,745,6,8,1,1,7,single-choice,spatial-relational,1|7,7,1/7,220401,1
3,4,22,402,1,576,3,11,4,4,7,single-choice,spatial-relational,4|7,7,4/7,220402,4
3,4,22,403,0,829,1,7,3,4,4,single-choice,spatial-relational,3|4,7,3/4,220403,3
3,4,22,404,1,783,3,11,4,4,7,single-choice,spatial-relational,4|7,7,4/7,220404,4
3,4,22,405,1,871,2,6,2,2,4,single-choice,spatial-relational,2|4,7,2/4,220405,2
3,4,22,406,1,1355,2,8,3,3,5,single-choice,spatial-relational,3|5,7,3/5,220406,3
3,4,22,407,1,1349,3,5,1,1,4,single-choice,spatial-relational,1|4,7,1/4,220407,1
3,4,22,408,1,1023,1,11,5,5,6,single-choice,spatial-relational,5|6,7,5/6,220408,5
3,4,22,409,1,1226,1,7,3,3,4,single-choice,spatial-relational,3|4,7,3/4,220409,3
3,4,22,410,1,848,4,10,3,3,7,single-choice,spatial-relational,3|7,7,3/7,220410,3
3,4,22,411,1,1017,2,8,3,3,5,single-choice,spatial-relational,3|5,7,3/5,220411,3
3,4,22,412,1,1949,5,7,1,1,6,single-choice,spatial-relational,1|6,7,1/6,220412,1
3,4,22,413,1,599,2,12,5,5,7,single-choice,spatial-relational,5|7,7,5/7,220413,5
3,4,22,414,1,716,3,9,3,3,6,single-choice,spatial-relational,3|6,7,3/6,220414,3
3,4,22,415,1,686,1,9,4,4,5,single-choice,spatial-relational,4|5,7,4/5,220415,4
3,4,22,416,1,1175,4,6,1,1,5,single-choice,spatial-relational,1|5,7,1/5,220416,1
3,4,22,417,1,1711,1,5,2,2,3,single-choice,spatial-relational,2|3,7,2/3,220417,2
3,4,22,418,1,1095,4,6,1,1,5,single-choice,spatial-relational,1|5,7,1/5,220418,1
3,4,22,419,1,672,3,7,2,2,5,single-choice,spatial-relational,2|5,7,2/5,220419,2
3,4,22,420,1,1275,6,8,1,1,7,single-choice,spatial-relational,1|7,7,1/7,220420,1
3,4,22,421,1,880,2,6,2,2,4,single-choice,spatial-relational,2|4,7,2/4,220421,2
3,4,22,422,1,820,4,6,1,1,5,single-choice,spatial-relational,1|5,7,1/5,220422,1
3,4,22,423,1,1599,2,10,4,4,6,single-choice,spatial-relational,4|6,7,4/6,220423,4
3,4,22,424,1,900,3,11,4,4,7,single-choice,spatial-relational,4|7,7,4/7,220424,4
3,4,22,425,1,558,5,9,2,2,7,single-choice,spatial-relational,2|7,7,2/7,220425,2
3,4,22,426,1,1250,2,4,1,1,3,single-choice,spatial-relational,1|3,7,1/3,220426,1
3,4,22,427,1,896,5,7,1,1,6,single-choice,spatial-relational,1|6,7,1/6,220427,1
3,4,22,428,0,774,3,5,1,4,4,single-choice,spatial-relational,1|4,7,1/4,220428,1
3,4,22,429,1,893,1,13,6,6,7,single-choice,spatial-relational,6|7,7,6/7,220429,6
3,4,22,430,1,1239,1,5,2,2,3,single-choice,spatial-relational,2|3,7,2/3,220430,2
3,4,22,431,1,1128,2,8,3,3,5,single-choice,spatial-relational,3|5,7,3/5,220431,3
3,4,22,432,1,1860,3,5,1,1,4,single-choice,spatial-relational,1|4,7,1/4,220432,1
3,4,22,433,1,954,3,7,2,2,5,single-choice,spatial-relational,2|5,7,2/5,220433,2
3,4,22,434,1,782,4,8,2,2,6,single-choice,spatial-relational,2|6,7,2/6,220434,2
3,4,22,435,1,622,4,8,2,2,6,single-choice,spatial-relational,2|6,7,2/6,220435,2
3,4,22,436,1,1187,2,4,1,1,3,single-choice,spatial-relational,1|3,7,1/3,220436,1
3,4,22,437,1,675,3,11,4,4,7,single-choice,spatial-relational,4|7,7,4/7,220437,4
3,4,22,438,1,859,3,9,3,3,6,single-choice,spatial-relational,3|6,7,3/6,220438,3
3,4,22,439,1,25,2,12,5,5,7,single-choice,spatial-relational,5|7,7,5/7,220439,5
3,4,22,440,1,909,1,11,5,5,6,single-choice,spatial-relational,5|6,7,5/6,220440,5
3,4,22,441,1,860,3,9,3,3,6,single-choice,spatial-relational,3|6,7,3/6,220441,3
3,4,22,442,1,921,2,8,3,3,5,single-choice,spatial-relational,3|5,7,3/5,220442,3
3,4,22,443,1,793,2,12,5,5,7,single-choice,spatial-relational,5|7,7,5/7,220443,5
3,4,22,444,1,1044,5,7,1,1,6,single-choice,spatial-relational,1|6,7,1/6,220444,1
3,4,22,445,1,1205,4,6,1,1,5,single-choice,spatial-relational,1|5,7,1/5,220445,1
3,4,22,446,1,764,1,9,4,4,5,single-choice,spatial-relational,4|5,7,4/5,220446,4
3,4,22,447,1,985,5,9,2,2,7,single-choice,spatial-relational,2|7,7,2/7,220447,2
3,4,22,448,1,7,6,8,1,1,7,single-choice,spatial-relational,1|7,7,1/7,220448,1
3,4,22,449,1,1056,1,7,3,3,4,single-choice,spatial-relational,3|4,7,3/4,220449,3
3,4,22,450,1,826,1,7,3,3,4,single-choice,spatial-relational,3|4,7,3/4,220450,3
3,4,22,451,1,1328,1,3,1,1,2,single-choice,spatial-relational,1|2,7,1/2,220451,1
3,4,22,452,1,877,2,10,4,4,6,single-choice,spatial-relational,4|6,7,4/6,220452,4
3,4,22,453,1,722,1,5,2,2,3,single-choice,spatial-relational,2|3,7,2/3,220453,2
3,4,22,454,1,1006,4,10,3,3,7,single-choice,spatial-relational,3|7,7,3/7,220454,3
3,4,22,455,0,794,3,7,2,5,5,single-choice,spatial-relational,2|5,7,2/5,220455,2
3,4,22,456,1,54,1,13,6,6,7,single-choice,spatial-relational,6|7,7,6/7,220456,6
3,4,22,457,1,57,6,8,1,1,7,single-choice,spatial-relational,1|7,7,1/7,220457,1
3,4,22,458,1,669,1,9,4,4,5,single-choice,spatial-relational,4|5,7,4/5,220458,4
3,4,22,459,1,888,2,6,2,2,4,single-choice,spatial-relational,2|4,7,2/4,220459,2
3,4,22,460,1,838,1,3,1,1,2,single-choice,spatial-relational,1|2,7,1/2,220460,1
3,4,22,461,1,838,1,11,5,5,6,single-choice,spatial-relational,5|6,7,5/6,220461,5
3,4,22,462,1,861,4,10,3,3,7,single-choice,spatial-relational,3|7,7,3/7,220462,3
3,4,22,463,1,795,1,9,4,4,5,single-choice,spatial-relational,4|5,7,4/5,220463,4
3,4,22,464,1,520,4,8,2,2,6,single-choice,spatial-relational,2|6,7,2/6,220464,2
3,4,22,465,1,858,2,10,4,4,6,single-choice,spatial-relational,4|6,7,4/6,220465,4
3,4,22,466,1,1049,1,13,6,6,7,single-choice,spatial-relational,6|7,7,6/7,220466,6
3,4,22,467,0,615,1,3,1,2,2,single-choice,spatial-relational,1|2,7,1/2,220467,1
3,4,22,468,1,785,2,12,5,5,7,single-choice,spatial-relational,5|7,7,5/7,220468,5
3,4,22,469,1,844,1,7,3,3,4,single-choice,spatial-relational,3|4,7,3/4,220469,3
3,4,22,470,1,581,1,13,6,6,7,single-choice,spatial-relational,6|7,7,6/7,220470,6
3,4,22,471,1,1360,1,5,2,2,3,single-choice,spatial-relational,2|3,7,2/3,220471,2
3,4,22,472,1,1174,2,8,3,3,5,single-choice,spatial-relational,3|5,7,3/5,220472,3
3,4,22,473,1,761,1,3,1,1,2,single-choice,spatial-relational,1|2,7,1/2,220473,1
3,4,22,474,1,950,2,4,1,1,3,single-choice,spatial-relational,1|3,7,1/3,220474,1
3,4,22,475,1,836,5,9,2,2,7,single-choice,spatial-relational,2|7,7,2/7,220475,2
3,4,22,476,1,918,4,6,1,1,5,single-choice,spatial-relational,1|5,7,1/5,220476,1
3,4,22,477,1,921,2,6,2,2,4,single-choice,spatial-relational,2|4,7,2/4,220477,2
3,4,22,478,1,11,3,7,2,2,5,single-choice,spatial-relational,2|5,7,2/5,220478,2
3,4,22,479,1,1221,2,6,2,2,4,single-choice,spatial-relational,2|4,7,2/4,220479,2
3,4,22,480,1,710,3,11,4,4,7,single-choice,spatial-relational,4|7,7,4/7,220480,4
3,4,22,481,1,1915,3,7,2,2,5,single-choice,spatial-relational,2|5,7,2/5,220481,2
3,4,22,482,0,52,2,4,1,3,3,single-choice,spatial-relational,1|3,7,1/3,220482,1
3,4,22,483,1,1058,1,11,5,5,6,single-choice,spatial-relational,5|6,7,5/6,220483,5
3,4,22,484,1,786,4,10,3,3,7,single-choice,spatial-relational,3|7,7,3/7,220484,3
3,4,22,485,1,979,3,9,3,3,6,single-choice,spatial-relational,3|6,7,3/6,220485,3
3,4,22,486,1,16,5,7,1,1,6,single-choice,spatial-relational,1|6,7,1/6,220486,1
3,4,22,487,1,1179,3,5,1,1,4,single-choice,spatial-relational,1|4,7,1/4,220487,1
3,4,22,488,1,568,3,11,4,4,7,single-choice,spatial-relational,4|7,7,4/7,220488,4
3,4,22,489,1,925,3,9,3,3,6,single-choice,spatial-relational,3|6,7,3/6,220489,3
3,4,22,490,1,1067,4,8,2,2,6,single-choice,spatial-relational,2|6,7,2/6,220490,2
3,4,22,491,0,543,5,7,1,6,6,single-choice,spatial-relational,1|6,7,1/6,220491,1
3,4,22,492,1,960,1,5,2,2,3,single-choice,spatial-relational,2|3,7,2/3,220492,2
3,4,22,493,1,1233,6,8,1,1,7,single-choice,spatial-relational,1|7,7,1/7,220493,1
3,4,22,494,1,644,4,10,3,3,7,single-choice,spatial-relational,3|7,7,3/7,220494,3
3,4,22,495,1,1305,1,9,4,4,5,single-choice,spatial-relational,4|5,7,4/5,220495,4
3,4,22,496,1,735,5,9,2,2,7,single-choice,spatial-relational,2|7,7,2/7,220496,2
3,4,22,497,1,791,6,8,1,1,7,single-choice,spatial-relational,1|7,7,1/7,220497,1
3,4,22,498,1,849,1,7,3,3,4,single-choice,spatial-relational,3|4,7,3/4,220498,3
3,4,22,499,1,1044,4,6,1,1,5,single-choice,spatial-relational,1|5,7,1/5,220499,1
3,4,22,500,1,659,2,10,4,4,6,single-choice,spatial-relational,4|6,7,4/6,220500,4
3,4,22,501,1,790,1,11,5,5,6,single-choice,spatial-relational,5|6,7,5/6,220501,5
3,4,22,502,1,968,2,8,3,3,5,single-choice,spatial-relational,3|5,7,3/5,220502,3
3,4,22,503,1,729,2,12,5,5,7,single-choice,spatial-relational,5|7,7,5/7,220503,5
3,4,22,504,1,1886,3,5,1,1,4,single-choice,spatial-relational,1|4,7,1/4,220504,1
3,4,22,505,1,958,3,5,1,1,4,single-choice,spatial-relational,1|4,7,1/4,220505,1
3,4,22,506,1,907,2,6,2,2,4,single-choice,spatial-relational,2|4,7,2/4,220506,2
3,4,22,507,1,815,1,13,6,6,7,single-choice,spatial-relational,6|7,7,6/7,220507,6
3,4,22,508,1,642,3,7,2,2,5,single-choice,spatial-relational,2|5,7,2/5,220508,2
3,4,22,509,1,872,2,4,1,1,3,single-choice,spatial-relational,1|3,7,1/3,220509,1
3,4,22,510,1,647,3,11,4,4,7,single-choice,spatial-relational,4|7,7,4/7,220510,4
3,4,22,511,0,737,1,3,1,2,2,single-choice,spatial-relational,1|2,7,1/2,220511,1
3,4,22,512,1,870,4,10,3,3,7,single-choice,spatial-relational,3|7,7,3/7,220512,3
3,4,22,513,1,723,3,11,4,4,7,single-choice,spatial-relational,4|7,7,4/7,220513,4
3,4,22,514,1,1102,2,4,1,1,3,single-choice,spatial-relational,1|3,7,1/3,220514,1
3,4,22,515,1,861,6,8,1,1,7,single-choice,spatial-relational,1|7,7,1/7,220515,1
3,4,22,516,1,807,1,11,5,5,6,single-choice,spatial-relational,5|6,7,5/6,220516,5
3,4,22,517,1,757,1,9,4,4,5,single-choice,spatial-relational,4|5,7,4/5,220517,4
3,4,22,518,1,808,3,7,2,2,5,single-choice,spatial-relational,2|5,7,2/5,220518,2
3,4,22,519,1,957,3,9,3,3,6,single-choice,spatial-relational,3|6,7,3/6,220519,3
3,4,22,520,1,934,5,9,2,2,7,single-choice,spatial-relational,2|7,7,2/7,220520,2
3,4,22,521,1,791,5,9,2,2,7,single-choice,spatial-relational,2|7,7,2/7,220521,2
3,4,22,522,1,789,3,9,3,3,6,single-choice,spatial-relational,3|6,7,3/6,220522,3
3,4,22,523,1,1064,2,10,4,4,6,single-choice,spatial-relational,4|6,7,4/6,220523,4
3,4,22,524,0,949,1,9,4,5,5,single-choice,spatial-relational,4|5,7,4/5,220524,4
3,4,22,525,1,1786,6,8,1,1,7,single-choice,spatial-relational,1|7,7,1/7,220525,1
3,4,22,526,0,679,5,7,1,6,6,single-choice,spatial-relational,1|6,7,1/6,220526,1
3,4,22,527,1,926,5,7,1,1,6,single-choice,spatial-relational,1|6,7,1/6,220527,1
3,4,22,528,1,893,2,12,5,5,7,single-choice,spatial-relational,5|7,7,5/7,220528,5
3,4,22,529,0,1750,1,3,1,2,2,single-choice,spatial-relational,1|2,7,1/2,220529,1
3,4,22,530,1,806,2,8,3,3,5,single-choice,spatial-relational,3|5,7,3/5,220530,3
3,4,22,531,1,1967,1,7,3,3,4,single-choice,spatial-relational,3|4,7,3/4,220531,3
3,4,22,532,1,863,4,6,1,1,5,single-choice,spatial-relational,1|5,7,1/5,220532,1
3,4,22,533,1,919,2,12,5,5,7,single-choice,spatial-relational,5|7,7,5/7,220533,5
3,4,22,534,1,993,4,8,2,2,6,single-choice,spatial-relational,2|6,7,2/6,220534,2
3,4,22,535,0,559,4,10,3,7,7,single-choice,spatial-relational,3|7,7,3/7,220535,3
3,4,22,536,1,1089,1,7,3,3,4,single-choice,spatial-relational,3|4,7,3/4,220536,3
3,4,22,537,1,1195,4,6,1,1,5,single-choice,spatial-relational,1|5,7,1/5,220537,1
3,4,22,538,1,776,2,10,4,4,6,single-choice,spatial-relational,4|6,7,4/6,220538,4
3,4,22,539,1,910,1,11,5,5,6,single-choice,spatial-relational,5|6,7,5/6,220539,5
3,4,22,540,1,1236,1,5,2,2,3,single-choice,spatial-relational,2|3,7,2/3,220540,2
3,4,22,541,1,497,1,13,6,6,7,single-choice,spatial-relational,6|7,7,6/7,220541,6
3,4,22,542,1,24,4,8,2,2,6,single-choice,spatial-relational,2|6,7,2/6,220542,2
3,4,22,543,0,1205,2,8,3,5,5,single-choice,spatial-relational,3|5,7,3/5,220543,3
3,4,22,544,1,930,3,5,1,1,4,single-choice,spatial-relational,1|4,7,1/4,220544,1
3,4,22,545,0,820,1,5,2,3,3,single-choice,spatial-relational,2|3,7,2/3,220545,2
3,4,22,546,1,1011,2,6,2,2,4,single-choice,spatial-relational,2|4,7,2/4,220546,2
3,4,22,547,1,842,5,7,1,1,6,single-choice,spatial-relational,1|6,7,1/6,220547,1
3,4,22,548,1,1189,6,8,1,1,7,single-choice,spatial-relational,1|7,7,1/7,220548,1
3,4,22,549,1,1300,4,6,1,1,5,single-choice,spatial-relational,1|5,7,1/5,220549,1
3,4,22,550,1,715,1,9,4,4,5,single-choice,spatial-relational,4|5,7,4/5,220550,4
3,4,22,551,1,881,2,4,1,1,3,single-choice,spatial-relational,1|3,7,1/3,220551,1
3,4,22,552,1,707,4,8,2,2,6,single-choice,spatial-relational,2|6,7,2/6,220552,2
3,4,22,553,1,1955,4,6,1,1,5,single-choice,spatial-relational,1|5,7,1/5,220553,1
3,4,22,554,1,861,4,10,3,3,7,single-choice,spatial-relational,3|7,7,3/7,220554,3
3,4,22,555,0,1024,3,5,1,4,4,single-choice,spatial-relational,1|4,7,1/4,220555,1
3,4,22,556,1,681,3,11,4,4,7,single-choice,spatial-relational,4|7,7,4/7,220556,4
3,4,22,557,1,1236,2,8,3,3,5,single-choice,spatial-relational,3|5,7,3/5,220557,3
3,4,22,558,1,1891,3,9,3,3,6,single-choice,spatial-relational,3|6,7,3/6,220558,3
3,4,22,559,1,927,1,5,2,2,3,single-choice,spatial-relational,2|3,7,2/3,220559,2
3,4,22,560,1,572,1,13,6,6,7,single-choice,spatial-relational,6|7,7,6/7,220560,6
3,4,22,561,1,882,5,9,2,2,7,single-choice,spatial-relational,2|7,7,2/7,220561,2
3,4,22,562,1,1464,3,5,1,1,4,single-choice,spatial-relational,1|4,7,1/4,220562,1
3,4,22,563,1,665,4,10,3,3,7,single-choice,spatial-relational,3|7,7,3/7,220563,3
3,4,22,564,1,1018,2,4,1,1,3,single-choice,spatial-relational,1|3,7,1/3,220564,1
3,4,22,565,1,982,1,9,4,4,5,single-choice,spatial-relational,4|5,7,4/5,220565,4
3,4,22,566,1,1069,5,7,1,1,6,single-choice,spatial-relational,1|6,7,1/6,220566,1
3,4,22,567,1,808,2,10,4,4,6,single-choice,spatial-relational,4|6,7,4/6,220567,4
3,4,22,568,1,658,3,11,4,4,7,single-choice,spatial-relational,4|7,7,4/7,220568,4
3,4,22,569,1,1080,1,7,3,3,4,single-choice,spatial-relational,3|4,7,3/4,220569,3
3,4,22,570,1,463,1,7,3,3,4,single-choice,spatial-relational,3|4,7,3/4,220570,3
3,4,22,571,1,718,2,12,5,5,7,single-choice,spatial-relational,5|7,7,5/7,220571,5
3,4,22,572,1,684,3,7,2,2,5,single-choice,spatial-relational,2|5,7,2/5,220572,2
3,4,22,573,1,762,2,8,3,3,5,single-choice,spatial-relational,3|5,7,3/5,220573,3
3,4,22,574,1,532,5,9,2,2,7,single-choice,spatial-relational,2|7,7,2/7,220574,2
3,4,22,575,1,798,1,11,5,5,6,single-choice,spatial-relational,5|6,7,5/6,220575,5
3,4,22,576,1,4714,2,10,4,4,6,single-choice,spatial-relational,4|6,7,4/6,220576,4
3,4,22,577,1,1190,2,6,2,2,4,single-choice,spatial-relational,2|4,7,2/4,220577,2
3,4,22,578,1,752,2,12,5,5,7,single-choice,spatial-relational,5|7,7,5/7,220578,5
3,4,22,579,1,1269,1,3,1,1,2,single-choice,spatial-relational,1|2,7,1/2,220579,1
3,4,22,580,1,909,2,6,2,2,4,single-choice,spatial-relational,2|4,7,2/4,220580,2
3,4,22,581,1,826,1,13,6,6,7,single-choice,spatial-relational,6|7,7,6/7,220581,6
3,4,22,582,1,927,3,9,3,3,6,single-choice,spatial-relational,3|6,7,3/6,220582,3
3,4,22,583,0,678,1,3,1,2,2,single-choice,spatial-relational,1|2,7,1/2,220583,1
3,4,22,584,0,598,3,7,2,5,5,single-choice,spatial-relational,2|5,7,2/5,220584,2
3,4,22,585,1,943,1,11,5,5,6,single-choice,spatial-relational,5|6,7,5/6,220585,5
3,4,22,586,1,1002,1,5,2,2,3,single-choice,spatial-relational,2|3,7,2/3,220586,2
3,4,22,587,1,1489,6,8,1,1,7,single-choice,spatial-relational,1|7,7,1/7,220587,1
3,4,22,588,0,643,4,8,2,6,6,single-choice,spatial-relational,2|6,7,2/6,220588,2
3,4,22,589,1,971,1,11,5,5,6,single-choice,spatial-relational,5|6,7,5/6,220589,5
3,4,22,590,1,862,2,12,5,5,7,single-choice,spatial-relational,5|7,7,5/7,220590,5
3,4,22,591,1,776,3,11,4,4,7,single-choice,spatial-relational,4|7,7,4/7,220591,4
3,4,22,592,1,855,1,9,4,4,5,single-choice,spatial-relational,4|5,7,4/5,220592,4
3,4,22,593,1,774,5,9,2,2,7,single-choice,spatial-relational,2|7,7,2/7,220593,2
3,4,22,594,1,1201,2,6,2,2,4,single-choice,spatial-relational,2|4,7,2/4,220594,2
3,4,22,595,1,755,3,11,4,4,7,single-choice,spatial-relational,4|7,7,4/7,220595,4
3,4,22,596,1,852,3,9,3,3,6,single-choice,spatial-relational,3|6,7,3/6,220596,3
3,4,22,597,1,990,1,13,6,6,7,single-choice,spatial-relational,6|7,7,6/7,220597,6
3,4,22,598,0,556,5,7,1,6,6,single-choice,spatial-relational,1|6,7,1/6,220598,1
3,4,22,599,1,905,1,5,2,2,3,single-choice,spatial-relational,2|3,7,2/3,220599,2
3,4,22,600,1,1112,3,7,2,2,5,single-choice,spatial-relational,2|5,7,2/5,220600,2
1,4,23,1,0,1962,1,5,2,3,3,single-choice,spatial-relational,2|3,7,2/3,230001,2
1,4,23,2,0,1204,1,11,5,6,6,single-choice,spatial-relational,5|6,7,5/6,230002,5
1,4,23,3,0,946,1,7,3,4,4,single-choice,spatial-relational,3|4,7,3/4,230003,3
1,4,23,4,0,1022,1,13,6,7,7,single-choice,spatial-relational,6|7,7,6/7,230004,6
1,4,23,5,0,952,1,7,3,4,4,single-choice,spatial-relational,3|4,7,3/4,230005,3
1,4,23,6,1,1256,1,3,1,1,2,single-choice,spatial-relational,1|2,7,1/2,230006,1
1,4,23,7,0,817,1,13,6,7,7,single-choice,spatial-relational,6|7,7,6/7,230007,6
1,4,23,8,1,1159,1,9,4,4,5,single-choice,spatial-relational,4|5,7,4/5,230008,4
1,4,23,9,0,1210,1,5,2,3,3,single-choice,spatial-relational,2|3,7,2/3,230009,2
1,4,23,10,1,1053,1,3,1,1,2,single-choice,spatial-relational,1|2,7,1/2,230010,1
1,4,23,11,1,928,1,11,5,5,6,single-choice,spatial-relational,5|6,7,5/6,230011,5
1,4,23,12,1,913,1,9,4,4,5,single-choice,spatial-relational,4|5,7,4/5,230012,4
1,4,23,13,1,1902,1,11,5,5,6,single-choice,spatial-relational,5|6,7,5/6,230013,5
1,4,23,14,1,1412,1,7,3,3,4,single-choice,spatial-relational,3|4,7,3/4,230014,3
1,4,23,15,0,1286,1,13,6,7,7,single-choice,spatial-relational,6|7,7,6/7,230015,6
1,4,23,16,0,1072,1,13,6,7,7,single-choice,spatial-relational,6|7,7,6/7,230016,6
1,4,23,17,0,1001,1,5,2,3,3,single-choice,spatial-relational,2|3,7,2/3,230017,2
1,4,23,18,0,1265,1,11,5,6,6,single-choice,spatial-relational,5|6,7,5/6,230018,5
1,4,23,19,0,1196,1,9,4,5,5,single-choice,spatial-relational,4|5,7,4/5,230019,4
1,4,23,20,1,1106,1,3,1,1,2,single-choice,spatial-relational,1|2,7,1/2,230020,1
1,4,23,21,0,1026,1,5,2,3,3,single-choice,spatial-relational,2|3,7,2/3,230021,2
1,4,23,22,1,973,1,3,1,1,2,single-choice,spatial-relational,1|2,7,1/2,230022,1
1,4,23,23,1,1273,1,9,4,4,5,single-choice,spatial-relational,4|5,7,4/5,230023,4
1,4,23,24,1,1225,1,7,3,3,4,single-choice,spatial-relational,3|4,7,3/4,230024,3
1,4,23,25,0,1302,1,11,5,6,6,single-choice,spatial-relational,5|6,7,5/6,230025,5
1,4,23,26,0,1211,1,13,6,7,7,single-choice,spatial-relational,6|7,7,6/7,230026,6
1,4,23,27,0,1304,1,5,2,3,3,single-choice,spatial-relational,2|3,7,2/3,230027,2
1,4,23,28,1,956,1,3,1,1,2,single-choice,spatial-relational,1|2,7,1/2,230028,1
1,4,23,29,0,1862,1,9,4,5,5,single-choice,spatial-relational,4|5,7,4/5,230029,4
1,4,23,30,1,946,1,7,3,3,4,single-choice,spatial-relational,3|4,7,3/4,230030,3
1,4,23,31,0,1038,1,5,2,3,3,single-choice,spatial-relational,2|3,7,2/3,230031,2
1,4,23,32,1,1368,1,11,5,5,6,single-choice,spatial-relational,5|6,7,5/6,230032,5
1,4,23,33,1,1096,1,3,1,1,2,single-choice,spatial-relational,1|2,7,1/2,230033,1
1,4,23,34,1,1121,1,13,6,6,7,single-choice,spatial-relational,6|7,7,6/7,230034,6
1,4,23,35,0,2095,1,9,4,5,5,single-choice,spatial-relational,4|5,7,4/5,230035,4
1,4,23,36,1,1415,1,7,3,3,4,single-choice,spatial-relational,3|4,7,3/4,230036,3
1,4,23,37,1,1539,1,9,4,4,5,single-choice,spatial-relational,4|5,7,4/5,230037,4
1,4,23,38,1,1676,1,7,3,3,4,single-choice,spatial-relational,3|4,7,3/4,230038,3
1,4,23,39,0,3587,1,13,6,7,7,single-choice,spatial-relational,6|7,7,6/7,230039,6
1,4,23,40,0,946,1,5,2,3,3,single-choice,spatial-relational,2|3,7,2/3,230040,2
1,4,23,41,1,1099,1,11,5,5,6,single-choice,spatial-relational,5|6,7,5/6,230041,5
1,4,23,42,1,1232,1,7,3,3,4,single-choice,spatial-relational,3|4,7,3/4,230042,3
1,4,23,43,1,919,1,11,5,5,6,single-choice,spatial-relational,5|6,7,5/6,230043,5
1,4,23,44,0,1333,1,3,1,2,2,single-choice,spatial-relational,1|2,7,1/2,230044,1
1,4,23,45,1,942,1,3,1,1,2,single-choice,spatial-relational,1|2,7,1/2,230045,1
1,4,23,46,1,937,1,5,2,2,3,single-choice,spatial-relational,2|3,7,2/3,230046,2
1,4,23,47,0,766,1,9,4,5,5,single-choice,spatial-relational,4|5,7,4/5,230047,4
1,4,23,48,0,1359,1,13,6,7,7,single-choice,spatial-relational,6|7,7,6/7,230048,6
1,4,23,49,1,1544,1,3,1,1,2,single-choice,spatial-relational,1|2,7,1/2,230049,1
1,4,23,50,0,986,1,7,3,4,4,single-choice,spatial-relational,3|4,7,3/4,230050,3
1,4,23,51,0,832,1,9,4,5,5,single-choice,spatial-relational,4|5,7,4/5,230051,4
1,4,23,52,1,1704,1,11,5,5,6,single-choice,spatial-relational,5|6,7,5/6,230052,5
1,4,23,53,1,2063,1,7,3,3,4,single-choice,spatial-relational,3|4,7,3/4,230053,3
1,4,23,54,1,1427,1,13,6,6,7,single-choice,spatial-relational,6|7,7,6/7,230054,6
1,4,23,55,1,2273,1,9,4,4,5,single-choice,spatial-relational,4|5,7,4/5,230055,4
1,4,23,56,0,1183,1,5,2,3,3,single-choice,spatial-relational,2|3,7,2/3,230056,2
1,4,23,57,0,1566,1,11,5,6,6,single-choice,spatial-relational,5|6,7,5/6,230057,5
1,4,23,58,1,1808,1,5,2,2,3,single-choice,spatial-relational,2|3,7,2/3,230058,2
1,4,23,59,1,1618,1,3,1,1,2,single-choice,spatial-relational,1|2,7,1/2,230059,1
1,4,23,60,0,1367,1,13,6,7,7,single-choice,spatial-relational,6|7,7,6/7,230060,6
1,4,23,61,1,1006,1,11,5,5,6,single-choice,spatial-relational,5|6,7,5/6,230061,5
1,4,23,62,0,1675,1,13,6,7,7,single-choice,spatial-relational,6|7,7,6/7,230062,6
1,4,23,63,0,1191,1,13,6,7,7,single-choice,spatial-relational,6|7,7,6/7,230063,6
1,4,23,64,0,1401,1,9,4,5,5,single-choice,spatial-relational,4|5,7,4/5,230064,4
1,4,23,65,1,2,1,3,1,1,2,single-choice,spatial-relational,1|2,7,1/2,230065,1
1,4,23,66,1,1296,1,7,3,3,4,single-choice,spatial-relational,3|4,7,3/4,230066,3
1,4,23,67,0,1399,1,3,1,2,2,single-choice,spatial-relational,1|2,7,1/2,230067,1
1,4,23,68,1,888,1,11,5,5,6,single-choice,spatial-relational,5|6,7,5/6,230068,5
1,4,23,69,0,788,1,9,4,5,5,single-choice,spatial-relational,4|5,7,4/5,230069,4
1,4,23,70,0,1158,1,5,2,3,3,single-choice,spatial-relational,2|3,7,2/3,230070,2
1,4,23,71,1,6,1,7,3,3,4,single-choice,spatial-relational,3|4,7,3/4,230071,3
1,4,23,72,0,1432,1,5,2,3,3,single-choice,spatial-relational,2|3,7,2/3,230072,2
1,4,23,73,1,1941,1,7,3,3,4,single-choice,spatial-relational,3|4,7,3/4,230073,3
1,4,23,74,0,1533,1,13,6,7,7,single-choice,spatial-relational,6|7,7,6/7,230074,6
1,4,23,75,1,1906,1,11,5,5,6,single-choice,spatial-relational,5|6,7,5/6,230075,5
1,4,23,76,1,1284,1,9,4,4,5,single-choice,spatial-relational,4|5,7,4/5,230076,4
1,4,23,77,1,1670,1,11,5,5,6,single-choice,spatial-relational,5|6,7,5/6,230077,5
1,4,23,78,0,2541,1,5,2,3,3,single-choice,spatial-relational,2|3,7,2/3,230078,2
1,4,23,79,0,1017,1,5,2,3,3,single-choice,spatial-relational,2|3,7,2/3,230079,2
1,4,23,80,1,866,1,3,1,1,2,single-choice,spatial-relational,1|2,7,1/2,230080,1
1,4,23,81,1,1370,1,13,6,6,7,single-choice,spatial-relational,6|7,7,6/7,230081,6
1,4,23,82,0,1564,1,9,4,5,5,single-choice,spatial-relational,4|5,7,4/5,230082,4
1,4,23,83,1,2015,1,7,3,3,4,single-choice,spatial-relational,3|4,7,3/4,230083,3
1,4,23,84,0,1284,1,3,1,2,2,single-choice,spatial-relational,1|2,7,1/2,230084,1
1,4,23,85,1,2191,1,7,3,3,4,single-choice,spatial-relational,3|4,7,3/4,230085,3
1,4,23,86,1,1176,1,13,6,6,7,single-choice,spatial-relational,6|7,7,6/7,230086,6
1,4,23,87,1,1638,1,3,1,1,2,single-choice,spatial-relational,1|2,7,1/2,230087,1
1,4,23,88,1,1222,1,9,4,4,5,single-choice,spatial-relational,4|5,7,4/5,230088,4
1,4,23,89,0,2114,1,7,3,4,4,single-choice,spatial-relational,3|4,7,3/4,230089,3
1,4,23,90,0,1857,1,11,5,6,6,single-choice,spatial-relational,5|6,7,5/6,230090,5
1,4,23,91,0,1284,1,3,1,2,2,single-choice,spatial-relational,1|2,7,1/2,230091,1
1,4,23,92,1,1033,1,13,6,6,7,single-choice,spatial-relational,6|7,7,6/7,230092,6
1,4,23,93,1,1844,1,11,5,5,6,single-choice,spatial-relational,5|6,7,5/6,230093,5
1,4,23,94,0,2810,1,5,2,3,3,single-choice,spatial-relational,2|3,7,2/3,230094,2
1,4,23,95,0,1282,1,5,2,3,3,single-choice,spatial-relational,2|3,7,2/3,230095,2
1,4,23,96,0,1309,1,9,4,5,5,single-choice,spatial-relational,4|5,7,4/5,230096,4
1,4,23,97,1,959,1,11,5,5,6,single-choice,spatial-relational,5|6,7,5/6,230097,5
1,4,23,98,0,1669,1,5,2,3,3,single-choice,spatial-relational,2|3,7,2/3,230098,2
1,4,23,99,0,1321,1,7,3,4,4,single-choice,spatial-relational,3|4,7,3/4,230099,3
1,4,23,100,1,2380,1,11,5,5,6,single-choice,spatial-relational,5|6,7,5/6,230100,5
1,4,23,101,0,1193,1,13,6,7,7,single-choice,spatial-relational,6|7,7,6/7,230101,6
1,4,23,102,1,1035,1,5,2,2,3,single-choice,spatial-relational,2|3,7,2/3,230102,2
1,4,23,103,0,1350,1,9,4,5,5,single-choice,spatial-relational,4|5,7,4/5,230103,4
1,4,23,104,1,1197,1,9,4,4,5,single-choice,spatial-relational,4|5,7,4/5,230104,4
1,4,23,105,1,1517,1,3,1,1,2,single-choice,spatial-relational,1|2,7,1/2,230105,1
1,4,23,106,1,2192,1,13,6,6,7,single-choice,spatial-relational,6|7,7,6/7,230106,6
1,4,23,107,1,2005,1,3,1,1,2,single-choice,spatial-relational,1|2,7,1/2,230107,1
1,4,23,108,1,1538,1,7,3,3,4,single-choice,spatial-relational,3|4,7,3/4,230108,3
1,4,23,109,1,1812,1,3,1,1,2,single-choice,spatial-relational,1|2,7,1/2,230109,1
1,4,23,110,1,1981,1,11,5,5,6,single-choice,spatial-relational,5|6,7,5/6,230110,5
1,4,23,111,1,1507,1,13,6,6,7,single-choice,spatial-relational,6|7,7,6/7,230111,6
1,4,23,112,0,2679,1,5,2,3,3,single-choice,spatial-relational,2|3,7,2/3,230112,2
1,4,23,113,0,988,1,5,2,3,3,single-choice,spatial-relational,2|3,7,2/3,230113,2
1,4,23,114,0,3,1,9,4,5,5,single-choice,spatial-relational,4|5,7,4/5,230114,4
1,4,23,115,1,1127,1,13,6,6,7,single-choice,spatial-relational,6|7,7,6/7,230115,6
1,4,23,116,0,1824,1,11,5,6,6,single-choice,spatial-relational,5|6,7,5/6,230116,5
1,4,23,117,0,1298,1,7,3,4,4,single-choice,spatial-relational,3|4,7,3/4,230117,3
1,4,23,118,1,1575,1,3,1,1,2,single-choice,spatial-relational,1|2,7,1/2,230118,1
1,4,23,119,1,1543,1,7,3,3,4,single-choice,spatial-relational,3|4,7,3/4,230119,3
1,4,23,120,1,2421,1,9,4,4,5,single-choice,spatial-relational,4|5,7,4/5,230120,4
1,4,23,121,1,1881,1,9,4,4,5,single-choice,spatial-relational,4|5,7,4/5,230121,4
1,4,23,122,1,979,1,7,3,3,4,single-choice,spatial-relational,3|4,7,3/4,230122,3
1,4,23,123,0,2098,1,13,6,7,7,single-choice,spatial-relational,6|7,7,6/7,230123,6
1,4,23,124,1,1397,1,9,4,4,5,single-choice,spatial-relational,4|5,7,4/5,230124,4
1,4,23,125,1,1634,1,5,2,2,3,single-choice,spatial-relational,2|3,7,2/3,230125,2
1,4,23,126,1,920,1,3,1,1,2,single-choice,spatial-relational,1|2,7,1/2,230126,1
1,4,23,127,0,1881,1,5,2,3,3,single-choice,spatial-relational,2|3,7,2/3,230127,2
1,4,23,128,0,1041,1,13,6,7,7,single-choice,spatial-relational,6|7,7,6/7,230128,6
1,4,23,129,0,1326,1,11,5,6,6,single-choice,spatial-relational,5|6,7,5/6,230129,5
1,4,23,130,0,2,1,3,1,2,2,single-choice,spatial-relational,1|2,7,1/2,230130,1
1,4,23,131,1,1280,1,11,5,5,6,single-choice,spatial-relational,5|6,7,5/6,230131,5
1,4,23,132,1,1328,1,7,3,3,4,single-choice,spatial-relational,3|4,7,3/4,230132,3
1,4,23,133,1,2089,1,9,4,4,5,single-choice,spatial-relational,4|5,7,4/5,230133,4
1,4,23,134,1,1436,1,3,1,1,2,single-choice,spatial-relational,1|2,7,1/2,230134,1
1,4,23,135,0,1697,1,11,5,6,6,single-choice,spatial-relational,5|6,7,5/6,230135,5
1,4,23,136,1,1031,1,5,2,2,3,single-choice,spatial-relational,2|3,7,2/3,230136,2
1,4,23,137,1,1137,1,9,4,4,5,single-choice,spatial-relational,4|5,7,4/5,230137,4
1,4,23,138,1,2872,1,13,6,6,7,single-choice,spatial-relational,6|7,7,6/7,230138,6
1,4,23,139,1,1459,1,11,5,5,6,single-choice,spatial-relational,5|6,7,5/6,230139,5
1,4,23,140,0,1574,1,7,3,4,4,single-choice,spatial-relational,3|4,7,3/4,230140,3
1,4,23,141,1,1273,1,13,6,6,7,single-choice,spatial-relational,6|7,7,6/7,230141,6
1,4,23,142,1,1110,1,3,1,1,2,single-choice,spatial-relational,1|2,7,1/2,230142,1
1,4,23,143,0,1007,1,7,3,4,4,single-choice,spatial-relational,3|4,7,3/4,230143,3
1,4,23,144,0,1163,1,5,2,3,3,single-choice,spatial-relational,2|3,7,2/3,230144,2
1,4,23,145,1,751,1,13,6,6,7,single-choice,spatial-relational,6|7,7,6/7,230145,6
1,4,23,146,1,944,1,3,1,1,2,single-choice,spatial-relational,1|2,7,1/2,230146,1
1,4,23,147,1,1127,1,9,4,4,5,single-choice,spatial-relational,4|5,7,4/5,230147,4
1,4,23,148,1,963,1,3,1,1,2,single-choice,spatial-relational,1|2,7,1/2,230148,1
1,4,23,149,0,1306,1,7,3,4,4,single-choice,spatial-relational,3|4,7,3/4,230149,3
1,4,23,150,0,1098,1,11,5,6,6,single-choice,spatial-relational,5|6,7,5/6,230150,5
1,4,23,151,0,1347,1,5,2,3,3,single-choice,spatial-relational,2|3,7,2/3,230151,2
1,4,23,152,1,1264,1,9,4,4,5,single-choice,spatial-relational,4|5,7,4/5,230152,4
1,4,23,153,1,1008,1,7,3,3,4,single-choice,spatial-relational,3|4,7,3/4,230153,3
1,4,23,154,1,2823,1,13,6,6,7,single-choice,spatial-relational,6|7,7,6/7,230154,6
1,4,23,155,0,2179,1,5,2,3,3,single-choice,spatial-relational,2|3,7,2/3,230155,2
1,4,23,156,1,738,1,11,5,5,6,single-choice,spatial-relational,5|6,7,5/6,230156,5
1,4,23,157,1,1104,1,3,1,1,2,single-choice,spatial-relational,1|2,7,1/2,230157,1
1,4,23,158,1,2079,1,9,4,4,5,single-choice,spatial-relational,4|5,7,4/5,230158,4
1,4,23,159,0,1897,1,11,5,6,6,single-choice,spatial-relational,5|6,7,5/6,230159,5
1,4,23,160,1,1121,1,7,3,3,4,single-choice,spatial-relational,3|4,7,3/4,230160,3
1,4,23,161,1,2221,1,13,6,6,7,single-choice,spatial-relational,6|7,7,6/7,230161,6
1,4,23,162,1,1216,1,7,3,3,4,single-choice,spatial-relational,3|4,7,3/4,230162,3
1,4,23,163,0,2757,1,11,5,6,6,single-choice,spatial-relational,5|6,7,5/6,230163,5
1,4,23,164,1,1235,1,5,2,2,3,single-choice,spatial-relational,2|3,7,2/3,230164,2
1,4,23,165,0,893,1,5,2,3,3,single-choice,spatial-relational,2|3,7,2/3,230165,2
1,4,23,166,1,439,1,3,1,1,2,single-choice,spatial-relational,1|2,7,1/2,230166,1
1,4,23,167,1,1891,1,9,4,4,5,single-choice,spatial-relational,4|5,7,4/5,230167,4
1,4,23,168,0,1151,1,13,6,7,7,single-choice,spatial-relational,6|7,7,6/7,230168,6
1,4,23,169,0,940,1,5,2,3,3,single-choice,spatial-relational,2|3,7,2/3,230169,2
1,4,23,170,0,2150,1,13,6,7,7,single-choice,spatial-relational,6|7,7,6/7,230170,6
1,4,23,171,1,949,1,3,1,1,2,single-choice,spatial-relational,1|2,7,1/2,230171,1
1,4,23,172,1,1359,1,7,3,3,4,single-choice,spatial-relational,3|4,7,3/4,230172,3
1,4,23,173,0,971,1,11,5,6,6,single-choice,spatial-relational,5|6,7,5/6,230173,5
1,4,23,174,0,1977,1,13,6,7,7,single-choice,spatial-relational,6|7,7,6/7,230174,6
1,4,23,175,1,842,1,3,1,1,2,single-choice,spatial-relational,1|2,7,1/2,230175,1
1,4,23,176,1,1096,1,7,3,3,4,single-choice,spatial-relational,3|4,7,3/4,230176,3
1,4,23,177,0,1211,1,5,2,3,3,single-choice,spatial-relational,2|3,7,2/3,230177,2
1,4,23,178,1,839,1,9,4,4,5,single-choice,spatial-relational,4|5,7,4/5,230178,4
1,4,23,179,1,1142,1,11,5,5,6,single-choice,spatial-relational,5|6,7,5/6,230179,5
1,4,23,180,1,1309,1,9,4,4,5,single-choice,spatial-relational,4|5,7,4/5,230180,4
1,4,23,181,1,870,1,9,4,4,5,single-choice,spatial-relational,4|5,7,4/5,230181,4
1,4,23,182,0,2183,1,5,2,3,3,single-choice,spatial-relational,2|3,7,2/3,230182,2
1,4,23,183,1,811,1,3,1,1,2,single-choice,spatial-relational,1|2,7,1/2,230183,1
1,4,23,184,0,1064,1,7,3,4,4,single-choice,spatial-relational,3|4,7,3/4,230184,3
1,4,23,185,1,1271,1,5,2,2,3,single-choice,spatial-relational,2|3,7,2/3,230185,2
1,4,23,186,0,1665,1,11,5,6,6,single-choice,spatial-relational,5|6,7,5/6,230186,5
1,4,23,187,1,943,1,3,1,1,2,single-choice,spatial-relational,1|2,7,1/2,230187,1
1,4,23,188,1,1171,1,7,3,3,4,single-choice,spatial-relational,3|4,7,3/4,230188,3
1,4,23,189,0,2670,1,13,6,7,7,single-choice,spatial-relational,6|7,7,6/7,230189,6
1,4,23,190,0,1115,1,9,4,5,5,single-choice,spatial-relational,4|5,7,4/5,230190,4
1,4,23,191,0,1117,1,13,6,7,7,single-choice,spatial-relational,6|7,7,6/7,230191,6
1,4,23,192,1,1340,1,11,5,5,6,single-choice,spatial-relational,5|6,7,5/6,230192,5
1,4,23,193,1,2025,1,13,6,6,7,single-choice,spatial-relational,6|7,7,6/7,230193,6
1,4,23,194,0,1136,1,3,1,2,2,single-choice,spatial-relational,1|2,7,1/2,230194,1
1,4,23,195,0,1871,1,5,2,3,3,single-choice,spatial-relational,2|3,7,2/3,230195,2
1,4,23,196,0,2494,1,9,4,5,5,single-choice,spatial-relational,4|5,7,4/5,230196,4
1,4,23,197,0,1424,1,13,6,7,7,single-choice,spatial-relational,6|7,7,6/7,230197,6
1,4,23,198,1,1215,1,7,3,3,4,single-choice,spatial-relational,3|4,7,3/4,230198,3
1,4,23,199,0,1013,1,11,5,6,6,single-choice,spatial-relational,5|6,7,5/6,230199,5
1,4,23,200,1,1064,1,9,4,4,5,single-choice,spatial-relational,4|5,7,4/5,230200,4
1,4,23,201,1,1338,1,7,3,3,4,single-choice,spatial-relational,3|4,7,3/4,230201,3
1,4,23,202,1,1451,1,11,5,5,6,single-choice,spatial-relational,5|6,7,5/6,230202,5
1,4,23,203,1,820,1,3,1,1,2,single-choice,spatial-relational,1|2,7,1/2,230203,1
1,4,23,204,0,1583,1,5,2,3,3,single-choice,spatial-relational,2|3,7,2/3,230204,2
1,4,23,205,1,1103,1,9,4,4,5,single-choice,spatial-relational,4|5,7,4/5,230205,4
1,4,23,206,1,2186,1,3,1,1,2,single-choice,spatial-relational,1|2,7,1/2,230206,1
1,4,23,207,1,746,1,11,5,5,6,single-choice,spatial-relational,5|6,7,5/6,230207,5
1,4,23,208,0,1519,1,13,6,7,7,single-choice,spatial-relational,6|7,7,6/7,230208,6
1,4,23,209,1,1184,1,5,2,2,3,single-choice,spatial-relational,2|3,7,2/3,230209,2
1,4,23,210,1,1528,1,7,3,3,4,single-choice,spatial-relational,3|4,7,3/4,230210,3
1,4,23,211,1,882,1,7,3,3,4,single-choice,spatial-relational,3|4,7,3/4,230211,3
1,4,23,212,1,2047,1,5,2,2,3,single-choice,spatial-relational,2|3,7,2/3,230212,2
1,4,23,213,1,1107,1,13,6,6,7,single-choice,spatial-relational,6|7,7,6/7,230213,6
1,4,23,214,1,1063,1,11,5,5,6,single-choice,spatial-relational,5|6,7,5/6,230214,5
1,4,23,215,1,1131,1,3,1,1,2,single-choice,spatial-relational,1|2,7,1/2,230215,1
1,4,23,216,1,1781,1,9,4,4,5,single-choice,spatial-relational,4|5,7,4/5,230216,4
1,4,23,217,0,1286,1,5,2,3,3,single-choice,spatial-relational,2|3,7,2/3,230217,2
1,4,23,218,1,314,1,3,1,1,2,single-choice,spatial-relational,1|2,7,1/2,230218,1
1,4,23,219,1,1010,1,9,4,4,5,single-choice,spatial-relational,4|5,7,4/5,230219,4
1,4,23,220,1,1762,1,11,5,5,6,single-choice,spatial-relational,5|6,7,5/6,230220,5
1,4,23,221,1,1690,1,5,2,2,3,single-choice,spatial-relational,2|3,7,2/3,230221,2
1,4,23,222,0,1152,1,13,6,7,7,single-choice,spatial-relational,6|7,7,6/7,230222,6
1,4,23,223,1,1377,1,3,1,1,2,single-choice,spatial-relational,1|2,7,1/2,230223,1
1,4,23,224,1,1671,1,7,3,3,4,single-choice,spatial-relational,3|4,7,3/4,230224,3
1,4,23,225,0,1788,1,9,4,5,5,single-choice,spatial-relational,4|5,7,4/5,230225,4
1,4,23,226,0,1956,1,11,5,6,6,single-choice,spatial-relational,5|6,7,5/6,230226,5
1,4,23,227,1,2614,1,7,3,3,4,single-choice,spatial-relational,3|4,7,3/4,230227,3
1,4,23,228,0,1086,1,13,6,7,7,single-choice,spatial-relational,6|7,7,6/7,230228,6
1,4,23,229,0,1023,1,9,4,5,5,single-choice,spatial-relational,4|5,7,4/5,230229,4
1,4,23,230,0,3,1,3,1,2,2,single-choice,spatial-relational,1|2,7,1/2,230230,1
1,4,23,231,1,1140,1,3,1,1,2,single-choice,spatial-relational,1|2,7,1/2,230231,1
1,4,23,232,0,1155,1,11,5,6,6,single-choice,spatial-relational,5|6,7,5/6,230232,5
1,4,23,233,0,1540,1,5,2,3,3,single-choice,spatial-relational,2|3,7,2/3,230233,2
1,4,23,234,1,1989,1,7,3,3,4,single-choice,spatial-relational,3|4,7,3/4,230234,3
1,4,23,235,1,1040,1,5,2,2,3,single-choice,spatial-relational,2|3,7,2/3,230235,2
1,4,23,236,0,1703,1,13,6,7,7,single-choice,spatial-relational,6|7,7,6/7,230236,6
1,4,23,237,1,1102,1,7,3,3,4,single-choice,spatial-relational,3|4,7,3/4,230237,3
1,4,23,238,1,1522,1,11,5,5,6,single-choice,spatial-relational,5|6,7,5/6,230238,5
1,4,23,239,1,1431,1,13,6,6,7,single-choice,spatial-relational,6|7,7,6/7,230239,6
1,4,23,240,1,1111,1,9,4,4,5,single-choice,spatial-relational,4|5,7,4/5,230240,4
1,4,23,241,1,2462,1,9,4,4,5,single-choice,spatial-relational,4|5,7,4/5,230241,4
1,4,23,242,1,2240,1,11,5,5,6,single-choice,spatial-relational,5|6,7,5/6,230242,5
1,4,23,243,1,1416,1,13,6,6,7,single-choice,spatial-relational,6|7,7,6/7,230243,6
1,4,23,244,1,1109,1,3,1,1,2,single-choice,spatial-relational,1|2,7,1/2,230244,1
1,4,23,245,0,1209,1,5,2,3,3,single-choice,spatial-relational,2|3,7,2/3,230245,2
1,4,23,246,0,1156,1,11,5,6,6,single-choice,spatial-relational,5|6,7,5/6,230246,5
1,4,23,247,0,924,1,3,1,2,2,single-choice,spatial-relational,1|2,7,1/2,230247,1
1,4,23,248,0,1502,1,13,6,7,7,single-choice,spatial-relational,6|7,7,6/7,230248,6
1,4,23,249,1,1772,1,5,2,2,3,single-choice,spatial-relational,2|3,7,2/3,230249,2
1,4,23,250,1,1781,1,7,3,3,4,single-choice,spatial-relational,3|4,7,3/4,230250,3
1,4,23,251,0,656,1,7,3,4,4,single-choice,spatial-relational,3|4,7,3/4,230251,3
1,4,23,252,1,816,1,9,4,4,5,single-choice,spatial-relational,4|5,7,4/5,230252,4
1,4,23,253,1,2271,1,5,2,2,3,single-choice,spatial-relational,2|3,7,2/3,230253,2
1,4,23,254,1,957,1,3,1,1,2,single-choice,spatial-relational,1|2,7,1/2,230254,1
1,4,23,255,1,1670,1,13,6,6,7,single-choice,spatial-relational,6|7,7,6/7,230255,6
1,4,23,256,0,882,1,7,3,4,4,single-choice,spatial-relational,3|4,7,3/4,230256,3
1,4,23,257,1,1271,1,9,4,4,5,single-choice,spatial-relational,4|5,7,4/5,230257,4
1,4,23,258,1,1101,1,11,5,5,6,single-choice,spatial-relational,5|6,7,5/6,230258,5
1,4,23,259,1,1805,1,11,5,5,6,single-choice,spatial-relational,5|6,7,5/6,230259,5
1,4,23,260,1,1019,1,3,1,1,2,single-choice,spatial-relational,1|2,7,1/2,230260,1
1,4,23,261,1,1448,1,5,2,2,3,single-choice,spatial-relational,2|3,7,2/3,230261,2
1,4,23,262,1,1828,1,7,3,3,4,single-choice,spatial-relational,3|4,7,3/4,230262,3
1,4,23,263,1,1344,1,13,6,6,7,single-choice,spatial-relational,6|7,7,6/7,230263,6
1,4,23,264,1,175,1,9,4,4,5,single-choice,spatial-relational,4|5,7,4/5,230264,4
1,4,23,265,0,999,1,7,3,4,4,single-choice,spatial-relational,3|4,7,3/4,230265,3
1,4,23,266,0,1096,1,13,6,7,7,single-choice,spatial-relational,6|7,7,6/7,230266,6
1,4,23,267,1,1288,1,5,2,2,3,single-choice,spatial-relational,2|3,7,2/3,230267,2
1,4,23,268,1,1126,1,9,4,4,5,single-choice,spatial-relational,4|5,7,4/5,230268,4
1,4,23,269,1,1776,1,7,3,3,4,single-choice,spatial-relational,3|4,7,3/4,230269,3
1,4,23,270,1,824,1,11,5,5,6,single-choice,spatial-relational,5|6,7,5/6,230270,5
1,4,23,271,1,2002,1,13,6,6,7,single-choice,spatial-relational,6|7,7,6/7,230271,6
1,4,23,272,1,1683,1,5,2,2,3,single-choice,spatial-relational,2|3,7,2/3,230272,2
1,4,23,273,1,887,1,3,1,1,2,single-choice,spatial-relational,1|2,7,1/2,230273,1
1,4,23,274,1,1653,1,3,1,1,2,single-choice,spatial-relational,1|2,7,1/2,230274,1
1,4,23,275,1,763,1,9,4,4,5,single-choice,spatial-relational,4|5,7,4/5,230275,4
1,4,23,276,1,1024,1,11,5,5,6,single-choice,spatial-relational,5|6,7,5/6,230276,5
1,4,23,277,0,2825,1,11,5,6,6,single-choice,spatial-relational,5|6,7,5/6,230277,5
1,4,23,278,1,1278,1,9,4,4,5,single-choice,spatial-relational,4|5,7,4/5,230278,4
1,4,23,279,0,2707,1,13,6,7,7,single-choice,spatial-relational,6|7,7,6/7,230279,6
1,4,23,280,0,2132,1,7,3,4,4,single-choice,spatial-relational,3|4,7,3/4,230280,3
1,4,23,281,1,1783,1,3,1,1,2,single-choice,spatial-relational,1|2,7,1/2,230281,1
1,4,23,282,0,1092,1,5,2,3,3,single-choice,spatial-relational,2|3,7,2/3,230282,2
1,4,23,283,1,1363,1,13,6,6,7,single-choice,spatial-relational,6|7,7,6/7,230283,6
1,4,23,284,1,1255,1,11,5,5,6,single-choice,spatial-relational,5|6,7,5/6,230284,5
1,4,23,285,0,1117,1,7,3,4,4,single-choice,spatial-relational,3|4,7,3/4,230285,3
1,4,23,286,1,816,1,9,4,4,5,single-choice,spatial-relational,4|5,7,4/5,230286,4
1,4,23,287,0,2781,1,5,2,3,3,single-choice,spatial-relational,2|3,7,2/3,230287,2
1,4,23,288,1,870,1,3,1,1,2,single-choice,spatial-relational,1|2,7,1/2,230288,1
1,4,23,289,0,1537,1,13,6,7,7,single-choice,spatial-relational,6|7,7,6/7,230289,6
1,4,23,290,1,1286,1,11,5,5,6,single-choice,spatial-relational,5|6,7,5/6,230290,5
1,4,23,291,1,1248,1,9,4,4,5,single-choice,spatial-relational,4|5,7,4/5,230291,4
1,4,23,292,1,953,1,3,1,1,2,single-choice,spatial-relational,1|2,7,1/2,230292,1
1,4,23,293,0,1959,1,7,3,4,4,single-choice,spatial-relational,3|4,7,3/4,230293,3
1,4,23,294,1,1246,1,13,6,6,7,single-choice,spatial-relational,6|7,7,6/7,230294,6
1,4,23,295,1,1128,1,5,2,2,3,single-choice,spatial-relational,2|3,7,2/3,230295,2
1,4,23,296,1,865,1,3,1,1,2,single-choice,spatial-relational,1|2,7,1/2,230296,1
1,4,23,297,1,803,1,9,4,4,5,single-choice,spatial-relational,4|5,7,4/5,230297,4
1,4,23,298,0,873,1,7,3,4,4,single-choice,spatial-relational,3|4,7,3/4,230298,3
1,4,23,299,0,1312,1,5,2,3,3,single-choice,spatial-relational,2|3,7,2/3,230299,2
1,4,23,300,1,1339,1,11,5,5,6,single-choice,spatial-relational,5|6,7,5/6,230300,5
1,4,23,301,1,803,1,11,5,5,6,single-choice,spatial-relational,5|6,7,5/6,230301,5
1,4,23,302,1,1119,1,9,4,4,5,single-choice,spatial-relational,4|5,7,4/5,230302,4
1,4,23,303,0,910,1,5,2,3,3,single-choice,spatial-relational,2|3,7,2/3,230303,2
1,4,23,304,0,2368,1,13,6,7,7,single-choice,spatial-relational,6|7,7,6/7,230304,6
1,4,23,305,1,1353,1,7,3,3,4,single-choice,spatial-relational,3|4,7,3/4,230305,3
1,4,23,306,1,1410,1,3,1,1,2,single-choice,spatial-relational,1|2,7,1/2,230306,1
1,4,23,307,1,1006,1,3,1,1,2,single-choice,spatial-relational,1|2,7,1/2,230307,1
1,4,23,308,1,915,1,13,6,6,7,single-choice,spatial-relational,6|7,7,6/7,230308,6
1,4,23,309,0,893,1,9,4,5,5,single-choice,spatial-relational,4|5,7,4/5,230309,4
1,4,23,310,1,869,1,11,5,5,6,single-choice,spatial-relational,5|6,7,5/6,230310,5
1,4,23,311,1,1469,1,7,3,3,4,single-choice,spatial-relational,3|4,7,3/4,230311,3
1,4,23,312,1,890,1,5,2,2,3,single-choice,spatial-relational,2|3,7,2/3,230312,2
1,4,23,313,0,1337,1,7,3,4,4,single-choice,spatial-relational,3|4,7,3/4,230313,3
1,4,23,314,1,930,1,5,2,2,3,single-choice,spatial-relational,2|3,7,2/3,230314,2
1,4,23,315,1,774,1,3,1,1,2,single-choice,spatial-relational,1|2,7,1/2,230315,1
1,4,23,316,1,705,1,11,5,5,6,single-choice,spatial-relational,5|6,7,5/6,230316,5
1,4,23,317,1,688,1,3,1,1,2,single-choice,spatial-relational,1|2,7,1/2,230317,1
1,4,23,318,1,1238,1,13,6,6,7,single-choice,spatial-relational,6|7,7,6/7,230318,6
1,4,23,319,0,525,1,7,3,4,4,single-choice,spatial-relational,3|4,7,3/4,230319,3
1,4,23,320,1,996,1,11,5,5,6,single-choice,spatial-relational,5|6,7,5/6,230320,5
1,4,23,321,0,1322,1,9,4,5,5,single-choice,spatial-relational,4|5,7,4/5,230321,4
1,4,23,322,1,1388,1,5,2,2,3,single-choice,spatial-relational,2|3,7,2/3,230322,2
1,4,23,323,0,661,1,9,4,5,5,single-choice,spatial-relational,4|5,7,4/5,230323,4
1,4,23,324,0,2,1,13,6,7,7,single-choice,spatial-relational,6|7,7,6/7,230324,6
1,4,23,325,1,52,1,7,3,3,4,single-choice,spatial-relational,3|4,7,3/4,230325,3
1,4,23,326,1,876,1,3,1,1,2,single-choice,spatial-relational,1|2,7,1/2,230326,1
1,4,23,327,1,1820,1,11,5,5,6,single-choice,spatial-relational,5|6,7,5/6,230327,5
1,4,23,328,1,1535,1,9,4,4,5,single-choice,spatial-relational,4|5,7,4/5,230328,4
1,4,23,329,0,1110,1,3,1,2,2,single-choice,spatial-relational,1|2,7,1/2,230329,1
1,4,23,330,0,984,1,11,5,6,6,single-choice,spatial-relational,5|6,7,5/6,230330,5
1,4,23,331,1,1058,1,9,4,4,5,single-choice,spatial-relational,4|5,7,4/5,230331,4
1,4,23,332,1,1039,1,7,3,3,4,single-choice,spatial-relational,3|4,7,3/4,230332,3
1,4,23,333,1,1591,1,13,6,6,7,single-choice,spatial-relational,6|7,7,6/7,230333,6
1,4,23,334,0,994,1,5,2,3,3,single-choice,spatial-relational,2|3,7,2/3,230334,2
1,4,23,335,1,2219,1,5,2,2,3,single-choice,spatial-relational,2|3,7,2/3,230335,2
1,4,23,336,1,1086,1,13,6,6,7,single-choice,spatial-relational,6|7,7,6/7,230336,6
1,4,23,337,1,1053,1,13,6,6,7,single-choice,spatial-relational,6|7,7,6/7,230337,6
1,4,23,338,1,1567,1,13,6,6,7,single-choice,spatial-relational,6|7,7,6/7,230338,6
1,4,23,339,1,856,1,5,2,2,3,single-choice,spatial-relational,2|3,7,2/3,230339,2
1,4,23,340,0,824,1,9,4,5,5,single-choice,spatial-relational,4|5,7,4/5,230340,4
1,4,23,341,1,1131,1,7,3,3,4,single-choice,spatial-relational,3|4,7,3/4,230341,3
1,4,23,342,1,716,1,3,1,1,2,single-choice,spatial-relational,1|2,7,1/2,230342,1
1,4,23,343,0,1508,1,11,5,6,6,single-choice,spatial-relational,5|6,7,5/6,230343,5
1,4,23,344,1,1229,1,5,2,2,3,single-choice,spatial-relational,2|3,7,2/3,230344,2
1,4,23,345,0,815,1,3,1,2,2,single-choice,spatial-relational,1|2,7,1/2,230345,1
1,4,23,346,0,1385,1,7,3,4,4,single-choice,spatial-relational,3|4,7,3/4,230346,3
1,4,23,347,1,2091,1,9,4,4,5,single-choice,spatial-relational,4|5,7,4/5,230347,4
1,4,23,348,1,1280,1,11,5,5,6,single-choice,spatial-relational,5|6,7,5/6,230348,5
1,4,23,349,1,752,1,5,2,2,3,single-choice,spatial-relational,2|3,7,2/3,230349,2
1,4,23,350,0,1186,1,11,5,6,6,single-choice,spatial-relational,5|6,7,5/6,230350,5
1,4,23,351,0,1020,1,13,6,7,7,single-choice,spatial-relational,6|7,7,6/7,230351,6
1,4,23,352,1,2,1,9,4,4,5,single-choice,spatial-relational,4|5,7,4/5,230352,4
1,4,23,353,1,1097,1,3,1,1,2,single-choice,spatial-relational,1|2,7,1/2,230353,1
1,4,23,354,1,1034,1,3,1,1,2,single-choice,spatial-relational,1|2,7,1/2,230354,1
1,4,23,355,0,1257,1,7,3,4,4,single-choice,spatial-relational,3|4,7,3/4,230355,3
1,4,23,356,1,1134,1,11,5,5,6,single-choice,spatial-relational,5|6,7,5/6,230356,5
1,4,23,357,1,1304,1,13,6,6,7,single-choice,spatial-relational,6|7,7,6/7,230357,6
1,4,23,358,1,1705,1,7,3,3,4,single-choice,spatial-relational,3|4,7,3/4,230358,3
1,4,23,359,1,1458,1,9,4,4,5,single-choice,spatial-relational,4|5,7,4/5,230359,4
1,4,23,360,0,951,1,5,2,3,3,single-choice,spatial-relational,2|3,7,2/3,230360,2
1,4,23,361,0,2077,1,9,4,5,5,single-choice,spatial-relational,4|5,7,4/5,230361,4
1,4,23,362,1,1427,1,5,2,2,3,single-choice,spatial-relational,2|3,7,2/3,230362,2
1,4,23,363,1,811,1,7,3,3,4,single-choice,spatial-relational,3|4,7,3/4,230363,3
1,4,23,364,1,918,1,9,4,4,5,single-choice,spatial-relational,4|5,7,4/5,230364,4
1,4,23,365,1,1018,1,13,6,6,7,single-choice,spatial-relational,6|7,7,6/7,230365,6
1,4,23,366,1,1284,1,5,2,2,3,single-choice,spatial-relational,2|3,7,2/3,230366,2
1,4,23,367,1,875,1,3,1,1,2,single-choice,spatial-relational,1|2,7,1/2,230367,1
1,4,23,368,1,1740,1,11,5,5,6,single-choice,spatial-relational,5|6,7,5/6,230368,5
1,4,23,369,0,1499,1,7,3,4,4,single-choice,spatial-relational,3|4,7,3/4,230369,3
1,4,23,370,1,783,1,3,1,1,2,single-choice,spatial-relational,1|2,7,1/2,230370,1
1,4,23,371,1,899,1,13,6,6,7,single-choice,spatial-relational,6|7,7,6/7,230371,6
1,4,23,372,1,993,1,11,5,5,6,single-choice,spatial-relational,5|6,7,5/6,230372,5
1,4,23,373,1,885,1,13,6,6,7,single-choice,spatial-relational,6|7,7,6/7,230373,6
1,4,23,374,0,775,1,5,2,3,3,single-choice,spatial-relational,2|3,7,2/3,230374,2
1,4,23,375,0,997,1,13,6,7,7,single-choice,spatial-relational,6|7,7,6/7,230375,6
1,4,23,376,0,20,1,11,5,6,6,single-choice,spatial-relational,5|6,7,5/6,230376,5
1,4,23,377,0,1088,1,9,4,5,5,single-choice,spatial-relational,4|5,7,4/5,230377,4
1,4,23,378,1,1657,1,7,3,3,4,single-choice,spatial-relational,3|4,7,3/4,230378,3
1,4,23,379,1,655,1,11,5,5,6,single-choice,spatial-relational,5|6,7,5/6,230379,5
1,4,23,380,1,732,1,3,1,1,2,single-choice,spatial-relational,1|2,7,1/2,230380,1
1,4,23,381,1,1319,1,7,3,3,4,single-choice,spatial-relational,3|4,7,3/4,230381,3
1,4,23,382,1,797,1,5,2,2,3,single-choice,spatial-relational,2|3,7,2/3,230382,2
1,4,23,383,0,1329,1,9,4,5,5,single-choice,spatial-relational,4|5,7,4/5,230383,4
1,4,23,384,1,1122,1,3,1,1,2,single-choice,spatial-relational,1|2,7,1/2,230384,1
1,4,23,385,1,802,1,13,6,6,7,single-choice,spatial-relational,6|7,7,6/7,230385,6
1,4,23,386,1,865,1,9,4,4,5,single-choice,spatial-relational,4|5,7,4/5,230386,4
1,4,23,387,1,867,1,3,1,1,2,single-choice,spatial-relational,1|2,7,1/2,230387,1
1,4,23,388,1,856,1,7,3,3,4,single-choice,spatial-relational,3|4,7,3/4,230388,3
1,4,23,389,0,866,1,11,5,6,6,single-choice,spatial-relational,5|6,7,5/6,230389,5
1,4,23,390,0,1105,1,5,2,3,3,single-choice,spatial-relational,2|3,7,2/3,230390,2
1,4,23,391,1,1596,1,13,6,6,7,single-choice,spatial-relational,6|7,7,6/7,230391,6
1,4,23,392,0,1486,1,11,5,6,6,single-choice,spatial-relational,5|6,7,5/6,230392,5
1,4,23,393,0,1296,1,9,4,5,5,single-choice,spatial-relational,4|5,7,4/5,230393,4
1,4,23,394,1,652,1,3,1,1,2,single-choice,spatial-relational,1|2,7,1/2,230394,1
1,4,23,395,1,1631,1,7,3,3,4,single-choice,spatial-relational,3|4,7,3/4,230395,3
1,4,23,396,1,852,1,5,2,2,3,single-choice,spatial-relational,2|3,7,2/3,230396,2
1,4,23,397,1,1081,1,11,5,5,6,single-choice,spatial-relational,5|6,7,5/6,230397,5
1,4,23,398,1,601,1,3,1,1,2,single-choice,spatial-relational,1|2,7,1/2,230398,1
1,4,23,399,0,781,1,9,4,5,5,single-choice,spatial-relational,4|5,7,4/5,230399,4
1,4,23,400,1,2044,1,9,4,4,5,single-choice,spatial-relational,4|5,7,4/5,230400,4
1,4,23,401,1,987,1,7,3,3,4,single-choice,spatial-relational,3|4,7,3/4,230401,3
1,4,23,402,1,895,1,13,6,6,7,single-choice,spatial-relational,6|7,7,6/7,230402,6
1,4,23,403,1,1305,1,3,1,1,2,single-choice,spatial-relational,1|2,7,1/2,230403,1
1,4,23,404,1,852,1,5,2,2,3,single-choice,spatial-relational,2|3,7,2/3,230404,2
1,4,23,405,0,851,1,5,2,3,3,single-choice,spatial-relational,2|3,7,2/3,230405,2
1,4,23,406,1,1762,1,7,3,3,4,single-choice,spatial-relational,3|4,7,3/4,230406,3
1,4,23,407,1,1050,1,11,5,5,6,single-choice,spatial-relational,5|6,7,5/6,230407,5
1,4,23,408,1,1147,1,13,6,6,7,single-choice,spatial-relational,6|7,7,6/7,230408,6
1,4,23,409,0,2018,1,11,5,6,6,single-choice,spatial-relational,5|6,7,5/6,230409,5
1,4,23,410,1,1385,1,13,6,6,7,single-choice,spatial-relational,6|7,7,6/7,230410,6
1,4,23,411,1,1129,1,3,1,1,2,single-choice,spatial-relational,1|2,7,1/2,230411,1
1,4,23,412,1,1611,1,7,3,3,4,single-choice,spatial-relational,3|4,7,3/4,230412,3
1,4,23,413,1,1105,1,11,5,5,6,single-choice,spatial-relational,5|6,7,5/6,230413,5
1,4,23,414,1,851,1,7,3,3,4,single-choice,spatial-relational,3|4,7,3/4,230414,3
1,4,23,415,1,1564,1,5,2,2,3,single-choice,spatial-relational,2|3,7,2/3,230415,2
1,4,23,416,0,1532,1,5,2,3,3,single-choice,spatial-relational,2|3,7,2/3,230416,2
1,4,23,417,1,720,1,3,1,1,2,single-choice,spatial-relational,1|2,7,1/2,230417,1
1,4,23,418,0,1093,1,9,4,5,5,single-choice,spatial-relational,4|5,7,4/5,230418,4
1,4,23,419,1,939,1,13,6,6,7,single-choice,spatial-relational,6|7,7,6/7,230419,6
1,4,23,420,1,1850,1,9,4,4,5,single-choice,spatial-relational,4|5,7,4/5,230420,4
1,4,23,421,1,656,1,9,4,4,5,single-choice,spatial-relational,4|5,7,4/5,230421,4
1,4,23,422,1,614,1,3,1,1,2,single-choice,spatial-relational,1|2,7,1/2,230422,1
1,4,23,423,1,1276,1,9,4,4,5,single-choice,spatial-relational,4|5,7,4/5,230423,4
1,4,23,424,0,568,1,7,3,4,4,single-choice,spatial-relational,3|4,7,3/4,230424,3
1,4,23,425,1,1611,1,7,3,3,4,single-choice,spatial-relational,3|4,7,3/4,230425,3
1,4,23,426,1,1490,1,5,2,2,3,single-choice,spatial-relational,2|3,7,2/3,230426,2
1,4,23,427,0,983,1,11,5,6,6,single-choice,spatial-relational,5|6,7,5/6,230427,5
1,4,23,428,0,1295,1,11,5,6,6,single-choice,spatial-relational,5|6,7,5/6,230428,5
1,4,23,429,0,1248,1,5,2,3,3,single-choice,spatial-relational,2|3,7,2/3,230429,2
1,4,23,430,1,1001,1,13,6,6,7,single-choice,spatial-relational,6|7,7,6/7,230430,6
1,4,23,431,1,1104,1,3,1,1,2,single-choice,spatial-relational,1|2,7,1/2,230431,1
1,4,23,432,1,1655,1,13,6,6,7,single-choice,spatial-relational,6|7,7,6/7,230432,6
1,4,23,433,1,1202,1,3,1,1,2,single-choice,spatial-relational,1|2,7,1/2,230433,1
1,4,23,434,1,1650,1,9,4,4,5,single-choice,spatial-relational,4|5,7,4/5,230434,4
1,4,23,435,1,883,1,7,3,3,4,single-choice,spatial-relational,3|4,7,3/4,230435,3
1,4,23,436,0,1505,1,11,5,6,6,single-choice,spatial-relational,5|6,7,5/6,230436,5
1,4,23,437,1,1706,1,13,6,6,7,single-choice,spatial-relational,6|7,7,6/7,230437,6
1,4,23,438,1,960,1,11,5,5,6,single-choice,spatial-relational,5|6,7,5/6,230438,5
1,4,23,439,1,664,1,9,4,4,5,single-choice,spatial-relational,4|5,7,4/5,230439,4
1,4,23,440,1,895,1,5,2,2,3,single-choice,spatial-relational,2|3,7,2/3,230440,2
1,4,23,441,1,912,1,7,3,3,4,single-choice,spatial-relational,3|4,7,3/4,230441,3
1,4,23,442,0,1107,1,5,2,3,3,single-choice,spatial-relational,2|3,7,2/3,230442,2
1,4,23,443,1,579,1,3,1,1,2,single-choice,spatial-relational,1|2,7,1/2,230443,1
1,4,23,444,1,707,1,13,6,6,7,single-choice,spatial-relational,6|7,7,6/7,230444,6
1,4,23,445,1,674,1,11,5,5,6,single-choice,spatial-relational,5|6,7,5/6,230445,5
1,4,23,446,1,958,1,5,2,2,3,single-choice,spatial-relational,2|3,7,2/3,230446,2
1,4,23,447,0,1047,1,7,3,4,4,single-choice,spatial-relational,3|4,7,3/4,230447,3
1,4,23,448,1,744,1,3,1,1,2,single-choice,spatial-relational,1|2,7,1/2,230448,1
1,4,23,449,1,926,1,13,6,6,7,single-choice,spatial-relational,6|7,7,6/7,230449,6
1,4,23,450,0,1491,1,9,4,5,5,single-choice,spatial-relational,4|5,7,4/5,230450,4
1,4,23,451,1,1011,1,9,4,4,5,single-choice,spatial-relational,4|5,7,4/5,230451,4
1,4,23,452,1,738,1,13,6,6,7,single-choice,spatial-relational,6|7,7,6/7,230452,6
1,4,23,453,1,1011,1,7,3,3,4,single-choice,spatial-relational,3|4,7,3/4,230453,3
1,4,23,454,1,1050,1,3,1,1,2,single-choice,spatial-relational,1|2,7,1/2,230454,1
1,4,23,455,0,1447,1,5,2,3,3,single-choice,spatial-relational,2|3,7,2/3,230455,2
1,4,23,456,0,1583,1,11,5,6,6,single-choice,spatial-relational,5|6,7,5/6,230456,5
1,4,23,457,0,980,1,5,2,3,3,single-choice,spatial-relational,2|3,7,2/3,230457,2
1,4,23,458,1,1265,1,13,6,6,7,single-choice,spatial-relational,6|7,7,6/7,230458,6
1,4,23,459,1,1014,1,11,5,5,6,single-choice,spatial-relational,5|6,7,5/6,230459,5
1,4,23,460,0,757,1,7,3,4,4,single-choice,spatial-relational,3|4,7,3/4,230460,3
1,4,23,461,1,759,1,13,6,6,7,single-choice,spatial-relational,6|7,7,6/7,230461,6
1,4,23,462,1,1480,1,5,2,2,3,single-choice,spatial-relational,2|3,7,2/3,230462,2
1,4,23,463,0,848,1,9,4,5,5,single-choice,spatial-relational,4|5,7,4/5,230463,4
1,4,23,464,1,604,1,3,1,1,2,single-choice,spatial-relational,1|2,7,1/2,230464,1
1,4,23,465,0,829,1,7,3,4,4,single-choice,spatial-relational,3|4,7,3/4,230465,3
1,4,23,466,1,918,1,3,1,1,2,single-choice,spatial-relational,1|2,7,1/2,230466,1
1,4,23,467,1,1127,1,9,4,4,5,single-choice,spatial-relational,4|5,7,4/5,230467,4
1,4,23,468,0,1274,1,11,5,6,6,single-choice,spatial-relational,5|6,7,5/6,230468,5
1,4,23,469,1,1110,1,9,4,4,5,single-choice,spatial-relational,4|5,7,4/5,230469,4
1,4,23,470,1,911,1,13,6,6,7,single-choice,spatial-relational,6|7,7,6/7,230470,6
1,4,23,471,0,1959,1,11,5,6,6,single-choice,spatial-relational,5|6,7,5/6,230471,5
1,4,23,472,0,899,1,7,3,4,4,single-choice,spatial-relational,3|4,7,3/4,230472,3
1,4,23,473,1,1001,1,3,1,1,2,single-choice,spatial-relational,1|2,7,1/2,230473,1
1,4,23,474,1,894,1,5,2,2,3,single-choice,spatial-relational,2|3,7,2/3,230474,2
1,4,23,475,1,682,1,3,1,1,2,single-choice,spatial-relational,1|2,7,1/2,230475,1
1,4,23,476,1,1555,1,9,4,4,5,single-choice,spatial-relational,4|5,7,4/5,230476,4
1,4,23,477,1,771,1,5,2,2,3,single-choice,spatial-relational,2|3,7,2/3,230477,2
1,4,23,478,1,1017,1,7,3,3,4,single-choice,spatial-relational,3|4,7,3/4,230478,3
1,4,23,479,0,1090,1,11,5,6,6,single-choice,spatial-relational,5|6,7,5/6,230479,5
1,4,23,480,1,734,1,13,6,6,7,single-choice,spatial-relational,6|7,7,6/7,230480,6
1,4,23,481,1,934,1,3,1,1,2,single-choice,spatial-relational,1|2,7,1/2,230481,1
1,4,23,482,1,862,1,13,6,6,7,single-choice,spatial-relational,6|7,7,6/7,230482,6
1,4,23,483,1,703,1,3,1,1,2,single-choice,spatial-relational,1|2,7,1/2,230483,1
1,4,23,484,1,1893,1,7,3,3,4,single-choice,spatial-relational,3|4,7,3/4,230484,3
1,4,23,485,0,915,1,11,5,6,6,single-choice,spatial-relational,5|6,7,5/6,230485,5
1,4,23,486,1,959,1,9,4,4,5,single-choice,spatial-relational,4|5,7,4/5,230486,4
1,4,23,487,0,1271,1,11,5,6,6,single-choice,spatial-relational,5|6,7,5/6,230487,5
1,4,23,488,0,1021,1,5,2,3,3,single-choice,spatial-relational,2|3,7,2/3,230488,2
1,4,23,489,1,1060,1,7,3,3,4,single-choice,spatial-relational,3|4,7,3/4,230489,3
1,4,23,490,1,1529,1,5,2,2,3,single-choice,spatial-relational,2|3,7,2/3,230490,2
1,4,23,491,1,1119,1,9,4,4,5,single-choice,spatial-relational,4|5,7,4/5,230491,4
1,4,23,492,1,1387,1,13,6,6,7,single-choice,spatial-relational,6|7,7,6/7,230492,6
1,4,23,493,0,1512,1,9,4,5,5,single-choice,spatial-relational,4|5,7,4/5,230493,4
1,4,23,494,1,762,1,3,1,1,2,single-choice,spatial-relational,1|2,7,1/2,230494,1
1,4,23,495,1,739,1,13,6,6,7,single-choice,spatial-relational,6|7,7,6/7,230495,6
1,4,23,496,1,975,1,7,3,3,4,single-choice,spatial-relational,3|4,7,3/4,230496,3
1,4,23,497,1,989,1,13,6,6,7,single-choice,spatial-relational,6|7,7,6/7,230497,6
1,4,23,498,0,1041,1,9,4,5,5,single-choice,spatial-relational,4|5,7,4/5,230498,4
1,4,23,499,0,1249,1,11,5,6,6,single-choice,spatial-relational,5|6,7,5/6,230499,5
1,4,23,500,0,1443,1,7,3,4,4,single-choice,spatial-relational,3|4,7,3/4,230500,3
1,4,23,501,1,1023,1,5,2,2,3,single-choice,spatial-relational,2|3,7,2/3,230501,2
1,4,23,502,1,1109,1,5,2,2,3,single-choice,spatial-relational,2|3,7,2/3,230502,2
1,4,23,503,1,2236,1,11,5,5,6,single-choice,spatial-relational,5|6,7,5/6,230503,5
1,4,23,504,1,955,1,3,1,1,2,single-choice,spatial-relational,1|2,7,1/2,230504,1
1,4,23,505,1,2164,1,7,3,3,4,single-choice,spatial-relational,3|4,7,3/4,230505,3
1,4,23,506,0,1145,1,9,4,5,5,single-choice,spatial-relational,4|5,7,4/5,230506,4
1,4,23,507,1,546,1,3,1,1,2,single-choice,spatial-relational,1|2,7,1/2,230507,1
1,4,23,508,0,1182,1,9,4,5,5,single-choice,spatial-relational,4|5,7,4/5,230508,4
1,4,23,509,0,1200,1,5,2,3,3,single-choice,spatial-relational,2|3,7,2/3,230509,2
1,4,23,510,1,931,1,5,2,2,3,single-choice,spatial-relational,2|3,7,2/3,230510,2
1,4,23,511,1,726,1,13,6,6,7,single-choice,spatial-relational,6|7,7,6/7,230511,6
1,4,23,512,1,837,1,13,6,6,7,single-choice,spatial-relational,6|7,7,6/7,230512,6
1,4,23,513,1,1099,1,11,5,5,6,single-choice,spatial-relational,5|6,7,5/6,230513,5
1,4,23,514,0,1954,1,11,5,6,6,single-choice,spatial-relational,5|6,7,5/6,230514,5
1,4,23,515,1,765,1,3,1,1,2,single-choice,spatial-relational,1|2,7,1/2,230515,1
1,4,23,516,1,1408,1,7,3,3,4,single-choice,spatial-relational,3|4,7,3/4,230516,3
1,4,23,517,0,960,1,9,4,5,5,single-choice,spatial-relational,4|5,7,4/5,230517,4
1,4,23,518,1,1189,1,5,2,2,3,single-choice,spatial-relational,2|3,7,2/3,230518,2
1,4,23,519,1,1528,1,13,6,6,7,single-choice,spatial-relational,6|7,7,6/7,230519,6
1,4,23,520,1,871,1,3,1,1,2,single-choice,spatial-relational,1|2,7,1/2,230520,1
1,4,23,521,1,900,1,13,6,6,7,single-choice,spatial-relational,6|7,7,6/7,230521,6
1,4,23,522,1,926,1,5,2,2,3,single-choice,spatial-relational,2|3,7,2/3,230522,2
1,4,23,523,1,1092,1,9,4,4,5,single-choice,spatial-relational,4|5,7,4/5,230523,4
1,4,23,524,0,1164,1,7,3,4,4,single-choice,spatial-relational,3|4,7,3/4,230524,3
1,4,23,525,0,5306,1,11,5,6,6,single-choice,spatial-relational,5|6,7,5/6,230525,5
1,4,23,526,1,9,1,7,3,3,4,single-choice,spatial-relational,3|4,7,3/4,230526,3
1,4,23,527,1,658,1,3,1,1,2,single-choice,spatial-relational,1|2,7,1/2,230527,1
1,4,23,528,1,1115,1,11,5,5,6,single-choice,spatial-relational,5|6,7,5/6,230528,5
1,4,23,529,1,1743,1,7,3,3,4,single-choice,spatial-relational,3|4,7,3/4,230529,3
1,4,23,530,0,1382,1,11,5,6,6,single-choice,spatial-relational,5|6,7,5/6,230530,5
1,4,23,531,1,408,1,5,2,2,3,single-choice,spatial-relational,2|3,7,2/3,230531,2
1,4,23,532,0,1200,1,13,6,7,7,single-choice,spatial-relational,6|7,7,6/7,230532,6
1,4,23,533,0,716,1,11,5,6,6,single-choice,spatial-relational,5|6,7,5/6,230533,5
1,4,23,534,1,1714,1,7,3,3,4,single-choice,spatial-relational,3|4,7,3/4,230534,3
1,4,23,535,1,2544,1,9,4,4,5,single-choice,spatial-relational,4|5,7,4/5,230535,4
1,4,23,536,1,964,1,3,1,1,2,single-choice,spatial-relational,1|2,7,1/2,230536,1
1,4,23,537,0,1235,1,13,6,7,7,single-choice,spatial-relational,6|7,7,6/7,230537,6
1,4,23,538,1,1208,1,9,4,4,5,single-choice,spatial-relational,4|5,7,4/5,230538,4
1,4,23,539,1,675,1,3,1,1,2,single-choice,spatial-relational,1|2,7,1/2,230539,1
1,4,23,540,0,951,1,5,2,3,3,single-choice,spatial-relational,2|3,7,2/3,230540,2
1,4,23,541,0,874,1,13,6,7,7,single-choice,spatial-relational,6|7,7,6/7,230541,6
1,4,23,542,1,969,1,5,2,2,3,single-choice,spatial-relational,2|3,7,2/3,230542,2
1,4,23,543,1,1034,1,7,3,3,4,single-choice,spatial-relational,3|4,7,3/4,230543,3
1,4,23,544,1,2350,1,5,2,2,3,single-choice,spatial-relational,2|3,7,2/3,230544,2
1,4,23,545,1,1097,1,7,3,3,4,single-choice,spatial-relational,3|4,7,3/4,230545,3
1,4,23,546,1,1307,1,9,4,4,5,single-choice,spatial-relational,4|5,7,4/5,230546,4
1,4,23,547,1,987,1,3,1,1,2,single-choice,spatial-relational,1|2,7,1/2,230547,1
1,4,23,548,1,826,1,11,5,5,6,single-choice,spatial-relational,5|6,7,5/6,230548,5
1,4,23,549,1,1103,1,3,1,1,2,single-choice,spatial-relational,1|2,7,1/2,230549,1
1,4,23,550,0,808,1,11,5,6,6,single-choice,spatial-relational,5|6,7,5/6,230550,5
1,4,23,551,1,1221,1,9,4,4,5,single-choice,spatial-relational,4|5,7,4/5,230551,4
1,4,23,552,0,1343,1,13,6,7,7,single-choice,spatial-relational,6|7,7,6/7,230552,6
1,4,23,553,0,839,1,5,2,3,3,single-choice,spatial-relational,2|3,7,2/3,230553,2
1,4,23,554,1,1331,1,7,3,3,4,single-choice,spatial-relational,3|4,7,3/4,230554,3
1,4,23,555,1,611,1,3,1,1,2,single-choice,spatial-relational,1|2,7,1/2,230555,1
1,4,23,556,0,3023,1,11,5,6,6,single-choice,spatial-relational,5|6,7,5/6,230556,5
1,4,23,557,0,1026,1,7,3,4,4,single-choice,spatial-relational,3|4,7,3/4,230557,3
1,4,23,558,1,1131,1,13,6,6,7,single-choice,spatial-relational,6|7,7,6/7,230558,6
1,4,23,559,0,1512,1,9,4,5,5,single-choice,spatial-relational,4|5,7,4/5,230559,4
1,4,23,560,1,785,1,3,1,1,2,single-choice,spatial-relational,1|2,7,1/2,230560,1
1,4,23,561,1,827,1,13,6,6,7,single-choice,spatial-relational,6|7,7,6/7,230561,6
1,4,23,562,1,967,1,11,5,5,6,single-choice,spatial-relational,5|6,7,5/6,230562,5
1,4,23,563,0,660,1,9,4,5,5,single-choice,spatial-relational,4|5,7,4/5,230563,4
1,4,23,564,1,1245,1,5,2,2,3,single-choice,spatial-relational,2|3,7,2/3,230564,2
1,4,23,565,1,818,1,3,1,1,2,single-choice,spatial-relational,1|2,7,1/2,230565,1
1,4,23,566,1,784,1,13,6,6,7,single-choice,spatial-relational,6|7,7,6/7,230566,6
1,4,23,567,0,966,1,5,2,3,3,single-choice,spatial-relational,2|3,7,2/3,230567,2
1,4,23,568,0,940,1,7,3,4,4,single-choice,spatial-relational,3|4,7,3/4,230568,3
1,4,23,569,1,1087,1,13,6,6,7,single-choice,spatial-relational,6|7,7,6/7,230569,6
1,4,23,570,1,629,1,11,5,5,6,single-choice,spatial-relational,5|6,7,5/6,230570,5
1,4,23,571,1,964,1,9,4,4,5,single-choice,spatial-relational,4|5,7,4/5,230571,4
1,4,23,572,1,670,1,3,1,1,2,single-choice,spatial-relational,1|2,7,1/2,230572,1
1,4,23,573,0,876,1,11,5,6,6,single-choice,spatial-relational,5|6,7,5/6,230573,5
1,4,23,574,1,1771,1,9,4,4,5,single-choice,spatial-relational,4|5,7,4/5,230574,4
1,4,23,575,1,705,1,5,2,2,3,single-choice,spatial-relational,2|3,7,2/3,230575,2
1,4,23,576,1,1155,1,7,3,3,4,single-choice,spatial-relational,3|4,7,3/4,230576,3
1,4,23,577,1,656,1,13,6,6,7,single-choice,spatial-relational,6|7,7,6/7,230577,6
1,4,23,578,1,1509,1,11,5,5,6,single-choice,spatial-relational,5|6,7,5/6,230578,5
1,4,23,579,0,748,1,5,2,3,3,single-choice,spatial-relational,2|3,7,2/3,230579,2
1,4,23,580,1,709,1,3,1,1,2,single-choice,spatial-relational,1|2,7,1/2,230580,1
1,4,23,581,1,1061,1,7,3,3,4,single-choice,spatial-relational,3|4,7,3/4,230581,3
1,4,23,582,1,1299,1,7,3,3,4,single-choice,spatial-relational,3|4,7,3/4,230582,3
1,4,23,583,0,1233,1,11,5,6,6,single-choice,spatial-relational,5|6,7,5/6,230583,5
1,4,23,584,0,2,1,9,4,5,5,single-choice,spatial-relational,4|5,7,4/5,230584,4
1,4,23,585,1,1499,1,9,4,4,5,single-choice,spatial-relational,4|5,7,4/5,230585,4
1,4,23,586,1,773,1,13,6,6,7,single-choice,spatial-relational,6|7,7,6/7,230586,6
1,4,23,587,1,599,1,3,1,1,2,single-choice,spatial-relational,1|2,7,1/2,230587,1
1,4,23,588,1,854,1,5,2,2,3,single-choice,spatial-relational,2|3,7,2/3,230588,2
1,4,23,589,1,1086,1,3,1,1,2,single-choice,spatial-relational,1|2,7,1/2,230589,1
1,4,23,590,0,1593,1,9,4,5,5,single-choice,spatial-relational,4|5,7,4/5,230590,4
1,4,23,591,0,933,1,7,3,4,4,single-choice,spatial-relational,3|4,7,3/4,230591,3
1,4,23,592,0,1757,1,9,4,5,5,single-choice,spatial-relational,4|5,7,4/5,230592,4
1,4,23,593,0,950,1,5,2,3,3,single-choice,spatial-relational,2|3,7,2/3,230593,2
1,4,23,594,1,424,1,3,1,1,2,single-choice,spatial-relational,1|2,7,1/2,230594,1
1,4,23,595,1,1418,1,7,3,3,4,single-choice,spatial-relational,3|4,7,3/4,230595,3
1,4,23,596,1,1068,1,5,2,2,3,single-choice,spatial-relational,2|3,7,2/3,230596,2
1,4,23,597,0,1831,1,11,5,6,6,single-choice,spatial-relational,5|6,7,5/6,230597,5
1,4,23,598,0,687,1,11,5,6,6,single-choice,spatial-relational,5|6,7,5/6,230598,5
1,4,23,599,1,1133,1,13,6,6,7,single-choice,spatial-relational,6|7,7,6/7,230599,6
1,4,23,600,1,731,1,13,6,6,7,single-choice,spatial-relational,6|7,7,6/7,230600,6
2,4,23,1,1,1034,1,13,6,6,7,single-choice,spatial-relational,6|7,7,6/7,230001,6
2,4,23,2,1,1103,1,7,3,3,4,single-choice,spatial-relational,3|4,7,3/4,230002,3
2,4,23,3,1,1088,1,3,1,1,2,single-choice,spatial-relational,1|2,7,1/2,230003,1
2,4,23,4,0,993,1,5,2,3,3,single-choice,spatial-relational,2|3,7,2/3,230004,2
2,4,23,5,0,772,1,9,4,5,5,single-choice,spatial-relational,4|5,7,4/5,230005,4
2,4,23,6,1,1001,1,3,1,1,2,single-choice,spatial-relational,1|2,7,1/2,230006,1
2,4,23,7,1,993,1,11,5,5,6,single-choice,spatial-relational,5|6,7,5/6,230007,5
2,4,23,8,1,1578,1,11,5,5,6,single-choice,spatial-relational,5|6,7,5/6,230008,5
2,4,23,9,0,1449,1,5,2,3,3,single-choice,spatial-relational,2|3,7,2/3,230009,2
2,4,23,10,1,838,1,13,6,6,7,single-choice,spatial-relational,6|7,7,6/7,230010,6
2,4,23,11,0,1083,1,9,4,5,5,single-choice,spatial-relational,4|5,7,4/5,230011,4
2,4,23,12,0,743,1,7,3,4,4,single-choice,spatial-relational,3|4,7,3/4,230012,3
2,4,23,13,1,997,1,7,3,3,4,single-choice,spatial-relational,3|4,7,3/4,230013,3
2,4,23,14,0,922,1,5,2,3,3,single-choice,spatial-relational,2|3,7,2/3,230014,2
2,4,23,15,1,932,1,7,3,3,4,single-choice,spatial-relational,3|4,7,3/4,230015,3
2,4,23,16,0,987,1,9,4,5,5,single-choice,spatial-relational,4|5,7,4/5,230016,4
2,4,23,17,0,741,1,5,2,3,3,single-choice,spatial-relational,2|3,7,2/3,230017,2
2,4,23,18,0,1340,1,9,4,5,5,single-choice,spatial-relational,4|5,7,4/5,230018,4
2,4,23,19,1,611,1,13,6,6,7,single-choice,spatial-relational,6|7,7,6/7,230019,6
2,4,23,20,1,1291,1,11,5,5,6,single-choice,spatial-relational,5|6,7,5/6,230020,5
2,4,23,21,1,589,1,3,1,1,2,single-choice,spatial-relational,1|2,7,1/2,230021,1
2,4,23,22,0,1276,1,11,5,6,6,single-choice,spatial-relational,5|6,7,5/6,230022,5
2,4,23,23,1,977,1,13,6,6,7,single-choice,spatial-relational,6|7,7,6/7,230023,6
2,4,23,24,1,1672,1,3,1,1,2,single-choice,spatial-relational,1|2,7,1/2,230024,1
2,4,23,25,0,1780,1,9,4,5,5,single-choice,spatial-relational,4|5,7,4/5,230025,4
2,4,23,26,1,1089,1,7,3,3,4,single-choice,spatial-relational,3|4,7,3/4,230026,3
2,4,23,27,0,1332,1,11,5,6,6,single-choice,spatial-relational,5|6,7,5/6,230027,5
2,4,23,28,1,1989,1,7,3,3,4,single-choice,spatial-relational,3|4,7,3/4,230028,3
2,4,23,29,0,2057,1,11,5,6,6,single-choice,spatial-relational,5|6,7,5/6,230029,5
2,4,23,30,1,913,1,5,2,2,3,single-choice,spatial-relational,2|3,7,2/3,230030,2
2,4,23,31,1,854,1,13,6,6,7,single-choice,spatial-relational,6|7,7,6/7,230031,6
2,4,23,32,1,1502,1,3,1,1,2,single-choice,spatial-relational,1|2,7,1/2,230032,1
2,4,23,33,1,1753,1,3,1,1,2,single-choice,spatial-relational,1|2,7,1/2,230033,1
2,4,23,34,1,870,1,13,6,6,7,single-choice,spatial-relational,6|7,7,6/7,230034,6
2,4,23,35,0,1017,1,5,2,3,3,single-choice,spatial-relational,2|3,7,2/3,230035,2
2,4,23,36,0,1256,1,9,4,5,5,single-choice,spatial-relational,4|5,7,4/5,230036,4
2,4,23,37,1,1523,1,9,4,4,5,single-choice,spatial-relational,4|5,7,4/5,230037,4
2,4,23,38,1,999,1,9,4,4,5,single-choice,spatial-relational,4|5,7,4/5,230038,4
2,4,23,39,0,1526,1,11,5,6,6,single-choice,spatial-relational,5|6,7,5/6,230039,5
2,4,23,40,1,1283,1,7,3,3,4,single-choice,spatial-relational,3|4,7,3/4,230040,3
2,4,23,41,1,1109,1,13,6,6,7,single-choice,spatial-relational,6|7,7,6/7,230041,6
2,4,23,42,1,1099,1,11,5,5,6,single-choice,spatial-relational,5|6,7,5/6,230042,5
2,4,23,43,1,1123,1,7,3,3,4,single-choice,spatial-relational,3|4,7,3/4,230043,3
2,4,23,44,1,1101,1,5,2,2,3,single-choice,spatial-relational,2|3,7,2/3,230044,2
2,4,23,45,1,937,1,13,6,6,7,single-choice,spatial-relational,6|7,7,6/7,230045,6
2,4,23,46,1,1220,1,3,1,1,2,single-choice,spatial-relational,1|2,7,1/2,230046,1
2,4,23,47,1,952,1,3,1,1,2,single-choice,spatial-relational,1|2,7,1/2,230047,1
2,4,23,48,1,1232,1,5,2,2,3,single-choice,spatial-relational,2|3,7,2/3,230048,2
2,4,23,49,1,1125,1,7,3,3,4,single-choice,spatial-relational,3|4,7,3/4,230049,3
2,4,23,50,0,1135,1,5,2,3,3,single-choice,spatial-relational,2|3,7,2/3,230050,2
2,4,23,51,1,1196,1,3,1,1,2,single-choice,spatial-relational,1|2,7,1/2,230051,1
2,4,23,52,0,788,1,11,5,6,6,single-choice,spatial-relational,5|6,7,5/6,230052,5
2,4,23,53,0,863,1,7,3,4,4,single-choice,spatial-relational,3|4,7,3/4,230053,3
2,4,23,54,1,1518,1,9,4,4,5,single-choice,spatial-relational,4|5,7,4/5,230054,4
2,4,23,55,1,1027,1,3,1,1,2,single-choice,spatial-relational,1|2,7,1/2,230055,1
2,4,23,56,0,1040,1,11,5,6,6,single-choice,spatial-relational,5|6,7,5/6,230056,5
2,4,23,57,1,1054,1,5,2,2,3,single-choice,spatial-relational,2|3,7,2/3,230057,2
2,4,23,58,0,1339,1,9,4,5,5,single-choice,spatial-relational,4|5,7,4/5,230058,4
2,4,23,59,1,991,1,13,6,6,7,single-choice,spatial-relational,6|7,7,6/7,230059,6
2,4,23,60,1,606,1,13,6,6,7,single-choice,spatial-relational,6|7,7,6/7,230060,6
2,4,23,61,0,2573,1,11,5,6,6,single-choice,spatial-relational,5|6,7,5/6,230061,5
2,4,23,62,1,981,1,7,3,3,4,single-choice,spatial-relational,3|4,7,3/4,230062,3
2,4,23,63,1,1838,1,5,2,2,3,single-choice,spatial-relational,2|3,7,2/3,230063,2
2,4,23,64,1,1611,1,3,1,1,2,single-choice,spatial-relational,1|2,7,1/2,230064,1
2,4,23,65,1,1118,1,9,4,4,5,single-choice,spatial-relational,4|5,7,4/5,230065,4
2,4,23,66,0,907,1,11,5,6,6,single-choice,spatial-relational,5|6,7,5/6,230066,5
2,4,23,67,1,837,1,13,6,6,7,single-choice,spatial-relational,6|7,7,6/7,230067,6
2,4,23,68,1,1491,1,9,4,4,5,single-choice,spatial-relational,4|5,7,4/5,230068,4
2,4,23,69,1,957,1,7,3,3,4,single-choice,spatial-relational,3|4,7,3/4,230069,3
2,4,23,70,1,1196,1,5,2,2,3,single-choice,spatial-relational,2|3,7,2/3,230070,2
2,4,23,71,1,1746,1,3,1,1,2,single-choice,spatial-relational,1|2,7,1/2,230071,1
2,4,23,72,1,708,1,13,6,6,7,single-choice,spatial-relational,6|7,7,6/7,230072,6
2,4,23,73,1,714,1,13,6,6,7,single-choice,spatial-relational,6|7,7,6/7,230073,6
2,4,23,74,1,1493,1,9,4,4,5,single-choice,spatial-relational,4|5,7,4/5,230074,4
2,4,23,75,0,1954,1,11,5,6,6,single-choice,spatial-relational,5|6,7,5/6,230075,5
2,4,23,76,0,417,1,5,2,3,3,single-choice,spatial-relational,2|3,7,2/3,230076,2
2,4,23,77,1,1024,1,3,1,1,2,single-choice,spatial-relational,1|2,7,1/2,230077,1
2,4,23,78,1,870,1,13,6,6,7,single-choice,spatial-relational,6|7,7,6/7,230078,6
2,4,23,79,1,1303,1,3,1,1,2,single-choice,spatial-relational,1|2,7,1/2,230079,1
2,4,23,80,1,1662,1,7,3,3,4,single-choice,spatial-relational,3|4,7,3/4,230080,3
2,4,23,81,1,1708,1,9,4,4,5,single-choice,spatial-relational,4|5,7,4/5,230081,4
2,4,23,82,1,1296,1,11,5,5,6,single-choice,spatial-relational,5|6,7,5/6,230082,5
2,4,23,83,1,1000,1,7,3,3,4,single-choice,spatial-relational,3|4,7,3/4,230083,3
2,4,23,84,0,1618,1,5,2,3,3,single-choice,spatial-relational,2|3,7,2/3,230084,2
2,4,23,85,0,1090,1,11,5,6,6,single-choice,spatial-relational,5|6,7,5/6,230085,5
2,4,23,86,1,753,1,3,1,1,2,single-choice,spatial-relational,1|2,7,1/2,230086,1
2,4,23,87,0,1294,1,5,2,3,3,single-choice,spatial-relational,2|3,7,2/3,230087,2
2,4,23,88,1,1420,1,7,3,3,4,single-choice,spatial-relational,3|4,7,3/4,230088,3
2,4,23,89,1,724,1,9,4,4,5,single-choice,spatial-relational,4|5,7,4/5,230089,4
2,4,23,90,1,1046,1,5,2,2,3,single-choice,spatial-relational,2|3,7,2/3,230090,2
2,4,23,91,1,1138,1,3,1,1,2,single-choice,spatial-relational,1|2,7,1/2,230091,1
2,4,23,92,1,954,1,13,6,6,7,single-choice,spatial-relational,6|7,7,6/7,230092,6
2,4,23,93,1,652,1,13,6,6,7,single-choice,spatial-relational,6|7,7,6/7,230093,6
2,4,23,94,1,3204,1,9,4,4,5,single-choice,spatial-relational,4|5,7,4/5,230094,4
2,4,23,95,0,1598,1,7,3,4,4,single-choice,spatial-relational,3|4,7,3/4,230095,3
2,4,23,96,0,1276,1,11,5,6,6,single-choice,spatial-relational,5|6,7,5/6,230096,5
2,4,23,97,1,873,1,3,1,1,2,single-choice,spatial-relational,1|2,7,1/2,230097,1
2,4,23,98,1,1117,1,5,2,2,3,single-choice,spatial-relational,2|3,7,2/3,230098,2
2,4,23,99,1,1141,1,13,6,6,7,single-choice,spatial-relational,6|7,7,6/7,230099,6
2,4,23,100,1,1342,1,11,5,5,6,single-choice,spatial-relational,5|6,7,5/6,230100,5
2,4,23,101,1,734,1,3,1,1,2,single-choice,spatial-relational,1|2,7,1/2,230101,1
2,4,23,102,0,1176,1,7,3,4,4,single-choice,spatial-relational,3|4,7,3/4,230102,3
2,4,23,103,0,794,1,11,5,6,6,single-choice,spatial-relational,5|6,7,5/6,230103,5
2,4,23,104,1,879,1,13,6,6,7,single-choice,spatial-relational,6|7,7,6/7,230104,6
2,4,23,105,1,1318,1,7,3,3,4,single-choice,spatial-relational,3|4,7,3/4,230105,3
2,4,23,106,0,1135,1,9,4,5,5,single-choice,spatial-relational,4|5,7,4/5,230106,4
2,4,23,107,1,1019,1,5,2,2,3,single-choice,spatial-relational,2|3,7,2/3,230107,2
2,4,23,108,1,1338,1,9,4,4,5,single-choice,spatial-relational,4|5,7,4/5,230108,4
2,4,23,109,1,897,1,13,6,6,7,single-choice,spatial-relational,6|7,7,6/7,230109,6
2,4,23,110,0,2505,1,9,4,5,5,single-choice,spatial-relational,4|5,7,4/5,230110,4
2,4,23,111,1,1392,1,5,2,2,3,single-choice,spatial-relational,2|3,7,2/3,230111,2
2,4,23,112,0,1107,1,11,5,6,6,single-choice,spatial-relational,5|6,7,5/6,230112,5
2,4,23,113,1,1136,1,9,4,4,5,single-choice,spatial-relational,4|5,7,4/5,230113,4
2,4,23,114,1,1443,1,3,1,1,2,single-choice,spatial-relational,1|2,7,1/2,230114,1
2,4,23,115,0,996,1,7,3,4,4,single-choice,spatial-relational,3|4,7,3/4,230115,3
2,4,23,116,1,844,1,13,6,6,7,single-choice,spatial-relational,6|7,7,6/7,230116,6
2,4,23,117,0,1011,1,5,2,3,3,single-choice,spatial-relational,2|3,7,2/3,230117,2
2,4,23,118,0,744,1,7,3,4,4,single-choice,spatial-relational,3|4,7,3/4,230118,3
2,4,23,119,0,1700,1,11,5,6,6,single-choice,spatial-relational,5|6,7,5/6,230119,5
2,4,23,120,1,749,1,3,1,1,2,single-choice,spatial-relational,1|2,7,1/2,230120,1
2,4,23,121,1,974,1,13,6,6,7,single-choice,spatial-relational,6|7,7,6/7,230121,6
2,4,23,122,0,1220,1,11,5,6,6,single-choice,spatial-relational,5|6,7,5/6,230122,5
2,4,23,123,1,727,1,3,1,1,2,single-choice,spatial-relational,1|2,7,1/2,230123,1
2,4,23,124,0,1303,1,5,2,3,3,single-choice,spatial-relational,2|3,7,2/3,230124,2
2,4,23,125,1,1043,1,9,4,4,5,single-choice,spatial-relational,4|5,7,4/5,230125,4
2,4,23,126,1,1479,1,3,1,1,2,single-choice,spatial-relational,1|2,7,1/2,230126,1
2,4,23,127,0,1185,1,7,3,4,4,single-choice,spatial-relational,3|4,7,3/4,230127,3
2,4,23,128,1,1080,1,9,4,4,5,single-choice,spatial-relational,4|5,7,4/5,230128,4
2,4,23,129,0,666,1,11,5,6,6,single-choice,spatial-relational,5|6,7,5/6,230129,5
2,4,23,130,1,1348,1,7,3,3,4,single-choice,spatial-relational,3|4,7,3/4,230130,3
2,4,23,131,1,1747,1,5,2,2,3,single-choice,spatial-relational,2|3,7,2/3,230131,2
2,4,23,132,1,1099,1,13,6,6,7,single-choice,spatial-relational,6|7,7,6/7,230132,6
2,4,23,133,1,678,1,3,1,1,2,single-choice,spatial-relational,1|2,7,1/2,230133,1
2,4,23,134,0,992,1,9,4,5,5,single-choice,spatial-relational,4|5,7,4/5,230134,4
2,4,23,135,1,1004,1,5,2,2,3,single-choice,spatial-relational,2|3,7,2/3,230135,2
2,4,23,136,1,1894,1,5,2,2,3,single-choice,spatial-relational,2|3,7,2/3,230136,2
2,4,23,137,1,1077,1,3,1,1,2,single-choice,spatial-relational,1|2,7,1/2,230137,1
2,4,23,138,0,1421,1,7,3,4,4,single-choice,spatial-relational,3|4,7,3/4,230138,3
2,4,23,139,1,1766,1,7,3,3,4,single-choice,spatial-relational,3|4,7,3/4,230139,3
2,4,23,140,0,1786,1,11,5,6,6,single-choice,spatial-relational,5|6,7,5/6,230140,5
2,4,23,141,1,828,1,13,6,6,7,single-choice,spatial-relational,6|7,7,6/7,230141,6
2,4,23,142,1,844,1,9,4,4,5,single-choice,spatial-relational,4|5,7,4/5,230142,4
2,4,23,143,1,1607,1,13,6,6,7,single-choice,spatial-relational,6|7,7,6/7,230143,6
2,4,23,144,0,824,1,11,5,6,6,single-choice,spatial-relational,5|6,7,5/6,230144,5
2,4,23,145,1,1331,1,9,4,4,5,single-choice,spatial-relational,4|5,7,4/5,230145,4
2,4,23,146,1,567,1,9,4,4,5,single-choice,spatial-relational,4|5,7,4/5,230146,4
2,4,23,147,1,1966,1,11,5,5,6,single-choice,spatial-relational,5|6,7,5/6,230147,5
2,4,23,148,0,3019,1,11,5,6,6,single-choice,spatial-relational,5|6,7,5/6,230148,5
2,4,23,149,0,1144,1,7,3,4,4,single-choice,spatial-relational,3|4,7,3/4,230149,3
2,4,23,150,0,882,1,5,2,3,3,single-choice,spatial-relational,2|3,7,2/3,230150,2
2,4,23,151,1,1116,1,7,3,3,4,single-choice,spatial-relational,3|4,7,3/4,230151,3
2,4,23,152,1,1178,1,5,2,2,3,single-choice,spatial-relational,2|3,7,2/3,230152,2
2,4,23,153,1,1026,1,13,6,6,7,single-choice,spatial-relational,6|7,7,6/7,230153,6
2,4,23,154,1,854,1,13,6,6,7,single-choice,spatial-relational,6|7,7,6/7,230154,6
2,4,23,155,1,1234,1,3,1,1,2,single-choice,spatial-relational,1|2,7,1/2,230155,1
2,4,23,156,1,888,1,3,1,1,2,single-choice,spatial-relational,1|2,7,1/2,230156,1
2,4,23,157,1,874,1,9,4,4,5,single-choice,spatial-relational,4|5,7,4/5,230157,4
2,4,23,158,0,1572,1,9,4,5,5,single-choice,spatial-relational,4|5,7,4/5,230158,4
2,4,23,159,1,690,1,3,1,1,2,single-choice,spatial-relational,1|2,7,1/2,230159,1
2,4,23,160,1,836,1,13,6,6,7,single-choice,spatial-relational,6|7,7,6/7,230160,6
2,4,23,161,0,660,1,11,5,6,6,single-choice,spatial-relational,5|6,7,5/6,230161,5
2,4,23,162,0,1716,1,11,5,6,6,single-choice,spatial-relational,5|6,7,5/6,230162,5
2,4,23,163,1,1001,1,7,3,3,4,single-choice,spatial-relational,3|4,7,3/4,230163,3
2,4,23,164,1,1276,1,5,2,2,3,single-choice,spatial-relational,2|3,7,2/3,230164,2
2,4,23,165,0,1048,1,5,2,3,3,single-choice,spatial-relational,2|3,7,2/3,230165,2
2,4,23,166,0,779,1,7,3,4,4,single-choice,spatial-relational,3|4,7,3/4,230166,3
2,4,23,167,1,841,1,13,6,6,7,single-choice,spatial-relational,6|7,7,6/7,230167,6
2,4,23,168,1,1008,1,3,1,1,2,single-choice,spatial-relational,1|2,7,1/2,230168,1
2,4,23,169,1,1305,1,5,2,2,3,single-choice,spatial-relational,2|3,7,2/3,230169,2
2,4,23,170,1,1162,1,11,5,5,6,single-choice,spatial-relational,5|6,7,5/6,230170,5
2,4,23,171,1,841,1,3,1,1,2,single-choice,spatial-relational,1|2,7,1/2,230171,1
2,4,23,172,1,1213,1,7,3,3,4,single-choice,spatial-relational,3|4,7,3/4,230172,3
2,4,23,173,0,652,1,7,3,4,4,single-choice,spatial-relational,3|4,7,3/4,230173,3
2,4,23,174,0,913,1,11,5,6,6,single-choice,spatial-relational,5|6,7,5/6,230174,5
2,4,23,175,1,763,1,13,6,6,7,single-choice,spatial-relational,6|7,7,6/7,230175,6
2,4,23,176,0,1273,1,9,4,5,5,single-choice,spatial-relational,4|5,7,4/5,230176,4
2,4,23,177,1,821,1,13,6,6,7,single-choice,spatial-relational,6|7,7,6/7,230177,6
2,4,23,178,1,666,1,3,1,1,2,single-choice,spatial-relational,1|2,7,1/2,230178,1
2,4,23,179,0,1750,1,5,2,3,3,single-choice,spatial-relational,2|3,7,2/3,230179,2
2,4,23,180,0,1321,1,9,4,5,5,single-choice,spatial-relational,4|5,7,4/5,230180,4
2,4,23,181,1,821,1,13,6,6,7,single-choice,spatial-relational,6|7,7,6/7,230181,6
2,4,23,182,1,1273,1,9,4,4,5,single-choice,spatial-relational,4|5,7,4/5,230182,4
2,4,23,183,1,895,1,3,1,1,2,single-choice,spatial-relational,1|2,7,1/2,230183,1
2,4,23,184,0,1349,1,11,5,6,6,single-choice,spatial-relational,5|6,7,5/6,230184,5
2,4,23,185,1,5182,1,5,2,2,3,single-choice,spatial-relational,2|3,7,2/3,230185,2
2,4,23,186,1,706,1,3,1,1,2,single-choice,spatial-relational,1|2,7,1/2,230186,1
2,4,23,187,0,1252,1,7,3,4,4,single-choice,spatial-relational,3|4,7,3/4,230187,3
2,4,23,188,0,833,1,5,2,3,3,single-choice,spatial-relational,2|3,7,2/3,230188,2
2,4,23,189,1,1787,1,7,3,3,4,single-choice,spatial-relational,3|4,7,3/4,230189,3
2,4,23,190,1,1026,1,13,6,6,7,single-choice,spatial-relational,6|7,7,6/7,230190,6
2,4,23,191,1,3215,1,11,5,5,6,single-choice,spatial-relational,5|6,7,5/6,230191,5
2,4,23,192,1,1374,1,9,4,4,5,single-choice,spatial-relational,4|5,7,4/5,230192,4
2,4,23,193,1,1200,1,5,2,2,3,single-choice,spatial-relational,2|3,7,2/3,230193,2
2,4,23,194,1,1004,1,13,6,6,7,single-choice,spatial-relational,6|7,7,6/7,230194,6
2,4,23,195,0,959,1,11,5,6,6,single-choice,spatial-relational,5|6,7,5/6,230195,5
2,4,23,196,1,762,1,13,6,6,7,single-choice,spatial-relational,6|7,7,6/7,230196,6
2,4,23,197,1,1577,1,7,3,3,4,single-choice,spatial-relational,3|4,7,3/4,230197,3
2,4,23,198,1,1529,1,9,4,4,5,single-choice,spatial-relational,4|5,7,4/5,230198,4
2,4,23,199,1,1039,1,7,3,3,4,single-choice,spatial-relational,3|4,7,3/4,230199,3
2,4,23,200,1,1194,1,3,1,1,2,single-choice,spatial-relational,1|2,7,1/2,230200,1
2,4,23,201,0,1642,1,9,4,5,5,single-choice,spatial-relational,4|5,7,4/5,230201,4
2,4,23,202,1,1190,1,5,2,2,3,single-choice,spatial-relational,2|3,7,2/3,230202,2
2,4,23,203,1,1002,1,11,5,5,6,single-choice,spatial-relational,5|6,7,5/6,230203,5
2,4,23,204,1,631,1,3,1,1,2,single-choice,spatial-relational,1|2,7,1/2,230204,1
2,4,23,205,1,1392,1,3,1,1,2,single-choice,spatial-relational,1|2,7,1/2,230205,1
2,4,23,206,0,828,1,11,5,6,6,single-choice,spatial-relational,5|6,7,5/6,230206,5
2,4,23,207,1,745,1,13,6,6,7,single-choice,spatial-relational,6|7,7,6/7,230207,6
2,4,23,208,1,2744,1,11,5,5,6,single-choice,spatial-relational,5|6,7,5/6,230208,5
2,4,23,209,1,1226,1,5,2,2,3,single-choice,spatial-relational,2|3,7,2/3,230209,2
2,4,23,210,0,1176,1,7,3,4,4,single-choice,spatial-relational,3|4,7,3/4,230210,3
2,4,23,211,1,1000,1,3,1,1,2,single-choice,spatial-relational,1|2,7,1/2,230211,1
2,4,23,212,1,1213,1,9,4,4,5,single-choice,spatial-relational,4|5,7,4/5,230212,4
2,4,23,213,0,1931,1,9,4,5,5,single-choice,spatial-relational,4|5,7,4/5,230213,4
2,4,23,214,1,1046,1,5,2,2,3,single-choice,spatial-relational,2|3,7,2/3,230214,2
2,4,23,215,1,1325,1,13,6,6,7,single-choice,spatial-relational,6|7,7,6/7,230215,6
2,4,23,216,1,979,1,7,3,3,4,single-choice,spatial-relational,3|4,7,3/4,230216,3
2,4,23,217,1,153,1,11,5,5,6,single-choice,spatial-relational,5|6,7,5/6,230217,5
2,4,23,218,1,675,1,3,1,1,2,single-choice,spatial-relational,1|2,7,1/2,230218,1
2,4,23,219,1,924,1,13,6,6,7,single-choice,spatial-relational,6|7,7,6/7,230219,6
2,4,23,220,1,2336,1,11,5,5,6,single-choice,spatial-relational,5|6,7,5/6,230220,5
2,4,23,221,1,971,1,3,1,1,2,single-choice,spatial-relational,1|2,7,1/2,230221,1
2,4,23,222,0,842,1,13,6,7,7,single-choice,spatial-relational,6|7,7,6/7,230222,6
2,4,23,223,0,1061,1,5,2,3,3,single-choice,spatial-relational,2|3,7,2/3,230223,2
2,4,23,224,1,1035,1,9,4,4,5,single-choice,spatial-relational,4|5,7,4/5,230224,4
2,4,23,225,1,1746,1,5,2,2,3,single-choice,spatial-relational,2|3,7,2/3,230225,2
2,4,23,226,1,2134,1,9,4,4,5,single-choice,spatial-relational,4|5,7,4/5,230226,4
2,4,23,227,1,1025,1,7,3,3,4,single-choice,spatial-relational,3|4,7,3/4,230227,3
2,4,23,228,1,959,1,7,3,3,4,single-choice,spatial-relational,3|4,7,3/4,230228,3
2,4,23,229,1,666,1,13,6,6,7,single-choice,spatial-relational,6|7,7,6/7,230229,6
2,4,23,230,0,1539,1,11,5,6,6,single-choice,spatial-relational,5|6,7,5/6,230230,5
2,4,23,231,0,893,1,11,5,6,6,single-choice,spatial-relational,5|6,7,5/6,230231,5
2,4,23,232,1,1097,1,7,3,3,4,single-choice,spatial-relational,3|4,7,3/4,230232,3
2,4,23,233,1,923,1,3,1,1,2,single-choice,spatial-relational,1|2,7,1/2,230233,1
2,4,23,234,1,1174,1,9,4,4,5,single-choice,spatial-relational,4|5,7,4/5,230234,4
2,4,23,235,1,960,1,7,3,3,4,single-choice,spatial-relational,3|4,7,3/4,230235,3
2,4,23,236,1,1666,1,9,4,4,5,single-choice,spatial-relational,4|5,7,4/5,230236,4
2,4,23,237,1,1263,1,13,6,6,7,single-choice,spatial-relational,6|7,7,6/7,230237,6
2,4,23,238,1,1413,1,5,2,2,3,single-choice,spatial-relational,2|3,7,2/3,230238,2
2,4,23,239,1,1278,1,5,2,2,3,single-choice,spatial-relational,2|3,7,2/3,230239,2
2,4,23,240,1,623,1,3,1,1,2,single-choice,spatial-relational,1|2,7,1/2,230240,1
2,4,23,241,1,1022,1,13,6,6,7,single-choice,spatial-relational,6|7,7,6/7,230241,6
2,4,23,242,1,1146,1,9,4,4,5,single-choice,spatial-relational,4|5,7,4/5,230242,4
2,4,23,243,1,555,1,3,1,1,2,single-choice,spatial-relational,1|2,7,1/2,230243,1
2,4,23,244,0,996,1,11,5,6,6,single-choice,spatial-relational,5|6,7,5/6,230244,5
2,4,23,245,0,1320,1,7,3,4,4,single-choice,spatial-relational,3|4,7,3/4,230245,3
2,4,23,246,0,636,1,7,3,4,4,single-choice,spatial-relational,3|4,7,3/4,230246,3
2,4,23,247,0,1081,1,5,2,3,3,single-choice,spatial-relational,2|3,7,2/3,230247,2
2,4,23,248,1,1597,1,5,2,2,3,single-choice,spatial-relational,2|3,7,2/3,230248,2
2,4,23,249,1,885,1,13,6,6,7,single-choice,spatial-relational,6|7,7,6/7,230249,6
2,4,23,250,1,714,1,9,4,4,5,single-choice,spatial-relational,4|5,7,4/5,230250,4
2,4,23,251,1,890,1,3,1,1,2,single-choice,spatial-relational,1|2,7,1/2,230251,1
2,4,23,252,1,1158,1,11,5,5,6,single-choice,spatial-relational,5|6,7,5/6,230252,5
2,4,23,253,1,935,1,3,1,1,2,single-choice,spatial-relational,1|2,7,1/2,230253,1
2,4,23,254,1,1041,1,7,3,3,4,single-choice,spatial-relational,3|4,7,3/4,230254,3
2,4,23,255,1,1926,1,9,4,4,5,single-choice,spatial-relational,4|5,7,4/5,230255,4
2,4,23,256,0,1341,1,11,5,6,6,single-choice,spatial-relational,5|6,7,5/6,230256,5
2,4,23,257,1,600,1,3,1,1,2,single-choice,spatial-relational,1|2,7,1/2,230257,1
2,4,23,258,1,1736,1,9,4,4,5,single-choice,spatial-relational,4|5,7,4/5,230258,4
2,4,23,259,1,991,1,13,6,6,7,single-choice,spatial-relational,6|7,7,6/7,230259,6
2,4,23,260,0,1002,1,5,2,3,3,single-choice,spatial-relational,2|3,7,2/3,230260,2
2,4,23,261,0,1172,1,11,5,6,6,single-choice,spatial-relational,5|6,7,5/6,230261,5
2,4,23,262,1,858,1,13,6,6,7,single-choice,spatial-relational,6|7,7,6/7,230262,6
2,4,23,263,1,1183,1,7,3,3,4,single-choice,spatial-relational,3|4,7,3/4,230263,3
2,4,23,264,1,853,1,5,2,2,3,single-choice,spatial-relational,2|3,7,2/3,230264,2
2,4,23,265,1,1055,1,7,3,3,4,single-choice,spatial-relational,3|4,7,3/4,230265,3
2,4,23,266,1,588,1,3,1,1,2,single-choice,spatial-relational,1|2,7,1/2,230266,1
2,4,23,267,1,909,1,13,6,6,7,single-choice,spatial-relational,6|7,7,6/7,230267,6
2,4,23,268,0,750,1,5,2,3,3,single-choice,spatial-relational,2|3,7,2/3,230268,2
2,4,23,269,0,1998,1,11,5,6,6,single-choice,spatial-relational,5|6,7,5/6,230269,5
2,4,23,270,1,927,1,5,2,2,3,single-choice,spatial-relational,2|3,7,2/3,230270,2
2,4,23,271,1,808,1,3,1,1,2,single-choice,spatial-relational,1|2,7,1/2,230271,1
2,4,23,272,0,752,1,11,5,6,6,single-choice,spatial-relational,5|6,7,5/6,230272,5
2,4,23,273,1,823,1,9,4,4,5,single-choice,spatial-relational,4|5,7,4/5,230273,4
2,4,23,274,1,1304,1,9,4,4,5,single-choice,spatial-relational,4|5,7,4/5,230274,4
2,4,23,275,1,691,1,13,6,6,7,single-choice,spatial-relational,6|7,7,6/7,230275,6
2,4,23,276,1,965,1,7,3,3,4,single-choice,spatial-relational,3|4,7,3/4,230276,3
2,4,23,277,1,1768,1,13,6,6,7,single-choice,spatial-relational,6|7,7,6/7,230277,6
2,4,23,278,1,2047,1,11,5,5,6,single-choice,spatial-relational,5|6,7,5/6,230278,5
2,4,23,279,1,2066,1,9,4,4,5,single-choice,spatial-relational,4|5,7,4/5,230279,4
2,4,23,280,1,899,1,9,4,4,5,single-choice,spatial-relational,4|5,7,4/5,230280,4
2,4,23,281,1,1085,1,13,6,6,7,single-choice,spatial-relational,6|7,7,6/7,230281,6
2,4,23,282,1,589,1,3,1,1,2,single-choice,spatial-relational,1|2,7,1/2,230282,1
2,4,23,283,1,858,1,3,1,1,2,single-choice,spatial-relational,1|2,7,1/2,230283,1
2,4,23,284,1,1029,1,5,2,2,3,single-choice,spatial-relational,2|3,7,2/3,230284,2
2,4,23,285,1,1113,1,7,3,3,4,single-choice,spatial-relational,3|4,7,3/4,230285,3
2,4,23,286,1,621,1,5,2,2,3,single-choice,spatial-relational,2|3,7,2/3,230286,2
2,4,23,287,0,770,1,7,3,4,4,single-choice,spatial-relational,3|4,7,3/4,230287,3
2,4,23,288,0,778,1,11,5,6,6,single-choice,spatial-relational,5|6,7,5/6,230288,5
2,4,23,289,0,69,1,13,6,7,7,single-choice,spatial-relational,6|7,7,6/7,230289,6
2,4,23,290,1,1023,1,5,2,2,3,single-choice,spatial-relational,2|3,7,2/3,230290,2
2,4,23,291,1,845,1,3,1,1,2,single-choice,spatial-relational,1|2,7,1/2,230291,1
2,4,23,292,1,1006,1,9,4,4,5,single-choice,spatial-relational,4|5,7,4/5,230292,4
2,4,23,293,1,649,1,3,1,1,2,single-choice,spatial-relational,1|2,7,1/2,230293,1
2,4,23,294,1,1363,1,7,3,3,4,single-choice,spatial-relational,3|4,7,3/4,230294,3
2,4,23,295,0,780,1,11,5,6,6,single-choice,spatial-relational,5|6,7,5/6,230295,5
2,4,23,296,0,986,1,5,2,3,3,single-choice,spatial-relational,2|3,7,2/3,230296,2
2,4,23,297,0,842,1,7,3,4,4,single-choice,spatial-relational,3|4,7,3/4,230297,3
2,4,23,298,1,1129,1,9,4,4,5,single-choice,spatial-relational,4|5,7,4/5,230298,4
2,4,23,299,0,1215,1,11,5,6,6,single-choice,spatial-relational,5|6,7,5/6,230299,5
2,4,23,300,0,726,1,13,6,7,7,single-choice,spatial-relational,6|7,7,6/7,230300,6
2,4,23,301,1,1050,1,13,6,6,7,single-choice,spatial-relational,6|7,7,6/7,230301,6
2,4,23,302,0,1233,1,5,2,3,3,single-choice,spatial-relational,2|3,7,2/3,230302,2
2,4,23,303,1,1309,1,5,2,2,3,single-choice,spatial-relational,2|3,7,2/3,230303,2
2,4,23,304,1,830,1,13,6,6,7,single-choice,spatial-relational,6|7,7,6/7,230304,6
2,4,23,305,1,629,1,3,1,1,2,single-choice,spatial-relational,1|2,7,1/2,230305,1
2,4,23,306,1,1428,1,11,5,5,6,single-choice,spatial-relational,5|6,7,5/6,230306,5
2,4,23,307,1,2067,1,7,3,3,4,single-choice,spatial-relational,3|4,7,3/4,230307,3
2,4,23,308,1,1175,1,11,5,5,6,single-choice,spatial-relational,5|6,7,5/6,230308,5
2,4,23,309,1,684,1,9,4,4,5,single-choice,spatial-relational,4|5,7,4/5,230309,4
2,4,23,310,1,1341,1,9,4,4,5,single-choice,spatial-relational,4|5,7,4/5,230310,4
2,4,23,311,1,1055,1,3,1,1,2,single-choice,spatial-relational,1|2,7,1/2,230311,1
2,4,23,312,0,793,1,7,3,4,4,single-choice,spatial-relational,3|4,7,3/4,230312,3
2,4,23,313,0,1090,1,11,5,6,6,single-choice,spatial-relational,5|6,7,5/6,230313,5
2,4,23,314,0,957,1,5,2,3,3,single-choice,spatial-relational,2|3,7,2/3,230314,2
2,4,23,315,1,4,1,7,3,3,4,single-choice,spatial-relational,3|4,7,3/4,230315,3
2,4,23,316,0,1757,1,9,4,5,5,single-choice,spatial-relational,4|5,7,4/5,230316,4
2,4,23,317,1,1140,1,3,1,1,2,single-choice,spatial-relational,1|2,7,1/2,230317,1
2,4,23,318,1,1441,1,9,4,4,5,single-choice,spatial-relational,4|5,7,4/5,230318,4
2,4,23,319,0,1199,1,11,5,6,6,single-choice,spatial-relational,5|6,7,5/6,230319,5
2,4,23,320,0,870,1,7,3,4,4,single-choice,spatial-relational,3|4,7,3/4,230320,3
2,4,23,321,1,1081,1,13,6,6,7,single-choice,spatial-relational,6|7,7,6/7,230321,6
2,4,23,322,1,763,1,3,1,1,2,single-choice,spatial-relational,1|2,7,1/2,230322,1
2,4,23,323,1,1549,1,13,6,6,7,single-choice,spatial-relational,6|7,7,6/7,230323,6
2,4,23,324,1,1447,1,5,2,2,3,single-choice,spatial-relational,2|3,7,2/3,230324,2
2,4,23,325,1,1814,1,7,3,3,4,single-choice,spatial-relational,3|4,7,3/4,230325,3
2,4,23,326,1,681,1,3,1,1,2,single-choice,spatial-relational,1|2,7,1/2,230326,1
2,4,23,327,0,835,1,11,5,6,6,single-choice,spatial-relational,5|6,7,5/6,230327,5
2,4,23,328,1,729,1,13,6,6,7,single-choice,spatial-relational,6|7,7,6/7,230328,6
2,4,23,329,1,1888,1,5,2,2,3,single-choice,spatial-relational,2|3,7,2/3,230329,2
2,4,23,330,1,2120,1,11,5,5,6,single-choice,spatial-relational,5|6,7,5/6,230330,5
2,4,23,331,0,533,1,7,3,4,4,single-choice,spatial-relational,3|4,7,3/4,230331,3
2,4,23,332,1,961,1,5,2,2,3,single-choice,spatial-relational,2|3,7,2/3,230332,2
2,4,23,333,1,1215,1,9,4,4,5,single-choice,spatial-relational,4|5,7,4/5,230333,4
2,4,23,334,1,905,1,3,1,1,2,single-choice,spatial-relational,1|2,7,1/2,230334,1
2,4,23,335,1,875,1,13,6,6,7,single-choice,spatial-relational,6|7,7,6/7,230335,6
2,4,23,336,0,1696,1,9,4,5,5,single-choice,spatial-relational,4|5,7,4/5,230336,4
2,4,23,337,0,1003,1,11,5,6,6,single-choice,spatial-relational,5|6,7,5/6,230337,5
2,4,23,338,1,1123,1,7,3,3,4,single-choice,spatial-relational,3|4,7,3/4,230338,3
2,4,23,339,1,1303,1,11,5,5,6,single-choice,spatial-relational,5|6,7,5/6,230339,5
2,4,23,340,1,928,1,9,4,4,5,single-choice,spatial-relational,4|5,7,4/5,230340,4
2,4,23,341,1,948,1,5,2,2,3,single-choice,spatial-relational,2|3,7,2/3,230341,2
2,4,23,342,0,1198,1,5,2,3,3,single-choice,spatial-relational,2|3,7,2/3,230342,2
2,4,23,343,1,898,1,3,1,1,2,single-choice,spatial-relational,1|2,7,1/2,230343,1
2,4,23,344,1,658,1,3,1,1,2,single-choice,spatial-relational,1|2,7,1/2,230344,1
2,4,23,345,1,870,1,13,6,6,7,single-choice,spatial-relational,6|7,7,6/7,230345,6
2,4,23,346,1,1059,1,13,6,6,7,single-choice,spatial-relational,6|7,7,6/7,230346,6
2,4,23,347,0,575,1,7,3,4,4,single-choice,spatial-relational,3|4,7,3/4,230347,3
2,4,23,348,1,1467,1,9,4,4,5,single-choice,spatial-relational,4|5,7,4/5,230348,4
2,4,23,349,1,1114,1,3,1,1,2,single-choice,spatial-relational,1|2,7,1/2,230349,1
2,4,23,350,1,1217,1,5,2,2,3,single-choice,spatial-relational,2|3,7,2/3,230350,2
2,4,23,351,1,935,1,13,6,6,7,single-choice,spatial-relational,6|7,7,6/7,230351,6
2,4,23,352,1,937,1,3,1,1,2,single-choice,spatial-relational,1|2,7,1/2,230352,1
2,4,23,353,0,1044,1,5,2,3,3,single-choice,spatial-relational,2|3,7,2/3,230353,2
2,4,23,354,1,873,1,9,4,4,5,single-choice,spatial-relational,4|5,7,4/5,230354,4
2,4,23,355,0,1059,1,11,5,6,6,single-choice,spatial-relational,5|6,7,5/6,230355,5
2,4,23,356,1,1049,1,7,3,3,4,single-choice,spatial-relational,3|4,7,3/4,230356,3
2,4,23,357,0,1324,1,11,5,6,6,single-choice,spatial-relational,5|6,7,5/6,230357,5
2,4,23,358,1,1167,1,7,3,3,4,single-choice,spatial-relational,3|4,7,3/4,230358,3
2,4,23,359,1,839,1,13,6,6,7,single-choice,spatial-relational,6|7,7,6/7,230359,6
2,4,23,360,1,1128,1,9,4,4,5,single-choice,spatial-relational,4|5,7,4/5,230360,4
2,4,23,361,0,858,1,11,5,6,6,single-choice,spatial-relational,5|6,7,5/6,230361,5
2,4,23,362,1,1075,1,7,3,3,4,single-choice,spatial-relational,3|4,7,3/4,230362,3
2,4,23,363,1,1264,1,11,5,5,6,single-choice,spatial-relational,5|6,7,5/6,230363,5
2,4,23,364,1,905,1,3,1,1,2,single-choice,spatial-relational,1|2,7,1/2,230364,1
2,4,23,365,1,1184,1,5,2,2,3,single-choice,spatial-relational,2|3,7,2/3,230365,2
2,4,23,366,1,1321,1,7,3,3,4,single-choice,spatial-relational,3|4,7,3/4,230366,3
2,4,23,367,1,1023,1,13,6,6,7,single-choice,spatial-relational,6|7,7,6/7,230367,6
2,4,23,368,1,977,1,3,1,1,2,single-choice,spatial-relational,1|2,7,1/2,230368,1
2,4,23,369,0,1551,1,9,4,5,5,single-choice,spatial-relational,4|5,7,4/5,230369,4
2,4,23,370,1,1179,1,13,6,6,7,single-choice,spatial-relational,6|7,7,6/7,230370,6
2,4,23,371,0,1385,1,5,2,3,3,single-choice,spatial-relational,2|3,7,2/3,230371,2
2,4,23,372,1,772,1,9,4,4,5,single-choice,spatial-relational,4|5,7,4/5,230372,4
2,4,23,373,1,1082,1,9,4,4,5,single-choice,spatial-relational,4|5,7,4/5,230373,4
2,4,23,374,1,1613,1,9,4,4,5,single-choice,spatial-relational,4|5,7,4/5,230374,4
2,4,23,375,1,884,1,3,1,1,2,single-choice,spatial-relational,1|2,7,1/2,230375,1
2,4,23,376,1,844,1,3,1,1,2,single-choice,spatial-relational,1|2,7,1/2,230376,1
2,4,23,377,1,1003,1,13,6,6,7,single-choice,spatial-relational,6|7,7,6/7,230377,6
2,4,23,378,1,1020,1,13,6,6,7,single-choice,spatial-relational,6|7,7,6/7,230378,6
2,4,23,379,1,1656,1,7,3,3,4,single-choice,spatial-relational,3|4,7,3/4,230379,3
2,4,23,380,0,1307,1,11,5,6,6,single-choice,spatial-relational,5|6,7,5/6,230380,5
2,4,23,381,0,499,1,11,5,6,6,single-choice,spatial-relational,5|6,7,5/6,230381,5
2,4,23,382,0,469,1,7,3,4,4,single-choice,spatial-relational,3|4,7,3/4,230382,3
2,4,23,383,1,1028,1,5,2,2,3,single-choice,spatial-relational,2|3,7,2/3,230383,2
2,4,23,384,1,1780,1,5,2,2,3,single-choice,spatial-relational,2|3,7,2/3,230384,2
2,4,23,385,1,1593,1,13,6,6,7,single-choice,spatial-relational,6|7,7,6/7,230385,6
2,4,23,386,0,764,1,11,5,6,6,single-choice,spatial-relational,5|6,7,5/6,230386,5
2,4,23,387,1,609,1,3,1,1,2,single-choice,spatial-relational,1|2,7,1/2,230387,1
2,4,23,388,1,1179,1,9,4,4,5,single-choice,spatial-relational,4|5,7,4/5,230388,4
2,4,23,389,0,845,1,5,2,3,3,single-choice,spatial-relational,2|3,7,2/3,230389,2
2,4,23,390,1,835,1,9,4,4,5,single-choice,spatial-relational,4|5,7,4/5,230390,4
2,4,23,391,1,808,1,5,2,2,3,single-choice,spatial-relational,2|3,7,2/3,230391,2
2,4,23,392,1,958,1,13,6,6,7,single-choice,spatial-relational,6|7,7,6/7,230392,6
2,4,23,393,1,1101,1,7,3,3,4,single-choice,spatial-relational,3|4,7,3/4,230393,3
2,4,23,394,0,873,1,11,5,6,6,single-choice,spatial-relational,5|6,7,5/6,230394,5
2,4,23,395,1,881,1,3,1,1,2,single-choice,spatial-relational,1|2,7,1/2,230395,1
2,4,23,396,1,1069,1,7,3,3,4,single-choice,spatial-relational,3|4,7,3/4,230396,3
2,4,23,397,0,508,1,7,3,4,4,single-choice,spatial-relational,3|4,7,3/4,230397,3
2,4,23,398,1,1289,1,13,6,6,7,single-choice,spatial-relational,6|7,7,6/7,230398,6
2,4,23,399,0,963,1,9,4,5,5,single-choice,spatial-relational,4|5,7,4/5,230399,4
2,4,23,400,1,1366,1,11,5,5,6,single-choice,spatial-relational,5|6,7,5/6,230400,5
2,4,23,401,1,691,1,9,4,4,5,single-choice,spatial-relational,4|5,7,4/5,230401,4
2,4,23,402,0,1413,1,11,5,6,6,single-choice,spatial-relational,5|6,7,5/6,230402,5
2,4,23,403,1,660,1,3,1,1,2,single-choice,spatial-relational,1|2,7,1/2,230403,1
2,4,23,404,1,976,1,7,3,3,4,single-choice,spatial-relational,3|4,7,3/4,230404,3
2,4,23,405,1,1087,1,5,2,2,3,single-choice,spatial-relational,2|3,7,2/3,230405,2
2,4,23,406,1,1042,1,3,1,1,2,single-choice,spatial-relational,1|2,7,1/2,230406,1
2,4,23,407,1,1042,1,13,6,6,7,single-choice,spatial-relational,6|7,7,6/7,230407,6
2,4,23,408,1,1550,1,5,2,2,3,single-choice,spatial-relational,2|3,7,2/3,230408,2
2,4,23,409,1,908,1,13,6,6,7,single-choice,spatial-relational,6|7,7,6/7,230409,6
2,4,23,410,1,1264,1,9,4,4,5,single-choice,spatial-relational,4|5,7,4/5,230410,4
2,4,23,411,1,1332,1,5,2,2,3,single-choice,spatial-relational,2|3,7,2/3,230411,2
2,4,23,412,0,1201,1,7,3,4,4,single-choice,spatial-relational,3|4,7,3/4,230412,3
2,4,23,413,0,803,1,11,5,6,6,single-choice,spatial-relational,5|6,7,5/6,230413,5
2,4,23,414,1,3,1,5,2,2,3,single-choice,spatial-relational,2|3,7,2/3,230414,2
2,4,23,415,1,1825,1,9,4,4,5,single-choice,spatial-relational,4|5,7,4/5,230415,4
2,4,23,416,1,2369,1,13,6,6,7,single-choice,spatial-relational,6|7,7,6/7,230416,6
2,4,23,417,1,620,1,3,1,1,2,single-choice,spatial-relational,1|2,7,1/2,230417,1
2,4,23,418,1,1073,1,7,3,3,4,single-choice,spatial-relational,3|4,7,3/4,230418,3
2,4,23,419,1,1102,1,11,5,5,6,single-choice,spatial-relational,5|6,7,5/6,230419,5
2,4,23,420,1,1068,1,3,1,1,2,single-choice,spatial-relational,1|2,7,1/2,230420,1
2,4,23,421,1,655,1,3,1,1,2,single-choice,spatial-relational,1|2,7,1/2,230421,1
2,4,23,422,0,690,1,11,5,6,6,single-choice,spatial-relational,5|6,7,5/6,230422,5
2,4,23,423,0,1034,1,7,3,4,4,single-choice,spatial-relational,3|4,7,3/4,230423,3
2,4,23,424,1,870,1,13,6,6,7,single-choice,spatial-relational,6|7,7,6/7,230424,6
2,4,23,425,0,1117,1,9,4,5,5,single-choice,spatial-relational,4|5,7,4/5,230425,4
2,4,23,426,1,957,1,5,2,2,3,single-choice,spatial-relational,2|3,7,2/3,230426,2
2,4,23,427,1,813,1,5,2,2,3,single-choice,spatial-relational,2|3,7,2/3,230427,2
2,4,23,428,1,673,1,3,1,1,2,single-choice,spatial-relational,1|2,7,1/2,230428,1
2,4,23,429,1,899,1,13,6,6,7,single-choice,spatial-relational,6|7,7,6/7,230429,6
2,4,23,430,1,1002,1,7,3,3,4,single-choice,spatial-relational,3|4,7,3/4,230430,3
2,4,23,431,1,1441,1,11,5,5,6,single-choice,spatial-relational,5|6,7,5/6,230431,5
2,4,23,432,1,536,1,9,4,4,5,single-choice,spatial-relational,4|5,7,4/5,230432,4
2,4,23,433,0,700,1,7,3,4,4,single-choice,spatial-relational,3|4,7,3/4,230433,3
2,4,23,434,0,688,1,3,1,2,2,single-choice,spatial-relational,1|2,7,1/2,230434,1
2,4,23,435,0,36,1,5,2,3,3,single-choice,spatial-relational,2|3,7,2/3,230435,2
2,4,23,436,0,1041,1,11,5,6,6,single-choice,spatial-relational,5|6,7,5/6,230436,5
2,4,23,437,1,1446,1,9,4,4,5,single-choice,spatial-relational,4|5,7,4/5,230437,4
2,4,23,438,1,954,1,13,6,6,7,single-choice,spatial-relational,6|7,7,6/7,230438,6
2,4,23,439,1,574,1,3,1,1,2,single-choice,spatial-relational,1|2,7,1/2,230439,1
2,4,23,440,1,990,1,11,5,5,6,single-choice,spatial-relational,5|6,7,5/6,230440,5
2,4,23,441,1,971,1,7,3,3,4,single-choice,spatial-relational,3|4,7,3/4,230441,3
2,4,23,442,1,1692,1,9,4,4,5,single-choice,spatial-relational,4|5,7,4/5,230442,4
2,4,23,443,0,1246,1,5,2,3,3,single-choice,spatial-relational,2|3,7,2/3,230443,2
2,4,23,444,1,792,1,13,6,6,7,single-choice,spatial-relational,6|7,7,6/7,230444,6
2,4,23,445,1,907,1,13,6,6,7,single-choice,spatial-relational,6|7,7,6/7,230445,6
2,4,23,446,1,1057,1,7,3,3,4,single-choice,spatial-relational,3|4,7,3/4,230446,3
2,4,23,447,1,646,1,3,1,1,2,single-choice,spatial-relational,1|2,7,1/2,230447,1
2,4,23,448,1,900,1,3,1,1,2,single-choice,spatial-relational,1|2,7,1/2,230448,1
2,4,23,449,1,1227,1,11,5,5,6,single-choice,spatial-relational,5|6,7,5/6,230449,5
2,4,23,450,1,898,1,13,6,6,7,single-choice,spatial-relational,6|7,7,6/7,230450,6
2,4,23,451,1,1395,1,11,5,5,6,single-choice,spatial-relational,5|6,7,5/6,230451,5
2,4,23,452,0,571,1,7,3,4,4,single-choice,spatial-relational,3|4,7,3/4,230452,3
2,4,23,453,0,2,1,5,2,3,3,single-choice,spatial-relational,2|3,7,2/3,230453,2
2,4,23,454,1,850,1,9,4,4,5,single-choice,spatial-relational,4|5,7,4/5,230454,4
2,4,23,455,1,1102,1,5,2,2,3,single-choice,spatial-relational,2|3,7,2/3,230455,2
2,4,23,456,1,1181,1,9,4,4,5,single-choice,spatial-relational,4|5,7,4/5,230456,4
2,4,23,457,1,1680,1,11,5,5,6,single-choice,spatial-relational,5|6,7,5/6,230457,5
2,4,23,458,1,1176,1,5,2,2,3,single-choice,spatial-relational,2|3,7,2/3,230458,2
2,4,23,459,1,892,1,7,3,3,4,single-choice,spatial-relational,3|4,7,3/4,230459,3
2,4,23,460,1,1465,1,9,4,4,5,single-choice,spatial-relational,4|5,7,4/5,230460,4
2,4,23,461,1,1281,1,5,2,2,3,single-choice,spatial-relational,2|3,7,2/3,230461,2
2,4,23,462,0,840,1,11,5,6,6,single-choice,spatial-relational,5|6,7,5/6,230462,5
2,4,23,463,0,547,1,7,3,4,4,single-choice,spatial-relational,3|4,7,3/4,230463,3
2,4,23,464,1,913,1,9,4,4,5,single-choice,spatial-relational,4|5,7,4/5,230464,4
2,4,23,465,1,1538,1,3,1,1,2,single-choice,spatial-relational,1|2,7,1/2,230465,1
2,4,23,466,1,2,1,13,6,6,7,single-choice,spatial-relational,6|7,7,6/7,230466,6
2,4,23,467,1,2,1,3,1,1,2,single-choice,spatial-relational,1|2,7,1/2,230467,1
2,4,23,468,0,38,1,13,6,7,7,single-choice,spatial-relational,6|7,7,6/7,230468,6
2,4,23,469,0,43,1,9,4,5,5,single-choice,spatial-relational,4|5,7,4/5,230469,4
2,4,23,470,0,1709,1,5,2,3,3,single-choice,spatial-relational,2|3,7,2/3,230470,2
2,4,23,471,0,899,1,5,2,3,3,single-choice,spatial-relational,2|3,7,2/3,230471,2
2,4,23,472,0,763,1,11,5,6,6,single-choice,spatial-relational,5|6,7,5/6,230472,5
2,4,23,473,1,885,1,13,6,6,7,single-choice,spatial-relational,6|7,7,6/7,230473,6
2,4,23,474,1,1599,1,7,3,3,4,single-choice,spatial-relational,3|4,7,3/4,230474,3
2,4,23,475,1,879,1,13,6,6,7,single-choice,spatial-relational,6|7,7,6/7,230475,6
2,4,23,476,0,608,1,7,3,4,4,single-choice,spatial-relational,3|4,7,3/4,230476,3
2,4,23,477,1,1049,1,3,1,1,2,single-choice,spatial-relational,1|2,7,1/2,230477,1
2,4,23,478,0,882,1,9,4,5,5,single-choice,spatial-relational,4|5,7,4/5,230478,4
2,4,23,479,1,801,1,3,1,1,2,single-choice,spatial-relational,1|2,7,1/2,230479,1
2,4,23,480,0,711,1,11,5,6,6,single-choice,spatial-relational,5|6,7,5/6,230480,5
2,4,23,481,1,1065,1,7,3,3,4,single-choice,spatial-relational,3|4,7,3/4,230481,3
2,4,23,482,1,960,1,7,3,3,4,single-choice,spatial-relational,3|4,7,3/4,230482,3
2,4,23,483,1,1266,1,9,4,4,5,single-choice,spatial-relational,4|5,7,4/5,230483,4
2,4,23,484,1,1777,1,5,2,2,3,single-choice,spatial-relational,2|3,7,2/3,230484,2
2,4,23,485,1,857,1,3,1,1,2,single-choice,spatial-relational,1|2,7,1/2,230485,1
2,4,23,486,0,1377,1,11,5,6,6,single-choice,spatial-relational,5|6,7,5/6,230486,5
2,4,23,487,1,983,1,13,6,6,7,single-choice,spatial-relational,6|7,7,6/7,230487,6
2,4,23,488,1,1182,1,9,4,4,5,single-choice,spatial-relational,4|5,7,4/5,230488,4
2,4,23,489,0,821,1,11,5,6,6,single-choice,spatial-relational,5|6,7,5/6,230489,5
2,4,23,490,1,847,1,3,1,1,2,single-choice,spatial-relational,1|2,7,1/2,230490,1
2,4,23,491,1,827,1,13,6,6,7,single-choice,spatial-relational,6|7,7,6/7,230491,6
2,4,23,492,0,1067,1,5,2,3,3,single-choice,spatial-relational,2|3,7,2/3,230492,2
2,4,23,493,1,1196,1,9,4,4,5,single-choice,spatial-relational,4|5,7,4/5,230493,4
2,4,23,494,1,610,1,9,4,4,5,single-choice,spatial-relational,4|5,7,4/5,230494,4
2,4,23,495,1,1286,1,13,6,6,7,single-choice,spatial-relational,6|7,7,6/7,230495,6
2,4,23,496,0,515,1,7,3,4,4,single-choice,spatial-relational,3|4,7,3/4,230496,3
2,4,23,497,1,1887,1,11,5,5,6,single-choice,spatial-relational,5|6,7,5/6,230497,5
2,4,23,498,1,590,1,3,1,1,2,single-choice,spatial-relational,1|2,7,1/2,230498,1
2,4,23,499,0,1008,1,5,2,3,3,single-choice,spatial-relational,2|3,7,2/3,230499,2
2,4,23,500,0,828,1,7,3,4,4,single-choice,spatial-relational,3|4,7,3/4,230500,3
2,4,23,501,1,1322,1,11,5,5,6,single-choice,spatial-relational,5|6,7,5/6,230501,5
2,4,23,502,1,792,1,3,1,1,2,single-choice,spatial-relational,1|2,7,1/2,230502,1
2,4,23,503,1,844,1,13,6,6,7,single-choice,spatial-relational,6|7,7,6/7,230503,6
2,4,23,504,1,1288,1,5,2,2,3,single-choice,spatial-relational,2|3,7,2/3,230504,2
2,4,23,505,1,1064,1,5,2,2,3,single-choice,spatial-relational,2|3,7,2/3,230505,2
2,4,23,506,1,2299,1,11,5,5,6,single-choice,spatial-relational,5|6,7,5/6,230506,5
2,4,23,507,1,1084,1,11,5,5,6,single-choice,spatial-relational,5|6,7,5/6,230507,5
2,4,23,508,0,875,1,13,6,7,7,single-choice,spatial-relational,6|7,7,6/7,230508,6
2,4,23,509,0,816,1,3,1,2,2,single-choice,spatial-relational,1|2,7,1/2,230509,1
2,4,23,510,1,2,1,7,3,3,4,single-choice,spatial-relational,3|4,7,3/4,230510,3
2,4,23,511,1,778,1,3,1,1,2,single-choice,spatial-relational,1|2,7,1/2,230511,1
2,4,23,512,1,1198,1,9,4,4,5,single-choice,spatial-relational,4|5,7,4/5,230512,4
2,4,23,513,1,522,1,9,4,4,5,single-choice,spatial-relational,4|5,7,4/5,230513,4
2,4,23,514,1,1093,1,7,3,3,4,single-choice,spatial-relational,3|4,7,3/4,230514,3
2,4,23,515,1,1598,1,5,2,2,3,single-choice,spatial-relational,2|3,7,2/3,230515,2
2,4,23,516,1,842,1,13,6,6,7,single-choice,spatial-relational,6|7,7,6/7,230516,6
2,4,23,517,1,1119,1,7,3,3,4,single-choice,spatial-relational,3|4,7,3/4,230517,3
2,4,23,518,1,1110,1,11,5,5,6,single-choice,spatial-relational,5|6,7,5/6,230518,5
2,4,23,519,1,1041,1,5,2,2,3,single-choice,spatial-relational,2|3,7,2/3,230519,2
2,4,23,520,1,702,1,13,6,6,7,single-choice,spatial-relational,6|7,7,6/7,230520,6
2,4,23,521,1,555,1,3,1,1,2,single-choice,spatial-relational,1|2,7,1/2,230521,1
2,4,23,522,1,489,1,5,2,2,3,single-choice,spatial-relational,2|3,7,2/3,230522,2
2,4,23,523,1,689,1,9,4,4,5,single-choice,spatial-relational,4|5,7,4/5,230523,4
2,4,23,524,0,112855,1,9,4,5,5,single-choice,spatial-relational,4|5,7,4/5,230524,4
2,4,23,525,1,1127,1,3,1,1,2,single-choice,spatial-relational,1|2,7,1/2,230525,1
2,4,23,526,1,919,1,7,3,3,4,single-choice,spatial-relational,3|4,7,3/4,230526,3
2,4,23,527,1,953,1,13,6,6,7,single-choice,spatial-relational,6|7,7,6/7,230527,6
2,4,23,528,1,1157,1,11,5,5,6,single-choice,spatial-relational,5|6,7,5/6,230528,5
2,4,23,529,1,748,1,13,6,6,7,single-choice,spatial-relational,6|7,7,6/7,230529,6
2,4,23,530,1,1010,1,9,4,4,5,single-choice,spatial-relational,4|5,7,4/5,230530,4
2,4,23,531,1,865,1,3,1,1,2,single-choice,spatial-relational,1|2,7,1/2,230531,1
2,4,23,532,1,1450,1,11,5,5,6,single-choice,spatial-relational,5|6,7,5/6,230532,5
2,4,23,533,0,1331,1,13,6,7,7,single-choice,spatial-relational,6|7,7,6/7,230533,6
2,4,23,534,1,1034,1,7,3,3,4,single-choice,spatial-relational,3|4,7,3/4,230534,3
2,4,23,535,1,1072,1,5,2,2,3,single-choice,spatial-relational,2|3,7,2/3,230535,2
2,4,23,536,1,1906,1,9,4,4,5,single-choice,spatial-relational,4|5,7,4/5,230536,4
2,4,23,537,1,995,1,5,2,2,3,single-choice,spatial-relational,2|3,7,2/3,230537,2
2,4,23,538,1,1102,1,11,5,5,6,single-choice,spatial-relational,5|6,7,5/6,230538,5
2,4,23,539,1,567,1,3,1,1,2,single-choice,spatial-relational,1|2,7,1/2,230539,1
2,4,23,540,1,918,1,7,3,3,4,single-choice,spatial-relational,3|4,7,3/4,230540,3
2,4,23,541,0,1137,1,7,3,4,4,single-choice,spatial-relational,3|4,7,3/4,230541,3
2,4,23,542,1,1530,1,3,1,1,2,single-choice,spatial-relational,1|2,7,1/2,230542,1
2,4,23,543,1,1090,1,7,3,3,4,single-choice,spatial-relational,3|4,7,3/4,230543,3
2,4,23,544,1,855,1,13,6,6,7,single-choice,spatial-relational,6|7,7,6/7,230544,6
2,4,23,545,0,834,1,11,5,6,6,single-choice,spatial-relational,5|6,7,5/6,230545,5
2,4,23,546,1,1674,1,9,4,4,5,single-choice,spatial-relational,4|5,7,4/5,230546,4
2,4,23,547,1,1268,1,11,5,5,6,single-choice,spatial-relational,5|6,7,5/6,230547,5
2,4,23,548,1,983,1,13,6,6,7,single-choice,spatial-relational,6|7,7,6/7,230548,6
2,4,23,549,1,811,1,3,1,1,2,single-choice,spatial-relational,1|2,7,1/2,230549,1
2,4,23,550,0,955,1,5,2,3,3,single-choice,spatial-relational,2|3,7,2/3,230550,2
2,4,23,551,1,1995,1,9,4,4,5,single-choice,spatial-relational,4|5,7,4/5,230551,4
2,4,23,552,0,937,1,5,2,3,3,single-choice,spatial-relational,2|3,7,2/3,230552,2
2,4,23,553,0,524,1,11,5,6,6,single-choice,spatial-relational,5|6,7,5/6,230553,5
2,4,23,554,1,798,1,5,2,2,3,single-choice,spatial-relational,2|3,7,2/3,230554,2
2,4,23,555,0,967,1,7,3,4,4,single-choice,spatial-relational,3|4,7,3/4,230555,3
2,4,23,556,1,738,1,13,6,6,7,single-choice,spatial-relational,6|7,7,6/7,230556,6
2,4,23,557,1,817,1,9,4,4,5,single-choice,spatial-relational,4|5,7,4/5,230557,4
2,4,23,558,0,414,1,3,1,2,2,single-choice,spatial-relational,1|2,7,1/2,230558,1
2,4,23,559,1,754,1,13,6,6,7,single-choice,spatial-relational,6|7,7,6/7,230559,6
2,4,23,560,1,1127,1,5,2,2,3,single-choice,spatial-relational,2|3,7,2/3,230560,2
2,4,23,561,1,650,1,3,1,1,2,single-choice,spatial-relational,1|2,7,1/2,230561,1
2,4,23,562,0,3760,1,7,3,4,4,single-choice,spatial-relational,3|4,7,3/4,230562,3
2,4,23,563,0,804,1,11,5,6,6,single-choice,spatial-relational,5|6,7,5/6,230563,5
2,4,23,564,1,903,1,9,4,4,5,single-choice,spatial-relational,4|5,7,4/5,230564,4
2,4,23,565,1,779,1,3,1,1,2,single-choice,spatial-relational,1|2,7,1/2,230565,1
2,4,23,566,0,828,1,11,5,6,6,single-choice,spatial-relational,5|6,7,5/6,230566,5
2,4,23,567,0,1037,1,5,2,3,3,single-choice,spatial-relational,2|3,7,2/3,230567,2
2,4,23,568,0,11,1,11,5,6,6,single-choice,spatial-relational,5|6,7,5/6,230568,5
2,4,23,569,0,707,1,7,3,4,4,single-choice,spatial-relational,3|4,7,3/4,230569,3
2,4,23,570,1,859,1,13,6,6,7,single-choice,spatial-relational,6|7,7,6/7,230570,6
2,4,23,571,1,752,1,3,1,1,2,single-choice,spatial-relational,1|2,7,1/2,230571,1
2,4,23,572,1,854,1,13,6,6,7,single-choice,spatial-relational,6|7,7,6/7,230572,6
2,4,23,573,1,1221,1,9,4,4,5,single-choice,spatial-relational,4|5,7,4/5,230573,4
2,4,23,574,0,958,1,5,2,3,3,single-choice,spatial-relational,2|3,7,2/3,230574,2
2,4,23,575,0,1003,1,9,4,5,5,single-choice,spatial-relational,4|5,7,4/5,230575,4
2,4,23,576,1,970,1,7,3,3,4,single-choice,spatial-relational,3|4,7,3/4,230576,3
2,4,23,577,1,1381,1,5,2,2,3,single-choice,spatial-relational,2|3,7,2/3,230577,2
2,4,23,578,1,751,1,13,6,6,7,single-choice,spatial-relational,6|7,7,6/7,230578,6
2,4,23,579,1,789,1,7,3,3,4,single-choice,spatial-relational,3|4,7,3/4,230579,3
2,4,23,580,0,880,1,9,4,5,5,single-choice,spatial-relational,4|5,7,4/5,230580,4
2,4,23,581,1,854,1,9,4,4,5,single-choice,spatial-relational,4|5,7,4/5,230581,4
2,4,23,582,1,618,1,13,6,6,7,single-choice,spatial-relational,6|7,7,6/7,230582,6
2,4,23,583,1,1182,1,5,2,2,3,single-choice,spatial-relational,2|3,7,2/3,230583,2
2,4,23,584,0,1034,1,11,5,6,6,single-choice,spatial-relational,5|6,7,5/6,230584,5
2,4,23,585,0,4987,1,11,5,6,6,single-choice,spatial-relational,5|6,7,5/6,230585,5
2,4,23,586,1,759,1,3,1,1,2,single-choice,spatial-relational,1|2,7,1/2,230586,1
2,4,23,587,1,679,1,3,1,1,2,single-choice,spatial-relational,1|2,7,1/2,230587,1
2,4,23,588,1,1674,1,7,3,3,4,single-choice,spatial-relational,3|4,7,3/4,230588,3
2,4,23,589,1,911,1,7,3,3,4,single-choice,spatial-relational,3|4,7,3/4,230589,3
2,4,23,590,1,776,1,9,4,4,5,single-choice,spatial-relational,4|5,7,4/5,230590,4
2,4,23,591,0,881,1,11,5,6,6,single-choice,spatial-relational,5|6,7,5/6,230591,5
2,4,23,592,0,899,1,7,3,4,4,single-choice,spatial-relational,3|4,7,3/4,230592,3
2,4,23,593,1,790,1,5,2,2,3,single-choice,spatial-relational,2|3,7,2/3,230593,2
2,4,23,594,1,1041,1,9,4,4,5,single-choice,spatial-relational,4|5,7,4/5,230594,4
2,4,23,595,1,1066,1,3,1,1,2,single-choice,spatial-relational,1|2,7,1/2,230595,1
2,4,23,596,1,1273,1,3,1,1,2,single-choice,spatial-relational,1|2,7,1/2,230596,1
2,4,23,597,0,829,1,5,2,3,3,single-choice,spatial-relational,2|3,7,2/3,230597,2
2,4,23,598,1,946,1,13,6,6,7,single-choice,spatial-relational,6|7,7,6/7,230598,6
2,4,23,599,1,1533,1,11,5,5,6,single-choice,spatial-relational,5|6,7,5/6,230599,5
2,4,23,600,1,1274,1,13,6,6,7,single-choice,spatial-relational,6|7,7,6/7,230600,6
3,4,23,1,0,749,1,7,3,4,4,single-choice,spatial-relational,3|4,7,3/4,230001,3
3,4,23,2,1,978,1,13,6,6,7,single-choice,spatial-relational,6|7,7,6/7,230002,6
3,4,23,3,0,1858,1,9,4,5,5,single-choice,spatial-relational,4|5,7,4/5,230003,4
3,4,23,4,0,1010,1,5,2,3,3,single-choice,spatial-relational,2|3,7,2/3,230004,2
3,4,23,5,0,1057,1,9,4,5,5,single-choice,spatial-relational,4|5,7,4/5,230005,4
3,4,23,6,1,1344,1,7,3,3,4,single-choice,spatial-relational,3|4,7,3/4,230006,3
3,4,23,7,1,849,1,3,1,1,2,single-choice,spatial-relational,1|2,7,1/2,230007,1
3,4,23,8,0,1190,1,3,1,2,2,single-choice,spatial-relational,1|2,7,1/2,230008,1
3,4,23,9,0,1407,1,11,5,6,6,single-choice,spatial-relational,5|6,7,5/6,230009,5
3,4,23,10,0,810,1,11,5,6,6,single-choice,spatial-relational,5|6,7,5/6,230010,5
3,4,23,11,1,989,1,5,2,2,3,single-choice,spatial-relational,2|3,7,2/3,230011,2
3,4,23,12,1,795,1,13,6,6,7,single-choice,spatial-relational,6|7,7,6/7,230012,6
3,4,23,13,1,1146,1,7,3,3,4,single-choice,spatial-relational,3|4,7,3/4,230013,3
3,4,23,14,0,1151,1,11,5,6,6,single-choice,spatial-relational,5|6,7,5/6,230014,5
3,4,23,15,1,951,1,7,3,3,4,single-choice,spatial-relational,3|4,7,3/4,230015,3
3,4,23,16,1,874,1,3,1,1,2,single-choice,spatial-relational,1|2,7,1/2,230016,1
3,4,23,17,1,1017,1,9,4,4,5,single-choice,spatial-relational,4|5,7,4/5,230017,4
3,4,23,18,1,642,1,13,6,6,7,single-choice,spatial-relational,6|7,7,6/7,230018,6
3,4,23,19,1,949,1,9,4,4,5,single-choice,spatial-relational,4|5,7,4/5,230019,4
3,4,23,20,1,918,1,3,1,1,2,single-choice,spatial-relational,1|2,7,1/2,230020,1
3,4,23,21,1,1047,1,13,6,6,7,single-choice,spatial-relational,6|7,7,6/7,230021,6
3,4,23,22,1,1650,1,11,5,5,6,single-choice,spatial-relational,5|6,7,5/6,230022,5
3,4,23,23,1,1200,1,5,2,2,3,single-choice,spatial-relational,2|3,7,2/3,230023,2
3,4,23,24,1,1780,1,5,2,2,3,single-choice,spatial-relational,2|3,7,2/3,230024,2
3,4,23,25,1,1385,1,9,4,4,5,single-choice,spatial-relational,4|5,7,4/5,230025,4
3,4,23,26,1,985,1,5,2,2,3,single-choice,spatial-relational,2|3,7,2/3,230026,2
3,4,23,27,1,954,1,3,1,1,2,single-choice,spatial-relational,1|2,7,1/2,230027,1
3,4,23,28,1,1374,1,13,6,6,7,single-choice,spatial-relational,6|7,7,6/7,230028,6
3,4,23,29,1,650,1,13,6,6,7,single-choice,spatial-relational,6|7,7,6/7,230029,6
3,4,23,30,1,999,1,11,5,5,6,single-choice,spatial-relational,5|6,7,5/6,230030,5
3,4,23,31,0,1203,1,9,4,5,5,single-choice,spatial-relational,4|5,7,4/5,230031,4
3,4,23,32,1,1258,1,5,2,2,3,single-choice,spatial-relational,2|3,7,2/3,230032,2
3,4,23,33,1,1291,1,11,5,5,6,single-choice,spatial-relational,5|6,7,5/6,230033,5
3,4,23,34,1,1029,1,3,1,1,2,single-choice,spatial-relational,1|2,7,1/2,230034,1
3,4,23,35,1,854,1,7,3,3,4,single-choice,spatial-relational,3|4,7,3/4,230035,3
3,4,23,36,0,526,1,7,3,4,4,single-choice,spatial-relational,3|4,7,3/4,230036,3
3,4,23,37,1,1617,1,13,6,6,7,single-choice,spatial-relational,6|7,7,6/7,230037,6
3,4,23,38,1,1364,1,11,5,5,6,single-choice,spatial-relational,5|6,7,5/6,230038,5
3,4,23,39,1,1631,1,5,2,2,3,single-choice,spatial-relational,2|3,7,2/3,230039,2
3,4,23,40,1,1676,1,9,4,4,5,single-choice,spatial-relational,4|5,7,4/5,230040,4
3,4,23,41,1,1144,1,7,3,3,4,single-choice,spatial-relational,3|4,7,3/4,230041,3
3,4,23,42,1,1166,1,11,5,5,6,single-choice,spatial-relational,5|6,7,5/6,230042,5
3,4,23,43,0,1104,1,13,6,7,7,single-choice,spatial-relational,6|7,7,6/7,230043,6
3,4,23,44,0,1415,1,7,3,4,4,single-choice,spatial-relational,3|4,7,3/4,230044,3
3,4,23,45,1,1047,1,9,4,4,5,single-choice,spatial-relational,4|5,7,4/5,230045,4
3,4,23,46,1,942,1,3,1,1,2,single-choice,spatial-relational,1|2,7,1/2,230046,1
3,4,23,47,1,1150,1,3,1,1,2,single-choice,spatial-relational,1|2,7,1/2,230047,1
3,4,23,48,1,1094,1,5,2,2,3,single-choice,spatial-relational,2|3,7,2/3,230048,2
3,4,23,49,1,1256,1,11,5,5,6,single-choice,spatial-relational,5|6,7,5/6,230049,5
3,4,23,50,1,1017,1,3,1,1,2,single-choice,spatial-relational,1|2,7,1/2,230050,1
3,4,23,51,0,847,1,13,6,7,7,single-choice,spatial-relational,6|7,7,6/7,230051,6
3,4,23,52,1,940,1,9,4,4,5,single-choice,spatial-relational,4|5,7,4/5,230052,4
3,4,23,53,1,1154,1,5,2,2,3,single-choice,spatial-relational,2|3,7,2/3,230053,2
3,4,23,54,1,911,1,13,6,6,7,single-choice,spatial-relational,6|7,7,6/7,230054,6
3,4,23,55,1,1252,1,7,3,3,4,single-choice,spatial-relational,3|4,7,3/4,230055,3
3,4,23,56,1,999,1,3,1,1,2,single-choice,spatial-relational,1|2,7,1/2,230056,1
3,4,23,57,0,1193,1,7,3,4,4,single-choice,spatial-relational,3|4,7,3/4,230057,3
3,4,23,58,0,1041,1,11,5,6,6,single-choice,spatial-relational,5|6,7,5/6,230058,5
3,4,23,59,1,1545,1,5,2,2,3,single-choice,spatial-relational,2|3,7,2/3,230059,2
3,4,23,60,1,763,1,9,4,4,5,single-choice,spatial-relational,4|5,7,4/5,230060,4
3,4,23,61,1,1009,1,3,1,1,2,single-choice,spatial-relational,1|2,7,1/2,230061,1
3,4,23,62,1,1357,1,5,2,2,3,single-choice,spatial-relational,2|3,7,2/3,230062,2
3,4,23,63,1,956,1,13,6,6,7,single-choice,spatial-relational,6|7,7,6/7,230063,6
3,4,23,64,1,1000,1,7,3,3,4,single-choice,spatial-relational,3|4,7,3/4,230064,3
3,4,23,65,1,1598,1,9,4,4,5,single-choice,spatial-relational,4|5,7,4/5,230065,4
3,4,23,66,0,1236,1,5,2,3,3,single-choice,spatial-relational,2|3,7,2/3,230066,2
3,4,23,67,0,1206,1,11,5,6,6,single-choice,spatial-relational,5|6,7,5/6,230067,5
3,4,23,68,0,838,1,13,6,7,7,single-choice,spatial-relational,6|7,7,6/7,230068,6
3,4,23,69,1,1358,1,9,4,4,5,single-choice,spatial-relational,4|5,7,4/5,230069,4
3,4,23,70,1,1629,1,7,3,3,4,single-choice,spatial-relational,3|4,7,3/4,230070,3
3,4,23,71,1,792,1,3,1,1,2,single-choice,spatial-relational,1|2,7,1/2,230071,1
3,4,23,72,1,1085,1,11,5,5,6,single-choice,spatial-relational,5|6,7,5/6,230072,5
3,4,23,73,0,2429,1,7,3,4,4,single-choice,spatial-relational,3|4,7,3/4,230073,3
3,4,23,74,1,1097,1,5,2,2,3,single-choice,spatial-relational,2|3,7,2/3,230074,2
3,4,23,75,0,786,1,13,6,7,7,single-choice,spatial-relational,6|7,7,6/7,230075,6
3,4,23,76,1,800,1,9,4,4,5,single-choice,spatial-relational,4|5,7,4/5,230076,4
3,4,23,77,0,1690,1,11,5,6,6,single-choice,spatial-relational,5|6,7,5/6,230077,5
3,4,23,78,1,913,1,9,4,4,5,single-choice,spatial-relational,4|5,7,4/5,230078,4
3,4,23,79,1,1165,1,5,2,2,3,single-choice,spatial-relational,2|3,7,2/3,230079,2
3,4,23,80,1,874,1,3,1,1,2,single-choice,spatial-relational,1|2,7,1/2,230080,1
3,4,23,81,1,869,1,3,1,1,2,single-choice,spatial-relational,1|2,7,1/2,230081,1
3,4,23,82,1,1595,1,13,6,6,7,single-choice,spatial-relational,6|7,7,6/7,230082,6
3,4,23,83,1,2051,1,11,5,5,6,single-choice,spatial-relational,5|6,7,5/6,230083,5
3,4,23,84,1,2077,1,7,3,3,4,single-choice,spatial-relational,3|4,7,3/4,230084,3
3,4,23,85,1,576,1,9,4,4,5,single-choice,spatial-relational,4|5,7,4/5,230085,4
3,4,23,86,1,1869,1,11,5,5,6,single-choice,spatial-relational,5|6,7,5/6,230086,5
3,4,23,87,1,1205,1,5,2,2,3,single-choice,spatial-relational,2|3,7,2/3,230087,2
3,4,23,88,1,1007,1,11,5,5,6,single-choice,spatial-relational,5|6,7,5/6,230088,5
3,4,23,89,1,970,1,5,2,2,3,single-choice,spatial-relational,2|3,7,2/3,230089,2
3,4,23,90,1,1254,1,9,4,4,5,single-choice,spatial-relational,4|5,7,4/5,230090,4
3,4,23,91,1,1274,1,7,3,3,4,single-choice,spatial-relational,3|4,7,3/4,230091,3
3,4,23,92,1,1042,1,13,6,6,7,single-choice,spatial-relational,6|7,7,6/7,230092,6
3,4,23,93,1,854,1,3,1,1,2,single-choice,spatial-relational,1|2,7,1/2,230093,1
3,4,23,94,1,906,1,13,6,6,7,single-choice,spatial-relational,6|7,7,6/7,230094,6
3,4,23,95,0,447,1,7,3,4,4,single-choice,spatial-relational,3|4,7,3/4,230095,3
3,4,23,96,1,675,1,3,1,1,2,single-choice,spatial-relational,1|2,7,1/2,230096,1
3,4,23,97,1,1104,1,7,3,3,4,single-choice,spatial-relational,3|4,7,3/4,230097,3
3,4,23,98,1,1583,1,11,5,5,6,single-choice,spatial-relational,5|6,7,5/6,230098,5
3,4,23,99,1,1163,1,13,6,6,7,single-choice,spatial-relational,6|7,7,6/7,230099,6
3,4,23,100,1,893,1,3,1,1,2,single-choice,spatial-relational,1|2,7,1/2,230100,1
3,4,23,101,1,764,1,5,2,2,3,single-choice,spatial-relational,2|3,7,2/3,230101,2
3,4,23,102,1,1346,1,13,6,6,7,single-choice,spatial-relational,6|7,7,6/7,230102,6
3,4,23,103,0,878,1,5,2,3,3,single-choice,spatial-relational,2|3,7,2/3,230103,2
3,4,23,104,1,688,1,3,1,1,2,single-choice,spatial-relational,1|2,7,1/2,230104,1
3,4,23,105,1,1078,1,7,3,3,4,single-choice,spatial-relational,3|4,7,3/4,230105,3
3,4,23,106,1,2146,1,11,5,5,6,single-choice,spatial-relational,5|6,7,5/6,230106,5
3,4,23,107,0,1042,1,9,4,5,5,single-choice,spatial-relational,4|5,7,4/5,230107,4
3,4,23,108,1,698,1,9,4,4,5,single-choice,spatial-relational,4|5,7,4/5,230108,4
3,4,23,109,0,774,1,7,3,4,4,single-choice,spatial-relational,3|4,7,3/4,230109,3
3,4,23,110,1,945,1,5,2,2,3,single-choice,spatial-relational,2|3,7,2/3,230110,2
3,4,23,111,1,773,1,3,1,1,2,single-choice,spatial-relational,1|2,7,1/2,230111,1
3,4,23,112,1,851,1,13,6,6,7,single-choice,spatial-relational,6|7,7,6/7,230112,6
3,4,23,113,1,940,1,7,3,3,4,single-choice,spatial-relational,3|4,7,3/4,230113,3
3,4,23,114,1,1936,1,9,4,4,5,single-choice,spatial-relational,4|5,7,4/5,230114,4
3,4,23,115,1,1086,1,5,2,2,3,single-choice,spatial-relational,2|3,7,2/3,230115,2
3,4,23,116,1,1150,1,11,5,5,6,single-choice,spatial-relational,5|6,7,5/6,230116,5
3,4,23,117,0,716,1,13,6,7,7,single-choice,spatial-relational,6|7,7,6/7,230117,6
3,4,23,118,0,1018,1,11,5,6,6,single-choice,spatial-relational,5|6,7,5/6,230118,5
3,4,23,119,1,650,1,9,4,4,5,single-choice,spatial-relational,4|5,7,4/5,230119,4
3,4,23,120,1,837,1,3,1,1,2,single-choice,spatial-relational,1|2,7,1/2,230120,1
3,4,23,121,1,1135,1,7,3,3,4,single-choice,spatial-relational,3|4,7,3/4,230121,3
3,4,23,122,1,2307,1,7,3,3,4,single-choice,spatial-relational,3|4,7,3/4,230122,3
3,4,23,123,0,1516,1,13,6,7,7,single-choice,spatial-relational,6|7,7,6/7,230123,6
3,4,23,124,1,999,1,5,2,2,3,single-choice,spatial-relational,2|3,7,2/3,230124,2
3,4,23,125,1,1025,1,11,5,5,6,single-choice,spatial-relational,5|6,7,5/6,230125,5
3,4,23,126,1,1620,1,11,5,5,6,single-choice,spatial-relational,5|6,7,5/6,230126,5
3,4,23,127,1,963,1,13,6,6,7,single-choice,spatial-relational,6|7,7,6/7,230127,6
3,4,23,128,0,1698,1,9,4,5,5,single-choice,spatial-relational,4|5,7,4/5,230128,4
3,4,23,129,1,1056,1,5,2,2,3,single-choice,spatial-relational,2|3,7,2/3,230129,2
3,4,23,130,1,750,1,3,1,1,2,single-choice,spatial-relational,1|2,7,1/2,230130,1
3,4,23,131,1,1045,1,9,4,4,5,single-choice,spatial-relational,4|5,7,4/5,230131,4
3,4,23,132,1,1234,1,3,1,1,2,single-choice,spatial-relational,1|2,7,1/2,230132,1
3,4,23,133,1,804,1,3,1,1,2,single-choice,spatial-relational,1|2,7,1/2,230133,1
3,4,23,134,1,1070,1,9,4,4,5,single-choice,spatial-relational,4|5,7,4/5,230134,4
3,4,23,135,0,1296,1,5,2,3,3,single-choice,spatial-relational,2|3,7,2/3,230135,2
3,4,23,136,0,803,1,7,3,4,4,single-choice,spatial-relational,3|4,7,3/4,230136,3
3,4,23,137,0,931,1,11,5,6,6,single-choice,spatial-relational,5|6,7,5/6,230137,5
3,4,23,138,1,647,1,13,6,6,7,single-choice,spatial-relational,6|7,7,6/7,230138,6
3,4,23,139,1,1293,1,5,2,2,3,single-choice,spatial-relational,2|3,7,2/3,230139,2
3,4,23,140,1,1835,1,9,4,4,5,single-choice,spatial-relational,4|5,7,4/5,230140,4
3,4,23,141,1,2293,1,13,6,6,7,single-choice,spatial-relational,6|7,7,6/7,230141,6
3,4,23,142,1,954,1,3,1,1,2,single-choice,spatial-relational,1|2,7,1/2,230142,1
3,4,23,143,1,1147,1,11,5,5,6,single-choice,spatial-relational,5|6,7,5/6,230143,5
3,4,23,144,1,2360,1,7,3,3,4,single-choice,spatial-relational,3|4,7,3/4,230144,3
3,4,23,145,1,1040,1,13,6,6,7,single-choice,spatial-relational,6|7,7,6/7,230145,6
3,4,23,146,1,805,1,3,1,1,2,single-choice,spatial-relational,1|2,7,1/2,230146,1
3,4,23,147,1,926,1,11,5,5,6,single-choice,spatial-relational,5|6,7,5/6,230147,5
3,4,23,148,0,1049,1,11,5,6,6,single-choice,spatial-relational,5|6,7,5/6,230148,5
3,4,23,149,0,1674,1,7,3,4,4,single-choice,spatial-relational,3|4,7,3/4,230149,3
3,4,23,150,1,3059,1,5,2,2,3,single-choice,spatial-relational,2|3,7,2/3,230150,2
3,4,23,151,1,888,1,9,4,4,5,single-choice,spatial-relational,4|5,7,4/5,230151,4
3,4,23,152,1,1099,1,5,2,2,3,single-choice,spatial-relational,2|3,7,2/3,230152,2
3,4,23,153,0,1120,1,9,4,5,5,single-choice,spatial-relational,4|5,7,4/5,230153,4
3,4,23,154,1,1007,1,7,3,3,4,single-choice,spatial-relational,3|4,7,3/4,230154,3
3,4,23,155,1,653,1,3,1,1,2,single-choice,spatial-relational,1|2,7,1/2,230155,1
3,4,23,156,1,1182,1,13,6,6,7,single-choice,spatial-relational,6|7,7,6/7,230156,6
3,4,23,157,1,749,1,3,1,1,2,single-choice,spatial-relational,1|2,7,1/2,230157,1
3,4,23,158,1,1050,1,9,4,4,5,single-choice,spatial-relational,4|5,7,4/5,230158,4
3,4,23,159,0,877,1,11,5,6,6,single-choice,spatial-relational,5|6,7,5/6,230159,5
3,4,23,160,1,485,1,5,2,2,3,single-choice,spatial-relational,2|3,7,2/3,230160,2
3,4,23,161,1,1554,1,9,4,4,5,single-choice,spatial-relational,4|5,7,4/5,230161,4
3,4,23,162,1,995,1,7,3,3,4,single-choice,spatial-relational,3|4,7,3/4,230162,3
3,4,23,163,1,617,1,3,1,1,2,single-choice,spatial-relational,1|2,7,1/2,230163,1
3,4,23,164,1,858,1,11,5,5,6,single-choice,spatial-relational,5|6,7,5/6,230164,5
3,4,23,165,1,832,1,5,2,2,3,single-choice,spatial-relational,2|3,7,2/3,230165,2
3,4,23,166,0,1412,1,7,3,4,4,single-choice,spatial-relational,3|4,7,3/4,230166,3
3,4,23,167,1,46,1,13,6,6,7,single-choice,spatial-relational,6|7,7,6/7,230167,6
3,4,23,168,1,1212,1,13,6,6,7,single-choice,spatial-relational,6|7,7,6/7,230168,6
3,4,23,169,1,952,1,11,5,5,6,single-choice,spatial-relational,5|6,7,5/6,230169,5
3,4,23,170,1,772,1,5,2,2,3,single-choice,spatial-relational,2|3,7,2/3,230170,2
3,4,23,171,0,1179,1,7,3,4,4,single-choice,spatial-relational,3|4,7,3/4,230171,3
3,4,23,172,1,2070,1,11,5,5,6,single-choice,spatial-relational,5|6,7,5/6,230172,5
3,4,23,173,1,603,1,3,1,1,2,single-choice,spatial-relational,1|2,7,1/2,230173,1
3,4,23,174,1,974,1,7,3,3,4,single-choice,spatial-relational,3|4,7,3/4,230174,3
3,4,23,175,1,1417,1,13,6,6,7,single-choice,spatial-relational,6|7,7,6/7,230175,6
3,4,23,176,1,765,1,9,4,4,5,single-choice,spatial-relational,4|5,7,4/5,230176,4
3,4,23,177,0,1201,1,9,4,5,5,single-choice,spatial-relational,4|5,7,4/5,230177,4
3,4,23,178,1,630,1,5,2,2,3,single-choice,spatial-relational,2|3,7,2/3,230178,2
3,4,23,179,1,692,1,3,1,1,2,single-choice,spatial-relational,1|2,7,1/2,230179,1
3,4,23,180,1,784,1,13,6,6,7,single-choice,spatial-relational,6|7,7,6/7,230180,6
3,4,23,181,1,783,1,3,1,1,2,single-choice,spatial-relational,1|2,7,1/2,230181,1
3,4,23,182,0,700,1,11,5,6,6,single-choice,spatial-relational,5|6,7,5/6,230182,5
3,4,23,183,0,571,1,7,3,4,4,single-choice,spatial-relational,3|4,7,3/4,230183,3
3,4,23,184,1,513,1,3,1,1,2,single-choice,spatial-relational,1|2,7,1/2,230184,1
3,4,23,185,1,1638,1,13,6,6,7,single-choice,spatial-relational,6|7,7,6/7,230185,6
3,4,23,186,1,928,1,7,3,3,4,single-choice,spatial-relational,3|4,7,3/4,230186,3
3,4,23,187,0,579,1,13,6,7,7,single-choice,spatial-relational,6|7,7,6/7,230187,6
3,4,23,188,0,912,1,5,2,3,3,single-choice,spatial-relational,2|3,7,2/3,230188,2
3,4,23,189,1,746,1,5,2,2,3,single-choice,spatial-relational,2|3,7,2/3,230189,2
3,4,23,190,1,1007,1,11,5,5,6,single-choice,spatial-relational,5|6,7,5/6,230190,5
3,4,23,191,1,1086,1,9,4,4,5,single-choice,spatial-relational,4|5,7,4/5,230191,4
3,4,23,192,1,1030,1,9,4,4,5,single-choice,spatial-relational,4|5,7,4/5,230192,4
3,4,23,193,1,812,1,5,2,2,3,single-choice,spatial-relational,2|3,7,2/3,230193,2
3,4,23,194,1,993,1,7,3,3,4,single-choice,spatial-relational,3|4,7,3/4,230194,3
3,4,23,195,1,1274,1,5,2,2,3,single-choice,spatial-relational,2|3,7,2/3,230195,2
3,4,23,196,1,759,1,3,1,1,2,single-choice,spatial-relational,1|2,7,1/2,230196,1
3,4,23,197,1,1422,1,13,6,6,7,single-choice,spatial-relational,6|7,7,6/7,230197,6
3,4,23,198,1,886,1,7,3,3,4,single-choice,spatial-relational,3|4,7,3/4,230198,3
3,4,23,199,1,968,1,11,5,5,6,single-choice,spatial-relational,5|6,7,5/6,230199,5
3,4,23,200,1,640,1,3,1,1,2,single-choice,spatial-relational,1|2,7,1/2,230200,1
3,4,23,201,1,1275,1,11,5,5,6,single-choice,spatial-relational,5|6,7,5/6,230201,5
3,4,23,202,1,1778,1,9,4,4,5,single-choice,spatial-relational,4|5,7,4/5,230202,4
3,4,23,203,1,638,1,9,4,4,5,single-choice,spatial-relational,4|5,7,4/5,230203,4
3,4,23,204,1,818,1,13,6,6,7,single-choice,spatial-relational,6|7,7,6/7,230204,6
3,4,23,205,1,852,1,3,1,1,2,single-choice,spatial-relational,1|2,7,1/2,230205,1
3,4,23,206,1,2057,1,11,5,5,6,single-choice,spatial-relational,5|6,7,5/6,230206,5
3,4,23,207,0,2800,1,7,3,4,4,single-choice,spatial-relational,3|4,7,3/4,230207,3
3,4,23,208,1,638,1,3,1,1,2,single-choice,spatial-relational,1|2,7,1/2,230208,1
3,4,23,209,1,1000,1,11,5,5,6,single-choice,spatial-relational,5|6,7,5/6,230209,5
3,4,23,210,0,1097,1,5,2,3,3,single-choice,spatial-relational,2|3,7,2/3,230210,2
3,4,23,211,1,665,1,9,4,4,5,single-choice,spatial-relational,4|5,7,4/5,230211,4
3,4,23,212,1,856,1,13,6,6,7,single-choice,spatial-relational,6|7,7,6/7,230212,6
3,4,23,213,0,1077,1,7,3,4,4,single-choice,spatial-relational,3|4,7,3/4,230213,3
3,4,23,214,0,627,1,13,6,7,7,single-choice,spatial-relational,6|7,7,6/7,230214,6
3,4,23,215,1,665,1,5,2,2,3,single-choice,spatial-relational,2|3,7,2/3,230215,2
3,4,23,216,1,1515,1,9,4,4,5,single-choice,spatial-relational,4|5,7,4/5,230216,4
3,4,23,217,1,821,1,3,1,1,2,single-choice,spatial-relational,1|2,7,1/2,230217,1
3,4,23,218,1,678,1,9,4,4,5,single-choice,spatial-relational,4|5,7,4/5,230218,4
3,4,23,219,0,1317,1,9,4,5,5,single-choice,spatial-relational,4|5,7,4/5,230219,4
3,4,23,220,1,806,1,13,6,6,7,single-choice,spatial-relational,6|7,7,6/7,230220,6
3,4,23,221,0,995,1,11,5,6,6,single-choice,spatial-relational,5|6,7,5/6,230221,5
3,4,23,222,0,4,1,13,6,7,7,single-choice,spatial-relational,6|7,7,6/7,230222,6
3,4,23,223,1,721,1,3,1,1,2,single-choice,spatial-relational,1|2,7,1/2,230223,1
3,4,23,224,0,1010,1,7,3,4,4,single-choice,spatial-relational,3|4,7,3/4,230224,3
3,4,23,225,0,3,1,5,2,3,3,single-choice,spatial-relational,2|3,7,2/3,230225,2
3,4,23,226,1,1995,1,11,5,5,6,single-choice,spatial-relational,5|6,7,5/6,230226,5
3,4,23,227,1,1542,1,5,2,2,3,single-choice,spatial-relational,2|3,7,2/3,230227,2
3,4,23,228,1,1051,1,7,3,3,4,single-choice,spatial-relational,3|4,7,3/4,230228,3
3,4,23,229,1,730,1,9,4,4,5,single-choice,spatial-relational,4|5,7,4/5,230229,4
3,4,23,230,1,893,1,13,6,6,7,single-choice,spatial-relational,6|7,7,6/7,230230,6
3,4,23,231,1,826,1,5,2,2,3,single-choice,spatial-relational,2|3,7,2/3,230231,2
3,4,23,232,0,638,1,7,3,4,4,single-choice,spatial-relational,3|4,7,3/4,230232,3
3,4,23,233,0,1237,1,13,6,7,7,single-choice,spatial-relational,6|7,7,6/7,230233,6
3,4,23,234,0,1007,1,5,2,3,3,single-choice,spatial-relational,2|3,7,2/3,230234,2
3,4,23,235,1,905,1,9,4,4,5,single-choice,spatial-relational,4|5,7,4/5,230235,4
3,4,23,236,0,853,1,11,5,6,6,single-choice,spatial-relational,5|6,7,5/6,230236,5
3,4,23,237,1,591,1,3,1,1,2,single-choice,spatial-relational,1|2,7,1/2,230237,1
3,4,23,238,0,938,1,11,5,6,6,single-choice,spatial-relational,5|6,7,5/6,230238,5
3,4,23,239,1,911,1,7,3,3,4,single-choice,spatial-relational,3|4,7,3/4,230239,3
3,4,23,240,0,1304,1,3,1,2,2,single-choice,spatial-relational,1|2,7,1/2,230240,1
3,4,23,241,0,1587,1,11,5,6,6,single-choice,spatial-relational,5|6,7,5/6,230241,5
3,4,23,242,1,1192,1,13,6,6,7,single-choice,spatial-relational,6|7,7,6/7,230242,6
3,4,23,243,1,949,1,3,1,1,2,single-choice,spatial-relational,1|2,7,1/2,230243,1
3,4,23,244,1,1771,1,7,3,3,4,single-choice,spatial-relational,3|4,7,3/4,230244,3
3,4,23,245,0,1120,1,9,4,5,5,single-choice,spatial-relational,4|5,7,4/5,230245,4
3,4,23,246,1,1136,1,13,6,6,7,single-choice,spatial-relational,6|7,7,6/7,230246,6
3,4,23,247,1,1502,1,5,2,2,3,single-choice,spatial-relational,2|3,7,2/3,230247,2
3,4,23,248,1,1231,1,7,3,3,4,single-choice,spatial-relational,3|4,7,3/4,230248,3
3,4,23,249,1,854,1,9,4,4,5,single-choice,spatial-relational,4|5,7,4/5,230249,4
3,4,23,250,1,774,1,3,1,1,2,single-choice,spatial-relational,1|2,7,1/2,230250,1
3,4,23,251,1,1373,1,5,2,2,3,single-choice,spatial-relational,2|3,7,2/3,230251,2
3,4,23,252,1,1018,1,11,5,5,6,single-choice,spatial-relational,5|6,7,5/6,230252,5
3,4,23,253,1,1239,1,5,2,2,3,single-choice,spatial-relational,2|3,7,2/3,230253,2
3,4,23,254,1,805,1,3,1,1,2,single-choice,spatial-relational,1|2,7,1/2,230254,1
3,4,23,255,1,1392,1,7,3,3,4,single-choice,spatial-relational,3|4,7,3/4,230255,3
3,4,23,256,1,1107,1,5,2,2,3,single-choice,spatial-relational,2|3,7,2/3,230256,2
3,4,23,257,1,690,1,3,1,1,2,single-choice,spatial-relational,1|2,7,1/2,230257,1
3,4,23,258,0,1024,1,9,4,5,5,single-choice,spatial-relational,4|5,7,4/5,230258,4
3,4,23,259,1,1523,1,13,6,6,7,single-choice,spatial-relational,6|7,7,6/7,230259,6
3,4,23,260,1,2133,1,11,5,5,6,single-choice,spatial-relational,5|6,7,5/6,230260,5
3,4,23,261,1,923,1,9,4,4,5,single-choice,spatial-relational,4|5,7,4/5,230261,4
3,4,23,262,1,1511,1,11,5,5,6,single-choice,spatial-relational,5|6,7,5/6,230262,5
3,4,23,263,0,1022,1,7,3,4,4,single-choice,spatial-relational,3|4,7,3/4,230263,3
3,4,23,264,1,843,1,13,6,6,7,single-choice,spatial-relational,6|7,7,6/7,230264,6
3,4,23,265,1,1208,1,5,2,2,3,single-choice,spatial-relational,2|3,7,2/3,230265,2
3,4,23,266,1,1728,1,7,3,3,4,single-choice,spatial-relational,3|4,7,3/4,230266,3
3,4,23,267,0,1381,1,9,4,5,5,single-choice,spatial-relational,4|5,7,4/5,230267,4
3,4,23,268,1,763,1,9,4,4,5,single-choice,spatial-relational,4|5,7,4/5,230268,4
3,4,23,269,1,1359,1,7,3,3,4,single-choice,spatial-relational,3|4,7,3/4,230269,3
3,4,23,270,1,1060,1,3,1,1,2,single-choice,spatial-relational,1|2,7,1/2,230270,1
3,4,23,271,1,813,1,11,5,5,6,single-choice,spatial-relational,5|6,7,5/6,230271,5
3,4,23,272,1,713,1,3,1,1,2,single-choice,spatial-relational,1|2,7,1/2,230272,1
3,4,23,273,1,1099,1,5,2,2,3,single-choice,spatial-relational,2|3,7,2/3,230273,2
3,4,23,274,1,1167,1,11,5,5,6,single-choice,spatial-relational,5|6,7,5/6,230274,5
3,4,23,275,1,916,1,13,6,6,7,single-choice,spatial-relational,6|7,7,6/7,230275,6
3,4,23,276,1,820,1,13,6,6,7,single-choice,spatial-relational,6|7,7,6/7,230276,6
3,4,23,277,0,948,1,11,5,6,6,single-choice,spatial-relational,5|6,7,5/6,230277,5
3,4,23,278,1,1072,1,11,5,5,6,single-choice,spatial-relational,5|6,7,5/6,230278,5
3,4,23,279,0,642,1,7,3,4,4,single-choice,spatial-relational,3|4,7,3/4,230279,3
3,4,23,280,1,675,1,5,2,2,3,single-choice,spatial-relational,2|3,7,2/3,230280,2
3,4,23,281,1,808,1,9,4,4,5,single-choice,spatial-relational,4|5,7,4/5,230281,4
3,4,23,282,1,664,1,3,1,1,2,single-choice,spatial-relational,1|2,7,1/2,230282,1
3,4,23,283,1,784,1,3,1,1,2,single-choice,spatial-relational,1|2,7,1/2,230283,1
3,4,23,284,0,1115,1,9,4,5,5,single-choice,spatial-relational,4|5,7,4/5,230284,4
3,4,23,285,1,932,1,13,6,6,7,single-choice,spatial-relational,6|7,7,6/7,230285,6
3,4,23,286,1,596,1,13,6,6,7,single-choice,spatial-relational,6|7,7,6/7,230286,6
3,4,23,287,0,970,1,5,2,3,3,single-choice,spatial-relational,2|3,7,2/3,230287,2
3,4,23,288,1,1576,1,7,3,3,4,single-choice,spatial-relational,3|4,7,3/4,230288,3
3,4,23,289,1,808,1,3,1,1,2,single-choice,spatial-relational,1|2,7,1/2,230289,1
3,4,23,290,1,1076,1,5,2,2,3,single-choice,spatial-relational,2|3,7,2/3,230290,2
3,4,23,291,1,1341,1,7,3,3,4,single-choice,spatial-relational,3|4,7,3/4,230291,3
3,4,23,292,1,974,1,13,6,6,7,single-choice,spatial-relational,6|7,7,6/7,230292,6
3,4,23,293,0,2108,1,7,3,4,4,single-choice,spatial-relational,3|4,7,3/4,230293,3
3,4,23,294,0,1315,1,11,5,6,6,single-choice,spatial-relational,5|6,7,5/6,230294,5
3,4,23,295,1,1020,1,9,4,4,5,single-choice,spatial-relational,4|5,7,4/5,230295,4
3,4,23,296,1,1413,1,5,2,2,3,single-choice,spatial-relational,2|3,7,2/3,230296,2
3,4,23,297,1,1751,1,11,5,5,6,single-choice,spatial-relational,5|6,7,5/6,230297,5
3,4,23,298,1,624,1,9,4,4,5,single-choice,spatial-relational,4|5,7,4/5,230298,4
3,4,23,299,1,665,1,3,1,1,2,single-choice,spatial-relational,1|2,7,1/2,230299,1
3,4,23,300,1,905,1,13,6,6,7,single-choice,spatial-relational,6|7,7,6/7,230300,6
3,4,23,301,1,1080,1,13,6,6,7,single-choice,spatial-relational,6|7,7,6/7,230301,6
3,4,23,302,1,1740,1,11,5,5,6,single-choice,spatial-relational,5|6,7,5/6,230302,5
3,4,23,303,1,1319,1,9,4,4,5,single-choice,spatial-relational,4|5,7,4/5,230303,4
3,4,23,304,1,661,1,9,4,4,5,single-choice,spatial-relational,4|5,7,4/5,230304,4
3,4,23,305,1,1275,1,7,3,3,4,single-choice,spatial-relational,3|4,7,3/4,230305,3
3,4,23,306,1,869,1,3,1,1,2,single-choice,spatial-relational,1|2,7,1/2,230306,1
3,4,23,307,0,717,1,11,5,6,6,single-choice,spatial-relational,5|6,7,5/6,230307,5
3,4,23,308,1,892,1,13,6,6,7,single-choice,spatial-relational,6|7,7,6/7,230308,6
3,4,23,309,1,48,1,5,2,2,3,single-choice,spatial-relational,2|3,7,2/3,230309,2
3,4,23,310,1,609,1,3,1,1,2,single-choice,spatial-relational,1|2,7,1/2,230310,1
3,4,23,311,1,922,1,7,3,3,4,single-choice,spatial-relational,3|4,7,3/4,230311,3
3,4,23,312,1,1670,1,5,2,2,3,single-choice,spatial-relational,2|3,7,2/3,230312,2
3,4,23,313,1,644,1,5,2,2,3,single-choice,spatial-relational,2|3,7,2/3,230313,2
3,4,23,314,0,942,1,7,3,4,4,single-choice,spatial-relational,3|4,7,3/4,230314,3
3,4,23,315,0,2,1,11,5,6,6,single-choice,spatial-relational,5|6,7,5/6,230315,5
3,4,23,316,1,73253,1,9,4,4,5,single-choice,spatial-relational,4|5,7,4/5,230316,4
3,4,23,317,0,31744,1,13,6,7,7,single-choice,spatial-relational,6|7,7,6/7,230317,6
3,4,23,318,1,1378,1,11,5,5,6,single-choice,spatial-relational,5|6,7,5/6,230318,5
3,4,23,319,1,1443,1,13,6,6,7,single-choice,spatial-relational,6|7,7,6/7,230319,6
3,4,23,320,1,1196,1,7,3,3,4,single-choice,spatial-relational,3|4,7,3/4,230320,3
3,4,23,321,1,1825,1,9,4,4,5,single-choice,spatial-relational,4|5,7,4/5,230321,4
3,4,23,322,1,910,1,3,1,1,2,single-choice,spatial-relational,1|2,7,1/2,230322,1
3,4,23,323,1,734,1,3,1,1,2,single-choice,spatial-relational,1|2,7,1/2,230323,1
3,4,23,324,0,1078,1,5,2,3,3,single-choice,spatial-relational,2|3,7,2/3,230324,2
3,4,23,325,1,853,1,9,4,4,5,single-choice,spatial-relational,4|5,7,4/5,230325,4
3,4,23,326,1,1135,1,5,2,2,3,single-choice,spatial-relational,2|3,7,2/3,230326,2
3,4,23,327,1,1334,1,13,6,6,7,single-choice,spatial-relational,6|7,7,6/7,230327,6
3,4,23,328,0,640,1,7,3,4,4,single-choice,spatial-relational,3|4,7,3/4,230328,3
3,4,23,329,1,749,1,13,6,6,7,single-choice,spatial-relational,6|7,7,6/7,230329,6
3,4,23,330,0,951,1,5,2,3,3,single-choice,spatial-relational,2|3,7,2/3,230330,2
3,4,23,331,1,889,1,3,1,1,2,single-choice,spatial-relational,1|2,7,1/2,230331,1
3,4,23,332,1,916,1,11,5,5,6,single-choice,spatial-relational,5|6,7,5/6,230332,5
3,4,23,333,1,1000,1,11,5,5,6,single-choice,spatial-relational,5|6,7,5/6,230333,5
3,4,23,334,1,741,1,3,1,1,2,single-choice,spatial-relational,1|2,7,1/2,230334,1
3,4,23,335,1,1139,1,9,4,4,5,single-choice,spatial-relational,4|5,7,4/5,230335,4
3,4,23,336,1,1062,1,7,3,3,4,single-choice,spatial-relational,3|4,7,3/4,230336,3
3,4,23,337,1,864,1,13,6,6,7,single-choice,spatial-relational,6|7,7,6/7,230337,6
3,4,23,338,1,2143,1,11,5,5,6,single-choice,spatial-relational,5|6,7,5/6,230338,5
3,4,23,339,1,569,1,3,1,1,2,single-choice,spatial-relational,1|2,7,1/2,230339,1
3,4,23,340,0,1083,1,7,3,4,4,single-choice,spatial-relational,3|4,7,3/4,230340,3
3,4,23,341,0,5,1,5,2,3,3,single-choice,spatial-relational,2|3,7,2/3,230341,2
3,4,23,342,1,727,1,5,2,2,3,single-choice,spatial-relational,2|3,7,2/3,230342,2
3,4,23,343,1,960,1,9,4,4,5,single-choice,spatial-relational,4|5,7,4/5,230343,4
3,4,23,344,1,983,1,3,1,1,2,single-choice,spatial-relational,1|2,7,1/2,230344,1
3,4,23,345,1,1560,1,7,3,3,4,single-choice,spatial-relational,3|4,7,3/4,230345,3
3,4,23,346,1,1124,1,9,4,4,5,single-choice,spatial-relational,4|5,7,4/5,230346,4
3,4,23,347,1,880,1,13,6,6,7,single-choice,spatial-relational,6|7,7,6/7,230347,6
3,4,23,348,1,1063,1,11,5,5,6,single-choice,spatial-relational,5|6,7,5/6,230348,5
3,4,23,349,1,837,1,3,1,1,2,single-choice,spatial-relational,1|2,7,1/2,230349,1
3,4,23,350,1,1109,1,5,2,2,3,single-choice,spatial-relational,2|3,7,2/3,230350,2
3,4,23,351,1,792,1,9,4,4,5,single-choice,spatial-relational,4|5,7,4/5,230351,4
3,4,23,352,1,1020,1,13,6,6,7,single-choice,spatial-relational,6|7,7,6/7,230352,6
3,4,23,353,1,939,1,13,6,6,7,single-choice,spatial-relational,6|7,7,6/7,230353,6
3,4,23,354,0,859,1,9,4,5,5,single-choice,spatial-relational,4|5,7,4/5,230354,4
3,4,23,355,1,1017,1,11,5,5,6,single-choice,spatial-relational,5|6,7,5/6,230355,5
3,4,23,356,1,1082,1,7,3,3,4,single-choice,spatial-relational,3|4,7,3/4,230356,3
3,4,23,357,1,1070,1,5,2,2,3,single-choice,spatial-relational,2|3,7,2/3,230357,2
3,4,23,358,1,1191,1,11,5,5,6,single-choice,spatial-relational,5|6,7,5/6,230358,5
3,4,23,359,0,558,1,7,3,4,4,single-choice,spatial-relational,3|4,7,3/4,230359,3
3,4,23,360,1,728,1,3,1,1,2,single-choice,spatial-relational,1|2,7,1/2,230360,1
3,4,23,361,1,1035,1,11,5,5,6,single-choice,spatial-relational,5|6,7,5/6,230361,5
3,4,23,362,1,841,1,13,6,6,7,single-choice,spatial-relational,6|7,7,6/7,230362,6
3,4,23,363,1,1072,1,3,1,1,2,single-choice,spatial-relational,1|2,7,1/2,230363,1
3,4,23,364,1,907,1,7,3,3,4,single-choice,spatial-relational,3|4,7,3/4,230364,3
3,4,23,365,1,639,1,5,2,2,3,single-choice,spatial-relational,2|3,7,2/3,230365,2
3,4,23,366,1,476,1,3,1,1,2,single-choice,spatial-relational,1|2,7,1/2,230366,1
3,4,23,367,1,808,1,9,4,4,5,single-choice,spatial-relational,4|5,7,4/5,230367,4
3,4,23,368,0,460,1,5,2,3,3,single-choice,spatial-relational,2|3,7,2/3,230368,2
3,4,23,369,1,725,1,9,4,4,5,single-choice,spatial-relational,4|5,7,4/5,230369,4
3,4,23,370,0,548,1,13,6,7,7,single-choice,spatial-relational,6|7,7,6/7,230370,6
3,4,23,371,0,788,1,11,5,6,6,single-choice,spatial-relational,5|6,7,5/6,230371,5
3,4,23,372,0,945,1,7,3,4,4,single-choice,spatial-relational,3|4,7,3/4,230372,3
3,4,23,373,1,867,1,9,4,4,5,single-choice,spatial-relational,4|5,7,4/5,230373,4
3,4,23,374,0,945,1,9,4,5,5,single-choice,spatial-relational,4|5,7,4/5,230374,4
3,4,23,375,0,1179,1,13,6,7,7,single-choice,spatial-relational,6|7,7,6/7,230375,6
3,4,23,376,0,2692,1,5,2,3,3,single-choice,spatial-relational,2|3,7,2/3,230376,2
3,4,23,377,0,737,1,11,5,6,6,single-choice,spatial-relational,5|6,7,5/6,230377,5
3,4,23,378,1,747,1,5,2,2,3,single-choice,spatial-relational,2|3,7,2/3,230378,2
3,4,23,379,1,1379,1,7,3,3,4,single-choice,spatial-relational,3|4,7,3/4,230379,3
3,4,23,380,1,977,1,13,6,6,7,single-choice,spatial-relational,6|7,7,6/7,230380,6
3,4,23,381,1,1084,1,11,5,5,6,single-choice,spatial-relational,5|6,7,5/6,230381,5
3,4,23,382,1,628,1,3,1,1,2,single-choice,spatial-relational,1|2,7,1/2,230382,1
3,4,23,383,1,735,1,3,1,1,2,single-choice,spatial-relational,1|2,7,1/2,230383,1
3,4,23,384,1,782,1,7,3,3,4,single-choice,spatial-relational,3|4,7,3/4,230384,3
3,4,23,385,1,878,1,13,6,6,7,single-choice,spatial-relational,6|7,7,6/7,230385,6
3,4,23,386,0,481,1,7,3,4,4,single-choice,spatial-relational,3|4,7,3/4,230386,3
3,4,23,387,1,33,1,7,3,3,4,single-choice,spatial-relational,3|4,7,3/4,230387,3
3,4,23,388,1,1103,1,11,5,5,6,single-choice,spatial-relational,5|6,7,5/6,230388,5
3,4,23,389,1,1029,1,11,5,5,6,single-choice,spatial-relational,5|6,7,5/6,230389,5
3,4,23,390,1,864,1,13,6,6,7,single-choice,spatial-relational,6|7,7,6/7,230390,6
3,4,23,391,1,898,1,5,2,2,3,single-choice,spatial-relational,2|3,7,2/3,230391,2
3,4,23,392,1,621,1,3,1,1,2,single-choice,spatial-relational,1|2,7,1/2,230392,1
3,4,23,393,1,3041,1,3,1,1,2,single-choice,spatial-relational,1|2,7,1/2,230393,1
3,4,23,394,0,420,1,5,2,3,3,single-choice,spatial-relational,2|3,7,2/3,230394,2
3,4,23,395,0,40633,1,9,4,5,5,single-choice,spatial-relational,4|5,7,4/5,230395,4
3,4,23,396,1,1971,1,9,4,4,5,single-choice,spatial-relational,4|5,7,4/5,230396,4
3,4,23,397,1,694,1,3,1,1,2,single-choice,spatial-relational,1|2,7,1/2,230397,1
3,4,23,398,1,720,1,5,2,2,3,single-choice,spatial-relational,2|3,7,2/3,230398,2
3,4,23,399,1,1017,1,9,4,4,5,single-choice,spatial-relational,4|5,7,4/5,230399,4
3,4,23,400,1,810,1,3,1,1,2,single-choice,spatial-relational,1|2,7,1/2,230400,1
3,4,23,401,1,915,1,9,4,4,5,single-choice,spatial-relational,4|5,7,4/5,230401,4
3,4,23,402,0,704,1,11,5,6,6,single-choice,spatial-relational,5|6,7,5/6,230402,5
3,4,23,403,0,568,1,7,3,4,4,single-choice,spatial-relational,3|4,7,3/4,230403,3
3,4,23,404,1,1134,1,11,5,5,6,single-choice,spatial-relational,5|6,7,5/6,230404,5
3,4,23,405,1,1007,1,7,3,3,4,single-choice,spatial-relational,3|4,7,3/4,230405,3
3,4,23,406,1,1047,1,13,6,6,7,single-choice,spatial-relational,6|7,7,6/7,230406,6
3,4,23,407,1,881,1,13,6,6,7,single-choice,spatial-relational,6|7,7,6/7,230407,6
3,4,23,408,0,744,1,5,2,3,3,single-choice,spatial-relational,2|3,7,2/3,230408,2
3,4,23,409,1,1106,1,5,2,2,3,single-choice,spatial-relational,2|3,7,2/3,230409,2
3,4,23,410,1,1171,1,11,5,5,6,single-choice,spatial-relational,5|6,7,5/6,230410,5
3,4,23,411,0,653,1,7,3,4,4,single-choice,spatial-relational,3|4,7,3/4,230411,3
3,4,23,412,1,1147,1,9,4,4,5,single-choice,spatial-relational,4|5,7,4/5,230412,4
3,4,23,413,1,707,1,3,1,1,2,single-choice,spatial-relational,1|2,7,1/2,230413,1
3,4,23,414,0,695,1,7,3,4,4,single-choice,spatial-relational,3|4,7,3/4,230414,3
3,4,23,415,1,640,1,9,4,4,5,single-choice,spatial-relational,4|5,7,4/5,230415,4
3,4,23,416,1,682,1,13,6,6,7,single-choice,spatial-relational,6|7,7,6/7,230416,6
3,4,23,417,1,738,1,5,2,2,3,single-choice,spatial-relational,2|3,7,2/3,230417,2
3,4,23,418,1,1000,1,13,6,6,7,single-choice,spatial-relational,6|7,7,6/7,230418,6
3,4,23,419,1,837,1,3,1,1,2,single-choice,spatial-relational,1|2,7,1/2,230419,1
3,4,23,420,1,994,1,11,5,5,6,single-choice,spatial-relational,5|6,7,5/6,230420,5
3,4,23,421,1,911,1,11,5,5,6,single-choice,spatial-relational,5|6,7,5/6,230421,5
3,4,23,422,1,1060,1,7,3,3,4,single-choice,spatial-relational,3|4,7,3/4,230422,3
3,4,23,423,1,699,1,3,1,1,2,single-choice,spatial-relational,1|2,7,1/2,230423,1
3,4,23,424,1,951,1,3,1,1,2,single-choice,spatial-relational,1|2,7,1/2,230424,1
3,4,23,425,1,1608,1,9,4,4,5,single-choice,spatial-relational,4|5,7,4/5,230425,4
3,4,23,426,1,962,1,7,3,3,4,single-choice,spatial-relational,3|4,7,3/4,230426,3
3,4,23,427,1,1424,1,11,5,5,6,single-choice,spatial-relational,5|6,7,5/6,230427,5
3,4,23,428,1,573,1,9,4,4,5,single-choice,spatial-relational,4|5,7,4/5,230428,4
3,4,23,429,1,1044,1,13,6,6,7,single-choice,spatial-relational,6|7,7,6/7,230429,6
3,4,23,430,1,1103,1,5,2,2,3,single-choice,spatial-relational,2|3,7,2/3,230430,2
3,4,23,431,1,856,1,13,6,6,7,single-choice,spatial-relational,6|7,7,6/7,230431,6
3,4,23,432,1,894,1,5,2,2,3,single-choice,spatial-relational,2|3,7,2/3,230432,2
3,4,23,433,1,876,1,13,6,6,7,single-choice,spatial-relational,6|7,7,6/7,230433,6
3,4,23,434,0,707,1,7,3,4,4,single-choice,spatial-relational,3|4,7,3/4,230434,3
3,4,23,435,1,946,1,9,4,4,5,single-choice,spatial-relational,4|5,7,4/5,230435,4
3,4,23,436,1,829,1,5,2,2,3,single-choice,spatial-relational,2|3,7,2/3,230436,2
3,4,23,437,1,978,1,7,3,3,4,single-choice,spatial-relational,3|4,7,3/4,230437,3
3,4,23,438,0,1263,1,11,5,6,6,single-choice,spatial-relational,5|6,7,5/6,230438,5
3,4,23,439,1,703,1,3,1,1,2,single-choice,spatial-relational,1|2,7,1/2,230439,1
3,4,23,440,0,799,1,11,5,6,6,single-choice,spatial-relational,5|6,7,5/6,230440,5
3,4,23,441,1,941,1,5,2,2,3,single-choice,spatial-relational,2|3,7,2/3,230441,2
3,4,23,442,1,1171,1,9,4,4,5,single-choice,spatial-relational,4|5,7,4/5,230442,4
3,4,23,443,1,742,1,3,1,1,2,single-choice,spatial-relational,1|2,7,1/2,230443,1
3,4,23,444,1,867,1,13,6,6,7,single-choice,spatial-relational,6|7,7,6/7,230444,6
3,4,23,445,0,731,1,11,5,6,6,single-choice,spatial-relational,5|6,7,5/6,230445,5
3,4,23,446,1,867,1,5,2,2,3,single-choice,spatial-relational,2|3,7,2/3,230446,2
3,4,23,447,0,1230,1,9,4,5,5,single-choice,spatial-relational,4|5,7,4/5,230447,4
3,4,23,448,1,1473,1,9,4,4,5,single-choice,spatial-relational,4|5,7,4/5,230448,4
3,4,23,449,1,914,1,7,3,3,4,single-choice,spatial-relational,3|4,7,3/4,230449,3
3,4,23,450,1,791,1,5,2,2,3,single-choice,spatial-relational,2|3,7,2/3,230450,2
3,4,23,451,1,1177,1,13,6,6,7,single-choice,spatial-relational,6|7,7,6/7,230451,6
3,4,23,452,1,1351,1,11,5,5,6,single-choice,spatial-relational,5|6,7,5/6,230452,5
3,4,23,453,1,895,1,3,1,1,2,single-choice,spatial-relational,1|2,7,1/2,230453,1
3,4,23,454,1,796,1,3,1,1,2,single-choice,spatial-relational,1|2,7,1/2,230454,1
3,4,23,455,1,25,1,7,3,3,4,single-choice,spatial-relational,3|4,7,3/4,230455,3
3,4,23,456,1,839,1,13,6,6,7,single-choice,spatial-relational,6|7,7,6/7,230456,6
3,4,23,457,1,892,1,7,3,3,4,single-choice,spatial-relational,3|4,7,3/4,230457,3
3,4,23,458,0,935,1,5,2,3,3,single-choice,spatial-relational,2|3,7,2/3,230458,2
3,4,23,459,1,790,1,3,1,1,2,single-choice,spatial-relational,1|2,7,1/2,230459,1
3,4,23,460,1,1003,1,11,5,5,6,single-choice,spatial-relational,5|6,7,5/6,230460,5
3,4,23,461,1,1126,1,9,4,4,5,single-choice,spatial-relational,4|5,7,4/5,230461,4
3,4,23,462,1,1534,1,9,4,4,5,single-choice,spatial-relational,4|5,7,4/5,230462,4
3,4,23,463,1,964,1,7,3,3,4,single-choice,spatial-relational,3|4,7,3/4,230463,3
3,4,23,464,1,938,1,11,5,5,6,single-choice,spatial-relational,5|6,7,5/6,230464,5
3,4,23,465,1,4,1,13,6,6,7,single-choice,spatial-relational,6|7,7,6/7,230465,6
3,4,23,466,0,501,1,3,1,2,2,single-choice,spatial-relational,1|2,7,1/2,230466,1
3,4,23,467,0,1090,1,13,6,7,7,single-choice,spatial-relational,6|7,7,6/7,230467,6
3,4,23,468,0,1483,1,5,2,3,3,single-choice,spatial-relational,2|3,7,2/3,230468,2
3,4,23,469,1,676,1,3,1,1,2,single-choice,spatial-relational,1|2,7,1/2,230469,1
3,4,23,470,1,811,1,11,5,5,6,single-choice,spatial-relational,5|6,7,5/6,230470,5
3,4,23,471,0,1080,1,7,3,4,4,single-choice,spatial-relational,3|4,7,3/4,230471,3
3,4,23,472,1,710,1,3,1,1,2,single-choice,spatial-relational,1|2,7,1/2,230472,1
3,4,23,473,0,958,1,9,4,5,5,single-choice,spatial-relational,4|5,7,4/5,230473,4
3,4,23,474,1,1093,1,7,3,3,4,single-choice,spatial-relational,3|4,7,3/4,230474,3
3,4,23,475,1,818,1,13,6,6,7,single-choice,spatial-relational,6|7,7,6/7,230475,6
3,4,23,476,0,1021,1,11,5,6,6,single-choice,spatial-relational,5|6,7,5/6,230476,5
3,4,23,477,1,779,1,5,2,2,3,single-choice,spatial-relational,2|3,7,2/3,230477,2
3,4,23,478,1,1169,1,9,4,4,5,single-choice,spatial-relational,4|5,7,4/5,230478,4
3,4,23,479,1,1313,1,13,6,6,7,single-choice,spatial-relational,6|7,7,6/7,230479,6
3,4,23,480,1,1127,1,11,5,5,6,single-choice,spatial-relational,5|6,7,5/6,230480,5
3,4,23,481,1,1414,1,5,2,2,3,single-choice,spatial-relational,2|3,7,2/3,230481,2
3,4,23,482,1,947,1,7,3,3,4,single-choice,spatial-relational,3|4,7,3/4,230482,3
3,4,23,483,1,959,1,3,1,1,2,single-choice,spatial-relational,1|2,7,1/2,230483,1
3,4,23,484,1,844,1,9,4,4,5,single-choice,spatial-relational,4|5,7,4/5,230484,4
3,4,23,485,1,1484,1,3,1,1,2,single-choice,spatial-relational,1|2,7,1/2,230485,1
3,4,23,486,1,945,1,9,4,4,5,single-choice,spatial-relational,4|5,7,4/5,230486,4
3,4,23,487,1,1312,1,7,3,3,4,single-choice,spatial-relational,3|4,7,3/4,230487,3
3,4,23,488,1,983,1,5,2,2,3,single-choice,spatial-relational,2|3,7,2/3,230488,2
3,4,23,489,1,1343,1,13,6,6,7,single-choice,spatial-relational,6|7,7,6/7,230489,6
3,4,23,490,0,914,1,11,5,6,6,single-choice,spatial-relational,5|6,7,5/6,230490,5
3,4,23,491,1,664,1,3,1,1,2,single-choice,spatial-relational,1|2,7,1/2,230491,1
3,4,23,492,1,1709,1,5,2,2,3,single-choice,spatial-relational,2|3,7,2/3,230492,2
3,4,23,493,1,893,1,13,6,6,7,single-choice,spatial-relational,6|7,7,6/7,230493,6
3,4,23,494,0,1199,1,11,5,6,6,single-choice,spatial-relational,5|6,7,5/6,230494,5
3,4,23,495,0,716,1,7,3,4,4,single-choice,spatial-relational,3|4,7,3/4,230495,3
3,4,23,496,0,955,1,5,2,3,3,single-choice,spatial-relational,2|3,7,2/3,230496,2
3,4,23,497,1,1182,1,11,5,5,6,single-choice,spatial-relational,5|6,7,5/6,230497,5
3,4,23,498,1,1045,1,9,4,4,5,single-choice,spatial-relational,4|5,7,4/5,230498,4
3,4,23,499,1,1097,1,5,2,2,3,single-choice,spatial-relational,2|3,7,2/3,230499,2
3,4,23,500,1,937,1,3,1,1,2,single-choice,spatial-relational,1|2,7,1/2,230500,1
3,4,23,501,1,1330,1,13,6,6,7,single-choice,spatial-relational,6|7,7,6/7,230501,6
3,4,23,502,1,877,1,9,4,4,5,single-choice,spatial-relational,4|5,7,4/5,230502,4
3,4,23,503,1,863,1,3,1,1,2,single-choice,spatial-relational,1|2,7,1/2,230503,1
3,4,23,504,1,883,1,7,3,3,4,single-choice,spatial-relational,3|4,7,3/4,230504,3
3,4,23,505,1,1128,1,7,3,3,4,single-choice,spatial-relational,3|4,7,3/4,230505,3
3,4,23,506,1,1654,1,11,5,5,6,single-choice,spatial-relational,5|6,7,5/6,230506,5
3,4,23,507,0,1269,1,13,6,7,7,single-choice,spatial-relational,6|7,7,6/7,230507,6
3,4,23,508,1,979,1,5,2,2,3,single-choice,spatial-relational,2|3,7,2/3,230508,2
3,4,23,509,1,1038,1,11,5,5,6,single-choice,spatial-relational,5|6,7,5/6,230509,5
3,4,23,510,1,918,1,7,3,3,4,single-choice,spatial-relational,3|4,7,3/4,230510,3
3,4,23,511,0,978,1,13,6,7,7,single-choice,spatial-relational,6|7,7,6/7,230511,6
3,4,23,512,1,915,1,9,4,4,5,single-choice,spatial-relational,4|5,7,4/5,230512,4
3,4,23,513,1,834,1,3,1,1,2,single-choice,spatial-relational,1|2,7,1/2,230513,1
3,4,23,514,1,979,1,9,4,4,5,single-choice,spatial-relational,4|5,7,4/5,230514,4
3,4,23,515,1,1903,1,3,1,1,2,single-choice,spatial-relational,1|2,7,1/2,230515,1
3,4,23,516,0,1182,1,5,2,3,3,single-choice,spatial-relational,2|3,7,2/3,230516,2
3,4,23,517,0,1049,1,13,6,7,7,single-choice,spatial-relational,6|7,7,6/7,230517,6
3,4,23,518,1,2,1,11,5,5,6,single-choice,spatial-relational,5|6,7,5/6,230518,5
3,4,23,519,1,922,1,7,3,3,4,single-choice,spatial-relational,3|4,7,3/4,230519,3
3,4,23,520,1,939,1,3,1,1,2,single-choice,spatial-relational,1|2,7,1/2,230520,1
3,4,23,521,1,1317,1,11,5,5,6,single-choice,spatial-relational,5|6,7,5/6,230521,5
3,4,23,522,1,1030,1,5,2,2,3,single-choice,spatial-relational,2|3,7,2/3,230522,2
3,4,23,523,1,1257,1,13,6,6,7,single-choice,spatial-relational,6|7,7,6/7,230523,6
3,4,23,524,0,2730,1,7,3,4,4,single-choice,spatial-relational,3|4,7,3/4,230524,3
3,4,23,525,1,798,1,9,4,4,5,single-choice,spatial-relational,4|5,7,4/5,230525,4
3,4,23,526,1,864,1,7,3,3,4,single-choice,spatial-relational,3|4,7,3/4,230526,3
3,4,23,527,1,1124,1,5,2,2,3,single-choice,spatial-relational,2|3,7,2/3,230527,2
3,4,23,528,1,1310,1,9,4,4,5,single-choice,spatial-relational,4|5,7,4/5,230528,4
3,4,23,529,1,793,1,3,1,1,2,single-choice,spatial-relational,1|2,7,1/2,230529,1
3,4,23,530,1,842,1,13,6,6,7,single-choice,spatial-relational,6|7,7,6/7,230530,6
3,4,23,531,0,886,1,11,5,6,6,single-choice,spatial-relational,5|6,7,5/6,230531,5
3,4,23,532,0,552,1,11,5,6,6,single-choice,spatial-relational,5|6,7,5/6,230532,5
3,4,23,533,1,2,1,3,1,1,2,single-choice,spatial-relational,1|2,7,1/2,230533,1
3,4,23,534,1,589,1,3,1,1,2,single-choice,spatial-relational,1|2,7,1/2,230534,1
3,4,23,535,0,636,1,13,6,7,7,single-choice,spatial-relational,6|7,7,6/7,230535,6
3,4,23,536,0,629,1,7,3,4,4,single-choice,spatial-relational,3|4,7,3/4,230536,3
3,4,23,537,1,1268,1,7,3,3,4,single-choice,spatial-relational,3|4,7,3/4,230537,3
3,4,23,538,1,959,1,13,6,6,7,single-choice,spatial-relational,6|7,7,6/7,230538,6
3,4,23,539,0,2755,1,9,4,5,5,single-choice,spatial-relational,4|5,7,4/5,230539,4
3,4,23,540,1,890,1,5,2,2,3,single-choice,spatial-relational,2|3,7,2/3,230540,2
3,4,23,541,1,929,1,9,4,4,5,single-choice,spatial-relational,4|5,7,4/5,230541,4
3,4,23,542,1,1209,1,5,2,2,3,single-choice,spatial-relational,2|3,7,2/3,230542,2
3,4,23,543,1,937,1,11,5,5,6,single-choice,spatial-relational,5|6,7,5/6,230543,5
3,4,23,544,1,570,1,9,4,4,5,single-choice,spatial-relational,4|5,7,4/5,230544,4
3,4,23,545,1,760,1,3,1,1,2,single-choice,spatial-relational,1|2,7,1/2,230545,1
3,4,23,546,1,1101,1,13,6,6,7,single-choice,spatial-relational,6|7,7,6/7,230546,6
3,4,23,547,1,967,1,13,6,6,7,single-choice,spatial-relational,6|7,7,6/7,230547,6
3,4,23,548,0,1265,1,5,2,3,3,single-choice,spatial-relational,2|3,7,2/3,230548,2
3,4,23,549,1,803,1,3,1,1,2,single-choice,spatial-relational,1|2,7,1/2,230549,1
3,4,23,550,1,875,1,7,3,3,4,single-choice,spatial-relational,3|4,7,3/4,230550,3
3,4,23,551,1,943,1,11,5,5,6,single-choice,spatial-relational,5|6,7,5/6,230551,5
3,4,23,552,0,534,1,7,3,4,4,single-choice,spatial-relational,3|4,7,3/4,230552,3
3,4,23,553,1,897,1,5,2,2,3,single-choice,spatial-relational,2|3,7,2/3,230553,2
3,4,23,554,1,1071,1,11,5,5,6,single-choice,spatial-relational,5|6,7,5/6,230554,5
3,4,23,555,1,1137,1,9,4,4,5,single-choice,spatial-relational,4|5,7,4/5,230555,4
3,4,23,556,1,1392,1,9,4,4,5,single-choice,spatial-relational,4|5,7,4/5,230556,4
3,4,23,557,1,1410,1,11,5,5,6,single-choice,spatial-relational,5|6,7,5/6,230557,5
3,4,23,558,1,1132,1,7,3,3,4,single-choice,spatial-relational,3|4,7,3/4,230558,3
3,4,23,559,0,1120,1,11,5,6,6,single-choice,spatial-relational,5|6,7,5/6,230559,5
3,4,23,560,1,812,1,13,6,6,7,single-choice,spatial-relational,6|7,7,6/7,230560,6
3,4,23,561,1,728,1,3,1,1,2,single-choice,spatial-relational,1|2,7,1/2,230561,1
3,4,23,562,1,919,1,13,6,6,7,single-choice,spatial-relational,6|7,7,6/7,230562,6
3,4,23,563,1,917,1,7,3,3,4,single-choice,spatial-relational,3|4,7,3/4,230563,3
3,4,23,564,1,881,1,9,4,4,5,single-choice,spatial-relational,4|5,7,4/5,230564,4
3,4,23,565,1,928,1,5,2,2,3,single-choice,spatial-relational,2|3,7,2/3,230565,2
3,4,23,566,1,946,1,5,2,2,3,single-choice,spatial-relational,2|3,7,2/3,230566,2
3,4,23,567,1,768,1,3,1,1,2,single-choice,spatial-relational,1|2,7,1/2,230567,1
3,4,23,568,1,548,1,5,2,2,3,single-choice,spatial-relational,2|3,7,2/3,230568,2
3,4,23,569,1,708,1,3,1,1,2,single-choice,spatial-relational,1|2,7,1/2,230569,1
3,4,23,570,1,431,1,7,3,3,4,single-choice,spatial-relational,3|4,7,3/4,230570,3
3,4,23,571,0,424,1,7,3,4,4,single-choice,spatial-relational,3|4,7,3/4,230571,3
3,4,23,572,0,670,1,11,5,6,6,single-choice,spatial-relational,5|6,7,5/6,230572,5
3,4,23,573,1,572,1,3,1,1,2,single-choice,spatial-relational,1|2,7,1/2,230573,1
3,4,23,574,1,459,1,9,4,4,5,single-choice,spatial-relational,4|5,7,4/5,230574,4
3,4,23,575,1,1517,1,11,5,5,6,single-choice,spatial-relational,5|6,7,5/6,230575,5
3,4,23,576,1,974,1,13,6,6,7,single-choice,spatial-relational,6|7,7,6/7,230576,6
3,4,23,577,1,970,1,13,6,6,7,single-choice,spatial-relational,6|7,7,6/7,230577,6
3,4,23,578,0,969,1,9,4,5,5,single-choice,spatial-relational,4|5,7,4/5,230578,4
3,4,23,579,1,3804,1,5,2,2,3,single-choice,spatial-relational,2|3,7,2/3,230579,2
3,4,23,580,1,636,1,3,1,1,2,single-choice,spatial-relational,1|2,7,1/2,230580,1
3,4,23,581,1,1266,1,11,5,5,6,single-choice,spatial-relational,5|6,7,5/6,230581,5
3,4,23,582,1,1610,1,9,4,4,5,single-choice,spatial-relational,4|5,7,4/5,230582,4
3,4,23,583,1,732,1,5,2,2,3,single-choice,spatial-relational,2|3,7,2/3,230583,2
3,4,23,584,0,649,1,7,3,4,4,single-choice,spatial-relational,3|4,7,3/4,230584,3
3,4,23,585,0,545,1,7,3,4,4,single-choice,spatial-relational,3|4,7,3/4,230585,3
3,4,23,586,1,535,1,5,2,2,3,single-choice,spatial-relational,2|3,7,2/3,230586,2
3,4,23,587,1,647,1,11,5,5,6,single-choice,spatial-relational,5|6,7,5/6,230587,5
3,4,23,588,1,603,1,9,4,4,5,single-choice,spatial-relational,4|5,7,4/5,230588,4
3,4,23,589,1,837,1,13,6,6,7,single-choice,spatial-relational,6|7,7,6/7,230589,6
3,4,23,590,1,812,1,13,6,6,7,single-choice,spatial-relational,6|7,7,6/7,230590,6
3,4,23,591,1,724,1,3,1,1,2,single-choice,spatial-relational,1|2,7,1/2,230591,1
3,4,23,592,1,601,1,3,1,1,2,single-choice,spatial-relational,1|2,7,1/2,230592,1
3,4,23,593,1,77,1,13,6,6,7,single-choice,spatial-relational,6|7,7,6/7,230593,6
3,4,23,594,1,1179,1,11,5,5,6,single-choice,spatial-relational,5|6,7,5/6,230594,5
3,4,23,595,1,1164,1,11,5,5,6,single-choice,spatial-relational,5|6,7,5/6,230595,5
3,4,23,596,0,818,1,9,4,5,5,single-choice,spatial-relational,4|5,7,4/5,230596,4
3,4,23,597,1,954,1,9,4,4,5,single-choice,spatial-relational,4|5,7,4/5,230597,4
3,4,23,598,1,921,1,3,1,1,2,single-choice,spatial-relational,1|2,7,1/2,230598,1
3,4,23,599,1,1096,1,7,3,3,4,single-choice,spatial-relational,3|4,7,3/4,230599,3
3,4,23,600,0,1137,1,7,3,4,4,single-choice,spatial-relational,3|4,7,3/4,230600,3
3,4,23,601,1,706,1,5,2,2,3,single-choice,spatial-relational,2|3,7,2/3,230601,2
3,4,23,602,1,929,1,13,6,6,7,single-choice,spatial-relational,6|7,7,6/7,230602,6
3,4,23,603,1,1082,1,5,2,2,3,single-choice,spatial-relational,2|3,7,2/3,230603,2
3,4,23,604,1,656,1,3,1,1,2,single-choice,spatial-relational,1|2,7,1/2,230604,1
3,4,23,605,1,858,1,13,6,6,7,single-choice,spatial-relational,6|7,7,6/7,230605,6
3,4,23,606,1,1006,1,7,3,3,4,single-choice,spatial-relational,3|4,7,3/4,230606,3
3,4,23,607,1,1162,1,5,2,2,3,single-choice,spatial-relational,2|3,7,2/3,230607,2
3,4,23,608,1,1078,1,11,5,5,6,single-choice,spatial-relational,5|6,7,5/6,230608,5
3,4,23,609,1,828,1,13,6,6,7,single-choice,spatial-relational,6|7,7,6/7,230609,6
3,4,23,610,1,970,1,11,5,5,6,single-choice,spatial-relational,5|6,7,5/6,230610,5
3,4,23,611,1,1902,1,5,2,2,3,single-choice,spatial-relational,2|3,7,2/3,230611,2
3,4,23,612,0,1380,1,9,4,5,5,single-choice,spatial-relational,4|5,7,4/5,230612,4
3,4,23,613,0,521,1,7,3,4,4,single-choice,spatial-relational,3|4,7,3/4,230613,3
3,4,23,614,1,1076,1,9,4,4,5,single-choice,spatial-relational,4|5,7,4/5,230614,4
3,4,23,615,0,567,1,3,1,2,2,single-choice,spatial-relational,1|2,7,1/2,230615,1
3,4,23,616,0,3,1,3,1,2,2,single-choice,spatial-relational,1|2,7,1/2,230616,1
3,4,23,617,1,632,1,13,6,6,7,single-choice,spatial-relational,6|7,7,6/7,230617,6
3,4,23,618,0,1167,1,9,4,5,5,single-choice,spatial-relational,4|5,7,4/5,230618,4
3,4,23,619,1,629,1,9,4,4,5,single-choice,spatial-relational,4|5,7,4/5,230619,4
3,4,23,620,1,1148,1,5,2,2,3,single-choice,spatial-relational,2|3,7,2/3,230620,2
3,4,23,621,1,850,1,3,1,1,2,single-choice,spatial-relational,1|2,7,1/2,230621,1
3,4,23,622,1,1207,1,11,5,5,6,single-choice,spatial-relational,5|6,7,5/6,230622,5
3,4,23,623,0,775,1,13,6,7,7,single-choice,spatial-relational,6|7,7,6/7,230623,6
3,4,23,624,1,1063,1,11,5,5,6,single-choice,spatial-relational,5|6,7,5/6,230624,5
3,4,23,625,1,1147,1,7,3,3,4,single-choice,spatial-relational,3|4,7,3/4,230625,3
3,4,23,626,0,1732,1,7,3,4,4,single-choice,spatial-relational,3|4,7,3/4,230626,3
3,4,23,627,0,28,1,5,2,3,3,single-choice,spatial-relational,2|3,7,2/3,230627,2
3,4,23,628,0,616,1,11,5,6,6,single-choice,spatial-relational,5|6,7,5/6,230628,5
3,4,23,629,0,1,1,13,6,7,7,single-choice,spatial-relational,6|7,7,6/7,230629,6
3,4,23,630,0,892,1,3,1,2,2,single-choice,spatial-relational,1|2,7,1/2,230630,1
3,4,23,631,1,780,1,13,6,6,7,single-choice,spatial-relational,6|7,7,6/7,230631,6
3,4,23,632,1,795,1,5,2,2,3,single-choice,spatial-relational,2|3,7,2/3,230632,2
3,4,23,633,1,920,1,5,2,2,3,single-choice,spatial-relational,2|3,7,2/3,230633,2
3,4,23,634,0,863,1,9,4,5,5,single-choice,spatial-relational,4|5,7,4/5,230634,4
3,4,23,635,1,1043,1,7,3,3,4,single-choice,spatial-relational,3|4,7,3/4,230635,3
3,4,23,636,1,889,1,11,5,5,6,single-choice,spatial-relational,5|6,7,5/6,230636,5
3,4,23,637,1,856,1,9,4,4,5,single-choice,spatial-relational,4|5,7,4/5,230637,4
3,4,23,638,1,1633,1,7,3,3,4,single-choice,spatial-relational,3|4,7,3/4,230638,3
3,4,23,639,1,802,1,3,1,1,2,single-choice,spatial-relational,1|2,7,1/2,230639,1
3,4,23,640,1,841,1,11,5,5,6,single-choice,spatial-relational,5|6,7,5/6,230640,5
3,4,23,641,1,966,1,9,4,4,5,single-choice,spatial-relational,4|5,7,4/5,230641,4
3,4,23,642,1,823,1,13,6,6,7,single-choice,spatial-relational,6|7,7,6/7,230642,6
3,4,23,643,1,892,1,9,4,4,5,single-choice,spatial-relational,4|5,7,4/5,230643,4
3,4,23,644,1,921,1,5,2,2,3,single-choice,spatial-relational,2|3,7,2/3,230644,2
3,4,23,645,1,956,1,3,1,1,2,single-choice,spatial-relational,1|2,7,1/2,230645,1
3,4,23,646,1,1075,1,5,2,2,3,single-choice,spatial-relational,2|3,7,2/3,230646,2
3,4,23,647,1,1046,1,7,3,3,4,single-choice,spatial-relational,3|4,7,3/4,230647,3
3,4,23,648,0,1064,1,7,3,4,4,single-choice,spatial-relational,3|4,7,3/4,230648,3
3,4,23,649,0,515,1,11,5,6,6,single-choice,spatial-relational,5|6,7,5/6,230649,5
3,4,23,650,1,537,1,3,1,1,2,single-choice,spatial-relational,1|2,7,1/2,230650,1
3,4,23,651,1,741,1,13,6,6,7,single-choice,spatial-relational,6|7,7,6/7,230651,6
3,4,23,652,0,544,1,7,3,4,4,single-choice,spatial-relational,3|4,7,3/4,230652,3
3,4,23,653,0,30,1,13,6,7,7,single-choice,spatial-relational,6|7,7,6/7,230653,6
3,4,23,654,1,547,1,3,1,1,2,single-choice,spatial-relational,1|2,7,1/2,230654,1
3,4,23,655,1,736,1,3,1,1,2,single-choice,spatial-relational,1|2,7,1/2,230655,1
3,4,23,656,1,869,1,7,3,3,4,single-choice,spatial-relational,3|4,7,3/4,230656,3
3,4,23,657,0,917,1,9,4,5,5,single-choice,spatial-relational,4|5,7,4/5,230657,4
3,4,23,658,1,928,1,13,6,6,7,single-choice,spatial-relational,6|7,7,6/7,230658,6
3,4,23,659,0,671,1,11,5,6,6,single-choice,spatial-relational,5|6,7,5/6,230659,5
3,4,23,660,1,1095,1,9,4,4,5,single-choice,spatial-relational,4|5,7,4/5,230660,4
3,4,23,661,1,880,1,11,5,5,6,single-choice,spatial-relational,5|6,7,5/6,230661,5
3,4,23,662,1,924,1,5,2,2,3,single-choice,spatial-relational,2|3,7,2/3,230662,2
3,4,23,663,1,884,1,5,2,2,3,single-choice,spatial-relational,2|3,7,2/3,230663,2
3,4,23,664,0,1245,1,5,2,3,3,single-choice,spatial-relational,2|3,7,2/3,230664,2
3,4,23,665,1,739,1,3,1,1,2,single-choice,spatial-relational,1|2,7,1/2,230665,1
3,4,23,666,1,656,1,13,6,6,7,single-choice,spatial-relational,6|7,7,6/7,230666,6
3,4,23,667,1,1081,1,13,6,6,7,single-choice,spatial-relational,6|7,7,6/7,230667,6
3,4,23,668,0,977,1,9,4,5,5,single-choice,spatial-relational,4|5,7,4/5,230668,4
3,4,23,669,1,377,1,3,1,1,2,single-choice,spatial-relational,1|2,7,1/2,230669,1
3,4,23,670,1,1184,1,11,5,5,6,single-choice,spatial-relational,5|6,7,5/6,230670,5
3,4,23,671,1,561,1,5,2,2,3,single-choice,spatial-relational,2|3,7,2/3,230671,2
3,4,23,672,0,594,1,7,3,4,4,single-choice,spatial-relational,3|4,7,3/4,230672,3
3,4,23,673,1,655,1,9,4,4,5,single-choice,spatial-relational,4|5,7,4/5,230673,4
3,4,23,674,0,552,1,11,5,6,6,single-choice,spatial-relational,5|6,7,5/6,230674,5
3,4,23,675,0,673,1,7,3,4,4,single-choice,spatial-relational,3|4,7,3/4,230675,3
3,4,23,676,0,3,1,11,5,6,6,single-choice,spatial-relational,5|6,7,5/6,230676,5
3,4,23,677,1,825,1,13,6,6,7,single-choice,spatial-relational,6|7,7,6/7,230677,6
3,4,23,678,1,925,1,11,5,5,6,single-choice,spatial-relational,5|6,7,5/6,230678,5
3,4,23,679,0,1520,1,5,2,3,3,single-choice,spatial-relational,2|3,7,2/3,230679,2
3,4,23,680,1,1023,1,9,4,4,5,single-choice,spatial-relational,4|5,7,4/5,230680,4
3,4,23,681,1,1001,1,5,2,2,3,single-choice,spatial-relational,2|3,7,2/3,230681,2
3,4,23,682,1,991,1,7,3,3,4,single-choice,spatial-relational,3|4,7,3/4,230682,3
3,4,23,683,1,978,1,7,3,3,4,single-choice,spatial-relational,3|4,7,3/4,230683,3
3,4,23,684,1,1438,1,9,4,4,5,single-choice,spatial-relational,4|5,7,4/5,230684,4
3,4,23,685,1,692,1,3,1,1,2,single-choice,spatial-relational,1|2,7,1/2,230685,1
3,4,23,686,1,720,1,3,1,1,2,single-choice,spatial-relational,1|2,7,1/2,230686,1
3,4,23,687,0,384,1,13,6,7,7,single-choice,spatial-relational,6|7,7,6/7,230687,6
3,4,23,688,1,363,1,5,2,2,3,single-choice,spatial-relational,2|3,7,2/3,230688,2
3,4,23,689,0,717,1,3,1,2,2,single-choice,spatial-relational,1|2,7,1/2,230689,1
3,4,23,690,0,917,1,7,3,4,4,single-choice,spatial-relational,3|4,7,3/4,230690,3
3,4,23,691,1,678,1,3,1,1,2,single-choice,spatial-relational,1|2,7,1/2,230691,1
3,4,23,692,1,1427,1,7,3,3,4,single-choice,spatial-relational,3|4,7,3/4,230692,3
3,4,23,693,0,875,1,11,5,6,6,single-choice,spatial-relational,5|6,7,5/6,230693,5
3,4,23,694,1,831,1,13,6,6,7,single-choice,spatial-relational,6|7,7,6/7,230694,6
3,4,23,695,1,2112,1,9,4,4,5,single-choice,spatial-relational,4|5,7,4/5,230695,4
3,4,23,696,0,1151,1,11,5,6,6,single-choice,spatial-relational,5|6,7,5/6,230696,5
3,4,23,697,0,962,1,9,4,5,5,single-choice,spatial-relational,4|5,7,4/5,230697,4
3,4,23,698,1,923,1,5,2,2,3,single-choice,spatial-relational,2|3,7,2/3,230698,2
3,4,23,699,1,814,1,13,6,6,7,single-choice,spatial-relational,6|7,7,6/7,230699,6
3,4,23,700,1,1117,1,7,3,3,4,single-choice,spatial-relational,3|4,7,3/4,230700,3
3,4,23,701,1,1105,1,7,3,3,4,single-choice,spatial-relational,3|4,7,3/4,230701,3
3,4,23,702,1,846,1,3,1,1,2,single-choice,spatial-relational,1|2,7,1/2,230702,1
3,4,23,703,1,800,1,5,2,2,3,single-choice,spatial-relational,2|3,7,2/3,230703,2
3,4,23,704,1,821,1,3,1,1,2,single-choice,spatial-relational,1|2,7,1/2,230704,1
3,4,23,705,1,574,1,5,2,2,3,single-choice,spatial-relational,2|3,7,2/3,230705,2
3,4,23,706,1,1065,1,11,5,5,6,single-choice,spatial-relational,5|6,7,5/6,230706,5
3,4,23,707,1,964,1,11,5,5,6,single-choice,spatial-relational,5|6,7,5/6,230707,5
3,4,23,708,0,1865,1,9,4,5,5,single-choice,spatial-relational,4|5,7,4/5,230708,4
3,4,23,709,1,1080,1,9,4,4,5,single-choice,spatial-relational,4|5,7,4/5,230709,4
3,4,23,710,1,948,1,13,6,6,7,single-choice,spatial-relational,6|7,7,6/7,230710,6
3,4,23,711,1,1377,1,13,6,6,7,single-choice,spatial-relational,6|7,7,6/7,230711,6
3,4,23,712,1,1358,1,11,5,5,6,single-choice,spatial-relational,5|6,7,5/6,230712,5
3,4,23,713,1,1178,1,7,3,3,4,single-choice,spatial-relational,3|4,7,3/4,230713,3
3,4,23,714,1,489,1,5,2,2,3,single-choice,spatial-relational,2|3,7,2/3,230714,2
3,4,23,715,0,394,1,5,2,3,3,single-choice,spatial-relational,2|3,7,2/3,230715,2
3,4,23,716,1,535,1,11,5,5,6,single-choice,spatial-relational,5|6,7,5/6,230716,5
3,4,23,717,1,822,1,13,6,6,7,single-choice,spatial-relational,6|7,7,6/7,230717,6
3,4,23,718,1,838,1,13,6,6,7,single-choice,spatial-relational,6|7,7,6/7,230718,6
3,4,23,719,0,938,1,9,4,5,5,single-choice,spatial-relational,4|5,7,4/5,230719,4
3,4,23,720,0,654,1,3,1,2,2,single-choice,spatial-relational,1|2,7,1/2,230720,1
3,4,23,721,1,622,1,3,1,1,2,single-choice,spatial-relational,1|2,7,1/2,230721,1
3,4,23,722,1,904,1,7,3,3,4,single-choice,spatial-relational,3|4,7,3/4,230722,3
3,4,23,723,1,1175,1,9,4,4,5,single-choice,spatial-relational,4|5,7,4/5,230723,4
3,4,23,724,1,790,1,5,2,2,3,single-choice,spatial-relational,2|3,7,2/3,230724,2
3,4,23,725,0,956,1,9,4,5,5,single-choice,spatial-relational,4|5,7,4/5,230725,4
3,4,23,726,1,1062,1,11,5,5,6,single-choice,spatial-relational,5|6,7,5/6,230726,5
3,4,23,727,1,845,1,3,1,1,2,single-choice,spatial-relational,1|2,7,1/2,230727,1
3,4,23,728,1,741,1,13,6,6,7,single-choice,spatial-relational,6|7,7,6/7,230728,6
3,4,23,729,1,2006,1,5,2,2,3,single-choice,spatial-relational,2|3,7,2/3,230729,2
3,4,23,730,1,923,1,7,3,3,4,single-choice,spatial-relational,3|4,7,3/4,230730,3
3,4,23,731,1,1152,1,11,5,5,6,single-choice,spatial-relational,5|6,7,5/6,230731,5
3,4,23,732,0,806,1,13,6,7,7,single-choice,spatial-relational,6|7,7,6/7,230732,6
3,4,23,733,0,644,1,3,1,2,2,single-choice,spatial-relational,1|2,7,1/2,230733,1
3,4,23,734,0,606,1,9,4,5,5,single-choice,spatial-relational,4|5,7,4/5,230734,4
3,4,23,735,1,56232,1,7,3,3,4,single-choice,spatial-relational,3|4,7,3/4,230735,3
3,4,23,736,1,674,1,5,2,2,3,single-choice,spatial-relational,2|3,7,2/3,230736,2
3,4,23,737,1,1088,1,11,5,5,6,single-choice,spatial-relational,5|6,7,5/6,230737,5
3,4,23,738,1,1612,1,5,2,2,3,single-choice,spatial-relational,2|3,7,2/3,230738,2
3,4,23,739,0,1109,1,9,4,5,5,single-choice,spatial-relational,4|5,7,4/5,230739,4
3,4,23,740,1,909,1,3,1,1,2,single-choice,spatial-relational,1|2,7,1/2,230740,1
3,4,23,741,1,671,1,9,4,4,5,single-choice,spatial-relational,4|5,7,4/5,230741,4
3,4,23,742,1,1372,1,7,3,3,4,single-choice,spatial-relational,3|4,7,3/4,230742,3
3,4,23,743,1,843,1,13,6,6,7,single-choice,spatial-relational,6|7,7,6/7,230743,6
3,4,23,744,1,1014,1,7,3,3,4,single-choice,spatial-relational,3|4,7,3/4,230744,3
3,4,23,745,1,899,1,13,6,6,7,single-choice,spatial-relational,6|7,7,6/7,230745,6
3,4,23,746,1,1448,1,3,1,1,2,single-choice,spatial-relational,1|2,7,1/2,230746,1
3,4,23,747,0,678,1,11,5,6,6,single-choice,spatial-relational,5|6,7,5/6,230747,5
3,4,23,748,1,57,1,9,4,4,5,single-choice,spatial-relational,4|5,7,4/5,230748,4
3,4,23,749,0,1035,1,5,2,3,3,single-choice,spatial-relational,2|3,7,2/3,230749,2
3,4,23,750,1,685,1,3,1,1,2,single-choice,spatial-relational,1|2,7,1/2,230750,1
3,4,23,751,1,871,1,7,3,3,4,single-choice,spatial-relational,3|4,7,3/4,230751,3
3,4,23,752,1,933,1,7,3,3,4,single-choice,spatial-relational,3|4,7,3/4,230752,3
3,4,23,753,1,770,1,3,1,1,2,single-choice,spatial-relational,1|2,7,1/2,230753,1
3,4,23,754,1,1039,1,9,4,4,5,single-choice,spatial-relational,4|5,7,4/5,230754,4
3,4,23,755,1,1000,1,13,6,6,7,single-choice,spatial-relational,6|7,7,6/7,230755,6
3,4,23,756,1,839,1,5,2,2,3,single-choice,spatial-relational,2|3,7,2/3,230756,2
3,4,23,757,0,1060,1,11,5,6,6,single-choice,spatial-relational,5|6,7,5/6,230757,5
3,4,23,758,1,714,1,13,6,6,7,single-choice,spatial-relational,6|7,7,6/7,230758,6
3,4,23,759,1,1049,1,11,5,5,6,single-choice,spatial-relational,5|6,7,5/6,230759,5
3,4,23,760,0,606,1,7,3,4,4,single-choice,spatial-relational,3|4,7,3/4,230760,3
3,4,23,761,1,3,1,13,6,6,7,single-choice,spatial-relational,6|7,7,6/7,230761,6
3,4,23,762,1,1093,1,5,2,2,3,single-choice,spatial-relational,2|3,7,2/3,230762,2
3,4,23,763,1,1090,1,13,6,6,7,single-choice,spatial-relational,6|7,7,6/7,230763,6
3,4,23,764,1,1419,1,11,5,5,6,single-choice,spatial-relational,5|6,7,5/6,230764,5
3,4,23,765,1,1109,1,7,3,3,4,single-choice,spatial-relational,3|4,7,3/4,230765,3
3,4,23,766,1,818,1,3,1,1,2,single-choice,spatial-relational,1|2,7,1/2,230766,1
3,4,23,767,0,1075,1,9,4,5,5,single-choice,spatial-relational,4|5,7,4/5,230767,4
3,4,23,768,1,748,1,9,4,4,5,single-choice,spatial-relational,4|5,7,4/5,230768,4
3,4,23,769,1,804,1,3,1,1,2,single-choice,spatial-relational,1|2,7,1/2,230769,1
3,4,23,770,1,1309,1,5,2,2,3,single-choice,spatial-relational,2|3,7,2/3,230770,2
3,4,23,771,1,1139,1,11,5,5,6,single-choice,spatial-relational,5|6,7,5/6,230771,5
3,4,23,772,1,1101,1,3,1,1,2,single-choice,spatial-relational,1|2,7,1/2,230772,1
3,4,23,773,1,865,1,5,2,2,3,single-choice,spatial-relational,2|3,7,2/3,230773,2
3,4,23,774,0,1004,1,9,4,5,5,single-choice,spatial-relational,4|5,7,4/5,230774,4
3,4,23,775,1,1200,1,3,1,1,2,single-choice,spatial-relational,1|2,7,1/2,230775,1
3,4,23,776,0,696,1,11,5,6,6,single-choice,spatial-relational,5|6,7,5/6,230776,5
3,4,23,777,1,983,1,7,3,3,4,single-choice,spatial-relational,3|4,7,3/4,230777,3
3,4,23,778,1,1321,1,11,5,5,6,single-choice,spatial-relational,5|6,7,5/6,230778,5
3,4,23,779,1,814,1,9,4,4,5,single-choice,spatial-relational,4|5,7,4/5,230779,4
3,4,23,780,1,922,1,7,3,3,4,single-choice,spatial-relational,3|4,7,3/4,230780,3
3,4,23,781,1,900,1,13,6,6,7,single-choice,spatial-relational,6|7,7,6/7,230781,6
3,4,23,782,1,1206,1,13,6,6,7,single-choice,spatial-relational,6|7,7,6/7,230782,6
3,4,23,783,1,1267,1,5,2,2,3,single-choice,spatial-relational,2|3,7,2/3,230783,2
3,4,23,784,1,959,1,13,6,6,7,single-choice,spatial-relational,6|7,7,6/7,230784,6
3,4,23,785,0,1222,1,9,4,5,5,single-choice,spatial-relational,4|5,7,4/5,230785,4
3,4,23,786,0,34,1,7,3,4,4,single-choice,spatial-relational,3|4,7,3/4,230786,3
3,4,23,787,0,51,1,5,2,3,3,single-choice,spatial-relational,2|3,7,2/3,230787,2
3,4,23,788,0,603,1,13,6,7,7,single-choice,spatial-relational,6|7,7,6/7,230788,6
3,4,23,789,0,666,1,7,3,4,4,single-choice,spatial-relational,3|4,7,3/4,230789,3
3,4,23,790,1,1020,1,9,4,4,5,single-choice,spatial-relational,4|5,7,4/5,230790,4
3,4,23,791,0,1093,1,11,5,6,6,single-choice,spatial-relational,5|6,7,5/6,230791,5
3,4,23,792,1,962,1,5,2,2,3,single-choice,spatial-relational,2|3,7,2/3,230792,2
3,4,23,793,1,722,1,3,1,1,2,single-choice,spatial-relational,1|2,7,1/2,230793,1
3,4,23,794,1,1227,1,11,5,5,6,single-choice,spatial-relational,5|6,7,5/6,230794,5
3,4,23,795,1,833,1,3,1,1,2,single-choice,spatial-relational,1|2,7,1/2,230795,1
3,4,23,796,1,1261,1,9,4,4,5,single-choice,spatial-relational,4|5,7,4/5,230796,4
3,4,23,797,1,903,1,3,1,1,2,single-choice,spatial-relational,1|2,7,1/2,230797,1
3,4,23,798,1,927,1,5,2,2,3,single-choice,spatial-relational,2|3,7,2/3,230798,2
3,4,23,799,1,1661,1,11,5,5,6,single-choice,spatial-relational,5|6,7,5/6,230799,5
3,4,23,800,1,1968,1,11,5,5,6,single-choice,spatial-relational,5|6,7,5/6,230800,5
3,4,23,801,0,1208,1,5,2,3,3,single-choice,spatial-relational,2|3,7,2/3,230801,2
3,4,23,802,1,2754,1,3,1,1,2,single-choice,spatial-relational,1|2,7,1/2,230802,1
3,4,23,803,1,956,1,9,4,4,5,single-choice,spatial-relational,4|5,7,4/5,230803,4
3,4,23,804,1,1250,1,7,3,3,4,single-choice,spatial-relational,3|4,7,3/4,230804,3
3,4,23,805,1,1134,1,13,6,6,7,single-choice,spatial-relational,6|7,7,6/7,230805,6
3,4,23,806,0,1747,1,7,3,4,4,single-choice,spatial-relational,3|4,7,3/4,230806,3
3,4,23,807,1,883,1,13,6,6,7,single-choice,spatial-relational,6|7,7,6/7,230807,6
3,4,23,808,1,1169,1,9,4,4,5,single-choice,spatial-relational,4|5,7,4/5,230808,4
3,4,23,809,1,1086,1,3,1,1,2,single-choice,spatial-relational,1|2,7,1/2,230809,1
3,4,23,810,1,862,1,7,3,3,4,single-choice,spatial-relational,3|4,7,3/4,230810,3
3,4,23,811,1,1132,1,11,5,5,6,single-choice,spatial-relational,5|6,7,5/6,230811,5
3,4,23,812,1,672,1,11,5,5,6,single-choice,spatial-relational,5|6,7,5/6,230812,5
3,4,23,813,0,1130,1,7,3,4,4,single-choice,spatial-relational,3|4,7,3/4,230813,3
3,4,23,814,0,532,1,13,6,7,7,single-choice,spatial-relational,6|7,7,6/7,230814,6
3,4,23,815,1,4603,1,5,2,2,3,single-choice,spatial-relational,2|3,7,2/3,230815,2
3,4,23,816,1,1075,1,9,4,4,5,single-choice,spatial-relational,4|5,7,4/5,230816,4
3,4,23,817,1,1115,1,13,6,6,7,single-choice,spatial-relational,6|7,7,6/7,230817,6
3,4,23,818,1,776,1,5,2,2,3,single-choice,spatial-relational,2|3,7,2/3,230818,2
3,4,23,819,0,853,1,3,1,2,2,single-choice,spatial-relational,1|2,7,1/2,230819,1
3,4,23,820,0,746,1,13,6,7,7,single-choice,spatial-relational,6|7,7,6/7,230820,6
3,4,23,821,1,15456,1,7,3,3,4,single-choice,spatial-relational,3|4,7,3/4,230821,3
3,4,23,822,1,572,1,9,4,4,5,single-choice,spatial-relational,4|5,7,4/5,230822,4
3,4,23,823,1,820,1,13,6,6,7,single-choice,spatial-relational,6|7,7,6/7,230823,6
3,4,23,824,1,1018,1,3,1,1,2,single-choice,spatial-relational,1|2,7,1/2,230824,1
3,4,23,825,1,826,1,5,2,2,3,single-choice,spatial-relational,2|3,7,2/3,230825,2
3,4,23,826,1,738,1,11,5,5,6,single-choice,spatial-relational,5|6,7,5/6,230826,5
3,4,23,827,1,1881,1,5,2,2,3,single-choice,spatial-relational,2|3,7,2/3,230827,2
3,4,23,828,1,855,1,3,1,1,2,single-choice,spatial-relational,1|2,7,1/2,230828,1
3,4,23,829,0,1265,1,11,5,6,6,single-choice,spatial-relational,5|6,7,5/6,230829,5
3,4,23,830,1,2085,1,7,3,3,4,single-choice,spatial-relational,3|4,7,3/4,230830,3
3,4,23,831,0,1183,1,9,4,5,5,single-choice,spatial-relational,4|5,7,4/5,230831,4
3,4,23,832,1,1471,1,9,4,4,5,single-choice,spatial-relational,4|5,7,4/5,230832,4
3,4,23,833,1,888,1,9,4,4,5,single-choice,spatial-relational,4|5,7,4/5,230833,4
3,4,23,834,1,813,1,5,2,2,3,single-choice,spatial-relational,2|3,7,2/3,230834,2
3,4,23,835,1,1171,1,11,5,5,6,single-choice,spatial-relational,5|6,7,5/6,230835,5
3,4,23,836,1,893,1,3,1,1,2,single-choice,spatial-relational,1|2,7,1/2,230836,1
3,4,23,837,1,711,1,13,6,6,7,single-choice,spatial-relational,6|7,7,6/7,230837,6
3,4,23,838,1,710,1,3,1,1,2,single-choice,spatial-relational,1|2,7,1/2,230838,1
3,4,23,839,1,1031,1,11,5,5,6,single-choice,spatial-relational,5|6,7,5/6,230839,5
3,4,23,840,1,975,1,7,3,3,4,single-choice,spatial-relational,3|4,7,3/4,230840,3
3,4,23,841,1,1042,1,5,2,2,3,single-choice,spatial-relational,2|3,7,2/3,230841,2
3,4,23,842,1,1474,1,13,6,6,7,single-choice,spatial-relational,6|7,7,6/7,230842,6
3,4,23,843,0,787,1,7,3,4,4,single-choice,spatial-relational,3|4,7,3/4,230843,3
3,4,23,844,1,54517,1,5,2,2,3,single-choice,spatial-relational,2|3,7,2/3,230844,2
3,4,23,845,0,21235,1,11,5,6,6,single-choice,spatial-relational,5|6,7,5/6,230845,5
3,4,23,846,1,1268,1,11,5,5,6,single-choice,spatial-relational,5|6,7,5/6,230846,5
3,4,23,847,1,1212,1,7,3,3,4,single-choice,spatial-relational,3|4,7,3/4,230847,3
3,4,23,848,1,1364,1,9,4,4,5,single-choice,spatial-relational,4|5,7,4/5,230848,4
3,4,23,849,1,1102,1,7,3,3,4,single-choice,spatial-relational,3|4,7,3/4,230849,3
3,4,23,850,1,1082,1,5,2,2,3,single-choice,spatial-relational,2|3,7,2/3,230850,2
3,4,23,851,1,786,1,13,6,6,7,single-choice,spatial-relational,6|7,7,6/7,230851,6
3,4,23,852,0,1364,1,9,4,5,5,single-choice,spatial-relational,4|5,7,4/5,230852,4
3,4,23,853,1,1018,1,3,1,1,2,single-choice,spatial-relational,1|2,7,1/2,230853,1
3,4,23,854,1,704,1,13,6,6,7,single-choice,spatial-relational,6|7,7,6/7,230854,6
3,4,23,855,1,984,1,3,1,1,2,single-choice,spatial-relational,1|2,7,1/2,230855,1
3,4,23,856,0,937,1,5,2,3,3,single-choice,spatial-relational,2|3,7,2/3,230856,2
3,4,23,857,1,1017,1,11,5,5,6,single-choice,spatial-relational,5|6,7,5/6,230857,5
3,4,23,858,0,1373,1,9,4,5,5,single-choice,spatial-relational,4|5,7,4/5,230858,4
3,4,23,859,1,958,1,9,4,4,5,single-choice,spatial-relational,4|5,7,4/5,230859,4
3,4,23,860,1,1060,1,3,1,1,2,single-choice,spatial-relational,1|2,7,1/2,230860,1
3,4,23,861,1,1051,1,11,5,5,6,single-choice,spatial-relational,5|6,7,5/6,230861,5
3,4,23,862,1,921,1,13,6,6,7,single-choice,spatial-relational,6|7,7,6/7,230862,6
3,4,23,863,1,836,1,3,1,1,2,single-choice,spatial-relational,1|2,7,1/2,230863,1
3,4,23,864,1,951,1,13,6,6,7,single-choice,spatial-relational,6|7,7,6/7,230864,6
3,4,23,865,1,869,1,7,3,3,4,single-choice,spatial-relational,3|4,7,3/4,230865,3
3,4,23,866,0,951,1,5,2,3,3,single-choice,spatial-relational,2|3,7,2/3,230866,2
3,4,23,867,0,537,1,7,3,4,4,single-choice,spatial-relational,3|4,7,3/4,230867,3
3,4,23,868,1,65,1,13,6,6,7,single-choice,spatial-relational,6|7,7,6/7,230868,6
3,4,23,869,1,1294,1,11,5,5,6,single-choice,spatial-relational,5|6,7,5/6,230869,5
3,4,23,870,1,1022,1,5,2,2,3,single-choice,spatial-relational,2|3,7,2/3,230870,2
3,4,23,871,1,2008,1,13,6,6,7,single-choice,spatial-relational,6|7,7,6/7,230871,6
3,4,23,872,0,1039,1,9,4,5,5,single-choice,spatial-relational,4|5,7,4/5,230872,4
3,4,23,873,1,1253,1,9,4,4,5,single-choice,spatial-relational,4|5,7,4/5,230873,4
3,4,23,874,1,927,1,11,5,5,6,single-choice,spatial-relational,5|6,7,5/6,230874,5
3,4,23,875,1,875,1,5,2,2,3,single-choice,spatial-relational,2|3,7,2/3,230875,2
3,4,23,876,0,169993,1,3,1,2,2,single-choice,spatial-relational,1|2,7,1/2,230876,1
3,4,23,877,1,1031,1,3,1,1,2,single-choice,spatial-relational,1|2,7,1/2,230877,1
3,4,23,878,1,945,1,7,3,3,4,single-choice,spatial-relational,3|4,7,3/4,230878,3
3,4,23,879,0,1881,1,7,3,4,4,single-choice,spatial-relational,3|4,7,3/4,230879,3
3,4,23,880,1,1058,1,5,2,2,3,single-choice,spatial-relational,2|3,7,2/3,230880,2
3,4,23,881,1,1057,1,3,1,1,2,single-choice,spatial-relational,1|2,7,1/2,230881,1
3,4,23,882,1,834,1,13,6,6,7,single-choice,spatial-relational,6|7,7,6/7,230882,6
3,4,23,883,1,1485,1,5,2,2,3,single-choice,spatial-relational,2|3,7,2/3,230883,2
3,4,23,884,0,933,1,9,4,5,5,single-choice,spatial-relational,4|5,7,4/5,230884,4
3,4,23,885,1,1685,1,9,4,4,5,single-choice,spatial-relational,4|5,7,4/5,230885,4
3,4,23,886,1,1179,1,7,3,3,4,single-choice,spatial-relational,3|4,7,3/4,230886,3
3,4,23,887,1,1346,1,11,5,5,6,single-choice,spatial-relational,5|6,7,5/6,230887,5
3,4,23,888,1,996,1,7,3,3,4,single-choice,spatial-relational,3|4,7,3/4,230888,3
3,4,23,889,1,975,1,13,6,6,7,single-choice,spatial-relational,6|7,7,6/7,230889,6
3,4,23,890,1,1097,1,11,5,5,6,single-choice,spatial-relational,5|6,7,5/6,230890,5
3,4,23,891,0,1505,1,3,1,2,2,single-choice,spatial-relational,1|2,7,1/2,230891,1
3,4,23,892,1,971,1,11,5,5,6,single-choice,spatial-relational,5|6,7,5/6,230892,5
3,4,23,893,1,1015,1,11,5,5,6,single-choice,spatial-relational,5|6,7,5/6,230893,5
3,4,23,894,1,1255,1,9,4,4,5,single-choice,spatial-relational,4|5,7,4/5,230894,4
3,4,23,895,1,924,1,5,2,2,3,single-choice,spatial-relational,2|3,7,2/3,230895,2
3,4,23,896,1,1031,1,13,6,6,7,single-choice,spatial-relational,6|7,7,6/7,230896,6
3,4,23,897,1,1039,1,13,6,6,7,single-choice,spatial-relational,6|7,7,6/7,230897,6
3,4,23,898,1,877,1,9,4,4,5,single-choice,spatial-relational,4|5,7,4/5,230898,4
3,4,23,899,0,906,1,7,3,4,4,single-choice,spatial-relational,3|4,7,3/4,230899,3
3,4,23,900,0,642,1,7,3,4,4,single-choice,spatial-relational,3|4,7,3/4,230900,3
3,4,23,901,0,137801,1,5,2,3,3,single-choice,spatial-relational,2|3,7,2/3,230901,2
3,4,23,902,1,1013,1,3,1,1,2,single-choice,spatial-relational,1|2,7,1/2,230902,1
3,4,23,903,1,882,1,3,1,1,2,single-choice,spatial-relational,1|2,7,1/2,230903,1
3,4,23,904,1,790,1,13,6,6,7,single-choice,spatial-relational,6|7,7,6/7,230904,6
3,4,23,905,1,1346,1,7,3,3,4,single-choice,spatial-relational,3|4,7,3/4,230905,3
3,4,23,906,1,1062,1,11,5,5,6,single-choice,spatial-relational,5|6,7,5/6,230906,5
3,4,23,907,1,1121,1,9,4,4,5,single-choice,spatial-relational,4|5,7,4/5,230907,4
3,4,23,908,0,1402,1,5,2,3,3,single-choice,spatial-relational,2|3,7,2/3,230908,2
3,4,23,909,1,969,1,3,1,1,2,single-choice,spatial-relational,1|2,7,1/2,230909,1
3,4,23,910,0,535,1,7,3,4,4,single-choice,spatial-relational,3|4,7,3/4,230910,3
3,4,23,911,0,877,1,9,4,5,5,single-choice,spatial-relational,4|5,7,4/5,230911,4
3,4,23,912,0,21,1,3,1,2,2,single-choice,spatial-relational,1|2,7,1/2,230912,1
3,4,23,913,1,1030,1,13,6,6,7,single-choice,spatial-relational,6|7,7,6/7,230913,6
3,4,23,914,1,2132,1,11,5,5,6,single-choice,spatial-relational,5|6,7,5/6,230914,5
3,4,23,915,1,1392,1,5,2,2,3,single-choice,spatial-relational,2|3,7,2/3,230915,2
3,4,23,916,1,863,1,11,5,5,6,single-choice,spatial-relational,5|6,7,5/6,230916,5
3,4,23,917,0,1529,1,5,2,3,3,single-choice,spatial-relational,2|3,7,2/3,230917,2
3,4,23,918,1,1040,1,3,1,1,2,single-choice,spatial-relational,1|2,7,1/2,230918,1
3,4,23,919,1,682,1,13,6,6,7,single-choice,spatial-relational,6|7,7,6/7,230919,6
3,4,23,920,0,1177,1,9,4,5,5,single-choice,spatial-relational,4|5,7,4/5,230920,4
3,4,23,921,0,653,1,7,3,4,4,single-choice,spatial-relational,3|4,7,3/4,230921,3
3,4,23,922,1,976,1,7,3,3,4,single-choice,spatial-relational,3|4,7,3/4,230922,3
3,4,23,923,1,842,1,5,2,2,3,single-choice,spatial-relational,2|3,7,2/3,230923,2
3,4,23,924,1,874,1,13,6,6,7,single-choice,spatial-relational,6|7,7,6/7,230924,6
3,4,23,925,1,1021,1,3,1,1,2,single-choice,spatial-relational,1|2,7,1/2,230925,1
3,4,23,926,1,935,1,11,5,5,6,single-choice,spatial-relational,5|6,7,5/6,230926,5
3,4,23,927,1,897,1,9,4,4,5,single-choice,spatial-relational,4|5,7,4/5,230927,4
3,4,23,928,1,1016,1,7,3,3,4,single-choice,spatial-relational,3|4,7,3/4,230928,3
3,4,23,929,1,851,1,3,1,1,2,single-choice,spatial-relational,1|2,7,1/2,230929,1
3,4,23,930,1,837,1,5,2,2,3,single-choice,spatial-relational,2|3,7,2/3,230930,2
3,4,23,931,0,1303,1,9,4,5,5,single-choice,spatial-relational,4|5,7,4/5,230931,4
3,4,23,932,1,71895,1,13,6,6,7,single-choice,spatial-relational,6|7,7,6/7,230932,6
3,4,23,933,1,599,1,3,1,1,2,single-choice,spatial-relational,1|2,7,1/2,230933,1
3,4,23,934,1,1023,1,7,3,3,4,single-choice,spatial-relational,3|4,7,3/4,230934,3
3,4,23,935,1,1065,1,13,6,6,7,single-choice,spatial-relational,6|7,7,6/7,230935,6
3,4,23,936,1,1840,1,5,2,2,3,single-choice,spatial-relational,2|3,7,2/3,230936,2
3,4,23,937,1,979,1,11,5,5,6,single-choice,spatial-relational,5|6,7,5/6,230937,5
3,4,23,938,1,1395,1,11,5,5,6,single-choice,spatial-relational,5|6,7,5/6,230938,5
3,4,23,939,1,902,1,9,4,4,5,single-choice,spatial-relational,4|5,7,4/5,230939,4
3,4,23,940,1,903,1,3,1,1,2,single-choice,spatial-relational,1|2,7,1/2,230940,1
3,4,23,941,0,1019,1,9,4,5,5,single-choice,spatial-relational,4|5,7,4/5,230941,4
3,4,23,942,1,1133,1,11,5,5,6,single-choice,spatial-relational,5|6,7,5/6,230942,5
3,4,23,943,1,1276,1,7,3,3,4,single-choice,spatial-relational,3|4,7,3/4,230943,3
3,4,23,944,1,804,1,9,4,4,5,single-choice,spatial-relational,4|5,7,4/5,230944,4
3,4,23,945,1,1187,1,7,3,3,4,single-choice,spatial-relational,3|4,7,3/4,230945,3
3,4,23,946,1,1022,1,13,6,6,7,single-choice,spatial-relational,6|7,7,6/7,230946,6
3,4,23,947,1,894,1,13,6,6,7,single-choice,spatial-relational,6|7,7,6/7,230947,6
3,4,23,948,1,969,1,11,5,5,6,single-choice,spatial-relational,5|6,7,5/6,230948,5
3,4,23,949,1,859,1,5,2,2,3,single-choice,spatial-relational,2|3,7,2/3,230949,2
3,4,23,950,0,1208,1,5,2,3,3,single-choice,spatial-relational,2|3,7,2/3,230950,2
3,4,23,951,1,929,1,3,1,1,2,single-choice,spatial-relational,1|2,7,1/2,230951,1
3,4,23,952,1,799,1,7,3,3,4,single-choice,spatial-relational,3|4,7,3/4,230952,3
3,4,23,953,1,1313,1,5,2,2,3,single-choice,spatial-relational,2|3,7,2/3,230953,2
3,4,23,954,1,754,1,9,4,4,5,single-choice,spatial-relational,4|5,7,4/5,230954,4
3,4,23,955,0,786,1,11,5,6,6,single-choice,spatial-relational,5|6,7,5/6,230955,5
3,4,23,956,1,1276,1,9,4,4,5,single-choice,spatial-relational,4|5,7,4/5,230956,4
3,4,23,957,1,1163,1,13,6,6,7,single-choice,spatial-relational,6|7,7,6/7,230957,6
3,4,23,958,1,775,1,3,1,1,2,single-choice,spatial-relational,1|2,7,1/2,230958,1
3,4,23,959,0,543,1,7,3,4,4,single-choice,spatial-relational,3|4,7,3/4,230959,3
3,4,23,960,0,458667,1,11,5,6,6,single-choice,spatial-relational,5|6,7,5/6,230960,5
3,4,23,961,0,73902,1,5,2,3,3,single-choice,spatial-relational,2|3,7,2/3,230961,2
3,4,23,962,1,13258,1,3,1,1,2,single-choice,spatial-relational,1|2,7,1/2,230962,1
3,4,23,963,1,956,1,13,6,6,7,single-choice,spatial-relational,6|7,7,6/7,230963,6
3,4,23,964,1,1033,1,13,6,6,7,single-choice,spatial-relational,6|7,7,6/7,230964,6
3,4,23,965,1,859,1,3,1,1,2,single-choice,spatial-relational,1|2,7,1/2,230965,1
3,4,23,966,1,1557,1,5,2,2,3,single-choice,spatial-relational,2|3,7,2/3,230966,2
3,4,23,967,1,892,1,11,5,5,6,single-choice,spatial-relational,5|6,7,5/6,230967,5
3,4,23,968,1,1158,1,7,3,3,4,single-choice,spatial-relational,3|4,7,3/4,230968,3
3,4,23,969,1,2570,1,9,4,4,5,single-choice,spatial-relational,4|5,7,4/5,230969,4
3,4,23,970,1,1172,1,7,3,3,4,single-choice,spatial-relational,3|4,7,3/4,230970,3
3,4,23,971,1,780,1,3,1,1,2,single-choice,spatial-relational,1|2,7,1/2,230971,1
3,4,23,972,1,993,1,13,6,6,7,single-choice,spatial-relational,6|7,7,6/7,230972,6
3,4,23,973,1,1126,1,5,2,2,3,single-choice,spatial-relational,2|3,7,2/3,230973,2
3,4,23,974,0,946,1,9,4,5,5,single-choice,spatial-relational,4|5,7,4/5,230974,4
3,4,23,975,0,1972,1,11,5,6,6,single-choice,spatial-relational,5|6,7,5/6,230975,5
3,4,23,976,0,2662,1,11,5,6,6,single-choice,spatial-relational,5|6,7,5/6,230976,5
3,4,23,977,1,941,1,5,2,2,3,single-choice,spatial-relational,2|3,7,2/3,230977,2
3,4,23,978,0,785,1,9,4,5,5,single-choice,spatial-relational,4|5,7,4/5,230978,4
3,4,23,979,1,702,1,9,4,4,5,single-choice,spatial-relational,4|5,7,4/5,230979,4
3,4,23,980,1,976,1,13,6,6,7,single-choice,spatial-relational,6|7,7,6/7,230980,6
3,4,23,981,1,1142,1,7,3,3,4,single-choice,spatial-relational,3|4,7,3/4,230981,3
3,4,23,982,1,1086,1,11,5,5,6,single-choice,spatial-relational,5|6,7,5/6,230982,5
3,4,23,983,1,868,1,5,2,2,3,single-choice,spatial-relational,2|3,7,2/3,230983,2
3,4,23,984,1,205825,1,13,6,6,7,single-choice,spatial-relational,6|7,7,6/7,230984,6
3,4,23,985,1,1858,1,3,1,1,2,single-choice,spatial-relational,1|2,7,1/2,230985,1
3,4,23,986,1,1168,1,7,3,3,4,single-choice,spatial-relational,3|4,7,3/4,230986,3
3,4,23,987,1,789,1,3,1,1,2,single-choice,spatial-relational,1|2,7,1/2,230987,1
3,4,23,988,1,984,1,7,3,3,4,single-choice,spatial-relational,3|4,7,3/4,230988,3
3,4,23,989,1,862,1,3,1,1,2,single-choice,spatial-relational,1|2,7,1/2,230989,1
3,4,23,990,1,847,1,13,6,6,7,single-choice,spatial-relational,6|7,7,6/7,230990,6
3,4,23,991,1,891,1,13,6,6,7,single-choice,spatial-relational,6|7,7,6/7,230991,6
3,4,23,992,0,1054,1,9,4,5,5,single-choice,spatial-relational,4|5,7,4/5,230992,4
3,4,23,993,1,1417,1,9,4,4,5,single-choice,spatial-relational,4|5,7,4/5,230993,4
3,4,23,994,1,786,1,3,1,1,2,single-choice,spatial-relational,1|2,7,1/2,230994,1
3,4,23,995,0,1118,1,5,2,3,3,single-choice,spatial-relational,2|3,7,2/3,230995,2
3,4,23,996,0,1114,1,5,2,3,3,single-choice,spatial-relational,2|3,7,2/3,230996,2
3,4,23,997,0,1924,1,7,3,4,4,single-choice,spatial-relational,3|4,7,3/4,230997,3
3,4,23,998,0,1531,1,11,5,6,6,single-choice,spatial-relational,5|6,7,5/6,230998,5
3,4,23,999,1,1244,1,11,5,5,6,single-choice,spatial-relational,5|6,7,5/6,230999,5
3,4,23,1000,1,1194,1,9,4,4,5,single-choice,spatial-relational,4|5,7,4/5,231000,4
3,4,23,1001,0,895,1,7,3,4,4,single-choice,spatial-relational,3|4,7,3/4,231001,3
3,4,23,1002,1,1689,1,11,5,5,6,single-choice,spatial-relational,5|6,7,5/6,231002,5
3,4,23,1003,0,1157,1,5,2,3,3,single-choice,spatial-relational,2|3,7,2/3,231003,2
3,4,23,1004,1,891,1,3,1,1,2,single-choice,spatial-relational,1|2,7,1/2,231004,1
3,4,23,1005,1,937,1,13,6,6,7,single-choice,spatial-relational,6|7,7,6/7,231005,6
3,4,23,1006,0,1035,1,9,4,5,5,single-choice,spatial-relational,4|5,7,4/5,231006,4
3,4,23,1007,0,40107,1,13,6,7,7,single-choice,spatial-relational,6|7,7,6/7,231007,6
3,4,23,1008,0,556,1,7,3,4,4,single-choice,spatial-relational,3|4,7,3/4,231008,3
3,4,23,1009,0,177841,1,11,5,6,6,single-choice,spatial-relational,5|6,7,5/6,231009,5
3,4,23,1010,1,852,1,3,1,1,2,single-choice,spatial-relational,1|2,7,1/2,231010,1
3,4,23,1011,0,1095,1,5,2,3,3,single-choice,spatial-relational,2|3,7,2/3,231011,2
3,4,23,1012,1,993,1,3,1,1,2,single-choice,spatial-relational,1|2,7,1/2,231012,1
3,4,23,1013,0,686,1,7,3,4,4,single-choice,spatial-relational,3|4,7,3/4,231013,3
3,4,23,1014,1,924,1,13,6,6,7,single-choice,spatial-relational,6|7,7,6/7,231014,6
3,4,23,1015,0,814,1,9,4,5,5,single-choice,spatial-relational,4|5,7,4/5,231015,4
3,4,23,1016,1,1025,1,7,3,3,4,single-choice,spatial-relational,3|4,7,3/4,231016,3
3,4,23,1017,0,1253,1,11,5,6,6,single-choice,spatial-relational,5|6,7,5/6,231017,5
3,4,23,1018,1,29,1,13,6,6,7,single-choice,spatial-relational,6|7,7,6/7,231018,6
3,4,23,1019,1,1024,1,5,2,2,3,single-choice,spatial-relational,2|3,7,2/3,231019,2
3,4,23,1020,1,932,1,9,4,4,5,single-choice,spatial-relational,4|5,7,4/5,231020,4
3,4,23,1021,1,846,1,3,1,1,2,single-choice,spatial-relational,1|2,7,1/2,231021,1
3,4,23,1022,1,965,1,11,5,5,6,single-choice,spatial-relational,5|6,7,5/6,231022,5
3,4,23,1023,1,939,1,5,2,2,3,single-choice,spatial-relational,2|3,7,2/3,231023,2
3,4,23,1024,1,781,1,3,1,1,2,single-choice,spatial-relational,1|2,7,1/2,231024,1
3,4,23,1025,1,727,1,13,6,6,7,single-choice,spatial-relational,6|7,7,6/7,231025,6
3,4,23,1026,0,33514,1,5,2,3,3,single-choice,spatial-relational,2|3,7,2/3,231026,2
3,4,23,1027,0,558195,1,9,4,5,5,single-choice,spatial-relational,4|5,7,4/5,231027,4
3,4,23,1028,0,119929,1,11,5,6,6,single-choice,spatial-relational,5|6,7,5/6,231028,5
3,4,23,1029,1,105123,1,11,5,5,6,single-choice,spatial-relational,5|6,7,5/6,231029,5
3,4,23,1030,0,377,1,5,2,3,3,single-choice,spatial-relational,2|3,7,2/3,231030,2
3,4,23,1031,1,1987,1,7,3,3,4,single-choice,spatial-relational,3|4,7,3/4,231031,3
3,4,23,1032,0,1364,1,9,4,5,5,single-choice,spatial-relational,4|5,7,4/5,231032,4
3,4,23,1033,0,1016,1,7,3,4,4,single-choice,spatial-relational,3|4,7,3/4,231033,3
3,4,23,1034,1,15,1,3,1,1,2,single-choice,spatial-relational,1|2,7,1/2,231034,1
3,4,23,1035,1,961,1,13,6,6,7,single-choice,spatial-relational,6|7,7,6/7,231035,6
3,4,23,1036,1,979,1,3,1,1,2,single-choice,spatial-relational,1|2,7,1/2,231036,1
3,4,23,1037,1,1162,1,13,6,6,7,single-choice,spatial-relational,6|7,7,6/7,231037,6
3,4,23,1038,0,922,1,9,4,5,5,single-choice,spatial-relational,4|5,7,4/5,231038,4
3,4,23,1039,0,1355,1,11,5,6,6,single-choice,spatial-relational,5|6,7,5/6,231039,5
3,4,23,1040,0,43,1,3,1,2,2,single-choice,spatial-relational,1|2,7,1/2,231040,1
3,4,23,1041,1,956,1,5,2,2,3,single-choice,spatial-relational,2|3,7,2/3,231041,2
3,4,23,1042,0,1263,1,7,3,4,4,single-choice,spatial-relational,3|4,7,3/4,231042,3
3,4,23,1043,1,25006,1,9,4,4,5,single-choice,spatial-relational,4|5,7,4/5,231043,4
3,4,23,1044,1,803,1,5,2,2,3,single-choice,spatial-relational,2|3,7,2/3,231044,2
3,4,23,1045,1,1095,1,11,5,5,6,single-choice,spatial-relational,5|6,7,5/6,231045,5
3,4,23,1046,1,1073,1,13,6,6,7,single-choice,spatial-relational,6|7,7,6/7,231046,6
3,4,23,1047,1,1015,1,7,3,3,4,single-choice,spatial-relational,3|4,7,3/4,231047,3
3,4,23,1048,1,937,1,5,2,2,3,single-choice,spatial-relational,2|3,7,2/3,231048,2
3,4,23,1049,1,1028,1,13,6,6,7,single-choice,spatial-relational,6|7,7,6/7,231049,6
3,4,23,1050,1,1045,1,3,1,1,2,single-choice,spatial-relational,1|2,7,1/2,231050,1
3,4,23,1051,1,779,1,5,2,2,3,single-choice,spatial-relational,2|3,7,2/3,231051,2
3,4,23,1052,1,1298,1,11,5,5,6,single-choice,spatial-relational,5|6,7,5/6,231052,5
3,4,23,1053,1,1207,1,7,3,3,4,single-choice,spatial-relational,3|4,7,3/4,231053,3
3,4,23,1054,1,745,1,3,1,1,2,single-choice,spatial-relational,1|2,7,1/2,231054,1
3,4,23,1055,1,381398,1,9,4,4,5,single-choice,spatial-relational,4|5,7,4/5,231055,4
3,4,23,1056,0,8621,1,9,4,5,5,single-choice,spatial-relational,4|5,7,4/5,231056,4
3,4,23,1057,0,966,1,11,5,6,6,single-choice,spatial-relational,5|6,7,5/6,231057,5
3,4,23,1058,1,1115,1,13,6,6,7,single-choice,spatial-relational,6|7,7,6/7,231058,6
3,4,23,1059,0,1147,1,7,3,4,4,single-choice,spatial-relational,3|4,7,3/4,231059,3
3,4,23,1060,1,1532,1,5,2,2,3,single-choice,spatial-relational,2|3,7,2/3,231060,2
3,4,23,1061,1,1040,1,11,5,5,6,single-choice,spatial-relational,5|6,7,5/6,231061,5
3,4,23,1062,1,1129,1,7,3,3,4,single-choice,spatial-relational,3|4,7,3/4,231062,3
3,4,23,1063,1,766,1,3,1,1,2,single-choice,spatial-relational,1|2,7,1/2,231063,1
3,4,23,1064,0,611,1,7,3,4,4,single-choice,spatial-relational,3|4,7,3/4,231064,3
3,4,23,1065,0,591,1,9,4,5,5,single-choice,spatial-relational,4|5,7,4/5,231065,4
3,4,23,1066,1,329328,1,11,5,5,6,single-choice,spatial-relational,5|6,7,5/6,231066,5
3,4,23,1067,0,329138,1,13,6,7,7,single-choice,spatial-relational,6|7,7,6/7,231067,6
3,4,23,1068,0,669,1,5,2,3,3,single-choice,spatial-relational,2|3,7,2/3,231068,2
3,4,23,1069,0,70082,1,3,1,2,2,single-choice,spatial-relational,1|2,7,1/2,231069,1
3,4,23,1070,1,1001,1,9,4,4,5,single-choice,spatial-relational,4|5,7,4/5,231070,4
3,4,23,1071,1,967,1,13,6,6,7,single-choice,spatial-relational,6|7,7,6/7,231071,6
4,4,23,1,0,990,1,11,5,6,6,single-choice,spatial-relational,5|6,7,5/6,230001,5
4,4,23,2,1,825,1,3,1,1,2,single-choice,spatial-relational,1|2,7,1/2,230002,1
4,4,23,3,1,917,1,9,4,4,5,single-choice,spatial-relational,4|5,7,4/5,230003,4
4,4,23,4,1,1165,1,5,2,2,3,single-choice,spatial-relational,2|3,7,2/3,230004,2
4,4,23,5,1,948,1,13,6,6,7,single-choice,spatial-relational,6|7,7,6/7,230005,6
4,4,23,6,1,950,1,9,4,4,5,single-choice,spatial-relational,4|5,7,4/5,230006,4
4,4,23,7,1,1179,1,13,6,6,7,single-choice,spatial-relational,6|7,7,6/7,230007,6
4,4,23,8,0,1080,1,5,2,3,3,single-choice,spatial-relational,2|3,7,2/3,230008,2
4,4,23,9,1,946,1,11,5,5,6,single-choice,spatial-relational,5|6,7,5/6,230009,5
4,4,23,10,1,891,1,7,3,3,4,single-choice,spatial-relational,3|4,7,3/4,230010,3
4,4,23,11,0,1068,1,3,1,2,2,single-choice,spatial-relational,1|2,7,1/2,230011,1
4,4,23,12,1,1093,1,7,3,3,4,single-choice,spatial-relational,3|4,7,3/4,230012,3
4,4,23,13,1,984,1,7,3,3,4,single-choice,spatial-relational,3|4,7,3/4,230013,3
4,4,23,14,1,808,1,7,3,3,4,single-choice,spatial-relational,3|4,7,3/4,230014,3
4,4,23,15,1,843,1,3,1,1,2,single-choice,spatial-relational,1|2,7,1/2,230015,1
4,4,23,16,1,763,1,13,6,6,7,single-choice,spatial-relational,6|7,7,6/7,230016,6
4,4,23,17,1,838,1,11,5,5,6,single-choice,spatial-relational,5|6,7,5/6,230017,5
4,4,23,18,1,674,1,3,1,1,2,single-choice,spatial-relational,1|2,7,1/2,230018,1
4,4,23,19,1,888,1,13,6,6,7,single-choice,spatial-relational,6|7,7,6/7,230019,6
4,4,23,20,1,1112,1,5,2,2,3,single-choice,spatial-relational,2|3,7,2/3,230020,2
4,4,23,21,0,819,1,9,4,5,5,single-choice,spatial-relational,4|5,7,4/5,230021,4
4,4,23,22,1,848,1,11,5,5,6,single-choice,spatial-relational,5|6,7,5/6,230022,5
4,4,23,23,1,967,1,5,2,2,3,single-choice,spatial-relational,2|3,7,2/3,230023,2
4,4,23,24,1,806,1,9,4,4,5,single-choice,spatial-relational,4|5,7,4/5,230024,4
4,4,23,25,1,970,1,7,3,3,4,single-choice,spatial-relational,3|4,7,3/4,230025,3
4,4,23,26,1,1614,1,9,4,4,5,single-choice,spatial-relational,4|5,7,4/5,230026,4
4,4,23,27,1,745,1,3,1,1,2,single-choice,spatial-relational,1|2,7,1/2,230027,1
4,4,23,28,1,843,1,7,3,3,4,single-choice,spatial-relational,3|4,7,3/4,230028,3
4,4,23,29,1,992,1,5,2,2,3,single-choice,spatial-relational,2|3,7,2/3,230029,2
4,4,23,30,1,937,1,13,6,6,7,single-choice,spatial-relational,6|7,7,6/7,230030,6
4,4,23,31,1,793,1,5,2,2,3,single-choice,spatial-relational,2|3,7,2/3,230031,2
4,4,23,32,1,1086,1,11,5,5,6,single-choice,spatial-relational,5|6,7,5/6,230032,5
4,4,23,33,1,1007,1,9,4,4,5,single-choice,spatial-relational,4|5,7,4/5,230033,4
4,4,23,34,1,646,1,3,1,1,2,single-choice,spatial-relational,1|2,7,1/2,230034,1
4,4,23,35,1,852,1,11,5,5,6,single-choice,spatial-relational,5|6,7,5/6,230035,5
4,4,23,36,1,790,1,13,6,6,7,single-choice,spatial-relational,6|7,7,6/7,230036,6
4,4,23,37,1,2349,1,11,5,5,6,single-choice,spatial-relational,5|6,7,5/6,230037,5
4,4,23,38,1,875,1,13,6,6,7,single-choice,spatial-relational,6|7,7,6/7,230038,6
4,4,23,39,1,1265,1,7,3,3,4,single-choice,spatial-relational,3|4,7,3/4,230039,3
4,4,23,40,1,915,1,11,5,5,6,single-choice,spatial-relational,5|6,7,5/6,230040,5
4,4,23,41,0,1238,1,9,4,5,5,single-choice,spatial-relational,4|5,7,4/5,230041,4
4,4,23,42,1,679,1,3,1,1,2,single-choice,spatial-relational,1|2,7,1/2,230042,1
4,4,23,43,1,2068,1,5,2,2,3,single-choice,spatial-relational,2|3,7,2/3,230043,2
4,4,23,44,1,1154,1,5,2,2,3,single-choice,spatial-relational,2|3,7,2/3,230044,2
4,4,23,45,1,1039,1,7,3,3,4,single-choice,spatial-relational,3|4,7,3/4,230045,3
4,4,23,46,1,848,1,13,6,6,7,single-choice,spatial-relational,6|7,7,6/7,230046,6
4,4,23,47,1,713,1,9,4,4,5,single-choice,spatial-relational,4|5,7,4/5,230047,4
4,4,23,48,1,793,1,3,1,1,2,single-choice,spatial-relational,1|2,7,1/2,230048,1
4,4,23,49,1,1030,1,11,5,5,6,single-choice,spatial-relational,5|6,7,5/6,230049,5
4,4,23,50,1,844,1,11,5,5,6,single-choice,spatial-relational,5|6,7,5/6,230050,5
4,4,23,51,1,969,1,3,1,1,2,single-choice,spatial-relational,1|2,7,1/2,230051,1
4,4,23,52,1,1372,1,5,2,2,3,single-choice,spatial-relational,2|3,7,2/3,230052,2
4,4,23,53,1,1169,1,5,2,2,3,single-choice,spatial-relational,2|3,7,2/3,230053,2
4,4,23,54,1,937,1,7,3,3,4,single-choice,spatial-relational,3|4,7,3/4,230054,3
4,4,23,55,1,833,1,3,1,1,2,single-choice,spatial-relational,1|2,7,1/2,230055,1
4,4,23,56,0,892,1,9,4,5,5,single-choice,spatial-relational,4|5,7,4/5,230056,4
4,4,23,57,1,732,1,13,6,6,7,single-choice,spatial-relational,6|7,7,6/7,230057,6
4,4,23,58,1,1197,1,13,6,6,7,single-choice,spatial-relational,6|7,7,6/7,230058,6
4,4,23,59,1,968,1,7,3,3,4,single-choice,spatial-relational,3|4,7,3/4,230059,3
4,4,23,60,1,1373,1,9,4,4,5,single-choice,spatial-relational,4|5,7,4/5,230060,4
4,4,23,61,1,975,1,13,6,6,7,single-choice,spatial-relational,6|7,7,6/7,230061,6
4,4,23,62,1,936,1,11,5,5,6,single-choice,spatial-relational,5|6,7,5/6,230062,5
4,4,23,63,1,1018,1,11,5,5,6,single-choice,spatial-relational,5|6,7,5/6,230063,5
4,4,23,64,1,895,1,9,4,4,5,single-choice,spatial-relational,4|5,7,4/5,230064,4
4,4,23,65,0,923,1,13,6,7,7,single-choice,spatial-relational,6|7,7,6/7,230065,6
4,4,23,66,1,10,1,5,2,2,3,single-choice,spatial-relational,2|3,7,2/3,230066,2
4,4,23,67,1,844,1,7,3,3,4,single-choice,spatial-relational,3|4,7,3/4,230067,3
4,4,23,68,0,847,1,9,4,5,5,single-choice,spatial-relational,4|5,7,4/5,230068,4
4,4,23,69,1,611,1,3,1,1,2,single-choice,spatial-relational,1|2,7,1/2,230069,1
4,4,23,70,0,877,1,5,2,3,3,single-choice,spatial-relational,2|3,7,2/3,230070,2
4,4,23,71,1,870,1,3,1,1,2,single-choice,spatial-relational,1|2,7,1/2,230071,1
4,4,23,72,1,1304,1,7,3,3,4,single-choice,spatial-relational,3|4,7,3/4,230072,3
4,4,23,73,1,963,1,5,2,2,3,single-choice,spatial-relational,2|3,7,2/3,230073,2
4,4,23,74,0,1017,1,7,3,4,4,single-choice,spatial-relational,3|4,7,3/4,230074,3
4,4,23,75,1,1152,1,13,6,6,7,single-choice,spatial-relational,6|7,7,6/7,230075,6
4,4,23,76,1,1362,1,11,5,5,6,single-choice,spatial-relational,5|6,7,5/6,230076,5
4,4,23,77,1,963,1,7,3,3,4,single-choice,spatial-relational,3|4,7,3/4,230077,3
4,4,23,78,0,1274,1,9,4,5,5,single-choice,spatial-relational,4|5,7,4/5,230078,4
4,4,23,79,1,911,1,13,6,6,7,single-choice,spatial-relational,6|7,7,6/7,230079,6
4,4,23,80,1,1160,1,9,4,4,5,single-choice,spatial-relational,4|5,7,4/5,230080,4
4,4,23,81,1,872,1,3,1,1,2,single-choice,spatial-relational,1|2,7,1/2,230081,1
4,4,23,82,0,1003,1,5,2,3,3,single-choice,spatial-relational,2|3,7,2/3,230082,2
4,4,23,83,1,923,1,11,5,5,6,single-choice,spatial-relational,5|6,7,5/6,230083,5
4,4,23,84,1,1344,1,3,1,1,2,single-choice,spatial-relational,1|2,7,1/2,230084,1
4,4,23,85,1,791,1,13,6,6,7,single-choice,spatial-relational,6|7,7,6/7,230085,6
4,4,23,86,1,1022,1,7,3,3,4,single-choice,spatial-relational,3|4,7,3/4,230086,3
4,4,23,87,1,936,1,5,2,2,3,single-choice,spatial-relational,2|3,7,2/3,230087,2
4,4,23,88,1,936,1,11,5,5,6,single-choice,spatial-relational,5|6,7,5/6,230088,5
4,4,23,89,0,1058,1,9,4,5,5,single-choice,spatial-relational,4|5,7,4/5,230089,4
4,4,23,90,1,752,1,13,6,6,7,single-choice,spatial-relational,6|7,7,6/7,230090,6
4,4,23,91,1,729,1,3,1,1,2,single-choice,spatial-relational,1|2,7,1/2,230091,1
4,4,23,92,0,986,1,5,2,3,3,single-choice,spatial-relational,2|3,7,2/3,230092,2
4,4,23,93,1,938,1,11,5,5,6,single-choice,spatial-relational,5|6,7,5/6,230093,5
4,4,23,94,1,749,1,7,3,3,4,single-choice,spatial-relational,3|4,7,3/4,230094,3
4,4,23,95,1,852,1,3,1,1,2,single-choice,spatial-relational,1|2,7,1/2,230095,1
4,4,23,96,1,1174,1,9,4,4,5,single-choice,spatial-relational,4|5,7,4/5,230096,4
4,4,23,97,1,903,1,13,6,6,7,single-choice,spatial-relational,6|7,7,6/7,230097,6
4,4,23,98,1,1153,1,11,5,5,6,single-choice,spatial-relational,5|6,7,5/6,230098,5
4,4,23,99,0,866,1,13,6,7,7,single-choice,spatial-relational,6|7,7,6/7,230099,6
4,4,23,100,1,858,1,9,4,4,5,single-choice,spatial-relational,4|5,7,4/5,230100,4
4,4,23,101,0,1351,1,9,4,5,5,single-choice,spatial-relational,4|5,7,4/5,230101,4
4,4,23,102,1,884,1,7,3,3,4,single-choice,spatial-relational,3|4,7,3/4,230102,3
4,4,23,103,0,822,1,7,3,4,4,single-choice,spatial-relational,3|4,7,3/4,230103,3
4,4,23,104,1,839,1,5,2,2,3,single-choice,spatial-relational,2|3,7,2/3,230104,2
4,4,23,105,0,873,1,11,5,6,6,single-choice,spatial-relational,5|6,7,5/6,230105,5
4,4,23,106,1,799,1,3,1,1,2,single-choice,spatial-relational,1|2,7,1/2,230106,1
4,4,23,107,0,764,1,3,1,2,2,single-choice,spatial-relational,1|2,7,1/2,230107,1
4,4,23,108,1,700,1,5,2,2,3,single-choice,spatial-relational,2|3,7,2/3,230108,2
4,4,23,109,1,677,1,3,1,1,2,single-choice,spatial-relational,1|2,7,1/2,230109,1
4,4,23,110,0,4,1,11,5,6,6,single-choice,spatial-relational,5|6,7,5/6,230110,5
4,4,23,111,0,854,1,13,6,7,7,single-choice,spatial-relational,6|7,7,6/7,230111,6
4,4,23,112,0,710,1,3,1,2,2,single-choice,spatial-relational,1|2,7,1/2,230112,1
4,4,23,113,0,851,1,7,3,4,4,single-choice,spatial-relational,3|4,7,3/4,230113,3
4,4,23,114,1,886,1,13,6,6,7,single-choice,spatial-relational,6|7,7,6/7,230114,6
4,4,23,115,0,958,1,11,5,6,6,single-choice,spatial-relational,5|6,7,5/6,230115,5
4,4,23,116,1,801,1,5,2,2,3,single-choice,spatial-relational,2|3,7,2/3,230116,2
4,4,23,117,1,3,1,5,2,2,3,single-choice,spatial-relational,2|3,7,2/3,230117,2
4,4,23,118,1,3,1,9,4,4,5,single-choice,spatial-relational,4|5,7,4/5,230118,4
4,4,23,119,1,1410,1,7,3,3,4,single-choice,spatial-relational,3|4,7,3/4,230119,3
4,4,23,120,0,1542,1,9,4,5,5,single-choice,spatial-relational,4|5,7,4/5,230120,4
4,4,23,121,0,687,1,11,5,6,6,single-choice,spatial-relational,5|6,7,5/6,230121,5
4,4,23,122,1,1102,1,11,5,5,6,single-choice,spatial-relational,5|6,7,5/6,230122,5
4,4,23,123,1,778,1,3,1,1,2,single-choice,spatial-relational,1|2,7,1/2,230123,1
4,4,23,124,0,813,1,9,4,5,5,single-choice,spatial-relational,4|5,7,4/5,230124,4
4,4,23,125,1,1412,1,3,1,1,2,single-choice,spatial-relational,1|2,7,1/2,230125,1
4,4,23,126,1,747,1,5,2,2,3,single-choice,spatial-relational,2|3,7,2/3,230126,2
4,4,23,127,0,2,1,13,6,7,7,single-choice,spatial-relational,6|7,7,6/7,230127,6
4,4,23,128,1,1043,1,5,2,2,3,single-choice,spatial-relational,2|3,7,2/3,230128,2
4,4,23,129,0,360,1,13,6,7,7,single-choice,spatial-relational,6|7,7,6/7,230129,6
4,4,23,130,0,661,1,7,3,4,4,single-choice,spatial-relational,3|4,7,3/4,230130,3
4,4,23,131,0,901,1,7,3,4,4,single-choice,spatial-relational,3|4,7,3/4,230131,3
4,4,23,132,1,981,1,9,4,4,5,single-choice,spatial-relational,4|5,7,4/5,230132,4
4,4,23,133,0,1317,1,9,4,5,5,single-choice,spatial-relational,4|5,7,4/5,230133,4
4,4,23,134,0,951,1,11,5,6,6,single-choice,spatial-relational,5|6,7,5/6,230134,5
4,4,23,135,1,847,1,5,2,2,3,single-choice,spatial-relational,2|3,7,2/3,230135,2
4,4,23,136,0,535,1,3,1,2,2,single-choice,spatial-relational,1|2,7,1/2,230136,1
4,4,23,137,1,3,1,9,4,4,5,single-choice,spatial-relational,4|5,7,4/5,230137,4
4,4,23,138,0,827,1,7,3,4,4,single-choice,spatial-relational,3|4,7,3/4,230138,3
4,4,23,139,1,605,1,3,1,1,2,single-choice,spatial-relational,1|2,7,1/2,230139,1
4,4,23,140,1,677,1,11,5,5,6,single-choice,spatial-relational,5|6,7,5/6,230140,5
4,4,23,141,1,1253,1,13,6,6,7,single-choice,spatial-relational,6|7,7,6/7,230141,6
4,4,23,142,1,1323,1,7,3,3,4,single-choice,spatial-relational,3|4,7,3/4,230142,3
4,4,23,143,1,925,1,13,6,6,7,single-choice,spatial-relational,6|7,7,6/7,230143,6
4,4,23,144,1,1131,1,5,2,2,3,single-choice,spatial-relational,2|3,7,2/3,230144,2
4,4,23,145,1,692,1,3,1,1,2,single-choice,spatial-relational,1|2,7,1/2,230145,1
4,4,23,146,1,932,1,7,3,3,4,single-choice,spatial-relational,3|4,7,3/4,230146,3
4,4,23,147,1,754,1,5,2,2,3,single-choice,spatial-relational,2|3,7,2/3,230147,2
4,4,23,148,1,694,1,3,1,1,2,single-choice,spatial-relational,1|2,7,1/2,230148,1
4,4,23,149,1,760,1,13,6,6,7,single-choice,spatial-relational,6|7,7,6/7,230149,6
4,4,23,150,1,577,1,5,2,2,3,single-choice,spatial-relational,2|3,7,2/3,230150,2
4,4,23,151,1,1140,1,11,5,5,6,single-choice,spatial-relational,5|6,7,5/6,230151,5
4,4,23,152,1,1150,1,9,4,4,5,single-choice,spatial-relational,4|5,7,4/5,230152,4
4,4,23,153,0,1586,1,11,5,6,6,single-choice,spatial-relational,5|6,7,5/6,230153,5
4,4,23,154,1,1667,1,13,6,6,7,single-choice,spatial-relational,6|7,7,6/7,230154,6
4,4,23,155,1,839,1,7,3,3,4,single-choice,spatial-relational,3|4,7,3/4,230155,3
4,4,23,156,0,677,1,9,4,5,5,single-choice,spatial-relational,4|5,7,4/5,230156,4
4,4,23,157,1,579,1,3,1,1,2,single-choice,spatial-relational,1|2,7,1/2,230157,1
4,4,23,158,1,2,1,5,2,2,3,single-choice,spatial-relational,2|3,7,2/3,230158,2
4,4,23,159,1,689,1,13,6,6,7,single-choice,spatial-relational,6|7,7,6/7,230159,6
4,4,23,160,1,2,1,9,4,4,5,single-choice,spatial-relational,4|5,7,4/5,230160,4
4,4,23,161,1,2,1,7,3,3,4,single-choice,spatial-relational,3|4,7,3/4,230161,3
4,4,23,162,0,3,1,13,6,7,7,single-choice,spatial-relational,6|7,7,6/7,230162,6
4,4,23,163,0,2,1,7,3,4,4,single-choice,spatial-relational,3|4,7,3/4,230163,3
4,4,23,164,1,1170,1,9,4,4,5,single-choice,spatial-relational,4|5,7,4/5,230164,4
4,4,23,165,1,64,1,3,1,1,2,single-choice,spatial-relational,1|2,7,1/2,230165,1
4,4,23,166,0,905,1,11,5,6,6,single-choice,spatial-relational,5|6,7,5/6,230166,5
4,4,23,167,1,976,1,11,5,5,6,single-choice,spatial-relational,5|6,7,5/6,230167,5
4,4,23,168,1,748,1,5,2,2,3,single-choice,spatial-relational,2|3,7,2/3,230168,2
4,4,23,169,1,576,1,9,4,4,5,single-choice,spatial-relational,4|5,7,4/5,230169,4
4,4,23,170,0,2,1,9,4,5,5,single-choice,spatial-relational,4|5,7,4/5,230170,4
4,4,23,171,1,785,1,13,6,6,7,single-choice,spatial-relational,6|7,7,6/7,230171,6
4,4,23,172,1,980,1,5,2,2,3,single-choice,spatial-relational,2|3,7,2/3,230172,2
4,4,23,173,1,625,1,7,3,3,4,single-choice,spatial-relational,3|4,7,3/4,230173,3
4,4,23,174,1,995,1,13,6,6,7,single-choice,spatial-relational,6|7,7,6/7,230174,6
4,4,23,175,1,3,1,3,1,1,2,single-choice,spatial-relational,1|2,7,1/2,230175,1
4,4,23,176,0,862,1,7,3,4,4,single-choice,spatial-relational,3|4,7,3/4,230176,3
4,4,23,177,1,628,1,11,5,5,6,single-choice,spatial-relational,5|6,7,5/6,230177,5
4,4,23,178,1,579,1,3,1,1,2,single-choice,spatial-relational,1|2,7,1/2,230178,1
4,4,23,179,0,657,1,5,2,3,3,single-choice,spatial-relational,2|3,7,2/3,230179,2
4,4,23,180,1,1386,1,11,5,5,6,single-choice,spatial-relational,5|6,7,5/6,230180,5
4,4,23,181,0,1029,1,7,3,4,4,single-choice,spatial-relational,3|4,7,3/4,230181,3
4,4,23,182,0,834,1,9,4,5,5,single-choice,spatial-relational,4|5,7,4/5,230182,4
4,4,23,183,1,764,1,3,1,1,2,single-choice,spatial-relational,1|2,7,1/2,230183,1
4,4,23,184,1,159,1,9,4,4,5,single-choice,spatial-relational,4|5,7,4/5,230184,4
4,4,23,185,1,962,1,13,6,6,7,single-choice,spatial-relational,6|7,7,6/7,230185,6
4,4,23,186,1,2,1,11,5,5,6,single-choice,spatial-relational,5|6,7,5/6,230186,5
4,4,23,187,1,634,1,5,2,2,3,single-choice,spatial-relational,2|3,7,2/3,230187,2
4,4,23,188,0,611,1,5,2,3,3,single-choice,spatial-relational,2|3,7,2/3,230188,2
4,4,23,189,1,981,1,11,5,5,6,single-choice,spatial-relational,5|6,7,5/6,230189,5
4,4,23,190,1,773,1,7,3,3,4,single-choice,spatial-relational,3|4,7,3/4,230190,3
4,4,23,191,1,822,1,13,6,6,7,single-choice,spatial-relational,6|7,7,6/7,230191,6
4,4,23,192,1,444,1,3,1,1,2,single-choice,spatial-relational,1|2,7,1/2,230192,1
4,4,23,193,1,516,1,3,1,1,2,single-choice,spatial-relational,1|2,7,1/2,230193,1
4,4,23,194,1,2,1,13,6,6,7,single-choice,spatial-relational,6|7,7,6/7,230194,6
4,4,23,195,0,691,1,7,3,4,4,single-choice,spatial-relational,3|4,7,3/4,230195,3
4,4,23,196,0,1034,1,11,5,6,6,single-choice,spatial-relational,5|6,7,5/6,230196,5
4,4,23,197,1,1103,1,13,6,6,7,single-choice,spatial-relational,6|7,7,6/7,230197,6
4,4,23,198,1,1348,1,11,5,5,6,single-choice,spatial-relational,5|6,7,5/6,230198,5
4,4,23,199,1,859,1,9,4,4,5,single-choice,spatial-relational,4|5,7,4/5,230199,4
4,4,23,200,0,739,1,7,3,4,4,single-choice,spatial-relational,3|4,7,3/4,230200,3
4,4,23,201,1,662,1,3,1,1,2,single-choice,spatial-relational,1|2,7,1/2,230201,1
4,4,23,202,1,516,1,5,2,2,3,single-choice,spatial-relational,2|3,7,2/3,230202,2
4,4,23,203,0,636,1,9,4,5,5,single-choice,spatial-relational,4|5,7,4/5,230203,4
4,4,23,204,1,907,1,5,2,2,3,single-choice,spatial-relational,2|3,7,2/3,230204,2
4,4,23,205,1,667,1,13,6,6,7,single-choice,spatial-relational,6|7,7,6/7,230205,6
4,4,23,206,0,2,1,7,3,4,4,single-choice,spatial-relational,3|4,7,3/4,230206,3
4,4,23,207,1,814,1,13,6,6,7,single-choice,spatial-relational,6|7,7,6/7,230207,6
4,4,23,208,0,775,1,11,5,6,6,single-choice,spatial-relational,5|6,7,5/6,230208,5
4,4,23,209,0,501,1,7,3,4,4,single-choice,spatial-relational,3|4,7,3/4,230209,3
4,4,23,210,1,713,1,3,1,1,2,single-choice,spatial-relational,1|2,7,1/2,230210,1
4,4,23,211,1,476,1,5,2,2,3,single-choice,spatial-relational,2|3,7,2/3,230211,2
4,4,23,212,0,701,1,9,4,5,5,single-choice,spatial-relational,4|5,7,4/5,230212,4
4,4,23,213,1,1161,1,9,4,4,5,single-choice,spatial-relational,4|5,7,4/5,230213,4
4,4,23,214,1,604,1,3,1,1,2,single-choice,spatial-relational,1|2,7,1/2,230214,1
4,4,23,215,0,438,1,11,5,6,6,single-choice,spatial-relational,5|6,7,5/6,230215,5
4,4,23,216,1,745,1,5,2,2,3,single-choice,spatial-relational,2|3,7,2/3,230216,2
4,4,23,217,1,446,1,3,1,1,2,single-choice,spatial-relational,1|2,7,1/2,230217,1
4,4,23,218,1,810,1,7,3,3,4,single-choice,spatial-relational,3|4,7,3/4,230218,3
4,4,23,219,1,1015,1,9,4,4,5,single-choice,spatial-relational,4|5,7,4/5,230219,4
4,4,23,220,0,1224,1,11,5,6,6,single-choice,spatial-relational,5|6,7,5/6,230220,5
4,4,23,221,0,432,1,7,3,4,4,single-choice,spatial-relational,3|4,7,3/4,230221,3
4,4,23,222,1,611,1,3,1,1,2,single-choice,spatial-relational,1|2,7,1/2,230222,1
4,4,23,223,1,1,1,11,5,5,6,single-choice,spatial-relational,5|6,7,5/6,230223,5
4,4,23,224,0,682,1,9,4,5,5,single-choice,spatial-relational,4|5,7,4/5,230224,4
4,4,23,225,1,906,1,13,6,6,7,single-choice,spatial-relational,6|7,7,6/7,230225,6
4,4,23,226,0,12,1,5,2,3,3,single-choice,spatial-relational,2|3,7,2/3,230226,2
4,4,23,227,1,847,1,13,6,6,7,single-choice,spatial-relational,6|7,7,6/7,230227,6
4,4,23,228,1,737,1,5,2,2,3,single-choice,spatial-relational,2|3,7,2/3,230228,2
4,4,23,229,1,536,1,3,1,1,2,single-choice,spatial-relational,1|2,7,1/2,230229,1
4,4,23,230,1,3,1,9,4,4,5,single-choice,spatial-relational,4|5,7,4/5,230230,4
4,4,23,231,1,3,1,7,3,3,4,single-choice,spatial-relational,3|4,7,3/4,230231,3
4,4,23,232,1,812,1,9,4,4,5,single-choice,spatial-relational,4|5,7,4/5,230232,4
4,4,23,233,1,459,1,3,1,1,2,single-choice,spatial-relational,1|2,7,1/2,230233,1
4,4,23,234,1,2,1,13,6,6,7,single-choice,spatial-relational,6|7,7,6/7,230234,6
4,4,23,235,1,703,1,13,6,6,7,single-choice,spatial-relational,6|7,7,6/7,230235,6
4,4,23,236,1,796,1,5,2,2,3,single-choice,spatial-relational,2|3,7,2/3,230236,2
4,4,23,237,0,656,1,11,5,6,6,single-choice,spatial-relational,5|6,7,5/6,230237,5
4,4,23,238,1,1065,1,11,5,5,6,single-choice,spatial-relational,5|6,7,5/6,230238,5
4,4,23,239,1,60,1,7,3,3,4,single-choice,spatial-relational,3|4,7,3/4,230239,3
4,4,23,240,1,824,1,5,2,2,3,single-choice,spatial-relational,2|3,7,2/3,230240,2
4,4,23,241,0,706,1,7,3,4,4,single-choice,spatial-relational,3|4,7,3/4,230241,3
4,4,23,242,1,814,1,7,3,3,4,single-choice,spatial-relational,3|4,7,3/4,230242,3
4,4,23,243,0,3,1,9,4,5,5,single-choice,spatial-relational,4|5,7,4/5,230243,4
4,4,23,244,1,1011,1,5,2,2,3,single-choice,spatial-relational,2|3,7,2/3,230244,2
4,4,23,245,1,1696,1,11,5,5,6,single-choice,spatial-relational,5|6,7,5/6,230245,5
4,4,23,246,0,686,1,3,1,2,2,single-choice,spatial-relational,1|2,7,1/2,230246,1
4,4,23,247,0,660,1,9,4,5,5,single-choice,spatial-relational,4|5,7,4/5,230247,4
4,4,23,248,1,615,1,3,1,1,2,single-choice,spatial-relational,1|2,7,1/2,230248,1
4,4,23,249,1,772,1,5,2,2,3,single-choice,spatial-relational,2|3,7,2/3,230249,2
4,4,23,250,0,2,1,13,6,7,7,single-choice,spatial-relational,6|7,7,6/7,230250,6
4,4,23,251,1,1329,1,13,6,6,7,single-choice,spatial-relational,6|7,7,6/7,230251,6
4,4,23,252,1,7,1,11,5,5,6,single-choice,spatial-relational,5|6,7,5/6,230252,5
4,4,23,253,1,498,1,3,1,1,2,single-choice,spatial-relational,1|2,7,1/2,230253,1
4,4,23,254,0,49,1,11,5,6,6,single-choice,spatial-relational,5|6,7,5/6,230254,5
4,4,23,255,1,876,1,13,6,6,7,single-choice,spatial-relational,6|7,7,6/7,230255,6
4,4,23,256,0,605,1,3,1,2,2,single-choice,spatial-relational,1|2,7,1/2,230256,1
4,4,23,257,1,784,1,13,6,6,7,single-choice,spatial-relational,6|7,7,6/7,230257,6
4,4,23,258,1,908,1,11,5,5,6,single-choice,spatial-relational,5|6,7,5/6,230258,5
4,4,23,259,0,463,1,7,3,4,4,single-choice,spatial-relational,3|4,7,3/4,230259,3
4,4,23,260,0,425,1,5,2,3,3,single-choice,spatial-relational,2|3,7,2/3,230260,2
4,4,23,261,1,1232,1,9,4,4,5,single-choice,spatial-relational,4|5,7,4/5,230261,4
4,4,23,262,1,388,1,7,3,3,4,single-choice,spatial-relational,3|4,7,3/4,230262,3
4,4,23,263,1,972,1,9,4,4,5,single-choice,spatial-relational,4|5,7,4/5,230263,4
4,4,23,264,1,604,1,5,2,2,3,single-choice,spatial-relational,2|3,7,2/3,230264,2
4,4,23,265,1,501,1,5,2,2,3,single-choice,spatial-relational,2|3,7,2/3,230265,2
4,4,23,266,1,600,1,3,1,1,2,single-choice,spatial-relational,1|2,7,1/2,230266,1
4,4,23,267,1,473,1,3,1,1,2,single-choice,spatial-relational,1|2,7,1/2,230267,1
4,4,23,268,1,708,1,13,6,6,7,single-choice,spatial-relational,6|7,7,6/7,230268,6
4,4,23,269,0,505,1,7,3,4,4,single-choice,spatial-relational,3|4,7,3/4,230269,3
4,4,23,270,1,845,1,13,6,6,7,single-choice,spatial-relational,6|7,7,6/7,230270,6
4,4,23,271,1,517,1,11,5,5,6,single-choice,spatial-relational,5|6,7,5/6,230271,5
4,4,23,272,0,781,1,9,4,5,5,single-choice,spatial-relational,4|5,7,4/5,230272,4
4,4,23,273,0,723,1,9,4,5,5,single-choice,spatial-relational,4|5,7,4/5,230273,4
4,4,23,274,1,901,1,5,2,2,3,single-choice,spatial-relational,2|3,7,2/3,230274,2
4,4,23,275,1,66,1,7,3,3,4,single-choice,spatial-relational,3|4,7,3/4,230275,3
4,4,23,276,0,5,1,11,5,6,6,single-choice,spatial-relational,5|6,7,5/6,230276,5
4,4,23,277,1,814,1,13,6,6,7,single-choice,spatial-relational,6|7,7,6/7,230277,6
4,4,23,278,1,3,1,7,3,3,4,single-choice,spatial-relational,3|4,7,3/4,230278,3
4,4,23,279,0,2,1,3,1,2,2,single-choice,spatial-relational,1|2,7,1/2,230279,1
4,4,23,280,0,624,1,11,5,6,6,single-choice,spatial-relational,5|6,7,5/6,230280,5
4,4,23,281,1,79,1,13,6,6,7,single-choice,spatial-relational,6|7,7,6/7,230281,6
4,4,23,282,1,682,1,9,4,4,5,single-choice,spatial-relational,4|5,7,4/5,230282,4
4,4,23,283,1,3606,1,3,1,1,2,single-choice,spatial-relational,1|2,7,1/2,230283,1
4,4,23,284,0,520,1,11,5,6,6,single-choice,spatial-relational,5|6,7,5/6,230284,5
4,4,23,285,1,708,1,5,2,2,3,single-choice,spatial-relational,2|3,7,2/3,230285,2
4,4,23,286,1,899,1,5,2,2,3,single-choice,spatial-relational,2|3,7,2/3,230286,2
4,4,23,287,0,617,1,7,3,4,4,single-choice,spatial-relational,3|4,7,3/4,230287,3
4,4,23,288,0,658,1,9,4,5,5,single-choice,spatial-relational,4|5,7,4/5,230288,4
4,4,23,289,0,410,1,9,4,5,5,single-choice,spatial-relational,4|5,7,4/5,230289,4
4,4,23,290,1,1053,1,13,6,6,7,single-choice,spatial-relational,6|7,7,6/7,230290,6
4,4,23,291,1,951,1,13,6,6,7,single-choice,spatial-relational,6|7,7,6/7,230291,6
4,4,23,292,1,672,1,5,2,2,3,single-choice,spatial-relational,2|3,7,2/3,230292,2
4,4,23,293,0,549,1,7,3,4,4,single-choice,spatial-relational,3|4,7,3/4,230293,3
4,4,23,294,1,644,1,3,1,1,2,single-choice,spatial-relational,1|2,7,1/2,230294,1
4,4,23,295,1,676,1,3,1,1,2,single-choice,spatial-relational,1|2,7,1/2,230295,1
4,4,23,296,1,69,1,11,5,5,6,single-choice,spatial-relational,5|6,7,5/6,230296,5
4,4,23,297,1,2,1,7,3,3,4,single-choice,spatial-relational,3|4,7,3/4,230297,3
4,4,23,298,1,1,1,11,5,5,6,single-choice,spatial-relational,5|6,7,5/6,230298,5
4,4,23,299,0,5,1,9,4,5,5,single-choice,spatial-relational,4|5,7,4/5,230299,4
4,4,23,300,1,606,1,5,2,2,3,single-choice,spatial-relational,2|3,7,2/3,230300,2
4,4,23,301,1,663,1,3,1,1,2,single-choice,spatial-relational,1|2,7,1/2,230301,1
4,4,23,302,0,3,1,13,6,7,7,single-choice,spatial-relational,6|7,7,6/7,230302,6
4,4,23,303,0,632,1,5,2,3,3,single-choice,spatial-relational,2|3,7,2/3,230303,2
4,4,23,304,1,806,1,11,5,5,6,single-choice,spatial-relational,5|6,7,5/6,230304,5
4,4,23,305,1,707,1,7,3,3,4,single-choice,spatial-relational,3|4,7,3/4,230305,3
4,4,23,306,1,708,1,9,4,4,5,single-choice,spatial-relational,4|5,7,4/5,230306,4
4,4,23,307,1,749,1,5,2,2,3,single-choice,spatial-relational,2|3,7,2/3,230307,2
4,4,23,308,0,962,1,9,4,5,5,single-choice,spatial-relational,4|5,7,4/5,230308,4
4,4,23,309,0,663,1,7,3,4,4,single-choice,spatial-relational,3|4,7,3/4,230309,3
4,4,23,310,1,618,1,3,1,1,2,single-choice,spatial-relational,1|2,7,1/2,230310,1
4,4,23,311,1,883,1,13,6,6,7,single-choice,spatial-relational,6|7,7,6/7,230311,6
4,4,23,312,1,1076,1,11,5,5,6,single-choice,spatial-relational,5|6,7,5/6,230312,5
4,4,23,313,1,885,1,13,6,6,7,single-choice,spatial-relational,6|7,7,6/7,230313,6
4,4,23,314,1,763,1,5,2,2,3,single-choice,spatial-relational,2|3,7,2/3,230314,2
4,4,23,315,1,1164,1,9,4,4,5,single-choice,spatial-relational,4|5,7,4/5,230315,4
4,4,23,316,0,1999,1,7,3,4,4,single-choice,spatial-relational,3|4,7,3/4,230316,3
4,4,23,317,0,1557,1,9,4,5,5,single-choice,spatial-relational,4|5,7,4/5,230317,4
4,4,23,318,1,1105,1,3,1,1,2,single-choice,spatial-relational,1|2,7,1/2,230318,1
4,4,23,319,1,882,1,13,6,6,7,single-choice,spatial-relational,6|7,7,6/7,230319,6
4,4,23,320,1,720,1,5,2,2,3,single-choice,spatial-relational,2|3,7,2/3,230320,2
4,4,23,321,1,1624,1,11,5,5,6,single-choice,spatial-relational,5|6,7,5/6,230321,5
4,4,23,322,1,735,1,3,1,1,2,single-choice,spatial-relational,1|2,7,1/2,230322,1
4,4,23,323,1,1450,1,7,3,3,4,single-choice,spatial-relational,3|4,7,3/4,230323,3
4,4,23,324,0,1495,1,11,5,6,6,single-choice,spatial-relational,5|6,7,5/6,230324,5
4,4,23,325,0,605,1,9,4,5,5,single-choice,spatial-relational,4|5,7,4/5,230325,4
4,4,23,326,0,1127,1,11,5,6,6,single-choice,spatial-relational,5|6,7,5/6,230326,5
4,4,23,327,1,645,1,5,2,2,3,single-choice,spatial-relational,2|3,7,2/3,230327,2
4,4,23,328,1,662,1,13,6,6,7,single-choice,spatial-relational,6|7,7,6/7,230328,6
4,4,23,329,1,685,1,3,1,1,2,single-choice,spatial-relational,1|2,7,1/2,230329,1
4,4,23,330,1,1363,1,9,4,4,5,single-choice,spatial-relational,4|5,7,4/5,230330,4
4,4,23,331,1,968,1,11,5,5,6,single-choice,spatial-relational,5|6,7,5/6,230331,5
4,4,23,332,1,2104,1,7,3,3,4,single-choice,spatial-relational,3|4,7,3/4,230332,3
4,4,23,333,1,870,1,13,6,6,7,single-choice,spatial-relational,6|7,7,6/7,230333,6
4,4,23,334,1,752,1,5,2,2,3,single-choice,spatial-relational,2|3,7,2/3,230334,2
4,4,23,335,0,1180,1,7,3,4,4,single-choice,spatial-relational,3|4,7,3/4,230335,3
4,4,23,336,1,589,1,3,1,1,2,single-choice,spatial-relational,1|2,7,1/2,230336,1
4,4,23,337,1,799,1,7,3,3,4,single-choice,spatial-relational,3|4,7,3/4,230337,3
4,4,23,338,0,806,1,9,4,5,5,single-choice,spatial-relational,4|5,7,4/5,230338,4
4,4,23,339,1,556,1,3,1,1,2,single-choice,spatial-relational,1|2,7,1/2,230339,1
4,4,23,340,1,1203,1,9,4,4,5,single-choice,spatial-relational,4|5,7,4/5,230340,4
4,4,23,341,1,743,1,5,2,2,3,single-choice,spatial-relational,2|3,7,2/3,230341,2
4,4,23,342,1,1049,1,5,2,2,3,single-choice,spatial-relational,2|3,7,2/3,230342,2
4,4,23,343,1,973,1,7,3,3,4,single-choice,spatial-relational,3|4,7,3/4,230343,3
4,4,23,344,1,900,1,13,6,6,7,single-choice,spatial-relational,6|7,7,6/7,230344,6
4,4,23,345,1,1101,1,11,5,5,6,single-choice,spatial-relational,5|6,7,5/6,230345,5
4,4,23,346,1,1155,1,11,5,5,6,single-choice,spatial-relational,5|6,7,5/6,230346,5
4,4,23,347,1,899,1,13,6,6,7,single-choice,spatial-relational,6|7,7,6/7,230347,6
4,4,23,348,1,799,1,3,1,1,2,single-choice,spatial-relational,1|2,7,1/2,230348,1
4,4,23,349,1,646,1,13,6,6,7,single-choice,spatial-relational,6|7,7,6/7,230349,6
4,4,23,350,0,1634,1,11,5,6,6,single-choice,spatial-relational,5|6,7,5/6,230350,5
4,4,23,351,1,707,1,5,2,2,3,single-choice,spatial-relational,2|3,7,2/3,230351,2
4,4,23,352,0,753,1,7,3,4,4,single-choice,spatial-relational,3|4,7,3/4,230352,3
4,4,23,353,0,713,1,9,4,5,5,single-choice,spatial-relational,4|5,7,4/5,230353,4
4,4,23,354,0,599,1,7,3,4,4,single-choice,spatial-relational,3|4,7,3/4,230354,3
4,4,23,355,0,991,1,13,6,7,7,single-choice,spatial-relational,6|7,7,6/7,230355,6
4,4,23,356,0,1658,1,11,5,6,6,single-choice,spatial-relational,5|6,7,5/6,230356,5
4,4,23,357,1,1024,1,9,4,4,5,single-choice,spatial-relational,4|5,7,4/5,230357,4
4,4,23,358,1,709,1,3,1,1,2,single-choice,spatial-relational,1|2,7,1/2,230358,1
4,4,23,359,1,994,1,3,1,1,2,single-choice,spatial-relational,1|2,7,1/2,230359,1
4,4,23,360,1,916,1,5,2,2,3,single-choice,spatial-relational,2|3,7,2/3,230360,2
4,4,23,361,1,1161,1,11,5,5,6,single-choice,spatial-relational,5|6,7,5/6,230361,5
4,4,23,362,0,1111,1,5,2,3,3,single-choice,spatial-relational,2|3,7,2/3,230362,2
4,4,23,363,1,1197,1,7,3,3,4,single-choice,spatial-relational,3|4,7,3/4,230363,3
4,4,23,364,1,631,1,3,1,1,2,single-choice,spatial-relational,1|2,7,1/2,230364,1
4,4,23,365,1,2004,1,9,4,4,5,single-choice,spatial-relational,4|5,7,4/5,230365,4
4,4,23,366,0,1106,1,11,5,6,6,single-choice,spatial-relational,5|6,7,5/6,230366,5
4,4,23,367,0,1178,1,9,4,5,5,single-choice,spatial-relational,4|5,7,4/5,230367,4
4,4,23,368,1,590,1,3,1,1,2,single-choice,spatial-relational,1|2,7,1/2,230368,1
4,4,23,369,1,900,1,7,3,3,4,single-choice,spatial-relational,3|4,7,3/4,230369,3
4,4,23,370,1,908,1,13,6,6,7,single-choice,spatial-relational,6|7,7,6/7,230370,6
4,4,23,371,1,851,1,13,6,6,7,single-choice,spatial-relational,6|7,7,6/7,230371,6
4,4,23,372,1,764,1,5,2,2,3,single-choice,spatial-relational,2|3,7,2/3,230372,2
4,4,23,373,1,947,1,3,1,1,2,single-choice,spatial-relational,1|2,7,1/2,230373,1
4,4,23,374,0,1046,1,9,4,5,5,single-choice,spatial-relational,4|5,7,4/5,230374,4
4,4,23,375,0,633,1,13,6,7,7,single-choice,spatial-relational,6|7,7,6/7,230375,6
4,4,23,376,1,902,1,7,3,3,4,single-choice,spatial-relational,3|4,7,3/4,230376,3
4,4,23,377,1,943,1,11,5,5,6,single-choice,spatial-relational,5|6,7,5/6,230377,5
4,4,23,378,1,1126,1,13,6,6,7,single-choice,spatial-relational,6|7,7,6/7,230378,6
4,4,23,379,1,1073,1,5,2,2,3,single-choice,spatial-relational,2|3,7,2/3,230379,2
4,4,23,380,1,775,1,5,2,2,3,single-choice,spatial-relational,2|3,7,2/3,230380,2
4,4,23,381,1,2179,1,9,4,4,5,single-choice,spatial-relational,4|5,7,4/5,230381,4
4,4,23,382,1,723,1,3,1,1,2,single-choice,spatial-relational,1|2,7,1/2,230382,1
4,4,23,383,1,1084,1,7,3,3,4,single-choice,spatial-relational,3|4,7,3/4,230383,3
4,4,23,384,1,1172,1,11,5,5,6,single-choice,spatial-relational,5|6,7,5/6,230384,5
4,4,23,385,1,826,1,5,2,2,3,single-choice,spatial-relational,2|3,7,2/3,230385,2
4,4,23,386,0,914,1,13,6,7,7,single-choice,spatial-relational,6|7,7,6/7,230386,6
4,4,23,387,1,1398,1,11,5,5,6,single-choice,spatial-relational,5|6,7,5/6,230387,5
4,4,23,388,0,1659,1,11,5,6,6,single-choice,spatial-relational,5|6,7,5/6,230388,5
4,4,23,389,1,820,1,7,3,3,4,single-choice,spatial-relational,3|4,7,3/4,230389,3
4,4,23,390,1,1076,1,5,2,2,3,single-choice,spatial-relational,2|3,7,2/3,230390,2
4,4,23,391,1,814,1,7,3,3,4,single-choice,spatial-relational,3|4,7,3/4,230391,3
4,4,23,392,1,1022,1,13,6,6,7,single-choice,spatial-relational,6|7,7,6/7,230392,6
4,4,23,393,1,808,1,3,1,1,2,single-choice,spatial-relational,1|2,7,1/2,230393,1
4,4,23,394,1,716,1,3,1,1,2,single-choice,spatial-relational,1|2,7,1/2,230394,1
4,4,23,395,0,1002,1,9,4,5,5,single-choice,spatial-relational,4|5,7,4/5,230395,4
4,4,23,396,0,832,1,9,4,5,5,single-choice,spatial-relational,4|5,7,4/5,230396,4
4,4,23,397,1,694,1,13,6,6,7,single-choice,spatial-relational,6|7,7,6/7,230397,6
4,4,23,398,1,1062,1,11,5,5,6,single-choice,spatial-relational,5|6,7,5/6,230398,5
4,4,23,399,1,849,1,13,6,6,7,single-choice,spatial-relational,6|7,7,6/7,230399,6
4,4,23,400,1,1355,1,3,1,1,2,single-choice,spatial-relational,1|2,7,1/2,230400,1
4,4,23,401,1,1090,1,11,5,5,6,single-choice,spatial-relational,5|6,7,5/6,230401,5
4,4,23,402,1,733,1,3,1,1,2,single-choice,spatial-relational,1|2,7,1/2,230402,1
4,4,23,403,1,1561,1,9,4,4,5,single-choice,spatial-relational,4|5,7,4/5,230403,4
4,4,23,404,1,1484,1,7,3,3,4,single-choice,spatial-relational,3|4,7,3/4,230404,3
4,4,23,405,1,834,1,5,2,2,3,single-choice,spatial-relational,2|3,7,2/3,230405,2
4,4,23,406,0,2187,1,7,3,4,4,single-choice,spatial-relational,3|4,7,3/4,230406,3
4,4,23,407,1,735,1,5,2,2,3,single-choice,spatial-relational,2|3,7,2/3,230407,2
4,4,23,408,0,592,1,9,4,5,5,single-choice,spatial-relational,4|5,7,4/5,230408,4
4,4,23,409,1,1005,1,3,1,1,2,single-choice,spatial-relational,1|2,7,1/2,230409,1
4,4,23,410,0,979,1,7,3,4,4,single-choice,spatial-relational,3|4,7,3/4,230410,3
4,4,23,411,1,636,1,3,1,1,2,single-choice,spatial-relational,1|2,7,1/2,230411,1
4,4,23,412,0,1093,1,9,4,5,5,single-choice,spatial-relational,4|5,7,4/5,230412,4
4,4,23,413,1,1230,1,13,6,6,7,single-choice,spatial-relational,6|7,7,6/7,230413,6
4,4,23,414,1,1118,1,11,5,5,6,single-choice,spatial-relational,5|6,7,5/6,230414,5
4,4,23,415,1,896,1,5,2,2,3,single-choice,spatial-relational,2|3,7,2/3,230415,2
4,4,23,416,0,1204,1,9,4,5,5,single-choice,spatial-relational,4|5,7,4/5,230416,4
4,4,23,417,1,834,1,7,3,3,4,single-choice,spatial-relational,3|4,7,3/4,230417,3
4,4,23,418,1,1026,1,5,2,2,3,single-choice,spatial-relational,2|3,7,2/3,230418,2
4,4,23,419,1,1151,1,11,5,5,6,single-choice,spatial-relational,5|6,7,5/6,230419,5
4,4,23,420,1,865,1,13,6,6,7,single-choice,spatial-relational,6|7,7,6/7,230420,6
4,4,23,421,1,1595,1,11,5,5,6,single-choice,spatial-relational,5|6,7,5/6,230421,5
4,4,23,422,1,848,1,13,6,6,7,single-choice,spatial-relational,6|7,7,6/7,230422,6
4,4,23,423,1,1209,1,11,5,5,6,single-choice,spatial-relational,5|6,7,5/6,230423,5
4,4,23,424,0,1109,1,7,3,4,4,single-choice,spatial-relational,3|4,7,3/4,230424,3
4,4,23,425,1,1416,1,7,3,3,4,single-choice,spatial-relational,3|4,7,3/4,230425,3
4,4,23,426,1,1762,1,9,4,4,5,single-choice,spatial-relational,4|5,7,4/5,230426,4
4,4,23,427,1,1000,1,3,1,1,2,single-choice,spatial-relational,1|2,7,1/2,230427,1
4,4,23,428,1,692,1,5,2,2,3,single-choice,spatial-relational,2|3,7,2/3,230428,2
4,4,23,429,0,1238,1,9,4,5,5,single-choice,spatial-relational,4|5,7,4/5,230429,4
4,4,23,430,1,831,1,5,2,2,3,single-choice,spatial-relational,2|3,7,2/3,230430,2
4,4,23,431,1,672,1,3,1,1,2,single-choice,spatial-relational,1|2,7,1/2,230431,1
4,4,23,432,1,630,1,13,6,6,7,single-choice,spatial-relational,6|7,7,6/7,230432,6
4,4,23,433,1,868,1,3,1,1,2,single-choice,spatial-relational,1|2,7,1/2,230433,1
4,4,23,434,1,1202,1,11,5,5,6,single-choice,spatial-relational,5|6,7,5/6,230434,5
4,4,23,435,1,1130,1,7,3,3,4,single-choice,spatial-relational,3|4,7,3/4,230435,3
4,4,23,436,1,792,1,5,2,2,3,single-choice,spatial-relational,2|3,7,2/3,230436,2
4,4,23,437,1,1054,1,9,4,4,5,single-choice,spatial-relational,4|5,7,4/5,230437,4
4,4,23,438,0,932,1,11,5,6,6,single-choice,spatial-relational,5|6,7,5/6,230438,5
4,4,23,439,1,925,1,13,6,6,7,single-choice,spatial-relational,6|7,7,6/7,230439,6
4,4,23,440,0,1707,1,9,4,5,5,single-choice,spatial-relational,4|5,7,4/5,230440,4
4,4,23,441,1,746,1,5,2,2,3,single-choice,spatial-relational,2|3,7,2/3,230441,2
4,4,23,442,1,1216,1,7,3,3,4,single-choice,spatial-relational,3|4,7,3/4,230442,3
4,4,23,443,1,850,1,13,6,6,7,single-choice,spatial-relational,6|7,7,6/7,230443,6
4,4,23,444,1,818,1,3,1,1,2,single-choice,spatial-relational,1|2,7,1/2,230444,1
4,4,23,445,1,1350,1,9,4,4,5,single-choice,spatial-relational,4|5,7,4/5,230445,4
4,4,23,446,1,743,1,3,1,1,2,single-choice,spatial-relational,1|2,7,1/2,230446,1
4,4,23,447,1,1040,1,11,5,5,6,single-choice,spatial-relational,5|6,7,5/6,230447,5
4,4,23,448,1,1094,1,5,2,2,3,single-choice,spatial-relational,2|3,7,2/3,230448,2
4,4,23,449,1,14955,1,9,4,4,5,single-choice,spatial-relational,4|5,7,4/5,230449,4
4,4,23,450,1,971,1,7,3,3,4,single-choice,spatial-relational,3|4,7,3/4,230450,3
4,4,23,451,1,1070,1,7,3,3,4,single-choice,spatial-relational,3|4,7,3/4,230451,3
4,4,23,452,1,1626,1,3,1,1,2,single-choice,spatial-relational,1|2,7,1/2,230452,1
4,4,23,453,1,815,1,13,6,6,7,single-choice,spatial-relational,6|7,7,6/7,230453,6
4,4,23,454,1,600,1,13,6,6,7,single-choice,spatial-relational,6|7,7,6/7,230454,6
4,4,23,455,1,879,1,5,2,2,3,single-choice,spatial-relational,2|3,7,2/3,230455,2
4,4,23,456,1,851,1,11,5,5,6,single-choice,spatial-relational,5|6,7,5/6,230456,5
4,4,23,457,1,1114,1,7,3,3,4,single-choice,spatial-relational,3|4,7,3/4,230457,3
4,4,23,458,1,1166,1,11,5,5,6,single-choice,spatial-relational,5|6,7,5/6,230458,5
4,4,23,459,0,146,1,13,6,7,7,single-choice,spatial-relational,6|7,7,6/7,230459,6
4,4,23,460,1,947,1,7,3,3,4,single-choice,spatial-relational,3|4,7,3/4,230460,3
4,4,23,461,1,1050,1,11,5,5,6,single-choice,spatial-relational,5|6,7,5/6,230461,5
4,4,23,462,1,658,1,13,6,6,7,single-choice,spatial-relational,6|7,7,6/7,230462,6
4,4,23,463,1,778,1,3,1,1,2,single-choice,spatial-relational,1|2,7,1/2,230463,1
4,4,23,464,1,1185,1,5,2,2,3,single-choice,spatial-relational,2|3,7,2/3,230464,2
4,4,23,465,1,1423,1,5,2,2,3,single-choice,spatial-relational,2|3,7,2/3,230465,2
4,4,23,466,1,878,1,3,1,1,2,single-choice,spatial-relational,1|2,7,1/2,230466,1
4,4,23,467,0,1236,1,9,4,5,5,single-choice,spatial-relational,4|5,7,4/5,230467,4
4,4,23,468,1,1084,1,9,4,4,5,single-choice,spatial-relational,4|5,7,4/5,230468,4
4,4,23,469,1,1362,1,7,3,3,4,single-choice,spatial-relational,3|4,7,3/4,230469,3
4,4,23,470,1,949,1,3,1,1,2,single-choice,spatial-relational,1|2,7,1/2,230470,1
4,4,23,471,1,2460,1,9,4,4,5,single-choice,spatial-relational,4|5,7,4/5,230471,4
4,4,23,472,1,931,1,5,2,2,3,single-choice,spatial-relational,2|3,7,2/3,230472,2
4,4,23,473,1,1222,1,11,5,5,6,single-choice,spatial-relational,5|6,7,5/6,230473,5
4,4,23,474,1,737,1,9,4,4,5,single-choice,spatial-relational,4|5,7,4/5,230474,4
4,4,23,475,1,782,1,3,1,1,2,single-choice,spatial-relational,1|2,7,1/2,230475,1
4,4,23,476,1,1182,1,5,2,2,3,single-choice,spatial-relational,2|3,7,2/3,230476,2
4,4,23,477,1,881,1,7,3,3,4,single-choice,spatial-relational,3|4,7,3/4,230477,3
4,4,23,478,0,970,1,13,6,7,7,single-choice,spatial-relational,6|7,7,6/7,230478,6
4,4,23,479,1,728,1,13,6,6,7,single-choice,spatial-relational,6|7,7,6/7,230479,6
4,4,23,480,1,1213,1,11,5,5,6,single-choice,spatial-relational,5|6,7,5/6,230480,5
4,4,23,481,1,1153,1,9,4,4,5,single-choice,spatial-relational,4|5,7,4/5,230481,4
4,4,23,482,1,1142,1,11,5,5,6,single-choice,spatial-relational,5|6,7,5/6,230482,5
4,4,23,483,1,1171,1,5,2,2,3,single-choice,spatial-relational,2|3,7,2/3,230483,2
4,4,23,484,1,1149,1,11,5,5,6,single-choice,spatial-relational,5|6,7,5/6,230484,5
4,4,23,485,1,925,1,7,3,3,4,single-choice,spatial-relational,3|4,7,3/4,230485,3
4,4,23,486,1,1186,1,7,3,3,4,single-choice,spatial-relational,3|4,7,3/4,230486,3
4,4,23,487,1,818,1,5,2,2,3,single-choice,spatial-relational,2|3,7,2/3,230487,2
4,4,23,488,1,891,1,3,1,1,2,single-choice,spatial-relational,1|2,7,1/2,230488,1
4,4,23,489,1,803,1,13,6,6,7,single-choice,spatial-relational,6|7,7,6/7,230489,6
4,4,23,490,1,751,1,3,1,1,2,single-choice,spatial-relational,1|2,7,1/2,230490,1
4,4,23,491,1,922,1,13,6,6,7,single-choice,spatial-relational,6|7,7,6/7,230491,6
4,4,23,492,1,1652,1,9,4,4,5,single-choice,spatial-relational,4|5,7,4/5,230492,4
4,4,23,493,1,892,1,7,3,3,4,single-choice,spatial-relational,3|4,7,3/4,230493,3
4,4,23,494,0,882,1,9,4,5,5,single-choice,spatial-relational,4|5,7,4/5,230494,4
4,4,23,495,1,738,1,3,1,1,2,single-choice,spatial-relational,1|2,7,1/2,230495,1
4,4,23,496,1,764,1,13,6,6,7,single-choice,spatial-relational,6|7,7,6/7,230496,6
4,4,23,497,1,1144,1,11,5,5,6,single-choice,spatial-relational,5|6,7,5/6,230497,5
4,4,23,498,0,850,1,9,4,5,5,single-choice,spatial-relational,4|5,7,4/5,230498,4
4,4,23,499,1,648,1,13,6,6,7,single-choice,spatial-relational,6|7,7,6/7,230499,6
4,4,23,500,1,724,1,5,2,2,3,single-choice,spatial-relational,2|3,7,2/3,230500,2
4,4,23,501,0,1402,1,7,3,4,4,single-choice,spatial-relational,3|4,7,3/4,230501,3
4,4,23,502,1,683,1,3,1,1,2,single-choice,spatial-relational,1|2,7,1/2,230502,1
4,4,23,503,1,1572,1,11,5,5,6,single-choice,spatial-relational,5|6,7,5/6,230503,5
4,4,23,504,1,913,1,5,2,2,3,single-choice,spatial-relational,2|3,7,2/3,230504,2
4,4,23,505,1,884,1,7,3,3,4,single-choice,spatial-relational,3|4,7,3/4,230505,3
4,4,23,506,1,959,1,13,6,6,7,single-choice,spatial-relational,6|7,7,6/7,230506,6
4,4,23,507,1,867,1,5,2,2,3,single-choice,spatial-relational,2|3,7,2/3,230507,2
4,4,23,508,0,1381,1,9,4,5,5,single-choice,spatial-relational,4|5,7,4/5,230508,4
4,4,23,509,0,712,1,11,5,6,6,single-choice,spatial-relational,5|6,7,5/6,230509,5
4,4,23,510,1,689,1,5,2,2,3,single-choice,spatial-relational,2|3,7,2/3,230510,2
4,4,23,511,0,1057,1,9,4,5,5,single-choice,spatial-relational,4|5,7,4/5,230511,4
4,4,23,512,0,629,1,3,1,2,2,single-choice,spatial-relational,1|2,7,1/2,230512,1
4,4,23,513,0,553,1,11,5,6,6,single-choice,spatial-relational,5|6,7,5/6,230513,5
4,4,23,514,0,596,1,7,3,4,4,single-choice,spatial-relational,3|4,7,3/4,230514,3
4,4,23,515,1,631,1,3,1,1,2,single-choice,spatial-relational,1|2,7,1/2,230515,1
4,4,23,516,1,645,1,13,6,6,7,single-choice,spatial-relational,6|7,7,6/7,230516,6
4,4,23,517,0,882,1,9,4,5,5,single-choice,spatial-relational,4|5,7,4/5,230517,4
4,4,23,518,1,1396,1,11,5,5,6,single-choice,spatial-relational,5|6,7,5/6,230518,5
4,4,23,519,1,936,1,13,6,6,7,single-choice,spatial-relational,6|7,7,6/7,230519,6
4,4,23,520,1,830,1,13,6,6,7,single-choice,spatial-relational,6|7,7,6/7,230520,6
4,4,23,521,1,780,1,7,3,3,4,single-choice,spatial-relational,3|4,7,3/4,230521,3
4,4,23,522,1,726,1,3,1,1,2,single-choice,spatial-relational,1|2,7,1/2,230522,1
4,4,23,523,1,1440,1,11,5,5,6,single-choice,spatial-relational,5|6,7,5/6,230523,5
4,4,23,524,1,739,1,3,1,1,2,single-choice,spatial-relational,1|2,7,1/2,230524,1
4,4,23,525,1,953,1,5,2,2,3,single-choice,spatial-relational,2|3,7,2/3,230525,2
4,4,23,526,0,888,1,9,4,5,5,single-choice,spatial-relational,4|5,7,4/5,230526,4
4,4,23,527,1,947,1,7,3,3,4,single-choice,spatial-relational,3|4,7,3/4,230527,3
4,4,23,528,1,766,1,5,2,2,3,single-choice,spatial-relational,2|3,7,2/3,230528,2
4,4,23,529,1,978,1,3,1,1,2,single-choice,spatial-relational,1|2,7,1/2,230529,1
4,4,23,530,0,823,1,9,4,5,5,single-choice,spatial-relational,4|5,7,4/5,230530,4
4,4,23,531,1,890,1,7,3,3,4,single-choice,spatial-relational,3|4,7,3/4,230531,3
4,4,23,532,1,746,1,5,2,2,3,single-choice,spatial-relational,2|3,7,2/3,230532,2
4,4,23,533,1,719,1,5,2,2,3,single-choice,spatial-relational,2|3,7,2/3,230533,2
4,4,23,534,1,683,1,13,6,6,7,single-choice,spatial-relational,6|7,7,6/7,230534,6
4,4,23,535,0,914,1,9,4,5,5,single-choice,spatial-relational,4|5,7,4/5,230535,4
4,4,23,536,0,1416,1,7,3,4,4,single-choice,spatial-relational,3|4,7,3/4,230536,3
4,4,23,537,0,944,1,11,5,6,6,single-choice,spatial-relational,5|6,7,5/6,230537,5
4,4,23,538,1,618,1,3,1,1,2,single-choice,spatial-relational,1|2,7,1/2,230538,1
4,4,23,539,0,1869,1,13,6,7,7,single-choice,spatial-relational,6|7,7,6/7,230539,6
4,4,23,540,1,887,1,11,5,5,6,single-choice,spatial-relational,5|6,7,5/6,230540,5
4,4,23,541,0,36,1,11,5,6,6,single-choice,spatial-relational,5|6,7,5/6,230541,5
4,4,23,542,0,33,1,9,4,5,5,single-choice,spatial-relational,4|5,7,4/5,230542,4
4,4,23,543,1,1187,1,13,6,6,7,single-choice,spatial-relational,6|7,7,6/7,230543,6
4,4,23,544,1,876,1,7,3,3,4,single-choice,spatial-relational,3|4,7,3/4,230544,3
4,4,23,545,1,827,1,5,2,2,3,single-choice,spatial-relational,2|3,7,2/3,230545,2
4,4,23,546,1,1075,1,3,1,1,2,single-choice,spatial-relational,1|2,7,1/2,230546,1
4,4,23,547,1,1799,1,9,4,4,5,single-choice,spatial-relational,4|5,7,4/5,230547,4
4,4,23,548,1,1170,1,5,2,2,3,single-choice,spatial-relational,2|3,7,2/3,230548,2
4,4,23,549,1,1090,1,11,5,5,6,single-choice,spatial-relational,5|6,7,5/6,230549,5
4,4,23,550,1,1055,1,7,3,3,4,single-choice,spatial-relational,3|4,7,3/4,230550,3
4,4,23,551,1,823,1,3,1,1,2,single-choice,spatial-relational,1|2,7,1/2,230551,1
4,4,23,552,1,886,1,13,6,6,7,single-choice,spatial-relational,6|7,7,6/7,230552,6
4,4,23,553,1,1598,1,7,3,3,4,single-choice,spatial-relational,3|4,7,3/4,230553,3
4,4,23,554,1,2066,1,7,3,3,4,single-choice,spatial-relational,3|4,7,3/4,230554,3
4,4,23,555,1,1007,1,13,6,6,7,single-choice,spatial-relational,6|7,7,6/7,230555,6
4,4,23,556,1,1816,1,11,5,5,6,single-choice,spatial-relational,5|6,7,5/6,230556,5
4,4,23,557,1,922,1,5,2,2,3,single-choice,spatial-relational,2|3,7,2/3,230557,2
4,4,23,558,1,1246,1,9,4,4,5,single-choice,spatial-relational,4|5,7,4/5,230558,4
4,4,23,559,1,1195,1,3,1,1,2,single-choice,spatial-relational,1|2,7,1/2,230559,1
4,4,23,560,1,1377,1,11,5,5,6,single-choice,spatial-relational,5|6,7,5/6,230560,5
4,4,23,561,0,2066,1,9,4,5,5,single-choice,spatial-relational,4|5,7,4/5,230561,4
4,4,23,562,1,697,1,13,6,6,7,single-choice,spatial-relational,6|7,7,6/7,230562,6
4,4,23,563,1,729,1,3,1,1,2,single-choice,spatial-relational,1|2,7,1/2,230563,1
4,4,23,564,1,833,1,5,2,2,3,single-choice,spatial-relational,2|3,7,2/3,230564,2
4,4,23,565,1,1094,1,13,6,6,7,single-choice,spatial-relational,6|7,7,6/7,230565,6
4,4,23,566,0,1936,1,9,4,5,5,single-choice,spatial-relational,4|5,7,4/5,230566,4
4,4,23,567,1,1209,1,9,4,4,5,single-choice,spatial-relational,4|5,7,4/5,230567,4
4,4,23,568,1,2335,1,11,5,5,6,single-choice,spatial-relational,5|6,7,5/6,230568,5
4,4,23,569,1,1210,1,7,3,3,4,single-choice,spatial-relational,3|4,7,3/4,230569,3
4,4,23,570,1,2020,1,11,5,5,6,single-choice,spatial-relational,5|6,7,5/6,230570,5
4,4,23,571,1,735,1,13,6,6,7,single-choice,spatial-relational,6|7,7,6/7,230571,6
4,4,23,572,0,913,1,3,1,2,2,single-choice,spatial-relational,1|2,7,1/2,230572,1
4,4,23,573,1,911,1,7,3,3,4,single-choice,spatial-relational,3|4,7,3/4,230573,3
4,4,23,574,1,740,1,5,2,2,3,single-choice,spatial-relational,2|3,7,2/3,230574,2
4,4,23,575,1,578,1,3,1,1,2,single-choice,spatial-relational,1|2,7,1/2,230575,1
4,4,23,576,1,1849,1,5,2,2,3,single-choice,spatial-relational,2|3,7,2/3,230576,2
4,4,23,577,0,767,1,3,1,2,2,single-choice,spatial-relational,1|2,7,1/2,230577,1
4,4,23,578,1,866,1,5,2,2,3,single-choice,spatial-relational,2|3,7,2/3,230578,2
4,4,23,579,1,1668,1,7,3,3,4,single-choice,spatial-relational,3|4,7,3/4,230579,3
4,4,23,580,1,1341,1,11,5,5,6,single-choice,spatial-relational,5|6,7,5/6,230580,5
4,4,23,581,1,607,1,3,1,1,2,single-choice,spatial-relational,1|2,7,1/2,230581,1
4,4,23,582,1,944,1,7,3,3,4,single-choice,spatial-relational,3|4,7,3/4,230582,3
4,4,23,583,1,734,1,5,2,2,3,single-choice,spatial-relational,2|3,7,2/3,230583,2
4,4,23,584,0,1098,1,9,4,5,5,single-choice,spatial-relational,4|5,7,4/5,230584,4
4,4,23,585,1,822,1,13,6,6,7,single-choice,spatial-relational,6|7,7,6/7,230585,6
4,4,23,586,1,890,1,13,6,6,7,single-choice,spatial-relational,6|7,7,6/7,230586,6
4,4,23,587,1,904,1,11,5,5,6,single-choice,spatial-relational,5|6,7,5/6,230587,5
4,4,23,588,1,1284,1,9,4,4,5,single-choice,spatial-relational,4|5,7,4/5,230588,4
4,4,23,589,0,1751,1,9,4,5,5,single-choice,spatial-relational,4|5,7,4/5,230589,4
4,4,23,590,1,904,1,9,4,4,5,single-choice,spatial-relational,4|5,7,4/5,230590,4
4,4,23,591,1,1016,1,11,5,5,6,single-choice,spatial-relational,5|6,7,5/6,230591,5
4,4,23,592,1,668,1,5,2,2,3,single-choice,spatial-relational,2|3,7,2/3,230592,2
4,4,23,593,0,1391,1,11,5,6,6,single-choice,spatial-relational,5|6,7,5/6,230593,5
4,4,23,594,1,989,1,7,3,3,4,single-choice,spatial-relational,3|4,7,3/4,230594,3
4,4,23,595,1,930,1,5,2,2,3,single-choice,spatial-relational,2|3,7,2/3,230595,2
4,4,23,596,0,1084,1,3,1,2,2,single-choice,spatial-relational,1|2,7,1/2,230596,1
4,4,23,597,1,656,1,3,1,1,2,single-choice,spatial-relational,1|2,7,1/2,230597,1
4,4,23,598,1,703,1,7,3,3,4,single-choice,spatial-relational,3|4,7,3/4,230598,3
4,4,23,599,1,711,1,13,6,6,7,single-choice,spatial-relational,6|7,7,6/7,230599,6
4,4,23,600,1,794,1,13,6,6,7,single-choice,spatial-relational,6|7,7,6/7,230600,6
5,4,23,1,1,1118,1,13,6,6,7,single-choice,spatial-relational,6|7,7,6/7,230001,6
5,4,23,2,0,1116,1,9,4,5,5,single-choice,spatial-relational,4|5,7,4/5,230002,4
5,4,23,3,1,620,1,3,1,1,2,single-choice,spatial-relational,1|2,7,1/2,230003,1
5,4,23,4,1,1079,1,11,5,5,6,single-choice,spatial-relational,5|6,7,5/6,230004,5
5,4,23,5,1,964,1,11,5,5,6,single-choice,spatial-relational,5|6,7,5/6,230005,5
5,4,23,6,1,1131,1,7,3,3,4,single-choice,spatial-relational,3|4,7,3/4,230006,3
5,4,23,7,1,746,1,3,1,1,2,single-choice,spatial-relational,1|2,7,1/2,230007,1
5,4,23,8,1,1132,1,9,4,4,5,single-choice,spatial-relational,4|5,7,4/5,230008,4
5,4,23,9,1,778,1,7,3,3,4,single-choice,spatial-relational,3|4,7,3/4,230009,3
5,4,23,10,1,914,1,5,2,2,3,single-choice,spatial-relational,2|3,7,2/3,230010,2
5,4,23,11,1,717,1,5,2,2,3,single-choice,spatial-relational,2|3,7,2/3,230011,2
5,4,23,12,1,788,1,13,6,6,7,single-choice,spatial-relational,6|7,7,6/7,230012,6
5,4,23,13,0,1022,1,9,4,5,5,single-choice,spatial-relational,4|5,7,4/5,230013,4
5,4,23,14,0,956,1,7,3,4,4,single-choice,spatial-relational,3|4,7,3/4,230014,3
5,4,23,15,1,1018,1,11,5,5,6,single-choice,spatial-relational,5|6,7,5/6,230015,5
5,4,23,16,1,722,1,7,3,3,4,single-choice,spatial-relational,3|4,7,3/4,230016,3
5,4,23,17,1,867,1,13,6,6,7,single-choice,spatial-relational,6|7,7,6/7,230017,6
5,4,23,18,1,1002,1,11,5,5,6,single-choice,spatial-relational,5|6,7,5/6,230018,5
5,4,23,19,1,671,1,3,1,1,2,single-choice,spatial-relational,1|2,7,1/2,230019,1
5,4,23,20,1,691,1,13,6,6,7,single-choice,spatial-relational,6|7,7,6/7,230020,6
5,4,23,21,1,1082,1,5,2,2,3,single-choice,spatial-relational,2|3,7,2/3,230021,2
5,4,23,22,1,1314,1,9,4,4,5,single-choice,spatial-relational,4|5,7,4/5,230022,4
5,4,23,23,1,760,1,3,1,1,2,single-choice,spatial-relational,1|2,7,1/2,230023,1
5,4,23,24,1,1171,1,5,2,2,3,single-choice,spatial-relational,2|3,7,2/3,230024,2
5,4,23,25,1,883,1,5,2,2,3,single-choice,spatial-relational,2|3,7,2/3,230025,2
5,4,23,26,1,948,1,3,1,1,2,single-choice,spatial-relational,1|2,7,1/2,230026,1
5,4,23,27,1,678,1,9,4,4,5,single-choice,spatial-relational,4|5,7,4/5,230027,4
5,4,23,28,1,831,1,7,3,3,4,single-choice,spatial-relational,3|4,7,3/4,230028,3
5,4,23,29,0,1431,1,9,4,5,5,single-choice,spatial-relational,4|5,7,4/5,230029,4
5,4,23,30,1,494,1,3,1,1,2,single-choice,spatial-relational,1|2,7,1/2,230030,1
5,4,23,31,1,612,1,5,2,2,3,single-choice,spatial-relational,2|3,7,2/3,230031,2
5,4,23,32,1,934,1,7,3,3,4,single-choice,spatial-relational,3|4,7,3/4,230032,3
5,4,23,33,1,1420,1,11,5,5,6,single-choice,spatial-relational,5|6,7,5/6,230033,5
5,4,23,34,1,640,1,13,6,6,7,single-choice,spatial-relational,6|7,7,6/7,230034,6
5,4,23,35,1,1165,1,11,5,5,6,single-choice,spatial-relational,5|6,7,5/6,230035,5
5,4,23,36,1,1050,1,13,6,6,7,single-choice,spatial-relational,6|7,7,6/7,230036,6
5,4,23,37,1,759,1,5,2,2,3,single-choice,spatial-relational,2|3,7,2/3,230037,2
5,4,23,38,1,939,1,7,3,3,4,single-choice,spatial-relational,3|4,7,3/4,230038,3
5,4,23,39,0,1275,1,9,4,5,5,single-choice,spatial-relational,4|5,7,4/5,230039,4
5,4,23,40,0,660,1,11,5,6,6,single-choice,spatial-relational,5|6,7,5/6,230040,5
5,4,23,41,1,883,1,3,1,1,2,single-choice,spatial-relational,1|2,7,1/2,230041,1
5,4,23,42,0,760,1,9,4,5,5,single-choice,spatial-relational,4|5,7,4/5,230042,4
5,4,23,43,0,881,1,11,5,6,6,single-choice,spatial-relational,5|6,7,5/6,230043,5
5,4,23,44,1,807,1,13,6,6,7,single-choice,spatial-relational,6|7,7,6/7,230044,6
5,4,23,45,1,1097,1,7,3,3,4,single-choice,spatial-relational,3|4,7,3/4,230045,3
5,4,23,46,1,843,1,3,1,1,2,single-choice,spatial-relational,1|2,7,1/2,230046,1
5,4,23,47,1,786,1,13,6,6,7,single-choice,spatial-relational,6|7,7,6/7,230047,6
5,4,23,48,1,1162,1,5,2,2,3,single-choice,spatial-relational,2|3,7,2/3,230048,2
5,4,23,49,1,993,1,11,5,5,6,single-choice,spatial-relational,5|6,7,5/6,230049,5
5,4,23,50,1,2057,1,9,4,4,5,single-choice,spatial-relational,4|5,7,4/5,230050,4
5,4,23,51,0,1917,1,9,4,5,5,single-choice,spatial-relational,4|5,7,4/5,230051,4
5,4,23,52,0,725,1,3,1,2,2,single-choice,spatial-relational,1|2,7,1/2,230052,1
5,4,23,53,0,762,1,11,5,6,6,single-choice,spatial-relational,5|6,7,5/6,230053,5
5,4,23,54,1,1031,1,5,2,2,3,single-choice,spatial-relational,2|3,7,2/3,230054,2
5,4,23,55,1,744,1,13,6,6,7,single-choice,spatial-relational,6|7,7,6/7,230055,6
5,4,23,56,1,931,1,5,2,2,3,single-choice,spatial-relational,2|3,7,2/3,230056,2
5,4,23,57,1,666,1,3,1,1,2,single-choice,spatial-relational,1|2,7,1/2,230057,1
5,4,23,58,1,574,1,13,6,6,7,single-choice,spatial-relational,6|7,7,6/7,230058,6
5,4,23,59,1,2045,1,7,3,3,4,single-choice,spatial-relational,3|4,7,3/4,230059,3
5,4,23,60,1,1085,1,7,3,3,4,single-choice,spatial-relational,3|4,7,3/4,230060,3
5,4,23,61,0,1672,1,7,3,4,4,single-choice,spatial-relational,3|4,7,3/4,230061,3
5,4,23,62,1,669,1,13,6,6,7,single-choice,spatial-relational,6|7,7,6/7,230062,6
5,4,23,63,0,1494,1,9,4,5,5,single-choice,spatial-relational,4|5,7,4/5,230063,4
5,4,23,64,1,945,1,5,2,2,3,single-choice,spatial-relational,2|3,7,2/3,230064,2
5,4,23,65,1,897,1,13,6,6,7,single-choice,spatial-relational,6|7,7,6/7,230065,6
5,4,23,66,1,1020,1,7,3,3,4,single-choice,spatial-relational,3|4,7,3/4,230066,3
5,4,23,67,1,740,1,5,2,2,3,single-choice,spatial-relational,2|3,7,2/3,230067,2
5,4,23,68,0,2015,1,9,4,5,5,single-choice,spatial-relational,4|5,7,4/5,230068,4
5,4,23,69,0,633,1,3,1,2,2,single-choice,spatial-relational,1|2,7,1/2,230069,1
5,4,23,70,0,497,1,11,5,6,6,single-choice,spatial-relational,5|6,7,5/6,230070,5
5,4,23,71,1,620,1,3,1,1,2,single-choice,spatial-relational,1|2,7,1/2,230071,1
5,4,23,72,0,1069,1,11,5,6,6,single-choice,spatial-relational,5|6,7,5/6,230072,5
5,4,23,73,1,961,1,9,4,4,5,single-choice,spatial-relational,4|5,7,4/5,230073,4
5,4,23,74,1,612,1,13,6,6,7,single-choice,spatial-relational,6|7,7,6/7,230074,6
5,4,23,75,0,991,1,9,4,5,5,single-choice,spatial-relational,4|5,7,4/5,230075,4
5,4,23,76,1,739,1,13,6,6,7,single-choice,spatial-relational,6|7,7,6/7,230076,6
5,4,23,77,1,904,1,11,5,5,6,single-choice,spatial-relational,5|6,7,5/6,230077,5
5,4,23,78,1,911,1,11,5,5,6,single-choice,spatial-relational,5|6,7,5/6,230078,5
5,4,23,79,1,764,1,5,2,2,3,single-choice,spatial-relational,2|3,7,2/3,230079,2
5,4,23,80,1,1328,1,3,1,1,2,single-choice,spatial-relational,1|2,7,1/2,230080,1
5,4,23,81,1,1351,1,5,2,2,3,single-choice,spatial-relational,2|3,7,2/3,230081,2
5,4,23,82,1,971,1,3,1,1,2,single-choice,spatial-relational,1|2,7,1/2,230082,1
5,4,23,83,1,833,1,7,3,3,4,single-choice,spatial-relational,3|4,7,3/4,230083,3
5,4,23,84,1,855,1,7,3,3,4,single-choice,spatial-relational,3|4,7,3/4,230084,3
5,4,23,85,1,1060,1,11,5,5,6,single-choice,spatial-relational,5|6,7,5/6,230085,5
5,4,23,86,0,934,1,3,1,2,2,single-choice,spatial-relational,1|2,7,1/2,230086,1
5,4,23,87,1,725,1,3,1,1,2,single-choice,spatial-relational,1|2,7,1/2,230087,1
5,4,23,88,1,752,1,13,6,6,7,single-choice,spatial-relational,6|7,7,6/7,230088,6
5,4,23,89,1,755,1,5,2,2,3,single-choice,spatial-relational,2|3,7,2/3,230089,2
5,4,23,90,1,810,1,5,2,2,3,single-choice,spatial-relational,2|3,7,2/3,230090,2
5,4,23,91,1,795,1,13,6,6,7,single-choice,spatial-relational,6|7,7,6/7,230091,6
5,4,23,92,1,927,1,7,3,3,4,single-choice,spatial-relational,3|4,7,3/4,230092,3
5,4,23,93,0,608,1,11,5,6,6,single-choice,spatial-relational,5|6,7,5/6,230093,5
5,4,23,94,1,1397,1,7,3,3,4,single-choice,spatial-relational,3|4,7,3/4,230094,3
5,4,23,95,0,1287,1,9,4,5,5,single-choice,spatial-relational,4|5,7,4/5,230095,4
5,4,23,96,0,799,1,9,4,5,5,single-choice,spatial-relational,4|5,7,4/5,230096,4
5,4,23,97,0,737,1,11,5,6,6,single-choice,spatial-relational,5|6,7,5/6,230097,5
5,4,23,98,1,1013,1,13,6,6,7,single-choice,spatial-relational,6|7,7,6/7,230098,6
5,4,23,99,1,1216,1,7,3,3,4,single-choice,spatial-relational,3|4,7,3/4,230099,3
5,4,23,100,1,876,1,13,6,6,7,single-choice,spatial-relational,6|7,7,6/7,230100,6
5,4,23,101,0,710,1,3,1,2,2,single-choice,spatial-relational,1|2,7,1/2,230101,1
5,4,23,102,1,772,1,11,5,5,6,single-choice,spatial-relational,5|6,7,5/6,230102,5
5,4,23,103,1,760,1,5,2,2,3,single-choice,spatial-relational,2|3,7,2/3,230103,2
5,4,23,104,1,906,1,5,2,2,3,single-choice,spatial-relational,2|3,7,2/3,230104,2
5,4,23,105,1,885,1,7,3,3,4,single-choice,spatial-relational,3|4,7,3/4,230105,3
5,4,23,106,1,642,1,3,1,1,2,single-choice,spatial-relational,1|2,7,1/2,230106,1
5,4,23,107,0,1025,1,9,4,5,5,single-choice,spatial-relational,4|5,7,4/5,230107,4
5,4,23,108,0,703,1,9,4,5,5,single-choice,spatial-relational,4|5,7,4/5,230108,4
5,4,23,109,1,878,1,3,1,1,2,single-choice,spatial-relational,1|2,7,1/2,230109,1
5,4,23,110,1,1061,1,7,3,3,4,single-choice,spatial-relational,3|4,7,3/4,230110,3
5,4,23,111,1,1196,1,7,3,3,4,single-choice,spatial-relational,3|4,7,3/4,230111,3
5,4,23,112,1,589,1,3,1,1,2,single-choice,spatial-relational,1|2,7,1/2,230112,1
5,4,23,113,1,963,1,5,2,2,3,single-choice,spatial-relational,2|3,7,2/3,230113,2
5,4,23,114,1,1261,1,11,5,5,6,single-choice,spatial-relational,5|6,7,5/6,230114,5
5,4,23,115,1,956,1,13,6,6,7,single-choice,spatial-relational,6|7,7,6/7,230115,6
5,4,23,116,0,1050,1,9,4,5,5,single-choice,spatial-relational,4|5,7,4/5,230116,4
5,4,23,117,1,777,1,13,6,6,7,single-choice,spatial-relational,6|7,7,6/7,230117,6
5,4,23,118,1,696,1,5,2,2,3,single-choice,spatial-relational,2|3,7,2/3,230118,2
5,4,23,119,1,1003,1,11,5,5,6,single-choice,spatial-relational,5|6,7,5/6,230119,5
5,4,23,120,0,962,1,9,4,5,5,single-choice,spatial-relational,4|5,7,4/5,230120,4
5,4,23,121,1,978,1,5,2,2,3,single-choice,spatial-relational,2|3,7,2/3,230121,2
5,4,23,122,1,685,1,13,6,6,7,single-choice,spatial-relational,6|7,7,6/7,230122,6
5,4,23,123,1,2005,1,11,5,5,6,single-choice,spatial-relational,5|6,7,5/6,230123,5
5,4,23,124,1,1068,1,9,4,4,5,single-choice,spatial-relational,4|5,7,4/5,230124,4
5,4,23,125,1,712,1,7,3,3,4,single-choice,spatial-relational,3|4,7,3/4,230125,3
5,4,23,126,0,974,1,9,4,5,5,single-choice,spatial-relational,4|5,7,4/5,230126,4
5,4,23,127,1,711,1,5,2,2,3,single-choice,spatial-relational,2|3,7,2/3,230127,2
5,4,23,128,0,694,1,3,1,2,2,single-choice,spatial-relational,1|2,7,1/2,230128,1
5,4,23,129,0,926,1,7,3,4,4,single-choice,spatial-relational,3|4,7,3/4,230129,3
5,4,23,130,1,674,1,3,1,1,2,single-choice,spatial-relational,1|2,7,1/2,230130,1
5,4,23,131,1,685,1,13,6,6,7,single-choice,spatial-relational,6|7,7,6/7,230131,6
5,4,23,132,1,1345,1,11,5,5,6,single-choice,spatial-relational,5|6,7,5/6,230132,5
5,4,23,133,0,839,1,9,4,5,5,single-choice,spatial-relational,4|5,7,4/5,230133,4
5,4,23,134,1,606,1,13,6,6,7,single-choice,spatial-relational,6|7,7,6/7,230134,6
5,4,23,135,1,998,1,5,2,2,3,single-choice,spatial-relational,2|3,7,2/3,230135,2
5,4,23,136,1,1081,1,9,4,4,5,single-choice,spatial-relational,4|5,7,4/5,230136,4
5,4,23,137,1,976,1,3,1,1,2,single-choice,spatial-relational,1|2,7,1/2,230137,1
5,4,23,138,1,1330,1,7,3,3,4,single-choice,spatial-relational,3|4,7,3/4,230138,3
5,4,23,139,1,766,1,5,2,2,3,single-choice,spatial-relational,2|3,7,2/3,230139,2
5,4,23,140,1,707,1,13,6,6,7,single-choice,spatial-relational,6|7,7,6/7,230140,6
5,4,23,141,0,1607,1,3,1,2,2,single-choice,spatial-relational,1|2,7,1/2,230141,1
5,4,23,142,0,1278,1,7,3,4,4,single-choice,spatial-relational,3|4,7,3/4,230142,3
5,4,23,143,1,977,1,11,5,5,6,single-choice,spatial-relational,5|6,7,5/6,230143,5
5,4,23,144,1,2088,1,11,5,5,6,single-choice,spatial-relational,5|6,7,5/6,230144,5
5,4,23,145,1,1039,1,7,3,3,4,single-choice,spatial-relational,3|4,7,3/4,230145,3
5,4,23,146,1,901,1,13,6,6,7,single-choice,spatial-relational,6|7,7,6/7,230146,6
5,4,23,147,0,773,1,3,1,2,2,single-choice,spatial-relational,1|2,7,1/2,230147,1
5,4,23,148,1,938,1,11,5,5,6,single-choice,spatial-relational,5|6,7,5/6,230148,5
5,4,23,149,1,1307,1,7,3,3,4,single-choice,spatial-relational,3|4,7,3/4,230149,3
5,4,23,150,1,1166,1,3,1,1,2,single-choice,spatial-relational,1|2,7,1/2,230150,1
5,4,23,151,1,1487,1,5,2,2,3,single-choice,spatial-relational,2|3,7,2/3,230151,2
5,4,23,152,1,1075,1,5,2,2,3,single-choice,spatial-relational,2|3,7,2/3,230152,2
5,4,23,153,0,1131,1,9,4,5,5,single-choice,spatial-relational,4|5,7,4/5,230153,4
5,4,23,154,1,1060,1,11,5,5,6,single-choice,spatial-relational,5|6,7,5/6,230154,5
5,4,23,155,1,765,1,13,6,6,7,single-choice,spatial-relational,6|7,7,6/7,230155,6
5,4,23,156,0,1386,1,9,4,5,5,single-choice,spatial-relational,4|5,7,4/5,230156,4
5,4,23,157,1,1201,1,11,5,5,6,single-choice,spatial-relational,5|6,7,5/6,230157,5
5,4,23,158,1,1836,1,11,5,5,6,single-choice,spatial-relational,5|6,7,5/6,230158,5
5,4,23,159,1,1037,1,5,2,2,3,single-choice,spatial-relational,2|3,7,2/3,230159,2
5,4,23,160,1,686,1,13,6,6,7,single-choice,spatial-relational,6|7,7,6/7,230160,6
5,4,23,161,1,869,1,7,3,3,4,single-choice,spatial-relational,3|4,7,3/4,230161,3
5,4,23,162,1,794,1,3,1,1,2,single-choice,spatial-relational,1|2,7,1/2,230162,1
5,4,23,163,1,745,1,13,6,6,7,single-choice,spatial-relational,6|7,7,6/7,230163,6
5,4,23,164,1,787,1,5,2,2,3,single-choice,spatial-relational,2|3,7,2/3,230164,2
5,4,23,165,1,1368,1,9,4,4,5,single-choice,spatial-relational,4|5,7,4/5,230165,4
5,4,23,166,1,1011,1,3,1,1,2,single-choice,spatial-relational,1|2,7,1/2,230166,1
5,4,23,167,1,1185,1,9,4,4,5,single-choice,spatial-relational,4|5,7,4/5,230167,4
5,4,23,168,1,1043,1,7,3,3,4,single-choice,spatial-relational,3|4,7,3/4,230168,3
5,4,23,169,1,1376,1,11,5,5,6,single-choice,spatial-relational,5|6,7,5/6,230169,5
5,4,23,170,1,1262,1,7,3,3,4,single-choice,spatial-relational,3|4,7,3/4,230170,3
5,4,23,171,1,758,1,13,6,6,7,single-choice,spatial-relational,6|7,7,6/7,230171,6
5,4,23,172,1,999,1,13,6,6,7,single-choice,spatial-relational,6|7,7,6/7,230172,6
5,4,23,173,0,2406,1,9,4,5,5,single-choice,spatial-relational,4|5,7,4/5,230173,4
5,4,23,174,1,410,1,5,2,2,3,single-choice,spatial-relational,2|3,7,2/3,230174,2
5,4,23,175,0,567,1,3,1,2,2,single-choice,spatial-relational,1|2,7,1/2,230175,1
5,4,23,176,0,951,1,9,4,5,5,single-choice,spatial-relational,4|5,7,4/5,230176,4
5,4,23,177,0,1219,1,11,5,6,6,single-choice,spatial-relational,5|6,7,5/6,230177,5
5,4,23,178,1,1310,1,7,3,3,4,single-choice,spatial-relational,3|4,7,3/4,230178,3
5,4,23,179,1,1083,1,5,2,2,3,single-choice,spatial-relational,2|3,7,2/3,230179,2
5,4,23,180,1,831,1,3,1,1,2,single-choice,spatial-relational,1|2,7,1/2,230180,1
5,4,23,181,1,927,1,7,3,3,4,single-choice,spatial-relational,3|4,7,3/4,230181,3
5,4,23,182,1,1139,1,5,2,2,3,single-choice,spatial-relational,2|3,7,2/3,230182,2
5,4,23,183,1,1328,1,11,5,5,6,single-choice,spatial-relational,5|6,7,5/6,230183,5
5,4,23,184,1,838,1,13,6,6,7,single-choice,spatial-relational,6|7,7,6/7,230184,6
5,4,23,185,1,1236,1,11,5,5,6,single-choice,spatial-relational,5|6,7,5/6,230185,5
5,4,23,186,1,1002,1,13,6,6,7,single-choice,spatial-relational,6|7,7,6/7,230186,6
5,4,23,187,0,2544,1,9,4,5,5,single-choice,spatial-relational,4|5,7,4/5,230187,4
5,4,23,188,1,821,1,3,1,1,2,single-choice,spatial-relational,1|2,7,1/2,230188,1
5,4,23,189,1,942,1,3,1,1,2,single-choice,spatial-relational,1|2,7,1/2,230189,1
5,4,23,190,0,1237,1,5,2,3,3,single-choice,spatial-relational,2|3,7,2/3,230190,2
5,4,23,191,1,912,1,7,3,3,4,single-choice,spatial-relational,3|4,7,3/4,230191,3
5,4,23,192,0,1516,1,9,4,5,5,single-choice,spatial-relational,4|5,7,4/5,230192,4
5,4,23,193,1,741,1,9,4,4,5,single-choice,spatial-relational,4|5,7,4/5,230193,4
5,4,23,194,0,721,1,5,2,3,3,single-choice,spatial-relational,2|3,7,2/3,230194,2
5,4,23,195,0,984,1,11,5,6,6,single-choice,spatial-relational,5|6,7,5/6,230195,5
5,4,23,196,1,745,1,13,6,6,7,single-choice,spatial-relational,6|7,7,6/7,230196,6
5,4,23,197,0,1346,1,9,4,5,5,single-choice,spatial-relational,4|5,7,4/5,230197,4
5,4,23,198,1,835,1,3,1,1,2,single-choice,spatial-relational,1|2,7,1/2,230198,1
5,4,23,199,1,896,1,11,5,5,6,single-choice,spatial-relational,5|6,7,5/6,230199,5
5,4,23,200,1,1117,1,5,2,2,3,single-choice,spatial-relational,2|3,7,2/3,230200,2
5,4,23,201,1,1098,1,3,1,1,2,single-choice,spatial-relational,1|2,7,1/2,230201,1
5,4,23,202,1,765,1,7,3,3,4,single-choice,spatial-relational,3|4,7,3/4,230202,3
5,4,23,203,0,1311,1,7,3,4,4,single-choice,spatial-relational,3|4,7,3/4,230203,3
5,4,23,204,1,702,1,13,6,6,7,single-choice,spatial-relational,6|7,7,6/7,230204,6
5,4,23,205,1,652,1,13,6,6,7,single-choice,spatial-relational,6|7,7,6/7,230205,6
5,4,23,206,1,1008,1,7,3,3,4,single-choice,spatial-relational,3|4,7,3/4,230206,3
5,4,23,207,1,663,1,5,2,2,3,single-choice,spatial-relational,2|3,7,2/3,230207,2
5,4,23,208,1,957,1,11,5,5,6,single-choice,spatial-relational,5|6,7,5/6,230208,5
5,4,23,209,1,2309,1,7,3,3,4,single-choice,spatial-relational,3|4,7,3/4,230209,3
5,4,23,210,0,834,1,9,4,5,5,single-choice,spatial-relational,4|5,7,4/5,230210,4
5,4,23,211,1,1022,1,3,1,1,2,single-choice,spatial-relational,1|2,7,1/2,230211,1
5,4,23,212,1,807,1,13,6,6,7,single-choice,spatial-relational,6|7,7,6/7,230212,6
5,4,23,213,1,707,1,3,1,1,2,single-choice,spatial-relational,1|2,7,1/2,230213,1
5,4,23,214,1,880,1,5,2,2,3,single-choice,spatial-relational,2|3,7,2/3,230214,2
5,4,23,215,1,1293,1,9,4,4,5,single-choice,spatial-relational,4|5,7,4/5,230215,4
5,4,23,216,1,1096,1,11,5,5,6,single-choice,spatial-relational,5|6,7,5/6,230216,5
5,4,23,217,1,1148,1,11,5,5,6,single-choice,spatial-relational,5|6,7,5/6,230217,5
5,4,23,218,1,906,1,13,6,6,7,single-choice,spatial-relational,6|7,7,6/7,230218,6
5,4,23,219,1,2254,1,9,4,4,5,single-choice,spatial-relational,4|5,7,4/5,230219,4
5,4,23,220,1,679,1,13,6,6,7,single-choice,spatial-relational,6|7,7,6/7,230220,6
5,4,23,221,1,1678,1,7,3,3,4,single-choice,spatial-relational,3|4,7,3/4,230221,3
5,4,23,222,1,856,1,3,1,1,2,single-choice,spatial-relational,1|2,7,1/2,230222,1
5,4,23,223,1,914,1,11,5,5,6,single-choice,spatial-relational,5|6,7,5/6,230223,5
5,4,23,224,0,993,1,3,1,2,2,single-choice,spatial-relational,1|2,7,1/2,230224,1
5,4,23,225,1,1090,1,5,2,2,3,single-choice,spatial-relational,2|3,7,2/3,230225,2
5,4,23,226,1,1881,1,5,2,2,3,single-choice,spatial-relational,2|3,7,2/3,230226,2
5,4,23,227,0,1169,1,9,4,5,5,single-choice,spatial-relational,4|5,7,4/5,230227,4
5,4,23,228,1,767,1,7,3,3,4,single-choice,spatial-relational,3|4,7,3/4,230228,3
5,4,23,229,1,977,1,11,5,5,6,single-choice,spatial-relational,5|6,7,5/6,230229,5
5,4,23,230,1,878,1,7,3,3,4,single-choice,spatial-relational,3|4,7,3/4,230230,3
5,4,23,231,1,1456,1,11,5,5,6,single-choice,spatial-relational,5|6,7,5/6,230231,5
5,4,23,232,1,1690,1,9,4,4,5,single-choice,spatial-relational,4|5,7,4/5,230232,4
5,4,23,233,1,872,1,13,6,6,7,single-choice,spatial-relational,6|7,7,6/7,230233,6
5,4,23,234,1,746,1,5,2,2,3,single-choice,spatial-relational,2|3,7,2/3,230234,2
5,4,23,235,1,1683,1,9,4,4,5,single-choice,spatial-relational,4|5,7,4/5,230235,4
5,4,23,236,1,794,1,3,1,1,2,single-choice,spatial-relational,1|2,7,1/2,230236,1
5,4,23,237,0,657,1,13,6,7,7,single-choice,spatial-relational,6|7,7,6/7,230237,6
5,4,23,238,1,387,1,5,2,2,3,single-choice,spatial-relational,2|3,7,2/3,230238,2
5,4,23,239,1,487,1,3,1,1,2,single-choice,spatial-relational,1|2,7,1/2,230239,1
5,4,23,240,1,1610,1,7,3,3,4,single-choice,spatial-relational,3|4,7,3/4,230240,3
5,4,23,241,1,1366,1,11,5,5,6,single-choice,spatial-relational,5|6,7,5/6,230241,5
5,4,23,242,1,716,1,13,6,6,7,single-choice,spatial-relational,6|7,7,6/7,230242,6
5,4,23,243,1,679,1,5,2,2,3,single-choice,spatial-relational,2|3,7,2/3,230243,2
5,4,23,244,1,893,1,7,3,3,4,single-choice,spatial-relational,3|4,7,3/4,230244,3
5,4,23,245,1,953,1,5,2,2,3,single-choice,spatial-relational,2|3,7,2/3,230245,2
5,4,23,246,1,758,1,3,1,1,2,single-choice,spatial-relational,1|2,7,1/2,230246,1
5,4,23,247,0,1186,1,9,4,5,5,single-choice,spatial-relational,4|5,7,4/5,230247,4
5,4,23,248,1,583,1,3,1,1,2,single-choice,spatial-relational,1|2,7,1/2,230248,1
5,4,23,249,1,810,1,11,5,5,6,single-choice,spatial-relational,5|6,7,5/6,230249,5
5,4,23,250,1,1207,1,9,4,4,5,single-choice,spatial-relational,4|5,7,4/5,230250,4
5,4,23,251,1,900,1,13,6,6,7,single-choice,spatial-relational,6|7,7,6/7,230251,6
5,4,23,252,1,1202,1,7,3,3,4,single-choice,spatial-relational,3|4,7,3/4,230252,3
5,4,23,253,1,907,1,5,2,2,3,single-choice,spatial-relational,2|3,7,2/3,230253,2
5,4,23,254,1,1071,1,11,5,5,6,single-choice,spatial-relational,5|6,7,5/6,230254,5
5,4,23,255,1,714,1,13,6,6,7,single-choice,spatial-relational,6|7,7,6/7,230255,6
5,4,23,256,1,1425,1,9,4,4,5,single-choice,spatial-relational,4|5,7,4/5,230256,4
5,4,23,257,1,900,1,13,6,6,7,single-choice,spatial-relational,6|7,7,6/7,230257,6
5,4,23,258,1,808,1,5,2,2,3,single-choice,spatial-relational,2|3,7,2/3,230258,2
5,4,23,259,1,931,1,9,4,4,5,single-choice,spatial-relational,4|5,7,4/5,230259,4
5,4,23,260,1,1230,1,11,5,5,6,single-choice,spatial-relational,5|6,7,5/6,230260,5
5,4,23,261,1,1168,1,7,3,3,4,single-choice,spatial-relational,3|4,7,3/4,230261,3
5,4,23,262,1,933,1,3,1,1,2,single-choice,spatial-relational,1|2,7,1/2,230262,1
5,4,23,263,1,950,1,3,1,1,2,single-choice,spatial-relational,1|2,7,1/2,230263,1
5,4,23,264,1,1077,1,7,3,3,4,single-choice,spatial-relational,3|4,7,3/4,230264,3
5,4,23,265,1,905,1,11,5,5,6,single-choice,spatial-relational,5|6,7,5/6,230265,5
5,4,23,266,1,662,1,3,1,1,2,single-choice,spatial-relational,1|2,7,1/2,230266,1
5,4,23,267,1,756,1,5,2,2,3,single-choice,spatial-relational,2|3,7,2/3,230267,2
5,4,23,268,1,781,1,3,1,1,2,single-choice,spatial-relational,1|2,7,1/2,230268,1
5,4,23,269,1,807,1,7,3,3,4,single-choice,spatial-relational,3|4,7,3/4,230269,3
5,4,23,270,1,970,1,5,2,2,3,single-choice,spatial-relational,2|3,7,2/3,230270,2
5,4,23,271,0,603,1,13,6,7,7,single-choice,spatial-relational,6|7,7,6/7,230271,6
5,4,23,272,1,4919,1,9,4,4,5,single-choice,spatial-relational,4|5,7,4/5,230272,4
5,4,23,273,0,1022,1,9,4,5,5,single-choice,spatial-relational,4|5,7,4/5,230273,4
5,4,23,274,0,562,1,13,6,7,7,single-choice,spatial-relational,6|7,7,6/7,230274,6
5,4,23,275,1,848,1,11,5,5,6,single-choice,spatial-relational,5|6,7,5/6,230275,5
5,4,23,276,1,740,1,7,3,3,4,single-choice,spatial-relational,3|4,7,3/4,230276,3
5,4,23,277,1,734,1,13,6,6,7,single-choice,spatial-relational,6|7,7,6/7,230277,6
5,4,23,278,0,1367,1,3,1,2,2,single-choice,spatial-relational,1|2,7,1/2,230278,1
5,4,23,279,1,575,1,5,2,2,3,single-choice,spatial-relational,2|3,7,2/3,230279,2
5,4,23,280,1,894,1,11,5,5,6,single-choice,spatial-relational,5|6,7,5/6,230280,5
5,4,23,281,1,1049,1,11,5,5,6,single-choice,spatial-relational,5|6,7,5/6,230281,5
5,4,23,282,0,788,1,3,1,2,2,single-choice,spatial-relational,1|2,7,1/2,230282,1
5,4,23,283,0,690,1,5,2,3,3,single-choice,spatial-relational,2|3,7,2/3,230283,2
5,4,23,284,1,841,1,9,4,4,5,single-choice,spatial-relational,4|5,7,4/5,230284,4
5,4,23,285,0,829,1,7,3,4,4,single-choice,spatial-relational,3|4,7,3/4,230285,3
5,4,23,286,1,695,1,7,3,3,4,single-choice,spatial-relational,3|4,7,3/4,230286,3
5,4,23,287,1,787,1,13,6,6,7,single-choice,spatial-relational,6|7,7,6/7,230287,6
5,4,23,288,0,901,1,9,4,5,5,single-choice,spatial-relational,4|5,7,4/5,230288,4
5,4,23,289,1,1061,1,11,5,5,6,single-choice,spatial-relational,5|6,7,5/6,230289,5
5,4,23,290,0,1404,1,9,4,5,5,single-choice,spatial-relational,4|5,7,4/5,230290,4
5,4,23,291,1,1005,1,7,3,3,4,single-choice,spatial-relational,3|4,7,3/4,230291,3
5,4,23,292,1,855,1,5,2,2,3,single-choice,spatial-relational,2|3,7,2/3,230292,2
5,4,23,293,1,1037,1,5,2,2,3,single-choice,spatial-relational,2|3,7,2/3,230293,2
5,4,23,294,0,1193,1,9,4,5,5,single-choice,spatial-relational,4|5,7,4/5,230294,4
5,4,23,295,1,753,1,7,3,3,4,single-choice,spatial-relational,3|4,7,3/4,230295,3
5,4,23,296,1,680,1,13,6,6,7,single-choice,spatial-relational,6|7,7,6/7,230296,6
5,4,23,297,1,857,1,13,6,6,7,single-choice,spatial-relational,6|7,7,6/7,230297,6
5,4,23,298,0,910,1,3,1,2,2,single-choice,spatial-relational,1|2,7,1/2,230298,1
5,4,23,299,1,726,1,11,5,5,6,single-choice,spatial-relational,5|6,7,5/6,230299,5
5,4,23,300,1,1230,1,3,1,1,2,single-choice,spatial-relational,1|2,7,1/2,230300,1
5,4,23,301,1,811,1,7,3,3,4,single-choice,spatial-relational,3|4,7,3/4,230301,3
5,4,23,302,0,1809,1,3,1,2,2,single-choice,spatial-relational,1|2,7,1/2,230302,1
5,4,23,303,1,1486,1,11,5,5,6,single-choice,spatial-relational,5|6,7,5/6,230303,5
5,4,23,304,1,1051,1,3,1,1,2,single-choice,spatial-relational,1|2,7,1/2,230304,1
5,4,23,305,1,1408,1,5,2,2,3,single-choice,spatial-relational,2|3,7,2/3,230305,2
5,4,23,306,1,1063,1,13,6,6,7,single-choice,spatial-relational,6|7,7,6/7,230306,6
5,4,23,307,1,1388,1,9,4,4,5,single-choice,spatial-relational,4|5,7,4/5,230307,4
5,4,23,308,0,1299,1,9,4,5,5,single-choice,spatial-relational,4|5,7,4/5,230308,4
5,4,23,309,1,649,1,13,6,6,7,single-choice,spatial-relational,6|7,7,6/7,230309,6
5,4,23,310,1,1307,1,7,3,3,4,single-choice,spatial-relational,3|4,7,3/4,230310,3
5,4,23,311,1,1227,1,11,5,5,6,single-choice,spatial-relational,5|6,7,5/6,230311,5
5,4,23,312,1,1112,1,5,2,2,3,single-choice,spatial-relational,2|3,7,2/3,230312,2
5,4,23,313,1,1139,1,9,4,4,5,single-choice,spatial-relational,4|5,7,4/5,230313,4
5,4,23,314,1,1131,1,5,2,2,3,single-choice,spatial-relational,2|3,7,2/3,230314,2
5,4,23,315,1,1187,1,11,5,5,6,single-choice,spatial-relational,5|6,7,5/6,230315,5
5,4,23,316,1,1292,1,9,4,4,5,single-choice,spatial-relational,4|5,7,4/5,230316,4
5,4,23,317,1,1129,1,11,5,5,6,single-choice,spatial-relational,5|6,7,5/6,230317,5
5,4,23,318,1,1942,1,7,3,3,4,single-choice,spatial-relational,3|4,7,3/4,230318,3
5,4,23,319,1,925,1,5,2,2,3,single-choice,spatial-relational,2|3,7,2/3,230319,2
5,4,23,320,1,882,1,3,1,1,2,single-choice,spatial-relational,1|2,7,1/2,230320,1
5,4,23,321,1,876,1,3,1,1,2,single-choice,spatial-relational,1|2,7,1/2,230321,1
5,4,23,322,1,758,1,7,3,3,4,single-choice,spatial-relational,3|4,7,3/4,230322,3
5,4,23,323,1,942,1,13,6,6,7,single-choice,spatial-relational,6|7,7,6/7,230323,6
5,4,23,324,1,641,1,13,6,6,7,single-choice,spatial-relational,6|7,7,6/7,230324,6
5,4,23,325,1,736,1,5,2,2,3,single-choice,spatial-relational,2|3,7,2/3,230325,2
5,4,23,326,1,975,1,7,3,3,4,single-choice,spatial-relational,3|4,7,3/4,230326,3
5,4,23,327,1,1192,1,3,1,1,2,single-choice,spatial-relational,1|2,7,1/2,230327,1
5,4,23,328,1,4209,1,13,6,6,7,single-choice,spatial-relational,6|7,7,6/7,230328,6
5,4,23,329,1,1207,1,9,4,4,5,single-choice,spatial-relational,4|5,7,4/5,230329,4
5,4,23,330,1,949,1,11,5,5,6,single-choice,spatial-relational,5|6,7,5/6,230330,5
5,4,23,331,1,1008,1,3,1,1,2,single-choice,spatial-relational,1|2,7,1/2,230331,1
5,4,23,332,1,598,1,7,3,3,4,single-choice,spatial-relational,3|4,7,3/4,230332,3
5,4,23,333,1,938,1,9,4,4,5,single-choice,spatial-relational,4|5,7,4/5,230333,4
5,4,23,334,1,974,1,5,2,2,3,single-choice,spatial-relational,2|3,7,2/3,230334,2
5,4,23,335,1,1020,1,11,5,5,6,single-choice,spatial-relational,5|6,7,5/6,230335,5
5,4,23,336,1,871,1,13,6,6,7,single-choice,spatial-relational,6|7,7,6/7,230336,6
5,4,23,337,1,1120,1,9,4,4,5,single-choice,spatial-relational,4|5,7,4/5,230337,4
5,4,23,338,1,1049,1,11,5,5,6,single-choice,spatial-relational,5|6,7,5/6,230338,5
5,4,23,339,1,841,1,13,6,6,7,single-choice,spatial-relational,6|7,7,6/7,230339,6
5,4,23,340,0,670,1,5,2,3,3,single-choice,spatial-relational,2|3,7,2/3,230340,2
5,4,23,341,1,542,1,3,1,1,2,single-choice,spatial-relational,1|2,7,1/2,230341,1
5,4,23,342,0,1772,1,3,1,2,2,single-choice,spatial-relational,1|2,7,1/2,230342,1
5,4,23,343,1,923,1,7,3,3,4,single-choice,spatial-relational,3|4,7,3/4,230343,3
5,4,23,344,1,891,1,5,2,2,3,single-choice,spatial-relational,2|3,7,2/3,230344,2
5,4,23,345,1,1110,1,11,5,5,6,single-choice,spatial-relational,5|6,7,5/6,230345,5
5,4,23,346,1,1187,1,9,4,4,5,single-choice,spatial-relational,4|5,7,4/5,230346,4
5,4,23,347,1,647,1,13,6,6,7,single-choice,spatial-relational,6|7,7,6/7,230347,6
5,4,23,348,1,1479,1,7,3,3,4,single-choice,spatial-relational,3|4,7,3/4,230348,3
5,4,23,349,0,1063,1,9,4,5,5,single-choice,spatial-relational,4|5,7,4/5,230349,4
5,4,23,350,0,815,1,9,4,5,5,single-choice,spatial-relational,4|5,7,4/5,230350,4
5,4,23,351,1,835,1,5,2,2,3,single-choice,spatial-relational,2|3,7,2/3,230351,2
5,4,23,352,1,925,1,13,6,6,7,single-choice,spatial-relational,6|7,7,6/7,230352,6
5,4,23,353,1,714,1,13,6,6,7,single-choice,spatial-relational,6|7,7,6/7,230353,6
5,4,23,354,0,1346,1,3,1,2,2,single-choice,spatial-relational,1|2,7,1/2,230354,1
5,4,23,355,1,1015,1,11,5,5,6,single-choice,spatial-relational,5|6,7,5/6,230355,5
5,4,23,356,1,1344,1,5,2,2,3,single-choice,spatial-relational,2|3,7,2/3,230356,2
5,4,23,357,1,1161,1,11,5,5,6,single-choice,spatial-relational,5|6,7,5/6,230357,5
5,4,23,358,1,1124,1,7,3,3,4,single-choice,spatial-relational,3|4,7,3/4,230358,3
5,4,23,359,1,1192,1,3,1,1,2,single-choice,spatial-relational,1|2,7,1/2,230359,1
5,4,23,360,1,698,1,7,3,3,4,single-choice,spatial-relational,3|4,7,3/4,230360,3
5,4,23,361,1,895,1,5,2,2,3,single-choice,spatial-relational,2|3,7,2/3,230361,2
5,4,23,362,1,1204,1,3,1,1,2,single-choice,spatial-relational,1|2,7,1/2,230362,1
5,4,23,363,1,1131,1,7,3,3,4,single-choice,spatial-relational,3|4,7,3/4,230363,3
5,4,23,364,1,1008,1,11,5,5,6,single-choice,spatial-relational,5|6,7,5/6,230364,5
5,4,23,365,0,779,1,13,6,7,7,single-choice,spatial-relational,6|7,7,6/7,230365,6
5,4,23,366,0,1406,1,9,4,5,5,single-choice,spatial-relational,4|5,7,4/5,230366,4
5,4,23,367,0,679,1,3,1,2,2,single-choice,spatial-relational,1|2,7,1/2,230367,1
5,4,23,368,0,762,1,9,4,5,5,single-choice,spatial-relational,4|5,7,4/5,230368,4
5,4,23,369,0,838,1,11,5,6,6,single-choice,spatial-relational,5|6,7,5/6,230369,5
5,4,23,370,1,827,1,5,2,2,3,single-choice,spatial-relational,2|3,7,2/3,230370,2
5,4,23,371,1,871,1,7,3,3,4,single-choice,spatial-relational,3|4,7,3/4,230371,3
5,4,23,372,1,1023,1,13,6,6,7,single-choice,spatial-relational,6|7,7,6/7,230372,6
5,4,23,373,1,1200,1,11,5,5,6,single-choice,spatial-relational,5|6,7,5/6,230373,5
5,4,23,374,0,1116,1,9,4,5,5,single-choice,spatial-relational,4|5,7,4/5,230374,4
5,4,23,375,1,1379,1,11,5,5,6,single-choice,spatial-relational,5|6,7,5/6,230375,5
5,4,23,376,1,961,1,13,6,6,7,single-choice,spatial-relational,6|7,7,6/7,230376,6
5,4,23,377,1,1487,1,9,4,4,5,single-choice,spatial-relational,4|5,7,4/5,230377,4
5,4,23,378,1,900,1,13,6,6,7,single-choice,spatial-relational,6|7,7,6/7,230378,6
5,4,23,379,1,1169,1,7,3,3,4,single-choice,spatial-relational,3|4,7,3/4,230379,3
5,4,23,380,1,1365,1,7,3,3,4,single-choice,spatial-relational,3|4,7,3/4,230380,3
5,4,23,381,1,1170,1,3,1,1,2,single-choice,spatial-relational,1|2,7,1/2,230381,1
5,4,23,382,1,809,1,5,2,2,3,single-choice,spatial-relational,2|3,7,2/3,230382,2
5,4,23,383,1,1081,1,3,1,1,2,single-choice,spatial-relational,1|2,7,1/2,230383,1
5,4,23,384,0,962,1,5,2,3,3,single-choice,spatial-relational,2|3,7,2/3,230384,2
5,4,23,385,0,629,1,3,1,2,2,single-choice,spatial-relational,1|2,7,1/2,230385,1
5,4,23,386,1,1024,1,7,3,3,4,single-choice,spatial-relational,3|4,7,3/4,230386,3
5,4,23,387,1,928,1,5,2,2,3,single-choice,spatial-relational,2|3,7,2/3,230387,2
5,4,23,388,1,1219,1,11,5,5,6,single-choice,spatial-relational,5|6,7,5/6,230388,5
5,4,23,389,1,990,1,11,5,5,6,single-choice,spatial-relational,5|6,7,5/6,230389,5
5,4,23,390,1,33065,1,7,3,3,4,single-choice,spatial-relational,3|4,7,3/4,230390,3
5,4,23,391,0,554,1,9,4,5,5,single-choice,spatial-relational,4|5,7,4/5,230391,4
5,4,23,392,1,579,1,3,1,1,2,single-choice,spatial-relational,1|2,7,1/2,230392,1
5,4,23,393,1,754,1,13,6,6,7,single-choice,spatial-relational,6|7,7,6/7,230393,6
5,4,23,394,1,808,1,5,2,2,3,single-choice,spatial-relational,2|3,7,2/3,230394,2
5,4,23,395,1,914,1,13,6,6,7,single-choice,spatial-relational,6|7,7,6/7,230395,6
5,4,23,396,0,1059,1,9,4,5,5,single-choice,spatial-relational,4|5,7,4/5,230396,4
5,4,23,397,1,646,1,13,6,6,7,single-choice,spatial-relational,6|7,7,6/7,230397,6
5,4,23,398,1,797,1,13,6,6,7,single-choice,spatial-relational,6|7,7,6/7,230398,6
5,4,23,399,1,742,1,7,3,3,4,single-choice,spatial-relational,3|4,7,3/4,230399,3
5,4,23,400,1,1167,1,11,5,5,6,single-choice,spatial-relational,5|6,7,5/6,230400,5
5,4,23,401,1,1311,1,9,4,4,5,single-choice,spatial-relational,4|5,7,4/5,230401,4
5,4,23,402,0,1277,1,9,4,5,5,single-choice,spatial-relational,4|5,7,4/5,230402,4
5,4,23,403,1,943,1,5,2,2,3,single-choice,spatial-relational,2|3,7,2/3,230403,2
5,4,23,404,0,639,1,3,1,2,2,single-choice,spatial-relational,1|2,7,1/2,230404,1
5,4,23,405,1,1057,1,5,2,2,3,single-choice,spatial-relational,2|3,7,2/3,230405,2
5,4,23,406,1,947,1,11,5,5,6,single-choice,spatial-relational,5|6,7,5/6,230406,5
5,4,23,407,1,1181,1,7,3,3,4,single-choice,spatial-relational,3|4,7,3/4,230407,3
5,4,23,408,1,1271,1,3,1,1,2,single-choice,spatial-relational,1|2,7,1/2,230408,1
5,4,23,409,1,692,1,7,3,3,4,single-choice,spatial-relational,3|4,7,3/4,230409,3
5,4,23,410,1,709,1,13,6,6,7,single-choice,spatial-relational,6|7,7,6/7,230410,6
5,4,23,411,0,1527,1,11,5,6,6,single-choice,spatial-relational,5|6,7,5/6,230411,5
5,4,23,412,1,833,1,9,4,4,5,single-choice,spatial-relational,4|5,7,4/5,230412,4
5,4,23,413,1,914,1,5,2,2,3,single-choice,spatial-relational,2|3,7,2/3,230413,2
5,4,23,414,1,844,1,5,2,2,3,single-choice,spatial-relational,2|3,7,2/3,230414,2
5,4,23,415,1,969,1,11,5,5,6,single-choice,spatial-relational,5|6,7,5/6,230415,5
5,4,23,416,1,961,1,3,1,1,2,single-choice,spatial-relational,1|2,7,1/2,230416,1
5,4,23,417,1,681,1,13,6,6,7,single-choice,spatial-relational,6|7,7,6/7,230417,6
5,4,23,418,0,761,1,3,1,2,2,single-choice,spatial-relational,1|2,7,1/2,230418,1
5,4,23,419,0,634,1,9,4,5,5,single-choice,spatial-relational,4|5,7,4/5,230419,4
5,4,23,420,1,1455,1,7,3,3,4,single-choice,spatial-relational,3|4,7,3/4,230420,3
5,4,23,421,1,862,1,7,3,3,4,single-choice,spatial-relational,3|4,7,3/4,230421,3
5,4,23,422,1,1298,1,5,2,2,3,single-choice,spatial-relational,2|3,7,2/3,230422,2
5,4,23,423,0,1016,1,11,5,6,6,single-choice,spatial-relational,5|6,7,5/6,230423,5
5,4,23,424,1,755,1,5,2,2,3,single-choice,spatial-relational,2|3,7,2/3,230424,2
5,4,23,425,1,680,1,13,6,6,7,single-choice,spatial-relational,6|7,7,6/7,230425,6
5,4,23,426,1,1160,1,9,4,4,5,single-choice,spatial-relational,4|5,7,4/5,230426,4
5,4,23,427,1,1070,1,3,1,1,2,single-choice,spatial-relational,1|2,7,1/2,230427,1
5,4,23,428,1,826,1,13,6,6,7,single-choice,spatial-relational,6|7,7,6/7,230428,6
5,4,23,429,0,1015,1,3,1,2,2,single-choice,spatial-relational,1|2,7,1/2,230429,1
5,4,23,430,1,934,1,9,4,4,5,single-choice,spatial-relational,4|5,7,4/5,230430,4
5,4,23,431,1,751,1,7,3,3,4,single-choice,spatial-relational,3|4,7,3/4,230431,3
5,4,23,432,1,1314,1,11,5,5,6,single-choice,spatial-relational,5|6,7,5/6,230432,5
5,4,23,433,1,1735,1,11,5,5,6,single-choice,spatial-relational,5|6,7,5/6,230433,5
5,4,23,434,1,1011,1,11,5,5,6,single-choice,spatial-relational,5|6,7,5/6,230434,5
5,4,23,435,1,1012,1,3,1,1,2,single-choice,spatial-relational,1|2,7,1/2,230435,1
5,4,23,436,1,1190,1,9,4,4,5,single-choice,spatial-relational,4|5,7,4/5,230436,4
5,4,23,437,0,930,1,9,4,5,5,single-choice,spatial-relational,4|5,7,4/5,230437,4
5,4,23,438,1,1409,1,7,3,3,4,single-choice,spatial-relational,3|4,7,3/4,230438,3
5,4,23,439,1,709,1,5,2,2,3,single-choice,spatial-relational,2|3,7,2/3,230439,2
5,4,23,440,0,406,1,7,3,4,4,single-choice,spatial-relational,3|4,7,3/4,230440,3
5,4,23,441,1,690,1,13,6,6,7,single-choice,spatial-relational,6|7,7,6/7,230441,6
5,4,23,442,1,765,1,13,6,6,7,single-choice,spatial-relational,6|7,7,6/7,230442,6
5,4,23,443,1,1299,1,5,2,2,3,single-choice,spatial-relational,2|3,7,2/3,230443,2
5,4,23,444,1,1187,1,3,1,1,2,single-choice,spatial-relational,1|2,7,1/2,230444,1
5,4,23,445,1,733,1,7,3,3,4,single-choice,spatial-relational,3|4,7,3/4,230445,3
5,4,23,446,1,894,1,13,6,6,7,single-choice,spatial-relational,6|7,7,6/7,230446,6
5,4,23,447,1,758,1,7,3,3,4,single-choice,spatial-relational,3|4,7,3/4,230447,3
5,4,23,448,0,1001,1,9,4,5,5,single-choice,spatial-relational,4|5,7,4/5,230448,4
5,4,23,449,0,605,1,11,5,6,6,single-choice,spatial-relational,5|6,7,5/6,230449,5
5,4,23,450,0,48,1,9,4,5,5,single-choice,spatial-relational,4|5,7,4/5,230450,4
5,4,23,451,0,643,1,3,1,2,2,single-choice,spatial-relational,1|2,7,1/2,230451,1
5,4,23,452,1,1068,1,11,5,5,6,single-choice,spatial-relational,5|6,7,5/6,230452,5
5,4,23,453,1,765,1,13,6,6,7,single-choice,spatial-relational,6|7,7,6/7,230453,6
5,4,23,454,1,968,1,5,2,2,3,single-choice,spatial-relational,2|3,7,2/3,230454,2
5,4,23,455,1,1069,1,5,2,2,3,single-choice,spatial-relational,2|3,7,2/3,230455,2
5,4,23,456,1,919,1,3,1,1,2,single-choice,spatial-relational,1|2,7,1/2,230456,1
5,4,23,457,1,781,1,11,5,5,6,single-choice,spatial-relational,5|6,7,5/6,230457,5
5,4,23,458,1,890,1,3,1,1,2,single-choice,spatial-relational,1|2,7,1/2,230458,1
5,4,23,459,1,714,1,13,6,6,7,single-choice,spatial-relational,6|7,7,6/7,230459,6
5,4,23,460,1,1265,1,3,1,1,2,single-choice,spatial-relational,1|2,7,1/2,230460,1
5,4,23,461,1,985,1,5,2,2,3,single-choice,spatial-relational,2|3,7,2/3,230461,2
5,4,23,462,1,950,1,5,2,2,3,single-choice,spatial-relational,2|3,7,2/3,230462,2
5,4,23,463,1,904,1,11,5,5,6,single-choice,spatial-relational,5|6,7,5/6,230463,5
5,4,23,464,1,1280,1,9,4,4,5,single-choice,spatial-relational,4|5,7,4/5,230464,4
5,4,23,465,1,915,1,13,6,6,7,single-choice,spatial-relational,6|7,7,6/7,230465,6
5,4,23,466,0,1240,1,7,3,4,4,single-choice,spatial-relational,3|4,7,3/4,230466,3
5,4,23,467,0,827,1,9,4,5,5,single-choice,spatial-relational,4|5,7,4/5,230467,4
5,4,23,468,0,20321,1,7,3,4,4,single-choice,spatial-relational,3|4,7,3/4,230468,3
5,4,23,469,1,495,1,13,6,6,7,single-choice,spatial-relational,6|7,7,6/7,230469,6
5,4,23,470,0,403,1,7,3,4,4,single-choice,spatial-relational,3|4,7,3/4,230470,3
5,4,23,471,1,1177,1,9,4,4,5,single-choice,spatial-relational,4|5,7,4/5,230471,4
5,4,23,472,1,1055,1,5,2,2,3,single-choice,spatial-relational,2|3,7,2/3,230472,2
5,4,23,473,0,847,1,9,4,5,5,single-choice,spatial-relational,4|5,7,4/5,230473,4
5,4,23,474,1,882,1,5,2,2,3,single-choice,spatial-relational,2|3,7,2/3,230474,2
5,4,23,475,1,774,1,3,1,1,2,single-choice,spatial-relational,1|2,7,1/2,230475,1
5,4,23,476,1,657,1,13,6,6,7,single-choice,spatial-relational,6|7,7,6/7,230476,6
5,4,23,477,0,973,1,3,1,2,2,single-choice,spatial-relational,1|2,7,1/2,230477,1
5,4,23,478,1,953,1,11,5,5,6,single-choice,spatial-relational,5|6,7,5/6,230478,5
5,4,23,479,1,1029,1,7,3,3,4,single-choice,spatial-relational,3|4,7,3/4,230479,3
5,4,23,480,1,1281,1,11,5,5,6,single-choice,spatial-relational,5|6,7,5/6,230480,5
5,4,23,481,0,899,1,13,6,7,7,single-choice,spatial-relational,6|7,7,6/7,230481,6
5,4,23,482,1,675,1,11,5,5,6,single-choice,spatial-relational,5|6,7,5/6,230482,5
5,4,23,483,1,1381,1,3,1,1,2,single-choice,spatial-relational,1|2,7,1/2,230483,1
5,4,23,484,1,1018,1,9,4,4,5,single-choice,spatial-relational,4|5,7,4/5,230484,4
5,4,23,485,1,773,1,13,6,6,7,single-choice,spatial-relational,6|7,7,6/7,230485,6
5,4,23,486,1,1553,1,11,5,5,6,single-choice,spatial-relational,5|6,7,5/6,230486,5
5,4,23,487,1,1125,1,7,3,3,4,single-choice,spatial-relational,3|4,7,3/4,230487,3
5,4,23,488,1,1100,1,9,4,4,5,single-choice,spatial-relational,4|5,7,4/5,230488,4
5,4,23,489,1,779,1,7,3,3,4,single-choice,spatial-relational,3|4,7,3/4,230489,3
5,4,23,490,1,838,1,5,2,2,3,single-choice,spatial-relational,2|3,7,2/3,230490,2
5,4,23,491,1,770,1,5,2,2,3,single-choice,spatial-relational,2|3,7,2/3,230491,2
5,4,23,492,1,813,1,3,1,1,2,single-choice,spatial-relational,1|2,7,1/2,230492,1
5,4,23,493,1,1068,1,5,2,2,3,single-choice,spatial-relational,2|3,7,2/3,230493,2
5,4,23,494,1,754,1,3,1,1,2,single-choice,spatial-relational,1|2,7,1/2,230494,1
5,4,23,495,1,945,1,7,3,3,4,single-choice,spatial-relational,3|4,7,3/4,230495,3
5,4,23,496,1,948,1,11,5,5,6,single-choice,spatial-relational,5|6,7,5/6,230496,5
5,4,23,497,1,722,1,13,6,6,7,single-choice,spatial-relational,6|7,7,6/7,230497,6
5,4,23,498,0,1258,1,9,4,5,5,single-choice,spatial-relational,4|5,7,4/5,230498,4
5,4,23,499,0,20,1,3,1,2,2,single-choice,spatial-relational,1|2,7,1/2,230499,1
5,4,23,500,1,772,1,5,2,2,3,single-choice,spatial-relational,2|3,7,2/3,230500,2
5,4,23,501,0,880,1,7,3,4,4,single-choice,spatial-relational,3|4,7,3/4,230501,3
5,4,23,502,1,1248,1,13,6,6,7,single-choice,spatial-relational,6|7,7,6/7,230502,6
5,4,23,503,1,930,1,11,5,5,6,single-choice,spatial-relational,5|6,7,5/6,230503,5
5,4,23,504,0,1626,1,9,4,5,5,single-choice,spatial-relational,4|5,7,4/5,230504,4
5,4,23,505,0,721,1,7,3,4,4,single-choice,spatial-relational,3|4,7,3/4,230505,3
5,4,23,506,0,863,1,7,3,4,4,single-choice,spatial-relational,3|4,7,3/4,230506,3
5,4,23,507,0,232,1,9,4,5,5,single-choice,spatial-relational,4|5,7,4/5,230507,4
5,4,23,508,1,845,1,13,6,6,7,single-choice,spatial-relational,6|7,7,6/7,230508,6
5,4,23,509,1,835,1,3,1,1,2,single-choice,spatial-relational,1|2,7,1/2,230509,1
5,4,23,510,1,781,1,11,5,5,6,single-choice,spatial-relational,5|6,7,5/6,230510,5
5,4,23,511,1,1158,1,11,5,5,6,single-choice,spatial-relational,5|6,7,5/6,230511,5
5,4,23,512,1,1288,1,3,1,1,2,single-choice,spatial-relational,1|2,7,1/2,230512,1
5,4,23,513,1,1065,1,5,2,2,3,single-choice,spatial-relational,2|3,7,2/3,230513,2
5,4,23,514,0,1766,1,5,2,3,3,single-choice,spatial-relational,2|3,7,2/3,230514,2
5,4,23,515,1,865,1,9,4,4,5,single-choice,spatial-relational,4|5,7,4/5,230515,4
5,4,23,516,1,726,1,13,6,6,7,single-choice,spatial-relational,6|7,7,6/7,230516,6
5,4,23,517,1,1000,1,13,6,6,7,single-choice,spatial-relational,6|7,7,6/7,230517,6
5,4,23,518,1,1077,1,11,5,5,6,single-choice,spatial-relational,5|6,7,5/6,230518,5
5,4,23,519,1,853,1,11,5,5,6,single-choice,spatial-relational,5|6,7,5/6,230519,5
5,4,23,520,1,863,1,13,6,6,7,single-choice,spatial-relational,6|7,7,6/7,230520,6
5,4,23,521,1,1055,1,7,3,3,4,single-choice,spatial-relational,3|4,7,3/4,230521,3
5,4,23,522,0,1255,1,9,4,5,5,single-choice,spatial-relational,4|5,7,4/5,230522,4
5,4,23,523,1,613,1,3,1,1,2,single-choice,spatial-relational,1|2,7,1/2,230523,1
5,4,23,524,1,1050,1,5,2,2,3,single-choice,spatial-relational,2|3,7,2/3,230524,2
5,4,23,525,1,1249,1,7,3,3,4,single-choice,spatial-relational,3|4,7,3/4,230525,3
5,4,23,526,1,1352,1,9,4,4,5,single-choice,spatial-relational,4|5,7,4/5,230526,4
5,4,23,527,1,961,1,5,2,2,3,single-choice,spatial-relational,2|3,7,2/3,230527,2
5,4,23,528,1,795,1,3,1,1,2,single-choice,spatial-relational,1|2,7,1/2,230528,1
5,4,23,529,1,624,1,5,2,2,3,single-choice,spatial-relational,2|3,7,2/3,230529,2
5,4,23,530,0,812,1,9,4,5,5,single-choice,spatial-relational,4|5,7,4/5,230530,4
5,4,23,531,1,1097,1,11,5,5,6,single-choice,spatial-relational,5|6,7,5/6,230531,5
5,4,23,532,1,821,1,3,1,1,2,single-choice,spatial-relational,1|2,7,1/2,230532,1
5,4,23,533,1,1161,1,3,1,1,2,single-choice,spatial-relational,1|2,7,1/2,230533,1
5,4,23,534,1,1371,1,7,3,3,4,single-choice,spatial-relational,3|4,7,3/4,230534,3
5,4,23,535,1,967,1,5,2,2,3,single-choice,spatial-relational,2|3,7,2/3,230535,2
5,4,23,536,1,817,1,13,6,6,7,single-choice,spatial-relational,6|7,7,6/7,230536,6
5,4,23,537,1,998,1,11,5,5,6,single-choice,spatial-relational,5|6,7,5/6,230537,5
5,4,23,538,1,1653,1,9,4,4,5,single-choice,spatial-relational,4|5,7,4/5,230538,4
5,4,23,539,1,775,1,13,6,6,7,single-choice,spatial-relational,6|7,7,6/7,230539,6
5,4,23,540,1,2489,1,7,3,3,4,single-choice,spatial-relational,3|4,7,3/4,230540,3
5,4,23,541,1,940,1,11,5,5,6,single-choice,spatial-relational,5|6,7,5/6,230541,5
5,4,23,542,1,1037,1,11,5,5,6,single-choice,spatial-relational,5|6,7,5/6,230542,5
5,4,23,543,1,882,1,13,6,6,7,single-choice,spatial-relational,6|7,7,6/7,230543,6
5,4,23,544,1,991,1,5,2,2,3,single-choice,spatial-relational,2|3,7,2/3,230544,2
5,4,23,545,1,1025,1,5,2,2,3,single-choice,spatial-relational,2|3,7,2/3,230545,2
5,4,23,546,1,732,1,7,3,3,4,single-choice,spatial-relational,3|4,7,3/4,230546,3
5,4,23,547,0,675,1,3,1,2,2,single-choice,spatial-relational,1|2,7,1/2,230547,1
5,4,23,548,0,644,1,9,4,5,5,single-choice,spatial-relational,4|5,7,4/5,230548,4
5,4,23,549,0,574,1,3,1,2,2,single-choice,spatial-relational,1|2,7,1/2,230549,1
5,4,23,550,1,779,1,7,3,3,4,single-choice,spatial-relational,3|4,7,3/4,230550,3
5,4,23,551,0,1282,1,9,4,5,5,single-choice,spatial-relational,4|5,7,4/5,230551,4
5,4,23,552,1,650,1,13,6,6,7,single-choice,spatial-relational,6|7,7,6/7,230552,6
5,4,23,553,0,1567,1,9,4,5,5,single-choice,spatial-relational,4|5,7,4/5,230553,4
5,4,23,554,1,803,1,11,5,5,6,single-choice,spatial-relational,5|6,7,5/6,230554,5
5,4,23,555,1,994,1,11,5,5,6,single-choice,spatial-relational,5|6,7,5/6,230555,5
5,4,23,556,1,949,1,13,6,6,7,single-choice,spatial-relational,6|7,7,6/7,230556,6
5,4,23,557,1,658,1,13,6,6,7,single-choice,spatial-relational,6|7,7,6/7,230557,6
5,4,23,558,1,1076,1,7,3,3,4,single-choice,spatial-relational,3|4,7,3/4,230558,3
5,4,23,559,1,861,1,5,2,2,3,single-choice,spatial-relational,2|3,7,2/3,230559,2
5,4,23,560,1,844,1,3,1,1,2,single-choice,spatial-relational,1|2,7,1/2,230560,1
5,4,23,561,1,911,1,3,1,1,2,single-choice,spatial-relational,1|2,7,1/2,230561,1
5,4,23,562,1,757,1,7,3,3,4,single-choice,spatial-relational,3|4,7,3/4,230562,3
5,4,23,563,1,1170,1,5,2,2,3,single-choice,spatial-relational,2|3,7,2/3,230563,2
5,4,23,564,0,768,1,9,4,5,5,single-choice,spatial-relational,4|5,7,4/5,230564,4
5,4,23,565,1,720,1,9,4,4,5,single-choice,spatial-relational,4|5,7,4/5,230565,4
5,4,23,566,1,677,1,13,6,6,7,single-choice,spatial-relational,6|7,7,6/7,230566,6
5,4,23,567,1,882,1,3,1,1,2,single-choice,spatial-relational,1|2,7,1/2,230567,1
5,4,23,568,0,1152,1,3,1,2,2,single-choice,spatial-relational,1|2,7,1/2,230568,1
5,4,23,569,0,626,1,7,3,4,4,single-choice,spatial-relational,3|4,7,3/4,230569,3
5,4,23,570,1,816,1,5,2,2,3,single-choice,spatial-relational,2|3,7,2/3,230570,2
5,4,23,571,1,622,1,5,2,2,3,single-choice,spatial-relational,2|3,7,2/3,230571,2
5,4,23,572,1,965,1,11,5,5,6,single-choice,spatial-relational,5|6,7,5/6,230572,5
5,4,23,573,1,1080,1,7,3,3,4,single-choice,spatial-relational,3|4,7,3/4,230573,3
5,4,23,574,1,1541,1,11,5,5,6,single-choice,spatial-relational,5|6,7,5/6,230574,5
5,4,23,575,1,940,1,13,6,6,7,single-choice,spatial-relational,6|7,7,6/7,230575,6
5,4,23,576,1,1476,1,9,4,4,5,single-choice,spatial-relational,4|5,7,4/5,230576,4
5,4,23,577,1,883,1,11,5,5,6,single-choice,spatial-relational,5|6,7,5/6,230577,5
5,4,23,578,1,935,1,7,3,3,4,single-choice,spatial-relational,3|4,7,3/4,230578,3
5,4,23,579,1,569,1,3,1,1,2,single-choice,spatial-relational,1|2,7,1/2,230579,1
5,4,23,580,0,527,1,9,4,5,5,single-choice,spatial-relational,4|5,7,4/5,230580,4
5,4,23,581,1,908,1,5,2,2,3,single-choice,spatial-relational,2|3,7,2/3,230581,2
5,4,23,582,1,701,1,13,6,6,7,single-choice,spatial-relational,6|7,7,6/7,230582,6
5,4,23,583,1,828,1,5,2,2,3,single-choice,spatial-relational,2|3,7,2/3,230583,2
5,4,23,584,1,632,1,13,6,6,7,single-choice,spatial-relational,6|7,7,6/7,230584,6
5,4,23,585,1,934,1,7,3,3,4,single-choice,spatial-relational,3|4,7,3/4,230585,3
5,4,23,586,1,821,1,3,1,1,2,single-choice,spatial-relational,1|2,7,1/2,230586,1
5,4,23,587,1,1016,1,11,5,5,6,single-choice,spatial-relational,5|6,7,5/6,230587,5
5,4,23,588,1,2128,1,9,4,4,5,single-choice,spatial-relational,4|5,7,4/5,230588,4
5,4,23,589,1,1026,1,11,5,5,6,single-choice,spatial-relational,5|6,7,5/6,230589,5
5,4,23,590,1,1191,1,9,4,4,5,single-choice,spatial-relational,4|5,7,4/5,230590,4
5,4,23,591,1,1232,1,9,4,4,5,single-choice,spatial-relational,4|5,7,4/5,230591,4
5,4,23,592,1,1032,1,7,3,3,4,single-choice,spatial-relational,3|4,7,3/4,230592,3
5,4,23,593,1,758,1,5,2,2,3,single-choice,spatial-relational,2|3,7,2/3,230593,2
5,4,23,594,0,851,1,3,1,2,2,single-choice,spatial-relational,1|2,7,1/2,230594,1
5,4,23,595,0,810,1,11,5,6,6,single-choice,spatial-relational,5|6,7,5/6,230595,5
5,4,23,596,0,881,1,7,3,4,4,single-choice,spatial-relational,3|4,7,3/4,230596,3
5,4,23,597,1,851,1,13,6,6,7,single-choice,spatial-relational,6|7,7,6/7,230597,6
5,4,23,598,0,973,1,3,1,2,2,single-choice,spatial-relational,1|2,7,1/2,230598,1
5,4,23,599,1,938,1,13,6,6,7,single-choice,spatial-relational,6|7,7,6/7,230599,6
5,4,23,600,1,1063,1,5,2,2,3,single-choice,spatial-relational,2|3,7,2/3,230600,2
6,4,23,1,0,1025,1,11,5,6,6,single-choice,spatial-relational,5|6,7,5/6,230001,5
6,4,23,2,1,775,1,3,1,1,2,single-choice,spatial-relational,1|2,7,1/2,230002,1
6,4,23,3,1,1076,1,11,5,5,6,single-choice,spatial-relational,5|6,7,5/6,230003,5
6,4,23,4,1,1203,1,5,2,2,3,single-choice,spatial-relational,2|3,7,2/3,230004,2
6,4,23,5,1,1011,1,9,4,4,5,single-choice,spatial-relational,4|5,7,4/5,230005,4
6,4,23,6,0,2245,1,13,6,7,7,single-choice,spatial-relational,6|7,7,6/7,230006,6
6,4,23,7,0,835,1,5,2,3,3,single-choice,spatial-relational,2|3,7,2/3,230007,2
6,4,23,8,1,834,1,7,3,3,4,single-choice,spatial-relational,3|4,7,3/4,230008,3
6,4,23,9,1,1007,1,7,3,3,4,single-choice,spatial-relational,3|4,7,3/4,230009,3
6,4,23,10,1,984,1,9,4,4,5,single-choice,spatial-relational,4|5,7,4/5,230010,4
6,4,23,11,0,923,1,13,6,7,7,single-choice,spatial-relational,6|7,7,6/7,230011,6
6,4,23,12,1,305,1,3,1,1,2,single-choice,spatial-relational,1|2,7,1/2,230012,1
6,4,23,13,0,828,1,11,5,6,6,single-choice,spatial-relational,5|6,7,5/6,230013,5
6,4,23,14,0,603,1,7,3,4,4,single-choice,spatial-relational,3|4,7,3/4,230014,3
6,4,23,15,0,790,1,9,4,5,5,single-choice,spatial-relational,4|5,7,4/5,230015,4
6,4,23,16,1,632,1,3,1,1,2,single-choice,spatial-relational,1|2,7,1/2,230016,1
6,4,23,17,1,723,1,13,6,6,7,single-choice,spatial-relational,6|7,7,6/7,230017,6
6,4,23,18,1,918,1,5,2,2,3,single-choice,spatial-relational,2|3,7,2/3,230018,2
6,4,23,19,1,769,1,13,6,6,7,single-choice,spatial-relational,6|7,7,6/7,230019,6
6,4,23,20,1,905,1,7,3,3,4,single-choice,spatial-relational,3|4,7,3/4,230020,3
6,4,23,21,0,978,1,9,4,5,5,single-choice,spatial-relational,4|5,7,4/5,230021,4
6,4,23,22,0,933,1,3,1,2,2,single-choice,spatial-relational,1|2,7,1/2,230022,1
6,4,23,23,0,903,1,11,5,6,6,single-choice,spatial-relational,5|6,7,5/6,230023,5
6,4,23,24,1,932,1,5,2,2,3,single-choice,spatial-relational,2|3,7,2/3,230024,2
6,4,23,25,0,1173,1,9,4,5,5,single-choice,spatial-relational,4|5,7,4/5,230025,4
6,4,23,26,1,1053,1,5,2,2,3,single-choice,spatial-relational,2|3,7,2/3,230026,2
6,4,23,27,1,843,1,11,5,5,6,single-choice,spatial-relational,5|6,7,5/6,230027,5
6,4,23,28,1,2267,1,11,5,5,6,single-choice,spatial-relational,5|6,7,5/6,230028,5
6,4,23,29,1,882,1,5,2,2,3,single-choice,spatial-relational,2|3,7,2/3,230029,2
6,4,23,30,1,1214,1,7,3,3,4,single-choice,spatial-relational,3|4,7,3/4,230030,3
6,4,23,31,1,912,1,3,1,1,2,single-choice,spatial-relational,1|2,7,1/2,230031,1
6,4,23,32,0,1130,1,7,3,4,4,single-choice,spatial-relational,3|4,7,3/4,230032,3
6,4,23,33,1,980,1,13,6,6,7,single-choice,spatial-relational,6|7,7,6/7,230033,6
6,4,23,34,1,1310,1,3,1,1,2,single-choice,spatial-relational,1|2,7,1/2,230034,1
6,4,23,35,1,711,1,13,6,6,7,single-choice,spatial-relational,6|7,7,6/7,230035,6
6,4,23,36,1,2016,1,9,4,4,5,single-choice,spatial-relational,4|5,7,4/5,230036,4
6,4,23,37,1,985,1,11,5,5,6,single-choice,spatial-relational,5|6,7,5/6,230037,5
6,4,23,38,1,1052,1,11,5,5,6,single-choice,spatial-relational,5|6,7,5/6,230038,5
6,4,23,39,1,1169,1,3,1,1,2,single-choice,spatial-relational,1|2,7,1/2,230039,1
6,4,23,40,1,782,1,5,2,2,3,single-choice,spatial-relational,2|3,7,2/3,230040,2
6,4,23,41,1,1428,1,3,1,1,2,single-choice,spatial-relational,1|2,7,1/2,230041,1
6,4,23,42,1,803,1,7,3,3,4,single-choice,spatial-relational,3|4,7,3/4,230042,3
6,4,23,43,0,1193,1,7,3,4,4,single-choice,spatial-relational,3|4,7,3/4,230043,3
6,4,23,44,0,862,1,9,4,5,5,single-choice,spatial-relational,4|5,7,4/5,230044,4
6,4,23,45,1,610,1,13,6,6,7,single-choice,spatial-relational,6|7,7,6/7,230045,6
6,4,23,46,1,694,1,13,6,6,7,single-choice,spatial-relational,6|7,7,6/7,230046,6
6,4,23,47,1,937,1,5,2,2,3,single-choice,spatial-relational,2|3,7,2/3,230047,2
6,4,23,48,1,1553,1,9,4,4,5,single-choice,spatial-relational,4|5,7,4/5,230048,4
6,4,23,49,0,1334,1,9,4,5,5,single-choice,spatial-relational,4|5,7,4/5,230049,4
6,4,23,50,1,1057,1,7,3,3,4,single-choice,spatial-relational,3|4,7,3/4,230050,3
6,4,23,51,1,816,1,11,5,5,6,single-choice,spatial-relational,5|6,7,5/6,230051,5
6,4,23,52,1,902,1,5,2,2,3,single-choice,spatial-relational,2|3,7,2/3,230052,2
6,4,23,53,1,949,1,3,1,1,2,single-choice,spatial-relational,1|2,7,1/2,230053,1
6,4,23,54,1,948,1,9,4,4,5,single-choice,spatial-relational,4|5,7,4/5,230054,4
6,4,23,55,1,939,1,13,6,6,7,single-choice,spatial-relational,6|7,7,6/7,230055,6
6,4,23,56,1,1649,1,3,1,1,2,single-choice,spatial-relational,1|2,7,1/2,230056,1
6,4,23,57,1,616,1,13,6,6,7,single-choice,spatial-relational,6|7,7,6/7,230057,6
6,4,23,58,1,970,1,11,5,5,6,single-choice,spatial-relational,5|6,7,5/6,230058,5
6,4,23,59,1,1172,1,5,2,2,3,single-choice,spatial-relational,2|3,7,2/3,230059,2
6,4,23,60,1,1203,1,7,3,3,4,single-choice,spatial-relational,3|4,7,3/4,230060,3
6,4,23,61,1,1137,1,5,2,2,3,single-choice,spatial-relational,2|3,7,2/3,230061,2
6,4,23,62,1,920,1,3,1,1,2,single-choice,spatial-relational,1|2,7,1/2,230062,1
6,4,23,63,1,990,1,9,4,4,5,single-choice,spatial-relational,4|5,7,4/5,230063,4
6,4,23,64,1,819,1,5,2,2,3,single-choice,spatial-relational,2|3,7,2/3,230064,2
6,4,23,65,1,1059,1,11,5,5,6,single-choice,spatial-relational,5|6,7,5/6,230065,5
6,4,23,66,0,1317,1,7,3,4,4,single-choice,spatial-relational,3|4,7,3/4,230066,3
6,4,23,67,1,1031,1,11,5,5,6,single-choice,spatial-relational,5|6,7,5/6,230067,5
6,4,23,68,0,1773,1,9,4,5,5,single-choice,spatial-relational,4|5,7,4/5,230068,4
6,4,23,69,1,903,1,3,1,1,2,single-choice,spatial-relational,1|2,7,1/2,230069,1
6,4,23,70,1,751,1,13,6,6,7,single-choice,spatial-relational,6|7,7,6/7,230070,6
6,4,23,71,1,621,1,13,6,6,7,single-choice,spatial-relational,6|7,7,6/7,230071,6
6,4,23,72,1,994,1,7,3,3,4,single-choice,spatial-relational,3|4,7,3/4,230072,3
6,4,23,73,1,975,1,5,2,2,3,single-choice,spatial-relational,2|3,7,2/3,230073,2
6,4,23,74,0,1393,1,7,3,4,4,single-choice,spatial-relational,3|4,7,3/4,230074,3
6,4,23,75,1,615,1,13,6,6,7,single-choice,spatial-relational,6|7,7,6/7,230075,6
6,4,23,76,1,959,1,9,4,4,5,single-choice,spatial-relational,4|5,7,4/5,230076,4
6,4,23,77,1,953,1,3,1,1,2,single-choice,spatial-relational,1|2,7,1/2,230077,1
6,4,23,78,1,961,1,11,5,5,6,single-choice,spatial-relational,5|6,7,5/6,230078,5
6,4,23,79,1,645,1,13,6,6,7,single-choice,spatial-relational,6|7,7,6/7,230079,6
6,4,23,80,1,1379,1,11,5,5,6,single-choice,spatial-relational,5|6,7,5/6,230080,5
6,4,23,81,1,770,1,5,2,2,3,single-choice,spatial-relational,2|3,7,2/3,230081,2
6,4,23,82,1,1303,1,9,4,4,5,single-choice,spatial-relational,4|5,7,4/5,230082,4
6,4,23,83,0,1309,1,7,3,4,4,single-choice,spatial-relational,3|4,7,3/4,230083,3
6,4,23,84,1,604,1,3,1,1,2,single-choice,spatial-relational,1|2,7,1/2,230084,1
6,4,23,85,1,588,1,13,6,6,7,single-choice,spatial-relational,6|7,7,6/7,230085,6
6,4,23,86,1,667,1,5,2,2,3,single-choice,spatial-relational,2|3,7,2/3,230086,2
6,4,23,87,1,831,1,13,6,6,7,single-choice,spatial-relational,6|7,7,6/7,230087,6
6,4,23,88,0,853,1,3,1,2,2,single-choice,spatial-relational,1|2,7,1/2,230088,1
6,4,23,89,0,600,1,3,1,2,2,single-choice,spatial-relational,1|2,7,1/2,230089,1
6,4,23,90,1,1087,1,9,4,4,5,single-choice,spatial-relational,4|5,7,4/5,230090,4
6,4,23,91,1,913,1,11,5,5,6,single-choice,spatial-relational,5|6,7,5/6,230091,5
6,4,23,92,1,899,1,7,3,3,4,single-choice,spatial-relational,3|4,7,3/4,230092,3
6,4,23,93,1,1091,1,7,3,3,4,single-choice,spatial-relational,3|4,7,3/4,230093,3
6,4,23,94,1,1277,1,11,5,5,6,single-choice,spatial-relational,5|6,7,5/6,230094,5
6,4,23,95,1,1945,1,9,4,4,5,single-choice,spatial-relational,4|5,7,4/5,230095,4
6,4,23,96,1,994,1,5,2,2,3,single-choice,spatial-relational,2|3,7,2/3,230096,2
6,4,23,97,1,1281,1,11,5,5,6,single-choice,spatial-relational,5|6,7,5/6,230097,5
6,4,23,98,1,783,1,3,1,1,2,single-choice,spatial-relational,1|2,7,1/2,230098,1
6,4,23,99,1,620,1,13,6,6,7,single-choice,spatial-relational,6|7,7,6/7,230099,6
6,4,23,100,1,1429,1,11,5,5,6,single-choice,spatial-relational,5|6,7,5/6,230100,5
6,4,23,101,1,700,1,5,2,2,3,single-choice,spatial-relational,2|3,7,2/3,230101,2
6,4,23,102,1,944,1,3,1,1,2,single-choice,spatial-relational,1|2,7,1/2,230102,1
6,4,23,103,1,1022,1,9,4,4,5,single-choice,spatial-relational,4|5,7,4/5,230103,4
6,4,23,104,1,1120,1,7,3,3,4,single-choice,spatial-relational,3|4,7,3/4,230104,3
6,4,23,105,0,1383,1,9,4,5,5,single-choice,spatial-relational,4|5,7,4/5,230105,4
6,4,23,106,1,790,1,5,2,2,3,single-choice,spatial-relational,2|3,7,2/3,230106,2
6,4,23,107,1,632,1,13,6,6,7,single-choice,spatial-relational,6|7,7,6/7,230107,6
6,4,23,108,1,1055,1,7,3,3,4,single-choice,spatial-relational,3|4,7,3/4,230108,3
6,4,23,109,1,1262,1,13,6,6,7,single-choice,spatial-relational,6|7,7,6/7,230109,6
6,4,23,110,1,1353,1,7,3,3,4,single-choice,spatial-relational,3|4,7,3/4,230110,3
6,4,23,111,1,1465,1,5,2,2,3,single-choice,spatial-relational,2|3,7,2/3,230111,2
6,4,23,112,1,791,1,13,6,6,7,single-choice,spatial-relational,6|7,7,6/7,230112,6
6,4,23,113,1,1201,1,11,5,5,6,single-choice,spatial-relational,5|6,7,5/6,230113,5
6,4,23,114,1,1144,1,9,4,4,5,single-choice,spatial-relational,4|5,7,4/5,230114,4
6,4,23,115,1,839,1,5,2,2,3,single-choice,spatial-relational,2|3,7,2/3,230115,2
6,4,23,116,0,1497,1,7,3,4,4,single-choice,spatial-relational,3|4,7,3/4,230116,3
6,4,23,117,1,624,1,3,1,1,2,single-choice,spatial-relational,1|2,7,1/2,230117,1
6,4,23,118,0,1078,1,9,4,5,5,single-choice,spatial-relational,4|5,7,4/5,230118,4
6,4,23,119,1,1249,1,3,1,1,2,single-choice,spatial-relational,1|2,7,1/2,230119,1
6,4,23,120,1,925,1,11,5,5,6,single-choice,spatial-relational,5|6,7,5/6,230120,5
6,4,23,121,1,803,1,5,2,2,3,single-choice,spatial-relational,2|3,7,2/3,230121,2
6,4,23,122,1,1213,1,3,1,1,2,single-choice,spatial-relational,1|2,7,1/2,230122,1
6,4,23,123,0,987,1,9,4,5,5,single-choice,spatial-relational,4|5,7,4/5,230123,4
6,4,23,124,1,710,1,3,1,1,2,single-choice,spatial-relational,1|2,7,1/2,230124,1
6,4,23,125,1,1607,1,11,5,5,6,single-choice,spatial-relational,5|6,7,5/6,230125,5
6,4,23,126,1,3325,1,7,3,3,4,single-choice,spatial-relational,3|4,7,3/4,230126,3
6,4,23,127,1,1729,1,5,2,2,3,single-choice,spatial-relational,2|3,7,2/3,230127,2
6,4,23,128,1,685,1,13,6,6,7,single-choice,spatial-relational,6|7,7,6/7,230128,6
6,4,23,129,1,928,1,13,6,6,7,single-choice,spatial-relational,6|7,7,6/7,230129,6
6,4,23,130,0,1247,1,9,4,5,5,single-choice,spatial-relational,4|5,7,4/5,230130,4
6,4,23,131,1,917,1,7,3,3,4,single-choice,spatial-relational,3|4,7,3/4,230131,3
6,4,23,132,1,782,1,11,5,5,6,single-choice,spatial-relational,5|6,7,5/6,230132,5
6,4,23,133,1,1127,1,11,5,5,6,single-choice,spatial-relational,5|6,7,5/6,230133,5
6,4,23,134,1,1689,1,3,1,1,2,single-choice,spatial-relational,1|2,7,1/2,230134,1
6,4,23,135,1,1091,1,7,3,3,4,single-choice,spatial-relational,3|4,7,3/4,230135,3
6,4,23,136,1,1040,1,3,1,1,2,single-choice,spatial-relational,1|2,7,1/2,230136,1
6,4,23,137,0,1085,1,9,4,5,5,single-choice,spatial-relational,4|5,7,4/5,230137,4
6,4,23,138,1,874,1,13,6,6,7,single-choice,spatial-relational,6|7,7,6/7,230138,6
6,4,23,139,1,1520,1,9,4,4,5,single-choice,spatial-relational,4|5,7,4/5,230139,4
6,4,23,140,1,673,1,13,6,6,7,single-choice,spatial-relational,6|7,7,6/7,230140,6
6,4,23,141,0,1414,1,11,5,6,6,single-choice,spatial-relational,5|6,7,5/6,230141,5
6,4,23,142,1,1060,1,7,3,3,4,single-choice,spatial-relational,3|4,7,3/4,230142,3
6,4,23,143,1,739,1,5,2,2,3,single-choice,spatial-relational,2|3,7,2/3,230143,2
6,4,23,144,1,1119,1,5,2,2,3,single-choice,spatial-relational,2|3,7,2/3,230144,2
6,4,23,145,1,624,1,13,6,6,7,single-choice,spatial-relational,6|7,7,6/7,230145,6
6,4,23,146,1,1059,1,11,5,5,6,single-choice,spatial-relational,5|6,7,5/6,230146,5
6,4,23,147,1,927,1,13,6,6,7,single-choice,spatial-relational,6|7,7,6/7,230147,6
6,4,23,148,0,765,1,3,1,2,2,single-choice,spatial-relational,1|2,7,1/2,230148,1
6,4,23,149,1,950,1,5,2,2,3,single-choice,spatial-relational,2|3,7,2/3,230149,2
6,4,23,150,1,911,1,11,5,5,6,single-choice,spatial-relational,5|6,7,5/6,230150,5
6,4,23,151,1,2078,1,7,3,3,4,single-choice,spatial-relational,3|4,7,3/4,230151,3
6,4,23,152,0,1279,1,7,3,4,4,single-choice,spatial-relational,3|4,7,3/4,230152,3
6,4,23,153,0,1688,1,9,4,5,5,single-choice,spatial-relational,4|5,7,4/5,230153,4
6,4,23,154,1,1140,1,5,2,2,3,single-choice,spatial-relational,2|3,7,2/3,230154,2
6,4,23,155,1,1505,1,3,1,1,2,single-choice,spatial-relational,1|2,7,1/2,230155,1
6,4,23,156,1,1333,1,9,4,4,5,single-choice,spatial-relational,4|5,7,4/5,230156,4
6,4,23,157,1,1120,1,3,1,1,2,single-choice,spatial-relational,1|2,7,1/2,230157,1
6,4,23,158,1,757,1,7,3,3,4,single-choice,spatial-relational,3|4,7,3/4,230158,3
6,4,23,159,0,1230,1,3,1,2,2,single-choice,spatial-relational,1|2,7,1/2,230159,1
6,4,23,160,1,699,1,5,2,2,3,single-choice,spatial-relational,2|3,7,2/3,230160,2
6,4,23,161,1,852,1,11,5,5,6,single-choice,spatial-relational,5|6,7,5/6,230161,5
6,4,23,162,1,770,1,13,6,6,7,single-choice,spatial-relational,6|7,7,6/7,230162,6
6,4,23,163,1,1238,1,7,3,3,4,single-choice,spatial-relational,3|4,7,3/4,230163,3
6,4,23,164,1,1567,1,9,4,4,5,single-choice,spatial-relational,4|5,7,4/5,230164,4
6,4,23,165,1,1368,1,11,5,5,6,single-choice,spatial-relational,5|6,7,5/6,230165,5
6,4,23,166,1,757,1,5,2,2,3,single-choice,spatial-relational,2|3,7,2/3,230166,2
6,4,23,167,0,1159,1,9,4,5,5,single-choice,spatial-relational,4|5,7,4/5,230167,4
6,4,23,168,1,823,1,13,6,6,7,single-choice,spatial-relational,6|7,7,6/7,230168,6
6,4,23,169,1,1109,1,3,1,1,2,single-choice,spatial-relational,1|2,7,1/2,230169,1
6,4,23,170,1,957,1,7,3,3,4,single-choice,spatial-relational,3|4,7,3/4,230170,3
6,4,23,171,0,980,1,11,5,6,6,single-choice,spatial-relational,5|6,7,5/6,230171,5
6,4,23,172,1,993,1,5,2,2,3,single-choice,spatial-relational,2|3,7,2/3,230172,2
6,4,23,173,1,1422,1,9,4,4,5,single-choice,spatial-relational,4|5,7,4/5,230173,4
6,4,23,174,1,802,1,13,6,6,7,single-choice,spatial-relational,6|7,7,6/7,230174,6
6,4,23,175,1,957,1,13,6,6,7,single-choice,spatial-relational,6|7,7,6/7,230175,6
6,4,23,176,1,1261,1,3,1,1,2,single-choice,spatial-relational,1|2,7,1/2,230176,1
6,4,23,177,1,955,1,11,5,5,6,single-choice,spatial-relational,5|6,7,5/6,230177,5
6,4,23,178,1,1518,1,9,4,4,5,single-choice,spatial-relational,4|5,7,4/5,230178,4
6,4,23,179,1,990,1,5,2,2,3,single-choice,spatial-relational,2|3,7,2/3,230179,2
6,4,23,180,1,874,1,7,3,3,4,single-choice,spatial-relational,3|4,7,3/4,230180,3
6,4,23,181,1,1002,1,3,1,1,2,single-choice,spatial-relational,1|2,7,1/2,230181,1
6,4,23,182,1,1111,1,3,1,1,2,single-choice,spatial-relational,1|2,7,1/2,230182,1
6,4,23,183,1,1046,1,5,2,2,3,single-choice,spatial-relational,2|3,7,2/3,230183,2
6,4,23,184,1,1003,1,7,3,3,4,single-choice,spatial-relational,3|4,7,3/4,230184,3
6,4,23,185,1,816,1,13,6,6,7,single-choice,spatial-relational,6|7,7,6/7,230185,6
6,4,23,186,1,1180,1,11,5,5,6,single-choice,spatial-relational,5|6,7,5/6,230186,5
6,4,23,187,1,1892,1,9,4,4,5,single-choice,spatial-relational,4|5,7,4/5,230187,4
6,4,23,188,1,1161,1,5,2,2,3,single-choice,spatial-relational,2|3,7,2/3,230188,2
6,4,23,189,1,627,1,7,3,3,4,single-choice,spatial-relational,3|4,7,3/4,230189,3
6,4,23,190,0,1164,1,9,4,5,5,single-choice,spatial-relational,4|5,7,4/5,230190,4
6,4,23,191,1,830,1,13,6,6,7,single-choice,spatial-relational,6|7,7,6/7,230191,6
6,4,23,192,1,905,1,11,5,5,6,single-choice,spatial-relational,5|6,7,5/6,230192,5
6,4,23,193,1,2428,1,9,4,4,5,single-choice,spatial-relational,4|5,7,4/5,230193,4
6,4,23,194,1,921,1,13,6,6,7,single-choice,spatial-relational,6|7,7,6/7,230194,6
6,4,23,195,0,1029,1,3,1,2,2,single-choice,spatial-relational,1|2,7,1/2,230195,1
6,4,23,196,0,1449,1,11,5,6,6,single-choice,spatial-relational,5|6,7,5/6,230196,5
6,4,23,197,1,687,1,13,6,6,7,single-choice,spatial-relational,6|7,7,6/7,230197,6
6,4,23,198,1,1019,1,7,3,3,4,single-choice,spatial-relational,3|4,7,3/4,230198,3
6,4,23,199,1,1808,1,7,3,3,4,single-choice,spatial-relational,3|4,7,3/4,230199,3
6,4,23,200,1,1559,1,5,2,2,3,single-choice,spatial-relational,2|3,7,2/3,230200,2
6,4,23,201,1,1145,1,11,5,5,6,single-choice,spatial-relational,5|6,7,5/6,230201,5
6,4,23,202,1,1110,1,3,1,1,2,single-choice,spatial-relational,1|2,7,1/2,230202,1
6,4,23,203,1,27410,1,9,4,4,5,single-choice,spatial-relational,4|5,7,4/5,230203,4
6,4,23,204,1,1704,1,5,2,2,3,single-choice,spatial-relational,2|3,7,2/3,230204,2
6,4,23,205,1,1152,1,5,2,2,3,single-choice,spatial-relational,2|3,7,2/3,230205,2
6,4,23,206,1,645,1,13,6,6,7,single-choice,spatial-relational,6|7,7,6/7,230206,6
6,4,23,207,1,1113,1,5,2,2,3,single-choice,spatial-relational,2|3,7,2/3,230207,2
6,4,23,208,0,1351,1,9,4,5,5,single-choice,spatial-relational,4|5,7,4/5,230208,4
6,4,23,209,1,1040,1,7,3,3,4,single-choice,spatial-relational,3|4,7,3/4,230209,3
6,4,23,210,1,1543,1,11,5,5,6,single-choice,spatial-relational,5|6,7,5/6,230210,5
6,4,23,211,1,899,1,13,6,6,7,single-choice,spatial-relational,6|7,7,6/7,230211,6
6,4,23,212,1,1239,1,9,4,4,5,single-choice,spatial-relational,4|5,7,4/5,230212,4
6,4,23,213,1,1448,1,11,5,5,6,single-choice,spatial-relational,5|6,7,5/6,230213,5
6,4,23,214,1,1225,1,3,1,1,2,single-choice,spatial-relational,1|2,7,1/2,230214,1
6,4,23,215,1,829,1,3,1,1,2,single-choice,spatial-relational,1|2,7,1/2,230215,1
6,4,23,216,1,828,1,7,3,3,4,single-choice,spatial-relational,3|4,7,3/4,230216,3
6,4,23,217,1,874,1,7,3,3,4,single-choice,spatial-relational,3|4,7,3/4,230217,3
6,4,23,218,1,1124,1,7,3,3,4,single-choice,spatial-relational,3|4,7,3/4,230218,3
6,4,23,219,1,1665,1,11,5,5,6,single-choice,spatial-relational,5|6,7,5/6,230219,5
6,4,23,220,0,61111,1,9,4,5,5,single-choice,spatial-relational,4|5,7,4/5,230220,4
6,4,23,221,1,896,1,9,4,4,5,single-choice,spatial-relational,4|5,7,4/5,230221,4
6,4,23,222,1,1067,1,5,2,2,3,single-choice,spatial-relational,2|3,7,2/3,230222,2
6,4,23,223,1,996,1,3,1,1,2,single-choice,spatial-relational,1|2,7,1/2,230223,1
6,4,23,224,1,1020,1,5,2,2,3,single-choice,spatial-relational,2|3,7,2/3,230224,2
6,4,23,225,1,1732,1,3,1,1,2,single-choice,spatial-relational,1|2,7,1/2,230225,1
6,4,23,226,1,853,1,11,5,5,6,single-choice,spatial-relational,5|6,7,5/6,230226,5
6,4,23,227,1,987,1,13,6,6,7,single-choice,spatial-relational,6|7,7,6/7,230227,6
6,4,23,228,1,636,1,13,6,6,7,single-choice,spatial-relational,6|7,7,6/7,230228,6
6,4,23,229,1,891,1,13,6,6,7,single-choice,spatial-relational,6|7,7,6/7,230229,6
6,4,23,230,0,942,1,3,1,2,2,single-choice,spatial-relational,1|2,7,1/2,230230,1
6,4,23,231,1,870,1,5,2,2,3,single-choice,spatial-relational,2|3,7,2/3,230231,2
6,4,23,232,1,1139,1,9,4,4,5,single-choice,spatial-relational,4|5,7,4/5,230232,4
6,4,23,233,1,936,1,3,1,1,2,single-choice,spatial-relational,1|2,7,1/2,230233,1
6,4,23,234,1,846,1,11,5,5,6,single-choice,spatial-relational,5|6,7,5/6,230234,5
6,4,23,235,1,2368,1,11,5,5,6,single-choice,spatial-relational,5|6,7,5/6,230235,5
6,4,23,236,0,1372,1,9,4,5,5,single-choice,spatial-relational,4|5,7,4/5,230236,4
6,4,23,237,1,774,1,7,3,3,4,single-choice,spatial-relational,3|4,7,3/4,230237,3
6,4,23,238,1,651,1,13,6,6,7,single-choice,spatial-relational,6|7,7,6/7,230238,6
6,4,23,239,1,1271,1,7,3,3,4,single-choice,spatial-relational,3|4,7,3/4,230239,3
6,4,23,240,1,1807,1,5,2,2,3,single-choice,spatial-relational,2|3,7,2/3,230240,2
6,4,23,241,1,828,1,13,6,6,7,single-choice,spatial-relational,6|7,7,6/7,230241,6
6,4,23,242,0,1971,1,11,5,6,6,single-choice,spatial-relational,5|6,7,5/6,230242,5
6,4,23,243,1,792,1,9,4,4,5,single-choice,spatial-relational,4|5,7,4/5,230243,4
6,4,23,244,1,998,1,13,6,6,7,single-choice,spatial-relational,6|7,7,6/7,230244,6
6,4,23,245,1,2527,1,9,4,4,5,single-choice,spatial-relational,4|5,7,4/5,230245,4
6,4,23,246,1,1093,1,7,3,3,4,single-choice,spatial-relational,3|4,7,3/4,230246,3
6,4,23,247,1,1510,1,5,2,2,3,single-choice,spatial-relational,2|3,7,2/3,230247,2
6,4,23,248,1,1321,1,7,3,3,4,single-choice,spatial-relational,3|4,7,3/4,230248,3
6,4,23,249,1,1164,1,3,1,1,2,single-choice,spatial-relational,1|2,7,1/2,230249,1
6,4,23,250,1,771,1,3,1,1,2,single-choice,spatial-relational,1|2,7,1/2,230250,1
6,4,23,251,1,772,1,5,2,2,3,single-choice,spatial-relational,2|3,7,2/3,230251,2
6,4,23,252,1,985,1,11,5,5,6,single-choice,spatial-relational,5|6,7,5/6,230252,5
6,4,23,253,1,1019,1,5,2,2,3,single-choice,spatial-relational,2|3,7,2/3,230253,2
6,4,23,254,1,863,1,7,3,3,4,single-choice,spatial-relational,3|4,7,3/4,230254,3
6,4,23,255,1,856,1,13,6,6,7,single-choice,spatial-relational,6|7,7,6/7,230255,6
6,4,23,256,1,796,1,5,2,2,3,single-choice,spatial-relational,2|3,7,2/3,230256,2
6,4,23,257,0,875,1,3,1,2,2,single-choice,spatial-relational,1|2,7,1/2,230257,1
6,4,23,258,0,470,1,11,5,6,6,single-choice,spatial-relational,5|6,7,5/6,230258,5
6,4,23,259,1,1188,1,9,4,4,5,single-choice,spatial-relational,4|5,7,4/5,230259,4
6,4,23,260,0,1472,1,11,5,6,6,single-choice,spatial-relational,5|6,7,5/6,230260,5
6,4,23,261,1,759,1,9,4,4,5,single-choice,spatial-relational,4|5,7,4/5,230261,4
6,4,23,262,0,46,1,3,1,2,2,single-choice,spatial-relational,1|2,7,1/2,230262,1
6,4,23,263,1,786,1,13,6,6,7,single-choice,spatial-relational,6|7,7,6/7,230263,6
6,4,23,264,1,1177,1,7,3,3,4,single-choice,spatial-relational,3|4,7,3/4,230264,3
6,4,23,265,1,1287,1,11,5,5,6,single-choice,spatial-relational,5|6,7,5/6,230265,5
6,4,23,266,1,1726,1,7,3,3,4,single-choice,spatial-relational,3|4,7,3/4,230266,3
6,4,23,267,0,1278,1,13,6,7,7,single-choice,spatial-relational,6|7,7,6/7,230267,6
6,4,23,268,1,864,1,5,2,2,3,single-choice,spatial-relational,2|3,7,2/3,230268,2
6,4,23,269,1,1389,1,5,2,2,3,single-choice,spatial-relational,2|3,7,2/3,230269,2
6,4,23,270,1,1030,1,3,1,1,2,single-choice,spatial-relational,1|2,7,1/2,230270,1
6,4,23,271,1,1148,1,9,4,4,5,single-choice,spatial-relational,4|5,7,4/5,230271,4
6,4,23,272,1,1142,1,11,5,5,6,single-choice,spatial-relational,5|6,7,5/6,230272,5
6,4,23,273,1,908,1,7,3,3,4,single-choice,spatial-relational,3|4,7,3/4,230273,3
6,4,23,274,1,992,1,3,1,1,2,single-choice,spatial-relational,1|2,7,1/2,230274,1
6,4,23,275,1,1079,1,9,4,4,5,single-choice,spatial-relational,4|5,7,4/5,230275,4
6,4,23,276,1,714,1,13,6,6,7,single-choice,spatial-relational,6|7,7,6/7,230276,6
6,4,23,277,1,1075,1,13,6,6,7,single-choice,spatial-relational,6|7,7,6/7,230277,6
6,4,23,278,1,1120,1,11,5,5,6,single-choice,spatial-relational,5|6,7,5/6,230278,5
6,4,23,279,1,1404,1,7,3,3,4,single-choice,spatial-relational,3|4,7,3/4,230279,3
6,4,23,280,1,1030,1,7,3,3,4,single-choice,spatial-relational,3|4,7,3/4,230280,3
6,4,23,281,1,978,1,5,2,2,3,single-choice,spatial-relational,2|3,7,2/3,230281,2
6,4,23,282,0,814,1,3,1,2,2,single-choice,spatial-relational,1|2,7,1/2,230282,1
6,4,23,283,1,1092,1,5,2,2,3,single-choice,spatial-relational,2|3,7,2/3,230283,2
6,4,23,284,1,1088,1,9,4,4,5,single-choice,spatial-relational,4|5,7,4/5,230284,4
6,4,23,285,1,1199,1,11,5,5,6,single-choice,spatial-relational,5|6,7,5/6,230285,5
6,4,23,286,1,1095,1,3,1,1,2,single-choice,spatial-relational,1|2,7,1/2,230286,1
6,4,23,287,1,740,1,13,6,6,7,single-choice,spatial-relational,6|7,7,6/7,230287,6
6,4,23,288,1,2149,1,9,4,4,5,single-choice,spatial-relational,4|5,7,4/5,230288,4
6,4,23,289,1,1218,1,3,1,1,2,single-choice,spatial-relational,1|2,7,1/2,230289,1
6,4,23,290,1,659,1,13,6,6,7,single-choice,spatial-relational,6|7,7,6/7,230290,6
6,4,23,291,1,1095,1,11,5,5,6,single-choice,spatial-relational,5|6,7,5/6,230291,5
6,4,23,292,1,1566,1,9,4,4,5,single-choice,spatial-relational,4|5,7,4/5,230292,4
6,4,23,293,1,997,1,11,5,5,6,single-choice,spatial-relational,5|6,7,5/6,230293,5
6,4,23,294,1,1278,1,9,4,4,5,single-choice,spatial-relational,4|5,7,4/5,230294,4
6,4,23,295,1,702,1,5,2,2,3,single-choice,spatial-relational,2|3,7,2/3,230295,2
6,4,23,296,1,1463,1,7,3,3,4,single-choice,spatial-relational,3|4,7,3/4,230296,3
6,4,23,297,0,692,1,3,1,2,2,single-choice,spatial-relational,1|2,7,1/2,230297,1
6,4,23,298,1,792,1,13,6,6,7,single-choice,spatial-relational,6|7,7,6/7,230298,6
6,4,23,299,1,6125,1,5,2,2,3,single-choice,spatial-relational,2|3,7,2/3,230299,2
6,4,23,300,0,1315,1,7,3,4,4,single-choice,spatial-relational,3|4,7,3/4,230300,3
6,4,23,301,0,1165,1,9,4,5,5,single-choice,spatial-relational,4|5,7,4/5,230301,4
6,4,23,302,1,1248,1,3,1,1,2,single-choice,spatial-relational,1|2,7,1/2,230302,1
6,4,23,303,1,1148,1,11,5,5,6,single-choice,spatial-relational,5|6,7,5/6,230303,5
6,4,23,304,1,1150,1,7,3,3,4,single-choice,spatial-relational,3|4,7,3/4,230304,3
6,4,23,305,1,951,1,7,3,3,4,single-choice,spatial-relational,3|4,7,3/4,230305,3
6,4,23,306,1,858,1,5,2,2,3,single-choice,spatial-relational,2|3,7,2/3,230306,2
6,4,23,307,1,953,1,3,1,1,2,single-choice,spatial-relational,1|2,7,1/2,230307,1
6,4,23,308,1,1153,1,5,2,2,3,single-choice,spatial-relational,2|3,7,2/3,230308,2
6,4,23,309,1,788,1,13,6,6,7,single-choice,spatial-relational,6|7,7,6/7,230309,6
6,4,23,310,1,1172,1,11,5,5,6,single-choice,spatial-relational,5|6,7,5/6,230310,5
6,4,23,311,1,1141,1,13,6,6,7,single-choice,spatial-relational,6|7,7,6/7,230311,6
6,4,23,312,1,1212,1,9,4,4,5,single-choice,spatial-relational,4|5,7,4/5,230312,4
6,4,23,313,1,1050,1,11,5,5,6,single-choice,spatial-relational,5|6,7,5/6,230313,5
6,4,23,314,1,1412,1,9,4,4,5,single-choice,spatial-relational,4|5,7,4/5,230314,4
6,4,23,315,1,865,1,7,3,3,4,single-choice,spatial-relational,3|4,7,3/4,230315,3
6,4,23,316,1,719,1,13,6,6,7,single-choice,spatial-relational,6|7,7,6/7,230316,6
6,4,23,317,1,1183,1,3,1,1,2,single-choice,spatial-relational,1|2,7,1/2,230317,1
6,4,23,318,1,1221,1,3,1,1,2,single-choice,spatial-relational,1|2,7,1/2,230318,1
6,4,23,319,1,815,1,13,6,6,7,single-choice,spatial-relational,6|7,7,6/7,230319,6
6,4,23,320,1,1108,1,9,4,4,5,single-choice,spatial-relational,4|5,7,4/5,230320,4
6,4,23,321,1,1090,1,7,3,3,4,single-choice,spatial-relational,3|4,7,3/4,230321,3
6,4,23,322,1,1101,1,5,2,2,3,single-choice,spatial-relational,2|3,7,2/3,230322,2
6,4,23,323,1,1119,1,11,5,5,6,single-choice,spatial-relational,5|6,7,5/6,230323,5
6,4,23,324,1,969,1,5,2,2,3,single-choice,spatial-relational,2|3,7,2/3,230324,2
6,4,23,325,1,1047,1,11,5,5,6,single-choice,spatial-relational,5|6,7,5/6,230325,5
6,4,23,326,1,687,1,13,6,6,7,single-choice,spatial-relational,6|7,7,6/7,230326,6
6,4,23,327,1,958,1,3,1,1,2,single-choice,spatial-relational,1|2,7,1/2,230327,1
6,4,23,328,1,1066,1,5,2,2,3,single-choice,spatial-relational,2|3,7,2/3,230328,2
6,4,23,329,1,837,1,11,5,5,6,single-choice,spatial-relational,5|6,7,5/6,230329,5
6,4,23,330,1,1103,1,3,1,1,2,single-choice,spatial-relational,1|2,7,1/2,230330,1
6,4,23,331,1,739,1,9,4,4,5,single-choice,spatial-relational,4|5,7,4/5,230331,4
6,4,23,332,1,856,1,7,3,3,4,single-choice,spatial-relational,3|4,7,3/4,230332,3
6,4,23,333,0,1347,1,9,4,5,5,single-choice,spatial-relational,4|5,7,4/5,230333,4
6,4,23,334,1,981,1,13,6,6,7,single-choice,spatial-relational,6|7,7,6/7,230334,6
6,4,23,335,1,1018,1,5,2,2,3,single-choice,spatial-relational,2|3,7,2/3,230335,2
6,4,23,336,1,1283,1,7,3,3,4,single-choice,spatial-relational,3|4,7,3/4,230336,3
6,4,23,337,1,1238,1,3,1,1,2,single-choice,spatial-relational,1|2,7,1/2,230337,1
6,4,23,338,0,1118,1,9,4,5,5,single-choice,spatial-relational,4|5,7,4/5,230338,4
6,4,23,339,1,1141,1,11,5,5,6,single-choice,spatial-relational,5|6,7,5/6,230339,5
6,4,23,340,0,1151,1,5,2,3,3,single-choice,spatial-relational,2|3,7,2/3,230340,2
6,4,23,341,0,1200,1,7,3,4,4,single-choice,spatial-relational,3|4,7,3/4,230341,3
6,4,23,342,1,891,1,7,3,3,4,single-choice,spatial-relational,3|4,7,3/4,230342,3
6,4,23,343,1,826,1,13,6,6,7,single-choice,spatial-relational,6|7,7,6/7,230343,6
6,4,23,344,1,845,1,13,6,6,7,single-choice,spatial-relational,6|7,7,6/7,230344,6
6,4,23,345,1,1401,1,5,2,2,3,single-choice,spatial-relational,2|3,7,2/3,230345,2
6,4,23,346,1,2209,1,9,4,4,5,single-choice,spatial-relational,4|5,7,4/5,230346,4
6,4,23,347,1,903,1,3,1,1,2,single-choice,spatial-relational,1|2,7,1/2,230347,1
6,4,23,348,1,859,1,11,5,5,6,single-choice,spatial-relational,5|6,7,5/6,230348,5
6,4,23,349,1,1316,1,7,3,3,4,single-choice,spatial-relational,3|4,7,3/4,230349,3
6,4,23,350,1,1111,1,3,1,1,2,single-choice,spatial-relational,1|2,7,1/2,230350,1
6,4,23,351,1,783,1,13,6,6,7,single-choice,spatial-relational,6|7,7,6/7,230351,6
6,4,23,352,1,1112,1,11,5,5,6,single-choice,spatial-relational,5|6,7,5/6,230352,5
6,4,23,353,1,750,1,5,2,2,3,single-choice,spatial-relational,2|3,7,2/3,230353,2
6,4,23,354,0,757,1,9,4,5,5,single-choice,spatial-relational,4|5,7,4/5,230354,4
6,4,23,355,1,620,1,13,6,6,7,single-choice,spatial-relational,6|7,7,6/7,230355,6
6,4,23,356,1,1294,1,7,3,3,4,single-choice,spatial-relational,3|4,7,3/4,230356,3
6,4,23,357,1,921,1,3,1,1,2,single-choice,spatial-relational,1|2,7,1/2,230357,1
6,4,23,358,0,1258,1,9,4,5,5,single-choice,spatial-relational,4|5,7,4/5,230358,4
6,4,23,359,0,1092,1,11,5,6,6,single-choice,spatial-relational,5|6,7,5/6,230359,5
6,4,23,360,1,968,1,5,2,2,3,single-choice,spatial-relational,2|3,7,2/3,230360,2
6,4,23,361,1,919,1,13,6,6,7,single-choice,spatial-relational,6|7,7,6/7,230361,6
6,4,23,362,1,931,1,13,6,6,7,single-choice,spatial-relational,6|7,7,6/7,230362,6
6,4,23,363,1,1493,1,5,2,2,3,single-choice,spatial-relational,2|3,7,2/3,230363,2
6,4,23,364,1,979,1,11,5,5,6,single-choice,spatial-relational,5|6,7,5/6,230364,5
6,4,23,365,1,898,1,3,1,1,2,single-choice,spatial-relational,1|2,7,1/2,230365,1
6,4,23,366,0,1411,1,3,1,2,2,single-choice,spatial-relational,1|2,7,1/2,230366,1
6,4,23,367,1,905,1,5,2,2,3,single-choice,spatial-relational,2|3,7,2/3,230367,2
6,4,23,368,1,903,1,11,5,5,6,single-choice,spatial-relational,5|6,7,5/6,230368,5
6,4,23,369,1,2264,1,7,3,3,4,single-choice,spatial-relational,3|4,7,3/4,230369,3
6,4,23,370,1,1377,1,9,4,4,5,single-choice,spatial-relational,4|5,7,4/5,230370,4
6,4,23,371,1,1057,1,7,3,3,4,single-choice,spatial-relational,3|4,7,3/4,230371,3
6,4,23,372,0,4971,1,9,4,5,5,single-choice,spatial-relational,4|5,7,4/5,230372,4
6,4,23,373,1,1099,1,9,4,4,5,single-choice,spatial-relational,4|5,7,4/5,230373,4
6,4,23,374,1,743,1,13,6,6,7,single-choice,spatial-relational,6|7,7,6/7,230374,6
6,4,23,375,1,1432,1,5,2,2,3,single-choice,spatial-relational,2|3,7,2/3,230375,2
6,4,23,376,1,921,1,3,1,1,2,single-choice,spatial-relational,1|2,7,1/2,230376,1
6,4,23,377,0,923,1,3,1,2,2,single-choice,spatial-relational,1|2,7,1/2,230377,1
6,4,23,378,1,1368,1,5,2,2,3,single-choice,spatial-relational,2|3,7,2/3,230378,2
6,4,23,379,1,1172,1,7,3,3,4,single-choice,spatial-relational,3|4,7,3/4,230379,3
6,4,23,380,1,1771,1,11,5,5,6,single-choice,spatial-relational,5|6,7,5/6,230380,5
6,4,23,381,1,1632,1,9,4,4,5,single-choice,spatial-relational,4|5,7,4/5,230381,4
6,4,23,382,1,638,1,13,6,6,7,single-choice,spatial-relational,6|7,7,6/7,230382,6
6,4,23,383,0,1530,1,11,5,6,6,single-choice,spatial-relational,5|6,7,5/6,230383,5
6,4,23,384,1,1204,1,7,3,3,4,single-choice,spatial-relational,3|4,7,3/4,230384,3
6,4,23,385,1,870,1,13,6,6,7,single-choice,spatial-relational,6|7,7,6/7,230385,6
6,4,23,386,1,701,1,13,6,6,7,single-choice,spatial-relational,6|7,7,6/7,230386,6
6,4,23,387,1,1092,1,11,5,5,6,single-choice,spatial-relational,5|6,7,5/6,230387,5
6,4,23,388,1,1351,1,3,1,1,2,single-choice,spatial-relational,1|2,7,1/2,230388,1
6,4,23,389,1,762,1,11,5,5,6,single-choice,spatial-relational,5|6,7,5/6,230389,5
6,4,23,390,1,1116,1,7,3,3,4,single-choice,spatial-relational,3|4,7,3/4,230390,3
6,4,23,391,0,1031,1,9,4,5,5,single-choice,spatial-relational,4|5,7,4/5,230391,4
6,4,23,392,1,986,1,9,4,4,5,single-choice,spatial-relational,4|5,7,4/5,230392,4
6,4,23,393,1,785,1,3,1,1,2,single-choice,spatial-relational,1|2,7,1/2,230393,1
6,4,23,394,0,981,1,5,2,3,3,single-choice,spatial-relational,2|3,7,2/3,230394,2
6,4,23,395,1,1040,1,5,2,2,3,single-choice,spatial-relational,2|3,7,2/3,230395,2
6,4,23,396,1,841,1,7,3,3,4,single-choice,spatial-relational,3|4,7,3/4,230396,3
6,4,23,397,1,884,1,13,6,6,7,single-choice,spatial-relational,6|7,7,6/7,230397,6
6,4,23,398,1,818,1,5,2,2,3,single-choice,spatial-relational,2|3,7,2/3,230398,2
6,4,23,399,1,986,1,11,5,5,6,single-choice,spatial-relational,5|6,7,5/6,230399,5
6,4,23,400,1,1711,1,9,4,4,5,single-choice,spatial-relational,4|5,7,4/5,230400,4
6,4,23,401,1,897,1,13,6,6,7,single-choice,spatial-relational,6|7,7,6/7,230401,6
6,4,23,402,1,1092,1,11,5,5,6,single-choice,spatial-relational,5|6,7,5/6,230402,5
6,4,23,403,1,789,1,7,3,3,4,single-choice,spatial-relational,3|4,7,3/4,230403,3
6,4,23,404,1,1047,1,9,4,4,5,single-choice,spatial-relational,4|5,7,4/5,230404,4
6,4,23,405,0,523,1,3,1,2,2,single-choice,spatial-relational,1|2,7,1/2,230405,1
6,4,23,406,0,493,1,7,3,4,4,single-choice,spatial-relational,3|4,7,3/4,230406,3
6,4,23,407,1,455,1,3,1,1,2,single-choice,spatial-relational,1|2,7,1/2,230407,1
6,4,23,408,0,454,1,5,2,3,3,single-choice,spatial-relational,2|3,7,2/3,230408,2
6,4,23,409,1,469,1,9,4,4,5,single-choice,spatial-relational,4|5,7,4/5,230409,4
6,4,23,410,1,516,1,13,6,6,7,single-choice,spatial-relational,6|7,7,6/7,230410,6
6,4,23,411,1,1024,1,5,2,2,3,single-choice,spatial-relational,2|3,7,2/3,230411,2
6,4,23,412,1,1249,1,9,4,4,5,single-choice,spatial-relational,4|5,7,4/5,230412,4
6,4,23,413,1,970,1,3,1,1,2,single-choice,spatial-relational,1|2,7,1/2,230413,1
6,4,23,414,1,1196,1,11,5,5,6,single-choice,spatial-relational,5|6,7,5/6,230414,5
6,4,23,415,1,1276,1,5,2,2,3,single-choice,spatial-relational,2|3,7,2/3,230415,2
6,4,23,416,1,890,1,7,3,3,4,single-choice,spatial-relational,3|4,7,3/4,230416,3
6,4,23,417,0,921,1,3,1,2,2,single-choice,spatial-relational,1|2,7,1/2,230417,1
6,4,23,418,1,690,1,13,6,6,7,single-choice,spatial-relational,6|7,7,6/7,230418,6
6,4,23,419,1,1274,1,7,3,3,4,single-choice,spatial-relational,3|4,7,3/4,230419,3
6,4,23,420,1,1677,1,11,5,5,6,single-choice,spatial-relational,5|6,7,5/6,230420,5
6,4,23,421,1,889,1,13,6,6,7,single-choice,spatial-relational,6|7,7,6/7,230421,6
6,4,23,422,1,795,1,13,6,6,7,single-choice,spatial-relational,6|7,7,6/7,230422,6
6,4,23,423,1,1346,1,9,4,4,5,single-choice,spatial-relational,4|5,7,4/5,230423,4
6,4,23,424,1,1339,1,7,3,3,4,single-choice,spatial-relational,3|4,7,3/4,230424,3
6,4,23,425,1,1153,1,5,2,2,3,single-choice,spatial-relational,2|3,7,2/3,230425,2
6,4,23,426,1,1141,1,7,3,3,4,single-choice,spatial-relational,3|4,7,3/4,230426,3
6,4,23,427,1,1596,1,11,5,5,6,single-choice,spatial-relational,5|6,7,5/6,230427,5
6,4,23,428,1,1552,1,9,4,4,5,single-choice,spatial-relational,4|5,7,4/5,230428,4
6,4,23,429,1,962,1,3,1,1,2,single-choice,spatial-relational,1|2,7,1/2,230429,1
6,4,23,430,1,1168,1,11,5,5,6,single-choice,spatial-relational,5|6,7,5/6,230430,5
6,4,23,431,1,1133,1,5,2,2,3,single-choice,spatial-relational,2|3,7,2/3,230431,2
6,4,23,432,0,845,1,3,1,2,2,single-choice,spatial-relational,1|2,7,1/2,230432,1
6,4,23,433,1,974,1,13,6,6,7,single-choice,spatial-relational,6|7,7,6/7,230433,6
6,4,23,434,1,1352,1,9,4,4,5,single-choice,spatial-relational,4|5,7,4/5,230434,4
6,4,23,435,1,848,1,3,1,1,2,single-choice,spatial-relational,1|2,7,1/2,230435,1
6,4,23,436,1,823,1,7,3,3,4,single-choice,spatial-relational,3|4,7,3/4,230436,3
6,4,23,437,1,1002,1,3,1,1,2,single-choice,spatial-relational,1|2,7,1/2,230437,1
6,4,23,438,0,800,1,7,3,4,4,single-choice,spatial-relational,3|4,7,3/4,230438,3
6,4,23,439,1,703,1,9,4,4,5,single-choice,spatial-relational,4|5,7,4/5,230439,4
6,4,23,440,0,412,1,13,6,7,7,single-choice,spatial-relational,6|7,7,6/7,230440,6
6,4,23,441,0,980,1,5,2,3,3,single-choice,spatial-relational,2|3,7,2/3,230441,2
6,4,23,442,0,808,1,5,2,3,3,single-choice,spatial-relational,2|3,7,2/3,230442,2
6,4,23,443,1,1781,1,11,5,5,6,single-choice,spatial-relational,5|6,7,5/6,230443,5
6,4,23,444,1,1187,1,11,5,5,6,single-choice,spatial-relational,5|6,7,5/6,230444,5
6,4,23,445,1,868,1,13,6,6,7,single-choice,spatial-relational,6|7,7,6/7,230445,6
6,4,23,446,1,1411,1,5,2,2,3,single-choice,spatial-relational,2|3,7,2/3,230446,2
6,4,23,447,1,772,1,3,1,1,2,single-choice,spatial-relational,1|2,7,1/2,230447,1
6,4,23,448,1,839,1,5,2,2,3,single-choice,spatial-relational,2|3,7,2/3,230448,2
6,4,23,449,1,607,1,13,6,6,7,single-choice,spatial-relational,6|7,7,6/7,230449,6
6,4,23,450,0,901,1,3,1,2,2,single-choice,spatial-relational,1|2,7,1/2,230450,1
6,4,23,451,1,2042,1,7,3,3,4,single-choice,spatial-relational,3|4,7,3/4,230451,3
6,4,23,452,1,950,1,9,4,4,5,single-choice,spatial-relational,4|5,7,4/5,230452,4
6,4,23,453,1,1476,1,11,5,5,6,single-choice,spatial-relational,5|6,7,5/6,230453,5
6,4,23,454,1,2208,1,9,4,4,5,single-choice,spatial-relational,4|5,7,4/5,230454,4
6,4,23,455,1,980,1,11,5,5,6,single-choice,spatial-relational,5|6,7,5/6,230455,5
6,4,23,456,1,1040,1,7,3,3,4,single-choice,spatial-relational,3|4,7,3/4,230456,3
6,4,23,457,1,634,1,13,6,6,7,single-choice,spatial-relational,6|7,7,6/7,230457,6
6,4,23,458,1,1226,1,9,4,4,5,single-choice,spatial-relational,4|5,7,4/5,230458,4
6,4,23,459,0,791,1,11,5,6,6,single-choice,spatial-relational,5|6,7,5/6,230459,5
6,4,23,460,1,2117,1,9,4,4,5,single-choice,spatial-relational,4|5,7,4/5,230460,4
6,4,23,461,1,795,1,7,3,3,4,single-choice,spatial-relational,3|4,7,3/4,230461,3
6,4,23,462,1,1027,1,7,3,3,4,single-choice,spatial-relational,3|4,7,3/4,230462,3
6,4,23,463,1,966,1,3,1,1,2,single-choice,spatial-relational,1|2,7,1/2,230463,1
6,4,23,464,1,821,1,5,2,2,3,single-choice,spatial-relational,2|3,7,2/3,230464,2
6,4,23,465,1,1058,1,5,2,2,3,single-choice,spatial-relational,2|3,7,2/3,230465,2
6,4,23,466,1,831,1,13,6,6,7,single-choice,spatial-relational,6|7,7,6/7,230466,6
6,4,23,467,1,1237,1,11,5,5,6,single-choice,spatial-relational,5|6,7,5/6,230467,5
6,4,23,468,1,1195,1,3,1,1,2,single-choice,spatial-relational,1|2,7,1/2,230468,1
6,4,23,469,1,780,1,11,5,5,6,single-choice,spatial-relational,5|6,7,5/6,230469,5
6,4,23,470,1,914,1,13,6,6,7,single-choice,spatial-relational,6|7,7,6/7,230470,6
6,4,23,471,1,1162,1,11,5,5,6,single-choice,spatial-relational,5|6,7,5/6,230471,5
6,4,23,472,0,991,1,3,1,2,2,single-choice,spatial-relational,1|2,7,1/2,230472,1
6,4,23,473,0,776,1,3,1,2,2,single-choice,spatial-relational,1|2,7,1/2,230473,1
6,4,23,474,1,798,1,13,6,6,7,single-choice,spatial-relational,6|7,7,6/7,230474,6
6,4,23,475,1,2232,1,9,4,4,5,single-choice,spatial-relational,4|5,7,4/5,230475,4
6,4,23,476,0,847,1,7,3,4,4,single-choice,spatial-relational,3|4,7,3/4,230476,3
6,4,23,477,0,860,1,5,2,3,3,single-choice,spatial-relational,2|3,7,2/3,230477,2
6,4,23,478,1,955,1,7,3,3,4,single-choice,spatial-relational,3|4,7,3/4,230478,3
6,4,23,479,0,2856,1,5,2,3,3,single-choice,spatial-relational,2|3,7,2/3,230479,2
6,4,23,480,0,510,1,9,4,5,5,single-choice,spatial-relational,4|5,7,4/5,230480,4
6,4,23,481,0,995,1,11,5,6,6,single-choice,spatial-relational,5|6,7,5/6,230481,5
6,4,23,482,1,1064,1,9,4,4,5,single-choice,spatial-relational,4|5,7,4/5,230482,4
6,4,23,483,0,1128,1,3,1,2,2,single-choice,spatial-relational,1|2,7,1/2,230483,1
6,4,23,484,0,993,1,9,4,5,5,single-choice,spatial-relational,4|5,7,4/5,230484,4
6,4,23,485,0,1790,1,11,5,6,6,single-choice,spatial-relational,5|6,7,5/6,230485,5
6,4,23,486,1,1112,1,5,2,2,3,single-choice,spatial-relational,2|3,7,2/3,230486,2
6,4,23,487,1,1105,1,5,2,2,3,single-choice,spatial-relational,2|3,7,2/3,230487,2
6,4,23,488,1,2015,1,7,3,3,4,single-choice,spatial-relational,3|4,7,3/4,230488,3
6,4,23,489,1,784,1,13,6,6,7,single-choice,spatial-relational,6|7,7,6/7,230489,6
6,4,23,490,1,1056,1,3,1,1,2,single-choice,spatial-relational,1|2,7,1/2,230490,1
6,4,23,491,1,763,1,13,6,6,7,single-choice,spatial-relational,6|7,7,6/7,230491,6
6,4,23,492,1,827,1,7,3,3,4,single-choice,spatial-relational,3|4,7,3/4,230492,3
6,4,23,493,1,879,1,13,6,6,7,single-choice,spatial-relational,6|7,7,6/7,230493,6
6,4,23,494,0,1396,1,9,4,5,5,single-choice,spatial-relational,4|5,7,4/5,230494,4
6,4,23,495,1,2119,1,9,4,4,5,single-choice,spatial-relational,4|5,7,4/5,230495,4
6,4,23,496,0,846,1,7,3,4,4,single-choice,spatial-relational,3|4,7,3/4,230496,3
6,4,23,497,0,1729,1,3,1,2,2,single-choice,spatial-relational,1|2,7,1/2,230497,1
6,4,23,498,0,644,1,3,1,2,2,single-choice,spatial-relational,1|2,7,1/2,230498,1
6,4,23,499,1,1181,1,5,2,2,3,single-choice,spatial-relational,2|3,7,2/3,230499,2
6,4,23,500,1,929,1,7,3,3,4,single-choice,spatial-relational,3|4,7,3/4,230500,3
6,4,23,501,1,968,1,11,5,5,6,single-choice,spatial-relational,5|6,7,5/6,230501,5
6,4,23,502,1,1040,1,11,5,5,6,single-choice,spatial-relational,5|6,7,5/6,230502,5
6,4,23,503,1,2306,1,5,2,2,3,single-choice,spatial-relational,2|3,7,2/3,230503,2
6,4,23,504,1,619,1,13,6,6,7,single-choice,spatial-relational,6|7,7,6/7,230504,6
6,4,23,505,1,996,1,11,5,5,6,single-choice,spatial-relational,5|6,7,5/6,230505,5
6,4,23,506,1,988,1,3,1,1,2,single-choice,spatial-relational,1|2,7,1/2,230506,1
6,4,23,507,1,1023,1,9,4,4,5,single-choice,spatial-relational,4|5,7,4/5,230507,4
6,4,23,508,0,1164,1,5,2,3,3,single-choice,spatial-relational,2|3,7,2/3,230508,2
6,4,23,509,1,880,1,13,6,6,7,single-choice,spatial-relational,6|7,7,6/7,230509,6
6,4,23,510,1,921,1,7,3,3,4,single-choice,spatial-relational,3|4,7,3/4,230510,3
6,4,23,511,1,864,1,13,6,6,7,single-choice,spatial-relational,6|7,7,6/7,230511,6
6,4,23,512,0,1003,1,3,1,2,2,single-choice,spatial-relational,1|2,7,1/2,230512,1
6,4,23,513,1,1873,1,9,4,4,5,single-choice,spatial-relational,4|5,7,4/5,230513,4
6,4,23,514,0,688,1,5,2,3,3,single-choice,spatial-relational,2|3,7,2/3,230514,2
6,4,23,515,1,904,1,7,3,3,4,single-choice,spatial-relational,3|4,7,3/4,230515,3
6,4,23,516,1,923,1,11,5,5,6,single-choice,spatial-relational,5|6,7,5/6,230516,5
6,4,23,517,1,695,1,13,6,6,7,single-choice,spatial-relational,6|7,7,6/7,230517,6
6,4,23,518,0,871,1,3,1,2,2,single-choice,spatial-relational,1|2,7,1/2,230518,1
6,4,23,519,1,1109,1,5,2,2,3,single-choice,spatial-relational,2|3,7,2/3,230519,2
6,4,23,520,1,750,1,13,6,6,7,single-choice,spatial-relational,6|7,7,6/7,230520,6
6,4,23,521,1,1105,1,3,1,1,2,single-choice,spatial-relational,1|2,7,1/2,230521,1
6,4,23,522,1,837,1,9,4,4,5,single-choice,spatial-relational,4|5,7,4/5,230522,4
6,4,23,523,1,1773,1,11,5,5,6,single-choice,spatial-relational,5|6,7,5/6,230523,5
6,4,23,524,1,1143,1,7,3,3,4,single-choice,spatial-relational,3|4,7,3/4,230524,3
6,4,23,525,1,965,1,11,5,5,6,single-choice,spatial-relational,5|6,7,5/6,230525,5
6,4,23,526,1,1715,1,5,2,2,3,single-choice,spatial-relational,2|3,7,2/3,230526,2
6,4,23,527,1,861,1,7,3,3,4,single-choice,spatial-relational,3|4,7,3/4,230527,3
6,4,23,528,1,843,1,9,4,4,5,single-choice,spatial-relational,4|5,7,4/5,230528,4
6,4,23,529,0,2971,1,3,1,2,2,single-choice,spatial-relational,1|2,7,1/2,230529,1
6,4,23,530,0,38795,1,11,5,6,6,single-choice,spatial-relational,5|6,7,5/6,230530,5
6,4,23,531,1,2645,1,3,1,1,2,single-choice,spatial-relational,1|2,7,1/2,230531,1
6,4,23,532,1,1915,1,9,4,4,5,single-choice,spatial-relational,4|5,7,4/5,230532,4
6,4,23,533,1,1041,1,7,3,3,4,single-choice,spatial-relational,3|4,7,3/4,230533,3
6,4,23,534,1,1388,1,9,4,4,5,single-choice,spatial-relational,4|5,7,4/5,230534,4
6,4,23,535,1,1499,1,11,5,5,6,single-choice,spatial-relational,5|6,7,5/6,230535,5
6,4,23,536,1,948,1,13,6,6,7,single-choice,spatial-relational,6|7,7,6/7,230536,6
6,4,23,537,1,1093,1,7,3,3,4,single-choice,spatial-relational,3|4,7,3/4,230537,3
6,4,23,538,1,1015,1,5,2,2,3,single-choice,spatial-relational,2|3,7,2/3,230538,2
6,4,23,539,1,804,1,5,2,2,3,single-choice,spatial-relational,2|3,7,2/3,230539,2
6,4,23,540,1,615,1,13,6,6,7,single-choice,spatial-relational,6|7,7,6/7,230540,6
6,4,23,541,1,889,1,11,5,5,6,single-choice,spatial-relational,5|6,7,5/6,230541,5
6,4,23,542,1,1158,1,9,4,4,5,single-choice,spatial-relational,4|5,7,4/5,230542,4
6,4,23,543,1,1379,1,9,4,4,5,single-choice,spatial-relational,4|5,7,4/5,230543,4
6,4,23,544,1,877,1,7,3,3,4,single-choice,spatial-relational,3|4,7,3/4,230544,3
6,4,23,545,1,717,1,13,6,6,7,single-choice,spatial-relational,6|7,7,6/7,230545,6
6,4,23,546,1,603,1,5,2,2,3,single-choice,spatial-relational,2|3,7,2/3,230546,2
6,4,23,547,1,943,1,5,2,2,3,single-choice,spatial-relational,2|3,7,2/3,230547,2
6,4,23,548,1,896,1,13,6,6,7,single-choice,spatial-relational,6|7,7,6/7,230548,6
6,4,23,549,1,899,1,3,1,1,2,single-choice,spatial-relational,1|2,7,1/2,230549,1
6,4,23,550,1,781,1,11,5,5,6,single-choice,spatial-relational,5|6,7,5/6,230550,5
6,4,23,551,1,2226,1,7,3,3,4,single-choice,spatial-relational,3|4,7,3/4,230551,3
6,4,23,552,1,1299,1,3,1,1,2,single-choice,spatial-relational,1|2,7,1/2,230552,1
6,4,23,553,0,1033,1,5,2,3,3,single-choice,spatial-relational,2|3,7,2/3,230553,2
6,4,23,554,1,2014,1,13,6,6,7,single-choice,spatial-relational,6|7,7,6/7,230554,6
6,4,23,555,1,941,1,11,5,5,6,single-choice,spatial-relational,5|6,7,5/6,230555,5
6,4,23,556,1,978,1,9,4,4,5,single-choice,spatial-relational,4|5,7,4/5,230556,4
6,4,23,557,1,1370,1,9,4,4,5,single-choice,spatial-relational,4|5,7,4/5,230557,4
6,4,23,558,1,870,1,13,6,6,7,single-choice,spatial-relational,6|7,7,6/7,230558,6
6,4,23,559,1,1358,1,5,2,2,3,single-choice,spatial-relational,2|3,7,2/3,230559,2
6,4,23,560,1,986,1,11,5,5,6,single-choice,spatial-relational,5|6,7,5/6,230560,5
6,4,23,561,1,1180,1,3,1,1,2,single-choice,spatial-relational,1|2,7,1/2,230561,1
6,4,23,562,1,840,1,3,1,1,2,single-choice,spatial-relational,1|2,7,1/2,230562,1
6,4,23,563,1,804,1,7,3,3,4,single-choice,spatial-relational,3|4,7,3/4,230563,3
6,4,23,564,1,603,1,7,3,3,4,single-choice,spatial-relational,3|4,7,3/4,230564,3
6,4,23,565,1,1324,1,9,4,4,5,single-choice,spatial-relational,4|5,7,4/5,230565,4
6,4,23,566,1,805,1,13,6,6,7,single-choice,spatial-relational,6|7,7,6/7,230566,6
6,4,23,567,0,682,1,5,2,3,3,single-choice,spatial-relational,2|3,7,2/3,230567,2
6,4,23,568,1,762,1,7,3,3,4,single-choice,spatial-relational,3|4,7,3/4,230568,3
6,4,23,569,1,916,1,5,2,2,3,single-choice,spatial-relational,2|3,7,2/3,230569,2
6,4,23,570,1,1042,1,11,5,5,6,single-choice,spatial-relational,5|6,7,5/6,230570,5
6,4,23,571,1,952,1,13,6,6,7,single-choice,spatial-relational,6|7,7,6/7,230571,6
6,4,23,572,1,988,1,7,3,3,4,single-choice,spatial-relational,3|4,7,3/4,230572,3
6,4,23,573,1,1029,1,9,4,4,5,single-choice,spatial-relational,4|5,7,4/5,230573,4
6,4,23,574,0,1190,1,11,5,6,6,single-choice,spatial-relational,5|6,7,5/6,230574,5
6,4,23,575,1,939,1,3,1,1,2,single-choice,spatial-relational,1|2,7,1/2,230575,1
6,4,23,576,0,4007,1,3,1,2,2,single-choice,spatial-relational,1|2,7,1/2,230576,1
6,4,23,577,1,988,1,9,4,4,5,single-choice,spatial-relational,4|5,7,4/5,230577,4
6,4,23,578,1,881,1,11,5,5,6,single-choice,spatial-relational,5|6,7,5/6,230578,5
6,4,23,579,1,1198,1,3,1,1,2,single-choice,spatial-relational,1|2,7,1/2,230579,1
6,4,23,580,1,977,1,11,5,5,6,single-choice,spatial-relational,5|6,7,5/6,230580,5
6,4,23,581,1,1310,1,7,3,3,4,single-choice,spatial-relational,3|4,7,3/4,230581,3
6,4,23,582,1,1060,1,7,3,3,4,single-choice,spatial-relational,3|4,7,3/4,230582,3
6,4,23,583,1,1195,1,5,2,2,3,single-choice,spatial-relational,2|3,7,2/3,230583,2
6,4,23,584,1,912,1,5,2,2,3,single-choice,spatial-relational,2|3,7,2/3,230584,2
6,4,23,585,1,1309,1,9,4,4,5,single-choice,spatial-relational,4|5,7,4/5,230585,4
6,4,23,586,1,930,1,3,1,1,2,single-choice,spatial-relational,1|2,7,1/2,230586,1
6,4,23,587,1,784,1,13,6,6,7,single-choice,spatial-relational,6|7,7,6/7,230587,6
6,4,23,588,1,634,1,13,6,6,7,single-choice,spatial-relational,6|7,7,6/7,230588,6
6,4,23,589,1,1258,1,7,3,3,4,single-choice,spatial-relational,3|4,7,3/4,230589,3
6,4,23,590,1,791,1,5,2,2,3,single-choice,spatial-relational,2|3,7,2/3,230590,2
6,4,23,591,1,802,1,3,1,1,2,single-choice,spatial-relational,1|2,7,1/2,230591,1
6,4,23,592,1,859,1,9,4,4,5,single-choice,spatial-relational,4|5,7,4/5,230592,4
6,4,23,593,1,1107,1,11,5,5,6,single-choice,spatial-relational,5|6,7,5/6,230593,5
6,4,23,594,1,918,1,13,6,6,7,single-choice,spatial-relational,6|7,7,6/7,230594,6
6,4,23,595,1,1092,1,5,2,2,3,single-choice,spatial-relational,2|3,7,2/3,230595,2
6,4,23,596,1,1202,1,11,5,5,6,single-choice,spatial-relational,5|6,7,5/6,230596,5
6,4,23,597,1,913,1,9,4,4,5,single-choice,spatial-relational,4|5,7,4/5,230597,4
6,4,23,598,1,960,1,7,3,3,4,single-choice,spatial-relational,3|4,7,3/4,230598,3
6,4,23,599,1,812,1,13,6,6,7,single-choice,spatial-relational,6|7,7,6/7,230599,6
6,4,23,600,0,835,1,3,1,2,2,single-choice,spatial-relational,1|2,7,1/2,230600,1
7,4,23,1,0,1382,1,13,6,7,7,single-choice,spatial-relational,6|7,7,6/7,230001,6
7,4,23,2,0,1058,1,7,3,4,4,single-choice,spatial-relational,3|4,7,3/4,230002,3
7,4,23,3,1,806,1,9,4,4,5,single-choice,spatial-relational,4|5,7,4/5,230003,4
7,4,23,4,1,1084,1,13,6,6,7,single-choice,spatial-relational,6|7,7,6/7,230004,6
7,4,23,5,1,729,1,5,2,2,3,single-choice,spatial-relational,2|3,7,2/3,230005,2
7,4,23,6,1,1206,1,11,5,5,6,single-choice,spatial-relational,5|6,7,5/6,230006,5
7,4,23,7,1,1356,1,9,4,4,5,single-choice,spatial-relational,4|5,7,4/5,230007,4
7,4,23,8,0,1219,1,3,1,2,2,single-choice,spatial-relational,1|2,7,1/2,230008,1
7,4,23,9,0,871,1,3,1,2,2,single-choice,spatial-relational,1|2,7,1/2,230009,1
7,4,23,10,1,813,1,7,3,3,4,single-choice,spatial-relational,3|4,7,3/4,230010,3
7,4,23,11,1,863,1,11,5,5,6,single-choice,spatial-relational,5|6,7,5/6,230011,5
7,4,23,12,1,1212,1,5,2,2,3,single-choice,spatial-relational,2|3,7,2/3,230012,2
7,4,23,13,1,1497,1,3,1,1,2,single-choice,spatial-relational,1|2,7,1/2,230013,1
7,4,23,14,1,1040,1,5,2,2,3,single-choice,spatial-relational,2|3,7,2/3,230014,2
7,4,23,15,1,632,1,13,6,6,7,single-choice,spatial-relational,6|7,7,6/7,230015,6
7,4,23,16,1,1059,1,11,5,5,6,single-choice,spatial-relational,5|6,7,5/6,230016,5
7,4,23,17,1,993,1,11,5,5,6,single-choice,spatial-relational,5|6,7,5/6,230017,5
7,4,23,18,1,705,1,9,4,4,5,single-choice,spatial-relational,4|5,7,4/5,230018,4
7,4,23,19,1,1759,1,7,3,3,4,single-choice,spatial-relational,3|4,7,3/4,230019,3
7,4,23,20,1,1147,1,9,4,4,5,single-choice,spatial-relational,4|5,7,4/5,230020,4
7,4,23,21,1,837,1,13,6,6,7,single-choice,spatial-relational,6|7,7,6/7,230021,6
7,4,23,22,1,1288,1,7,3,3,4,single-choice,spatial-relational,3|4,7,3/4,230022,3
7,4,23,23,1,1021,1,5,2,2,3,single-choice,spatial-relational,2|3,7,2/3,230023,2
7,4,23,24,1,1235,1,3,1,1,2,single-choice,spatial-relational,1|2,7,1/2,230024,1
7,4,23,25,1,761,1,13,6,6,7,single-choice,spatial-relational,6|7,7,6/7,230025,6
7,4,23,26,0,744,1,9,4,5,5,single-choice,spatial-relational,4|5,7,4/5,230026,4
7,4,23,27,1,901,1,5,2,2,3,single-choice,spatial-relational,2|3,7,2/3,230027,2
7,4,23,28,1,669,1,5,2,2,3,single-choice,spatial-relational,2|3,7,2/3,230028,2
7,4,23,29,1,814,1,3,1,1,2,single-choice,spatial-relational,1|2,7,1/2,230029,1
7,4,23,30,1,1023,1,3,1,1,2,single-choice,spatial-relational,1|2,7,1/2,230030,1
7,4,23,31,0,831,1,11,5,6,6,single-choice,spatial-relational,5|6,7,5/6,230031,5
7,4,23,32,1,860,1,9,4,4,5,single-choice,spatial-relational,4|5,7,4/5,230032,4
7,4,23,33,1,927,1,11,5,5,6,single-choice,spatial-relational,5|6,7,5/6,230033,5
7,4,23,34,1,1042,1,7,3,3,4,single-choice,spatial-relational,3|4,7,3/4,230034,3
7,4,23,35,1,868,1,13,6,6,7,single-choice,spatial-relational,6|7,7,6/7,230035,6
7,4,23,36,1,1089,1,7,3,3,4,single-choice,spatial-relational,3|4,7,3/4,230036,3
7,4,23,37,1,1061,1,7,3,3,4,single-choice,spatial-relational,3|4,7,3/4,230037,3
7,4,23,38,1,977,1,5,2,2,3,single-choice,spatial-relational,2|3,7,2/3,230038,2
7,4,23,39,1,922,1,3,1,1,2,single-choice,spatial-relational,1|2,7,1/2,230039,1
7,4,23,40,1,938,1,9,4,4,5,single-choice,spatial-relational,4|5,7,4/5,230040,4
7,4,23,41,1,1988,1,11,5,5,6,single-choice,spatial-relational,5|6,7,5/6,230041,5
7,4,23,42,1,1728,1,11,5,5,6,single-choice,spatial-relational,5|6,7,5/6,230042,5
7,4,23,43,1,888,1,9,4,4,5,single-choice,spatial-relational,4|5,7,4/5,230043,4
7,4,23,44,1,1605,1,5,2,2,3,single-choice,spatial-relational,2|3,7,2/3,230044,2
7,4,23,45,1,564,1,13,6,6,7,single-choice,spatial-relational,6|7,7,6/7,230045,6
7,4,23,46,1,1082,1,7,3,3,4,single-choice,spatial-relational,3|4,7,3/4,230046,3
7,4,23,47,1,1063,1,3,1,1,2,single-choice,spatial-relational,1|2,7,1/2,230047,1
7,4,23,48,1,789,1,13,6,6,7,single-choice,spatial-relational,6|7,7,6/7,230048,6
7,4,23,49,1,845,1,9,4,4,5,single-choice,spatial-relational,4|5,7,4/5,230049,4
7,4,23,50,1,1016,1,5,2,2,3,single-choice,spatial-relational,2|3,7,2/3,230050,2
7,4,23,51,1,1059,1,5,2,2,3,single-choice,spatial-relational,2|3,7,2/3,230051,2
7,4,23,52,1,924,1,11,5,5,6,single-choice,spatial-relational,5|6,7,5/6,230052,5
7,4,23,53,1,1152,1,11,5,5,6,single-choice,spatial-relational,5|6,7,5/6,230053,5
7,4,23,54,1,798,1,3,1,1,2,single-choice,spatial-relational,1|2,7,1/2,230054,1
7,4,23,55,1,1119,1,9,4,4,5,single-choice,spatial-relational,4|5,7,4/5,230055,4
7,4,23,56,1,909,1,13,6,6,7,single-choice,spatial-relational,6|7,7,6/7,230056,6
7,4,23,57,1,882,1,3,1,1,2,single-choice,spatial-relational,1|2,7,1/2,230057,1
7,4,23,58,0,5002,1,7,3,4,4,single-choice,spatial-relational,3|4,7,3/4,230058,3
7,4,23,59,1,255,1,7,3,3,4,single-choice,spatial-relational,3|4,7,3/4,230059,3
7,4,23,60,1,698,1,13,6,6,7,single-choice,spatial-relational,6|7,7,6/7,230060,6
7,4,23,61,1,1322,1,9,4,4,5,single-choice,spatial-relational,4|5,7,4/5,230061,4
7,4,23,62,1,909,1,3,1,1,2,single-choice,spatial-relational,1|2,7,1/2,230062,1
7,4,23,63,1,724,1,11,5,5,6,single-choice,spatial-relational,5|6,7,5/6,230063,5
7,4,23,64,1,1252,1,7,3,3,4,single-choice,spatial-relational,3|4,7,3/4,230064,3
7,4,23,65,1,1132,1,3,1,1,2,single-choice,spatial-relational,1|2,7,1/2,230065,1
7,4,23,66,1,791,1,5,2,2,3,single-choice,spatial-relational,2|3,7,2/3,230066,2
7,4,23,67,1,824,1,7,3,3,4,single-choice,spatial-relational,3|4,7,3/4,230067,3
7,4,23,68,1,876,1,13,6,6,7,single-choice,spatial-relational,6|7,7,6/7,230068,6
7,4,23,69,0,1074,1,9,4,5,5,single-choice,spatial-relational,4|5,7,4/5,230069,4
7,4,23,70,1,1156,1,11,5,5,6,single-choice,spatial-relational,5|6,7,5/6,230070,5
7,4,23,71,1,926,1,5,2,2,3,single-choice,spatial-relational,2|3,7,2/3,230071,2
7,4,23,72,1,610,1,13,6,6,7,single-choice,spatial-relational,6|7,7,6/7,230072,6
7,4,23,73,1,920,1,13,6,6,7,single-choice,spatial-relational,6|7,7,6/7,230073,6
7,4,23,74,1,2093,1,7,3,3,4,single-choice,spatial-relational,3|4,7,3/4,230074,3
7,4,23,75,0,690,1,5,2,3,3,single-choice,spatial-relational,2|3,7,2/3,230075,2
7,4,23,76,0,1387,1,7,3,4,4,single-choice,spatial-relational,3|4,7,3/4,230076,3
7,4,23,77,1,900,1,9,4,4,5,single-choice,spatial-relational,4|5,7,4/5,230077,4
7,4,23,78,1,1035,1,9,4,4,5,single-choice,spatial-relational,4|5,7,4/5,230078,4
7,4,23,79,1,1078,1,5,2,2,3,single-choice,spatial-relational,2|3,7,2/3,230079,2
7,4,23,80,1,1754,1,11,5,5,6,single-choice,spatial-relational,5|6,7,5/6,230080,5
7,4,23,81,0,1254,1,11,5,6,6,single-choice,spatial-relational,5|6,7,5/6,230081,5
7,4,23,82,0,436,1,3,1,2,2,single-choice,spatial-relational,1|2,7,1/2,230082,1
7,4,23,83,1,958,1,13,6,6,7,single-choice,spatial-relational,6|7,7,6/7,230083,6
7,4,23,84,1,1336,1,3,1,1,2,single-choice,spatial-relational,1|2,7,1/2,230084,1
7,4,23,85,1,525,1,3,1,1,2,single-choice,spatial-relational,1|2,7,1/2,230085,1
7,4,23,86,1,807,1,9,4,4,5,single-choice,spatial-relational,4|5,7,4/5,230086,4
7,4,23,87,1,682,1,13,6,6,7,single-choice,spatial-relational,6|7,7,6/7,230087,6
7,4,23,88,0,801,1,7,3,4,4,single-choice,spatial-relational,3|4,7,3/4,230088,3
7,4,23,89,0,1889,1,11,5,6,6,single-choice,spatial-relational,5|6,7,5/6,230089,5
7,4,23,90,1,743,1,9,4,4,5,single-choice,spatial-relational,4|5,7,4/5,230090,4
7,4,23,91,1,937,1,5,2,2,3,single-choice,spatial-relational,2|3,7,2/3,230091,2
7,4,23,92,1,755,1,13,6,6,7,single-choice,spatial-relational,6|7,7,6/7,230092,6
7,4,23,93,1,1397,1,11,5,5,6,single-choice,spatial-relational,5|6,7,5/6,230093,5
7,4,23,94,1,930,1,7,3,3,4,single-choice,spatial-relational,3|4,7,3/4,230094,3
7,4,23,95,1,752,1,3,1,1,2,single-choice,spatial-relational,1|2,7,1/2,230095,1
7,4,23,96,1,841,1,5,2,2,3,single-choice,spatial-relational,2|3,7,2/3,230096,2
7,4,23,97,0,593,1,5,2,3,3,single-choice,spatial-relational,2|3,7,2/3,230097,2
7,4,23,98,0,475,1,11,5,6,6,single-choice,spatial-relational,5|6,7,5/6,230098,5
7,4,23,99,1,468,1,3,1,1,2,single-choice,spatial-relational,1|2,7,1/2,230099,1
7,4,23,100,1,1009,1,7,3,3,4,single-choice,spatial-relational,3|4,7,3/4,230100,3
7,4,23,101,1,938,1,7,3,3,4,single-choice,spatial-relational,3|4,7,3/4,230101,3
7,4,23,102,1,766,1,13,6,6,7,single-choice,spatial-relational,6|7,7,6/7,230102,6
7,4,23,103,1,1075,1,13,6,6,7,single-choice,spatial-relational,6|7,7,6/7,230103,6
7,4,23,104,1,845,1,3,1,1,2,single-choice,spatial-relational,1|2,7,1/2,230104,1
7,4,23,105,1,877,1,11,5,5,6,single-choice,spatial-relational,5|6,7,5/6,230105,5
7,4,23,106,1,1239,1,5,2,2,3,single-choice,spatial-relational,2|3,7,2/3,230106,2
7,4,23,107,1,969,1,9,4,4,5,single-choice,spatial-relational,4|5,7,4/5,230107,4
7,4,23,108,1,654,1,9,4,4,5,single-choice,spatial-relational,4|5,7,4/5,230108,4
7,4,23,109,0,643,1,7,3,4,4,single-choice,spatial-relational,3|4,7,3/4,230109,3
7,4,23,110,1,907,1,9,4,4,5,single-choice,spatial-relational,4|5,7,4/5,230110,4
7,4,23,111,1,969,1,11,5,5,6,single-choice,spatial-relational,5|6,7,5/6,230111,5
7,4,23,112,0,663,1,3,1,2,2,single-choice,spatial-relational,1|2,7,1/2,230112,1
7,4,23,113,1,1275,1,13,6,6,7,single-choice,spatial-relational,6|7,7,6/7,230113,6
7,4,23,114,1,1350,1,11,5,5,6,single-choice,spatial-relational,5|6,7,5/6,230114,5
7,4,23,115,1,750,1,3,1,1,2,single-choice,spatial-relational,1|2,7,1/2,230115,1
7,4,23,116,1,762,1,9,4,4,5,single-choice,spatial-relational,4|5,7,4/5,230116,4
7,4,23,117,1,965,1,5,2,2,3,single-choice,spatial-relational,2|3,7,2/3,230117,2
7,4,23,118,1,791,1,5,2,2,3,single-choice,spatial-relational,2|3,7,2/3,230118,2
7,4,23,119,1,1222,1,7,3,3,4,single-choice,spatial-relational,3|4,7,3/4,230119,3
7,4,23,120,1,673,1,13,6,6,7,single-choice,spatial-relational,6|7,7,6/7,230120,6
7,4,23,121,1,718,1,13,6,6,7,single-choice,spatial-relational,6|7,7,6/7,230121,6
7,4,23,122,0,959,1,7,3,4,4,single-choice,spatial-relational,3|4,7,3/4,230122,3
7,4,23,123,1,894,1,3,1,1,2,single-choice,spatial-relational,1|2,7,1/2,230123,1
7,4,23,124,1,870,1,5,2,2,3,single-choice,spatial-relational,2|3,7,2/3,230124,2
7,4,23,125,1,1198,1,11,5,5,6,single-choice,spatial-relational,5|6,7,5/6,230125,5
7,4,23,126,1,1529,1,9,4,4,5,single-choice,spatial-relational,4|5,7,4/5,230126,4
7,4,23,127,1,847,1,3,1,1,2,single-choice,spatial-relational,1|2,7,1/2,230127,1
7,4,23,128,1,771,1,13,6,6,7,single-choice,spatial-relational,6|7,7,6/7,230128,6
7,4,23,129,1,928,1,11,5,5,6,single-choice,spatial-relational,5|6,7,5/6,230129,5
7,4,23,130,1,1187,1,7,3,3,4,single-choice,spatial-relational,3|4,7,3/4,230130,3
7,4,23,131,1,733,1,5,2,2,3,single-choice,spatial-relational,2|3,7,2/3,230131,2
7,4,23,132,1,958,1,9,4,4,5,single-choice,spatial-relational,4|5,7,4/5,230132,4
7,4,23,133,1,2494,1,9,4,4,5,single-choice,spatial-relational,4|5,7,4/5,230133,4
7,4,23,134,1,1284,1,11,5,5,6,single-choice,spatial-relational,5|6,7,5/6,230134,5
7,4,23,135,1,1209,1,11,5,5,6,single-choice,spatial-relational,5|6,7,5/6,230135,5
7,4,23,136,0,1452,1,7,3,4,4,single-choice,spatial-relational,3|4,7,3/4,230136,3
7,4,23,137,1,1018,1,5,2,2,3,single-choice,spatial-relational,2|3,7,2/3,230137,2
7,4,23,138,1,911,1,5,2,2,3,single-choice,spatial-relational,2|3,7,2/3,230138,2
7,4,23,139,1,913,1,3,1,1,2,single-choice,spatial-relational,1|2,7,1/2,230139,1
7,4,23,140,1,573,1,13,6,6,7,single-choice,spatial-relational,6|7,7,6/7,230140,6
7,4,23,141,1,804,1,13,6,6,7,single-choice,spatial-relational,6|7,7,6/7,230141,6
7,4,23,142,1,817,1,3,1,1,2,single-choice,spatial-relational,1|2,7,1/2,230142,1
7,4,23,143,1,1134,1,9,4,4,5,single-choice,spatial-relational,4|5,7,4/5,230143,4
7,4,23,144,1,961,1,7,3,3,4,single-choice,spatial-relational,3|4,7,3/4,230144,3
7,4,23,145,1,1101,1,5,2,2,3,single-choice,spatial-relational,2|3,7,2/3,230145,2
7,4,23,146,1,1292,1,9,4,4,5,single-choice,spatial-relational,4|5,7,4/5,230146,4
7,4,23,147,1,1000,1,7,3,3,4,single-choice,spatial-relational,3|4,7,3/4,230147,3
7,4,23,148,0,809,1,9,4,5,5,single-choice,spatial-relational,4|5,7,4/5,230148,4
7,4,23,149,1,1288,1,11,5,5,6,single-choice,spatial-relational,5|6,7,5/6,230149,5
7,4,23,150,1,840,1,13,6,6,7,single-choice,spatial-relational,6|7,7,6/7,230150,6
7,4,23,151,1,724,1,3,1,1,2,single-choice,spatial-relational,1|2,7,1/2,230151,1
7,4,23,152,1,922,1,7,3,3,4,single-choice,spatial-relational,3|4,7,3/4,230152,3
7,4,23,153,1,873,1,13,6,6,7,single-choice,spatial-relational,6|7,7,6/7,230153,6
7,4,23,154,1,759,1,5,2,2,3,single-choice,spatial-relational,2|3,7,2/3,230154,2
7,4,23,155,1,1241,1,11,5,5,6,single-choice,spatial-relational,5|6,7,5/6,230155,5
7,4,23,156,1,1253,1,3,1,1,2,single-choice,spatial-relational,1|2,7,1/2,230156,1
7,4,23,157,1,842,1,7,3,3,4,single-choice,spatial-relational,3|4,7,3/4,230157,3
7,4,23,158,1,817,1,13,6,6,7,single-choice,spatial-relational,6|7,7,6/7,230158,6
7,4,23,159,1,973,1,7,3,3,4,single-choice,spatial-relational,3|4,7,3/4,230159,3
7,4,23,160,1,57974,1,9,4,4,5,single-choice,spatial-relational,4|5,7,4/5,230160,4
7,4,23,161,1,778,1,3,1,1,2,single-choice,spatial-relational,1|2,7,1/2,230161,1
7,4,23,162,1,1073,1,11,5,5,6,single-choice,spatial-relational,5|6,7,5/6,230162,5
7,4,23,163,1,580,1,13,6,6,7,single-choice,spatial-relational,6|7,7,6/7,230163,6
7,4,23,164,1,718,1,3,1,1,2,single-choice,spatial-relational,1|2,7,1/2,230164,1
7,4,23,165,1,1246,1,5,2,2,3,single-choice,spatial-relational,2|3,7,2/3,230165,2
7,4,23,166,1,1064,1,9,4,4,5,single-choice,spatial-relational,4|5,7,4/5,230166,4
7,4,23,167,1,1584,1,11,5,5,6,single-choice,spatial-relational,5|6,7,5/6,230167,5
7,4,23,168,1,1184,1,5,2,2,3,single-choice,spatial-relational,2|3,7,2/3,230168,2
7,4,23,169,1,872,1,11,5,5,6,single-choice,spatial-relational,5|6,7,5/6,230169,5
7,4,23,170,1,557,1,13,6,6,7,single-choice,spatial-relational,6|7,7,6/7,230170,6
7,4,23,171,1,974,1,7,3,3,4,single-choice,spatial-relational,3|4,7,3/4,230171,3
7,4,23,172,1,925,1,9,4,4,5,single-choice,spatial-relational,4|5,7,4/5,230172,4
7,4,23,173,1,737,1,5,2,2,3,single-choice,spatial-relational,2|3,7,2/3,230173,2
7,4,23,174,0,702,1,7,3,4,4,single-choice,spatial-relational,3|4,7,3/4,230174,3
7,4,23,175,0,53,1,3,1,2,2,single-choice,spatial-relational,1|2,7,1/2,230175,1
7,4,23,176,1,1483,1,5,2,2,3,single-choice,spatial-relational,2|3,7,2/3,230176,2
7,4,23,177,1,966,1,9,4,4,5,single-choice,spatial-relational,4|5,7,4/5,230177,4
7,4,23,178,1,836,1,13,6,6,7,single-choice,spatial-relational,6|7,7,6/7,230178,6
7,4,23,179,1,1753,1,11,5,5,6,single-choice,spatial-relational,5|6,7,5/6,230179,5
7,4,23,180,1,694,1,3,1,1,2,single-choice,spatial-relational,1|2,7,1/2,230180,1
7,4,23,181,1,781,1,9,4,4,5,single-choice,spatial-relational,4|5,7,4/5,230181,4
7,4,23,182,1,1045,1,7,3,3,4,single-choice,spatial-relational,3|4,7,3/4,230182,3
7,4,23,183,1,719,1,5,2,2,3,single-choice,spatial-relational,2|3,7,2/3,230183,2
7,4,23,184,1,948,1,9,4,4,5,single-choice,spatial-relational,4|5,7,4/5,230184,4
7,4,23,185,1,847,1,7,3,3,4,single-choice,spatial-relational,3|4,7,3/4,230185,3
7,4,23,186,1,1126,1,11,5,5,6,single-choice,spatial-relational,5|6,7,5/6,230186,5
7,4,23,187,1,604,1,13,6,6,7,single-choice,spatial-relational,6|7,7,6/7,230187,6
7,4,23,188,1,884,1,11,5,5,6,single-choice,spatial-relational,5|6,7,5/6,230188,5
7,4,23,189,1,1098,1,5,2,2,3,single-choice,spatial-relational,2|3,7,2/3,230189,2
7,4,23,190,0,1161,1,3,1,2,2,single-choice,spatial-relational,1|2,7,1/2,230190,1
7,4,23,191,1,950,1,13,6,6,7,single-choice,spatial-relational,6|7,7,6/7,230191,6
7,4,23,192,1,789,1,3,1,1,2,single-choice,spatial-relational,1|2,7,1/2,230192,1
7,4,23,193,1,651,1,13,6,6,7,single-choice,spatial-relational,6|7,7,6/7,230193,6
7,4,23,194,1,1148,1,7,3,3,4,single-choice,spatial-relational,3|4,7,3/4,230194,3
7,4,23,195,1,1182,1,11,5,5,6,single-choice,spatial-relational,5|6,7,5/6,230195,5
7,4,23,196,1,861,1,13,6,6,7,single-choice,spatial-relational,6|7,7,6/7,230196,6
7,4,23,197,0,839,1,11,5,6,6,single-choice,spatial-relational,5|6,7,5/6,230197,5
7,4,23,198,1,651,1,9,4,4,5,single-choice,spatial-relational,4|5,7,4/5,230198,4
7,4,23,199,1,576,1,9,4,4,5,single-choice,spatial-relational,4|5,7,4/5,230199,4
7,4,23,200,0,1339,1,3,1,2,2,single-choice,spatial-relational,1|2,7,1/2,230200,1
7,4,23,201,1,36,1,7,3,3,4,single-choice,spatial-relational,3|4,7,3/4,230201,3
7,4,23,202,1,1191,1,5,2,2,3,single-choice,spatial-relational,2|3,7,2/3,230202,2
7,4,23,203,1,778,1,5,2,2,3,single-choice,spatial-relational,2|3,7,2/3,230203,2
7,4,23,204,1,740,1,3,1,1,2,single-choice,spatial-relational,1|2,7,1/2,230204,1
7,4,23,205,1,854,1,7,3,3,4,single-choice,spatial-relational,3|4,7,3/4,230205,3
7,4,23,206,0,1433,1,7,3,4,4,single-choice,spatial-relational,3|4,7,3/4,230206,3
7,4,23,207,1,786,1,11,5,5,6,single-choice,spatial-relational,5|6,7,5/6,230207,5
7,4,23,208,1,889,1,13,6,6,7,single-choice,spatial-relational,6|7,7,6/7,230208,6
7,4,23,209,0,905,1,9,4,5,5,single-choice,spatial-relational,4|5,7,4/5,230209,4
7,4,23,210,1,968,1,9,4,4,5,single-choice,spatial-relational,4|5,7,4/5,230210,4
7,4,23,211,1,835,1,3,1,1,2,single-choice,spatial-relational,1|2,7,1/2,230211,1
7,4,23,212,1,867,1,5,2,2,3,single-choice,spatial-relational,2|3,7,2/3,230212,2
7,4,23,213,1,782,1,5,2,2,3,single-choice,spatial-relational,2|3,7,2/3,230213,2
7,4,23,214,1,1060,1,3,1,1,2,single-choice,spatial-relational,1|2,7,1/2,230214,1
7,4,23,215,1,863,1,11,5,5,6,single-choice,spatial-relational,5|6,7,5/6,230215,5
7,4,23,216,1,635,1,13,6,6,7,single-choice,spatial-relational,6|7,7,6/7,230216,6
7,4,23,217,1,967,1,7,3,3,4,single-choice,spatial-relational,3|4,7,3/4,230217,3
7,4,23,218,1,1019,1,9,4,4,5,single-choice,spatial-relational,4|5,7,4/5,230218,4
7,4,23,219,1,854,1,3,1,1,2,single-choice,spatial-relational,1|2,7,1/2,230219,1
7,4,23,220,1,874,1,11,5,5,6,single-choice,spatial-relational,5|6,7,5/6,230220,5
7,4,23,221,1,1312,1,7,3,3,4,single-choice,spatial-relational,3|4,7,3/4,230221,3
7,4,23,222,1,882,1,13,6,6,7,single-choice,spatial-relational,6|7,7,6/7,230222,6
7,4,23,223,1,970,1,9,4,4,5,single-choice,spatial-relational,4|5,7,4/5,230223,4
7,4,23,224,1,1876,1,11,5,5,6,single-choice,spatial-relational,5|6,7,5/6,230224,5
7,4,23,225,1,668,1,13,6,6,7,single-choice,spatial-relational,6|7,7,6/7,230225,6
7,4,23,226,1,952,1,5,2,2,3,single-choice,spatial-relational,2|3,7,2/3,230226,2
7,4,23,227,1,680,1,5,2,2,3,single-choice,spatial-relational,2|3,7,2/3,230227,2
7,4,23,228,0,688,1,3,1,2,2,single-choice,spatial-relational,1|2,7,1/2,230228,1
7,4,23,229,1,1319,1,9,4,4,5,single-choice,spatial-relational,4|5,7,4/5,230229,4
7,4,23,230,1,1169,1,7,3,3,4,single-choice,spatial-relational,3|4,7,3/4,230230,3
7,4,23,231,0,1033,1,5,2,3,3,single-choice,spatial-relational,2|3,7,2/3,230231,2
7,4,23,232,1,933,1,11,5,5,6,single-choice,spatial-relational,5|6,7,5/6,230232,5
7,4,23,233,1,1316,1,9,4,4,5,single-choice,spatial-relational,4|5,7,4/5,230233,4
7,4,23,234,1,1625,1,13,6,6,7,single-choice,spatial-relational,6|7,7,6/7,230234,6
7,4,23,235,1,744,1,3,1,1,2,single-choice,spatial-relational,1|2,7,1/2,230235,1
7,4,23,236,1,1122,1,11,5,5,6,single-choice,spatial-relational,5|6,7,5/6,230236,5
7,4,23,237,0,1109,1,7,3,4,4,single-choice,spatial-relational,3|4,7,3/4,230237,3
7,4,23,238,1,900,1,5,2,2,3,single-choice,spatial-relational,2|3,7,2/3,230238,2
7,4,23,239,1,652,1,13,6,6,7,single-choice,spatial-relational,6|7,7,6/7,230239,6
7,4,23,240,1,815,1,3,1,1,2,single-choice,spatial-relational,1|2,7,1/2,230240,1
7,4,23,241,0,956,1,9,4,5,5,single-choice,spatial-relational,4|5,7,4/5,230241,4
7,4,23,242,1,1020,1,5,2,2,3,single-choice,spatial-relational,2|3,7,2/3,230242,2
7,4,23,243,1,1062,1,11,5,5,6,single-choice,spatial-relational,5|6,7,5/6,230243,5
7,4,23,244,0,1140,1,13,6,7,7,single-choice,spatial-relational,6|7,7,6/7,230244,6
7,4,23,245,1,1060,1,7,3,3,4,single-choice,spatial-relational,3|4,7,3/4,230245,3
7,4,23,246,1,1029,1,9,4,4,5,single-choice,spatial-relational,4|5,7,4/5,230246,4
7,4,23,247,1,812,1,7,3,3,4,single-choice,spatial-relational,3|4,7,3/4,230247,3
7,4,23,248,1,861,1,3,1,1,2,single-choice,spatial-relational,1|2,7,1/2,230248,1
7,4,23,249,1,1203,1,11,5,5,6,single-choice,spatial-relational,5|6,7,5/6,230249,5
7,4,23,250,1,784,1,3,1,1,2,single-choice,spatial-relational,1|2,7,1/2,230250,1
7,4,23,251,1,650,1,13,6,6,7,single-choice,spatial-relational,6|7,7,6/7,230251,6
7,4,23,252,1,1218,1,5,2,2,3,single-choice,spatial-relational,2|3,7,2/3,230252,2
7,4,23,253,1,876,1,7,3,3,4,single-choice,spatial-relational,3|4,7,3/4,230253,3
7,4,23,254,1,1485,1,9,4,4,5,single-choice,spatial-relational,4|5,7,4/5,230254,4
7,4,23,255,1,632,1,13,6,6,7,single-choice,spatial-relational,6|7,7,6/7,230255,6
7,4,23,256,1,893,1,5,2,2,3,single-choice,spatial-relational,2|3,7,2/3,230256,2
7,4,23,257,1,729,1,13,6,6,7,single-choice,spatial-relational,6|7,7,6/7,230257,6
7,4,23,258,1,1113,1,5,2,2,3,single-choice,spatial-relational,2|3,7,2/3,230258,2
7,4,23,259,0,1228,1,7,3,4,4,single-choice,spatial-relational,3|4,7,3/4,230259,3
7,4,23,260,1,655,1,3,1,1,2,single-choice,spatial-relational,1|2,7,1/2,230260,1
7,4,23,261,1,754,1,11,5,5,6,single-choice,spatial-relational,5|6,7,5/6,230261,5
7,4,23,262,1,811,1,3,1,1,2,single-choice,spatial-relational,1|2,7,1/2,230262,1
7,4,23,263,1,986,1,9,4,4,5,single-choice,spatial-relational,4|5,7,4/5,230263,4
7,4,23,264,1,987,1,11,5,5,6,single-choice,spatial-relational,5|6,7,5/6,230264,5
7,4,23,265,1,1060,1,9,4,4,5,single-choice,spatial-relational,4|5,7,4/5,230265,4
7,4,23,266,1,1188,1,13,6,6,7,single-choice,spatial-relational,6|7,7,6/7,230266,6
7,4,23,267,1,1104,1,11,5,5,6,single-choice,spatial-relational,5|6,7,5/6,230267,5
7,4,23,268,1,1477,1,5,2,2,3,single-choice,spatial-relational,2|3,7,2/3,230268,2
7,4,23,269,1,801,1,7,3,3,4,single-choice,spatial-relational,3|4,7,3/4,230269,3
7,4,23,270,1,781,1,5,2,2,3,single-choice,spatial-relational,2|3,7,2/3,230270,2
7,4,23,271,1,959,1,11,5,5,6,single-choice,spatial-relational,5|6,7,5/6,230271,5
7,4,23,272,1,753,1,13,6,6,7,single-choice,spatial-relational,6|7,7,6/7,230272,6
7,4,23,273,1,731,1,3,1,1,2,single-choice,spatial-relational,1|2,7,1/2,230273,1
7,4,23,274,1,844,1,3,1,1,2,single-choice,spatial-relational,1|2,7,1/2,230274,1
7,4,23,275,1,1706,1,7,3,3,4,single-choice,spatial-relational,3|4,7,3/4,230275,3
7,4,23,276,1,1536,1,9,4,4,5,single-choice,spatial-relational,4|5,7,4/5,230276,4
7,4,23,277,1,827,1,3,1,1,2,single-choice,spatial-relational,1|2,7,1/2,230277,1
7,4,23,278,1,721,1,11,5,5,6,single-choice,spatial-relational,5|6,7,5/6,230278,5
7,4,23,279,1,1164,1,7,3,3,4,single-choice,spatial-relational,3|4,7,3/4,230279,3
7,4,23,280,1,645,1,5,2,2,3,single-choice,spatial-relational,2|3,7,2/3,230280,2
7,4,23,281,0,1150,1,9,4,5,5,single-choice,spatial-relational,4|5,7,4/5,230281,4
7,4,23,282,1,850,1,13,6,6,7,single-choice,spatial-relational,6|7,7,6/7,230282,6
7,4,23,283,1,825,1,9,4,4,5,single-choice,spatial-relational,4|5,7,4/5,230283,4
7,4,23,284,1,907,1,7,3,3,4,single-choice,spatial-relational,3|4,7,3/4,230284,3
7,4,23,285,1,806,1,13,6,6,7,single-choice,spatial-relational,6|7,7,6/7,230285,6
7,4,23,286,1,973,1,11,5,5,6,single-choice,spatial-relational,5|6,7,5/6,230286,5
7,4,23,287,1,639,1,3,1,1,2,single-choice,spatial-relational,1|2,7,1/2,230287,1
7,4,23,288,1,1384,1,5,2,2,3,single-choice,spatial-relational,2|3,7,2/3,230288,2
7,4,23,289,1,746,1,5,2,2,3,single-choice,spatial-relational,2|3,7,2/3,230289,2
7,4,23,290,1,1507,1,5,2,2,3,single-choice,spatial-relational,2|3,7,2/3,230290,2
7,4,23,291,0,1229,1,7,3,4,4,single-choice,spatial-relational,3|4,7,3/4,230291,3
7,4,23,292,1,703,1,3,1,1,2,single-choice,spatial-relational,1|2,7,1/2,230292,1
7,4,23,293,0,737,1,11,5,6,6,single-choice,spatial-relational,5|6,7,5/6,230293,5
7,4,23,294,1,978,1,3,1,1,2,single-choice,spatial-relational,1|2,7,1/2,230294,1
7,4,23,295,1,815,1,11,5,5,6,single-choice,spatial-relational,5|6,7,5/6,230295,5
7,4,23,296,1,883,1,13,6,6,7,single-choice,spatial-relational,6|7,7,6/7,230296,6
7,4,23,297,1,1587,1,7,3,3,4,single-choice,spatial-relational,3|4,7,3/4,230297,3
7,4,23,298,1,1168,1,9,4,4,5,single-choice,spatial-relational,4|5,7,4/5,230298,4
7,4,23,299,1,630,1,13,6,6,7,single-choice,spatial-relational,6|7,7,6/7,230299,6
7,4,23,300,1,1572,1,9,4,4,5,single-choice,spatial-relational,4|5,7,4/5,230300,4
7,4,23,301,0,911,1,3,1,2,2,single-choice,spatial-relational,1|2,7,1/2,230301,1
7,4,23,302,1,2153,1,11,5,5,6,single-choice,spatial-relational,5|6,7,5/6,230302,5
7,4,23,303,1,843,1,7,3,3,4,single-choice,spatial-relational,3|4,7,3/4,230303,3
7,4,23,304,1,1624,1,11,5,5,6,single-choice,spatial-relational,5|6,7,5/6,230304,5
7,4,23,305,0,1233,1,13,6,7,7,single-choice,spatial-relational,6|7,7,6/7,230305,6
7,4,23,306,1,2124,1,7,3,3,4,single-choice,spatial-relational,3|4,7,3/4,230306,3
7,4,23,307,0,903,1,5,2,3,3,single-choice,spatial-relational,2|3,7,2/3,230307,2
7,4,23,308,0,1199,1,3,1,2,2,single-choice,spatial-relational,1|2,7,1/2,230308,1
7,4,23,309,1,954,1,9,4,4,5,single-choice,spatial-relational,4|5,7,4/5,230309,4
7,4,23,310,1,1719,1,5,2,2,3,single-choice,spatial-relational,2|3,7,2/3,230310,2
7,4,23,311,1,635,1,13,6,6,7,single-choice,spatial-relational,6|7,7,6/7,230311,6
7,4,23,312,1,1654,1,9,4,4,5,single-choice,spatial-relational,4|5,7,4/5,230312,4
7,4,23,313,1,1021,1,11,5,5,6,single-choice,spatial-relational,5|6,7,5/6,230313,5
7,4,23,314,1,616,1,13,6,6,7,single-choice,spatial-relational,6|7,7,6/7,230314,6
7,4,23,315,0,1211,1,7,3,4,4,single-choice,spatial-relational,3|4,7,3/4,230315,3
7,4,23,316,0,1163,1,7,3,4,4,single-choice,spatial-relational,3|4,7,3/4,230316,3
7,4,23,317,1,1056,1,9,4,4,5,single-choice,spatial-relational,4|5,7,4/5,230317,4
7,4,23,318,1,1342,1,5,2,2,3,single-choice,spatial-relational,2|3,7,2/3,230318,2
7,4,23,319,1,828,1,3,1,1,2,single-choice,spatial-relational,1|2,7,1/2,230319,1
7,4,23,320,1,878,1,5,2,2,3,single-choice,spatial-relational,2|3,7,2/3,230320,2
7,4,23,321,1,808,1,13,6,6,7,single-choice,spatial-relational,6|7,7,6/7,230321,6
7,4,23,322,0,963,1,9,4,5,5,single-choice,spatial-relational,4|5,7,4/5,230322,4
7,4,23,323,1,934,1,11,5,5,6,single-choice,spatial-relational,5|6,7,5/6,230323,5
7,4,23,324,1,1252,1,3,1,1,2,single-choice,spatial-relational,1|2,7,1/2,230324,1
7,4,23,325,1,1383,1,11,5,5,6,single-choice,spatial-relational,5|6,7,5/6,230325,5
7,4,23,326,1,2301,1,9,4,4,5,single-choice,spatial-relational,4|5,7,4/5,230326,4
7,4,23,327,1,927,1,7,3,3,4,single-choice,spatial-relational,3|4,7,3/4,230327,3
7,4,23,328,1,1104,1,5,2,2,3,single-choice,spatial-relational,2|3,7,2/3,230328,2
7,4,23,329,1,1472,1,7,3,3,4,single-choice,spatial-relational,3|4,7,3/4,230329,3
7,4,23,330,1,689,1,9,4,4,5,single-choice,spatial-relational,4|5,7,4/5,230330,4
7,4,23,331,1,646,1,13,6,6,7,single-choice,spatial-relational,6|7,7,6/7,230331,6
7,4,23,332,1,873,1,5,2,2,3,single-choice,spatial-relational,2|3,7,2/3,230332,2
7,4,23,333,0,704,1,3,1,2,2,single-choice,spatial-relational,1|2,7,1/2,230333,1
7,4,23,334,0,663,1,3,1,2,2,single-choice,spatial-relational,1|2,7,1/2,230334,1
7,4,23,335,1,763,1,13,6,6,7,single-choice,spatial-relational,6|7,7,6/7,230335,6
7,4,23,336,1,1707,1,11,5,5,6,single-choice,spatial-relational,5|6,7,5/6,230336,5
7,4,23,337,1,765,1,3,1,1,2,single-choice,spatial-relational,1|2,7,1/2,230337,1
7,4,23,338,1,959,1,5,2,2,3,single-choice,spatial-relational,2|3,7,2/3,230338,2
7,4,23,339,0,617,1,5,2,3,3,single-choice,spatial-relational,2|3,7,2/3,230339,2
7,4,23,340,1,1033,1,7,3,3,4,single-choice,spatial-relational,3|4,7,3/4,230340,3
7,4,23,341,0,959,1,9,4,5,5,single-choice,spatial-relational,4|5,7,4/5,230341,4
7,4,23,342,1,682,1,13,6,6,7,single-choice,spatial-relational,6|7,7,6/7,230342,6
7,4,23,343,0,1639,1,9,4,5,5,single-choice,spatial-relational,4|5,7,4/5,230343,4
7,4,23,344,1,931,1,13,6,6,7,single-choice,spatial-relational,6|7,7,6/7,230344,6
7,4,23,345,1,1690,1,11,5,5,6,single-choice,spatial-relational,5|6,7,5/6,230345,5
7,4,23,346,1,809,1,3,1,1,2,single-choice,spatial-relational,1|2,7,1/2,230346,1
7,4,23,347,0,205,1,7,3,4,4,single-choice,spatial-relational,3|4,7,3/4,230347,3
7,4,23,348,1,1010,1,11,5,5,6,single-choice,spatial-relational,5|6,7,5/6,230348,5
7,4,23,349,1,775,1,13,6,6,7,single-choice,spatial-relational,6|7,7,6/7,230349,6
7,4,23,350,1,934,1,9,4,4,5,single-choice,spatial-relational,4|5,7,4/5,230350,4
7,4,23,351,1,847,1,3,1,1,2,single-choice,spatial-relational,1|2,7,1/2,230351,1
7,4,23,352,1,835,1,11,5,5,6,single-choice,spatial-relational,5|6,7,5/6,230352,5
7,4,23,353,1,1478,1,7,3,3,4,single-choice,spatial-relational,3|4,7,3/4,230353,3
7,4,23,354,1,523,1,13,6,6,7,single-choice,spatial-relational,6|7,7,6/7,230354,6
7,4,23,355,1,813,1,3,1,1,2,single-choice,spatial-relational,1|2,7,1/2,230355,1
7,4,23,356,1,701,1,11,5,5,6,single-choice,spatial-relational,5|6,7,5/6,230356,5
7,4,23,357,1,1078,1,5,2,2,3,single-choice,spatial-relational,2|3,7,2/3,230357,2
7,4,23,358,1,928,1,7,3,3,4,single-choice,spatial-relational,3|4,7,3/4,230358,3
7,4,23,359,1,1302,1,5,2,2,3,single-choice,spatial-relational,2|3,7,2/3,230359,2
7,4,23,360,1,1203,1,9,4,4,5,single-choice,spatial-relational,4|5,7,4/5,230360,4
7,4,23,361,1,1315,1,11,5,5,6,single-choice,spatial-relational,5|6,7,5/6,230361,5
7,4,23,362,1,878,1,5,2,2,3,single-choice,spatial-relational,2|3,7,2/3,230362,2
7,4,23,363,0,685,1,5,2,3,3,single-choice,spatial-relational,2|3,7,2/3,230363,2
7,4,23,364,1,851,1,11,5,5,6,single-choice,spatial-relational,5|6,7,5/6,230364,5
7,4,23,365,1,1430,1,7,3,3,4,single-choice,spatial-relational,3|4,7,3/4,230365,3
7,4,23,366,1,778,1,9,4,4,5,single-choice,spatial-relational,4|5,7,4/5,230366,4
7,4,23,367,1,1039,1,7,3,3,4,single-choice,spatial-relational,3|4,7,3/4,230367,3
7,4,23,368,1,879,1,3,1,1,2,single-choice,spatial-relational,1|2,7,1/2,230368,1
7,4,23,369,1,517,1,13,6,6,7,single-choice,spatial-relational,6|7,7,6/7,230369,6
7,4,23,370,1,2085,1,9,4,4,5,single-choice,spatial-relational,4|5,7,4/5,230370,4
7,4,23,371,1,832,1,13,6,6,7,single-choice,spatial-relational,6|7,7,6/7,230371,6
7,4,23,372,1,854,1,3,1,1,2,single-choice,spatial-relational,1|2,7,1/2,230372,1
7,4,23,373,1,811,1,5,2,2,3,single-choice,spatial-relational,2|3,7,2/3,230373,2
7,4,23,374,1,733,1,11,5,5,6,single-choice,spatial-relational,5|6,7,5/6,230374,5
7,4,23,375,1,1144,1,11,5,5,6,single-choice,spatial-relational,5|6,7,5/6,230375,5
7,4,23,376,1,843,1,3,1,1,2,single-choice,spatial-relational,1|2,7,1/2,230376,1
7,4,23,377,1,978,1,9,4,4,5,single-choice,spatial-relational,4|5,7,4/5,230377,4
7,4,23,378,1,564,1,3,1,1,2,single-choice,spatial-relational,1|2,7,1/2,230378,1
7,4,23,379,1,152133,1,13,6,6,7,single-choice,spatial-relational,6|7,7,6/7,230379,6
7,4,23,380,1,906,1,7,3,3,4,single-choice,spatial-relational,3|4,7,3/4,230380,3
7,4,23,381,1,955,1,5,2,2,3,single-choice,spatial-relational,2|3,7,2/3,230381,2
7,4,23,382,1,716,1,13,6,6,7,single-choice,spatial-relational,6|7,7,6/7,230382,6
7,4,23,383,0,1264,1,9,4,5,5,single-choice,spatial-relational,4|5,7,4/5,230383,4
7,4,23,384,1,938,1,7,3,3,4,single-choice,spatial-relational,3|4,7,3/4,230384,3
7,4,23,385,1,760,1,3,1,1,2,single-choice,spatial-relational,1|2,7,1/2,230385,1
7,4,23,386,1,1057,1,7,3,3,4,single-choice,spatial-relational,3|4,7,3/4,230386,3
7,4,23,387,1,1030,1,5,2,2,3,single-choice,spatial-relational,2|3,7,2/3,230387,2
7,4,23,388,1,1062,1,11,5,5,6,single-choice,spatial-relational,5|6,7,5/6,230388,5
7,4,23,389,0,2983,1,7,3,4,4,single-choice,spatial-relational,3|4,7,3/4,230389,3
7,4,23,390,1,882,1,3,1,1,2,single-choice,spatial-relational,1|2,7,1/2,230390,1
7,4,23,391,1,1114,1,9,4,4,5,single-choice,spatial-relational,4|5,7,4/5,230391,4
7,4,23,392,0,380,1,13,6,7,7,single-choice,spatial-relational,6|7,7,6/7,230392,6
7,4,23,393,1,963,1,9,4,4,5,single-choice,spatial-relational,4|5,7,4/5,230393,4
7,4,23,394,1,687,1,13,6,6,7,single-choice,spatial-relational,6|7,7,6/7,230394,6
7,4,23,395,1,979,1,5,2,2,3,single-choice,spatial-relational,2|3,7,2/3,230395,2
7,4,23,396,1,896,1,11,5,5,6,single-choice,spatial-relational,5|6,7,5/6,230396,5
7,4,23,397,1,837,1,3,1,1,2,single-choice,spatial-relational,1|2,7,1/2,230397,1
7,4,23,398,1,850,1,7,3,3,4,single-choice,spatial-relational,3|4,7,3/4,230398,3
7,4,23,399,1,859,1,9,4,4,5,single-choice,spatial-relational,4|5,7,4/5,230399,4
7,4,23,400,1,1239,1,5,2,2,3,single-choice,spatial-relational,2|3,7,2/3,230400,2
7,4,23,401,1,774,1,5,2,2,3,single-choice,spatial-relational,2|3,7,2/3,230401,2
7,4,23,402,1,1041,1,13,6,6,7,single-choice,spatial-relational,6|7,7,6/7,230402,6
7,4,23,403,1,1593,1,9,4,4,5,single-choice,spatial-relational,4|5,7,4/5,230403,4
7,4,23,404,1,998,1,11,5,5,6,single-choice,spatial-relational,5|6,7,5/6,230404,5
7,4,23,405,1,904,1,11,5,5,6,single-choice,spatial-relational,5|6,7,5/6,230405,5
7,4,23,406,1,725,1,3,1,1,2,single-choice,spatial-relational,1|2,7,1/2,230406,1
7,4,23,407,1,557,1,13,6,6,7,single-choice,spatial-relational,6|7,7,6/7,230407,6
7,4,23,408,1,1142,1,7,3,3,4,single-choice,spatial-relational,3|4,7,3/4,230408,3
7,4,23,409,1,590,1,5,2,2,3,single-choice,spatial-relational,2|3,7,2/3,230409,2
7,4,23,410,0,838,1,7,3,4,4,single-choice,spatial-relational,3|4,7,3/4,230410,3
7,4,23,411,1,966,1,11,5,5,6,single-choice,spatial-relational,5|6,7,5/6,230411,5
7,4,23,412,1,676,1,3,1,1,2,single-choice,spatial-relational,1|2,7,1/2,230412,1
7,4,23,413,0,1124,1,11,5,6,6,single-choice,spatial-relational,5|6,7,5/6,230413,5
7,4,23,414,1,852,1,3,1,1,2,single-choice,spatial-relational,1|2,7,1/2,230414,1
7,4,23,415,1,568,1,13,6,6,7,single-choice,spatial-relational,6|7,7,6/7,230415,6
7,4,23,416,1,736,1,13,6,6,7,single-choice,spatial-relational,6|7,7,6/7,230416,6
7,4,23,417,0,507,1,7,3,4,4,single-choice,spatial-relational,3|4,7,3/4,230417,3
7,4,23,418,1,1212,1,9,4,4,5,single-choice,spatial-relational,4|5,7,4/5,230418,4
7,4,23,419,1,1075,1,9,4,4,5,single-choice,spatial-relational,4|5,7,4/5,230419,4
7,4,23,420,1,989,1,5,2,2,3,single-choice,spatial-relational,2|3,7,2/3,230420,2
7,4,23,421,1,500,1,13,6,6,7,single-choice,spatial-relational,6|7,7,6/7,230421,6
7,4,23,422,1,1093,1,11,5,5,6,single-choice,spatial-relational,5|6,7,5/6,230422,5
7,4,23,423,1,1281,1,9,4,4,5,single-choice,spatial-relational,4|5,7,4/5,230423,4
7,4,23,424,0,474,1,5,2,3,3,single-choice,spatial-relational,2|3,7,2/3,230424,2
7,4,23,425,1,499,1,5,2,2,3,single-choice,spatial-relational,2|3,7,2/3,230425,2
7,4,23,426,1,851,1,9,4,4,5,single-choice,spatial-relational,4|5,7,4/5,230426,4
7,4,23,427,1,532,1,7,3,3,4,single-choice,spatial-relational,3|4,7,3/4,230427,3
7,4,23,428,0,530,1,13,6,7,7,single-choice,spatial-relational,6|7,7,6/7,230428,6
7,4,23,429,0,701,1,3,1,2,2,single-choice,spatial-relational,1|2,7,1/2,230429,1
7,4,23,430,1,859,1,3,1,1,2,single-choice,spatial-relational,1|2,7,1/2,230430,1
7,4,23,431,1,1216,1,11,5,5,6,single-choice,spatial-relational,5|6,7,5/6,230431,5
7,4,23,432,0,1193,1,7,3,4,4,single-choice,spatial-relational,3|4,7,3/4,230432,3
7,4,23,433,1,1257,1,13,6,6,7,single-choice,spatial-relational,6|7,7,6/7,230433,6
7,4,23,434,1,652,1,3,1,1,2,single-choice,spatial-relational,1|2,7,1/2,230434,1
7,4,23,435,0,760,1,5,2,3,3,single-choice,spatial-relational,2|3,7,2/3,230435,2
7,4,23,436,0,60,1,9,4,5,5,single-choice,spatial-relational,4|5,7,4/5,230436,4
7,4,23,437,1,824,1,7,3,3,4,single-choice,spatial-relational,3|4,7,3/4,230437,3
7,4,23,438,1,842,1,9,4,4,5,single-choice,spatial-relational,4|5,7,4/5,230438,4
7,4,23,439,1,1057,1,7,3,3,4,single-choice,spatial-relational,3|4,7,3/4,230439,3
7,4,23,440,1,684,1,3,1,1,2,single-choice,spatial-relational,1|2,7,1/2,230440,1
7,4,23,441,1,800,1,5,2,2,3,single-choice,spatial-relational,2|3,7,2/3,230441,2
7,4,23,442,1,930,1,11,5,5,6,single-choice,spatial-relational,5|6,7,5/6,230442,5
7,4,23,443,0,1125,1,11,5,6,6,single-choice,spatial-relational,5|6,7,5/6,230443,5
7,4,23,444,1,927,1,13,6,6,7,single-choice,spatial-relational,6|7,7,6/7,230444,6
7,4,23,445,1,1025,1,11,5,5,6,single-choice,spatial-relational,5|6,7,5/6,230445,5
7,4,23,446,1,591,1,13,6,6,7,single-choice,spatial-relational,6|7,7,6/7,230446,6
7,4,23,447,1,1019,1,7,3,3,4,single-choice,spatial-relational,3|4,7,3/4,230447,3
7,4,23,448,1,440,1,3,1,1,2,single-choice,spatial-relational,1|2,7,1/2,230448,1
7,4,23,449,1,1007,1,3,1,1,2,single-choice,spatial-relational,1|2,7,1/2,230449,1
7,4,23,450,1,1179,1,5,2,2,3,single-choice,spatial-relational,2|3,7,2/3,230450,2
7,4,23,451,1,1200,1,9,4,4,5,single-choice,spatial-relational,4|5,7,4/5,230451,4
7,4,23,452,0,1553,1,9,4,5,5,single-choice,spatial-relational,4|5,7,4/5,230452,4
7,4,23,453,1,1418,1,11,5,5,6,single-choice,spatial-relational,5|6,7,5/6,230453,5
7,4,23,454,1,974,1,13,6,6,7,single-choice,spatial-relational,6|7,7,6/7,230454,6
7,4,23,455,1,1215,1,5,2,2,3,single-choice,spatial-relational,2|3,7,2/3,230455,2
7,4,23,456,1,957,1,7,3,3,4,single-choice,spatial-relational,3|4,7,3/4,230456,3
7,4,23,457,1,923,1,5,2,2,3,single-choice,spatial-relational,2|3,7,2/3,230457,2
7,4,23,458,1,897,1,9,4,4,5,single-choice,spatial-relational,4|5,7,4/5,230458,4
7,4,23,459,1,729,1,3,1,1,2,single-choice,spatial-relational,1|2,7,1/2,230459,1
7,4,23,460,1,642,1,3,1,1,2,single-choice,spatial-relational,1|2,7,1/2,230460,1
7,4,23,461,1,827,1,11,5,5,6,single-choice,spatial-relational,5|6,7,5/6,230461,5
7,4,23,462,1,933,1,13,6,6,7,single-choice,spatial-relational,6|7,7,6/7,230462,6
7,4,23,463,1,893,1,5,2,2,3,single-choice,spatial-relational,2|3,7,2/3,230463,2
7,4,23,464,1,954,1,7,3,3,4,single-choice,spatial-relational,3|4,7,3/4,230464,3
7,4,23,465,1,594,1,13,6,6,7,single-choice,spatial-relational,6|7,7,6/7,230465,6
7,4,23,466,1,1030,1,7,3,3,4,single-choice,spatial-relational,3|4,7,3/4,230466,3
7,4,23,467,0,717,1,11,5,6,6,single-choice,spatial-relational,5|6,7,5/6,230467,5
7,4,23,468,1,54,1,9,4,4,5,single-choice,spatial-relational,4|5,7,4/5,230468,4
7,4,23,469,1,997,1,13,6,6,7,single-choice,spatial-relational,6|7,7,6/7,230469,6
7,4,23,470,1,794,1,9,4,4,5,single-choice,spatial-relational,4|5,7,4/5,230470,4
7,4,23,471,0,1039,1,9,4,5,5,single-choice,spatial-relational,4|5,7,4/5,230471,4
7,4,23,472,1,1166,1,11,5,5,6,single-choice,spatial-relational,5|6,7,5/6,230472,5
7,4,23,473,1,647,1,3,1,1,2,single-choice,spatial-relational,1|2,7,1/2,230473,1
7,4,23,474,1,833,1,5,2,2,3,single-choice,spatial-relational,2|3,7,2/3,230474,2
7,4,23,475,1,814,1,7,3,3,4,single-choice,spatial-relational,3|4,7,3/4,230475,3
7,4,23,476,1,1303,1,5,2,2,3,single-choice,spatial-relational,2|3,7,2/3,230476,2
7,4,23,477,1,659,1,3,1,1,2,single-choice,spatial-relational,1|2,7,1/2,230477,1
7,4,23,478,0,816,1,7,3,4,4,single-choice,spatial-relational,3|4,7,3/4,230478,3
7,4,23,479,0,912,1,13,6,7,7,single-choice,spatial-relational,6|7,7,6/7,230479,6
1,4,24,1,1,1118,1,13,6,6,7,single-choice,spatial-relational,6|7,7,6/7,240001,6
1,4,24,2,0,802,2,8,3,5,5,single-choice,spatial-relational,3|5,7,3/5,240002,3
1,4,24,3,0,1204,2,6,2,4,4,single-choice,spatial-relational,2|4,7,2/4,240003,2
1,4,24,4,1,852,2,6,2,2,4,single-choice,spatial-relational,2|4,7,2/4,240004,2
1,4,24,5,1,897,6,8,1,1,7,single-choice,spatial-relational,1|7,7,1/7,240005,1
1,4,24,6,1,936,4,6,1,1,5,single-choice,spatial-relational,1|5,7,1/5,240006,1
1,4,24,7,0,373,1,7,3,4,4,single-choice,spatial-relational,3|4,7,3/4,240007,3
1,4,24,8,0,67,3,9,3,6,6,single-choice,spatial-relational,3|6,7,3/6,240008,3
1,4,24,9,1,589,2,4,1,1,3,single-choice,spatial-relational,1|3,7,1/3,240009,1
1,4,24,10,0,629,1,5,2,3,3,single-choice,spatial-relational,2|3,7,2/3,240010,2
1,4,24,11,0,743,3,7,2,5,5,single-choice,spatial-relational,2|5,7,2/5,240011,2
1,4,24,12,1,920,1,7,3,3,4,single-choice,spatial-relational,3|4,7,3/4,240012,3
1,4,24,13,1,852,3,7,2,2,5,single-choice,spatial-relational,2|5,7,2/5,240013,2
1,4,24,14,0,2,1,3,1,2,2,single-choice,spatial-relational,1|2,7,1/2,240014,1
1,4,24,15,1,903,2,10,4,4,6,single-choice,spatial-relational,4|6,7,4/6,240015,4
1,4,24,16,0,824,5,7,1,6,6,single-choice,spatial-relational,1|6,7,1/6,240016,1
1,4,24,17,1,862,3,11,4,4,7,single-choice,spatial-relational,4|7,7,4/7,240017,4
1,4,24,18,1,872,5,7,1,1,6,single-choice,spatial-relational,1|6,7,1/6,240018,1
1,4,24,19,1,841,4,6,1,1,5,single-choice,spatial-relational,1|5,7,1/5,240019,1
1,4,24,20,1,798,3,9,3,3,6,single-choice,spatial-relational,3|6,7,3/6,240020,3
1,4,24,21,1,1403,3,5,1,1,4,single-choice,spatial-relational,1|4,7,1/4,240021,1
1,4,24,22,1,960,1,11,5,5,6,single-choice,spatial-relational,5|6,7,5/6,240022,5
1,4,24,23,0,804,5,9,2,7,7,single-choice,spatial-relational,2|7,7,2/7,240023,2
1,4,24,24,1,1192,1,3,1,1,2,single-choice,spatial-relational,1|2,7,1/2,240024,1
1,4,24,25,1,1017,1,9,4,4,5,single-choice,spatial-relational,4|5,7,4/5,240025,4
1,4,24,26,1,843,3,5,1,1,4,single-choice,spatial-relational,1|4,7,1/4,240026,1
1,4,24,27,1,1454,2,12,5,5,7,single-choice,spatial-relational,5|7,7,5/7,240027,5
1,4,24,28,1,962,2,8,3,3,5,single-choice,spatial-relational,3|5,7,3/5,240028,3
1,4,24,29,1,1281,4,8,2,2,6,single-choice,spatial-relational,2|6,7,2/6,240029,2
1,4,24,30,1,1266,5,9,2,2,7,single-choice,spatial-relational,2|7,7,2/7,240030,2
1,4,24,31,1,1112,1,11,5,5,6,single-choice,spatial-relational,5|6,7,5/6,240031,5
1,4,24,32,1,907,1,13,6,6,7,single-choice,spatial-relational,6|7,7,6/7,240032,6
1,4,24,33,1,1228,3,11,4,4,7,single-choice,spatial-relational,4|7,7,4/7,240033,4
1,4,24,34,1,1125,2,4,1,1,3,single-choice,spatial-relational,1|3,7,1/3,240034,1
1,4,24,35,1,756,4,10,3,3,7,single-choice,spatial-relational,3|7,7,3/7,240035,3
1,4,24,36,1,1345,2,12,5,5,7,single-choice,spatial-relational,5|7,7,5/7,240036,5
1,4,24,37,1,1007,6,8,1,1,7,single-choice,spatial-relational,1|7,7,1/7,240037,1
1,4,24,38,1,900,4,8,2,2,6,single-choice,spatial-relational,2|6,7,2/6,240038,2
1,4,24,39,1,884,4,10,3,3,7,single-choice,spatial-relational,3|7,7,3/7,240039,3
1,4,24,40,1,1398,2,10,4,4,6,single-choice,spatial-relational,4|6,7,4/6,240040,4
1,4,24,41,1,1193,1,9,4,4,5,single-choice,spatial-relational,4|5,7,4/5,240041,4
1,4,24,42,1,1721,1,5,2,2,3,single-choice,spatial-relational,2|3,7,2/3,240042,2
1,4,24,43,1,865,1,3,1,1,2,single-choice,spatial-relational,1|2,7,1/2,240043,1
1,4,24,44,1,770,2,10,4,4,6,single-choice,spatial-relational,4|6,7,4/6,240044,4
1,4,24,45,1,839,1,7,3,3,4,single-choice,spatial-relational,3|4,7,3/4,240045,3
1,4,24,46,1,988,6,8,1,1,7,single-choice,spatial-relational,1|7,7,1/7,240046,1
1,4,24,47,1,976,6,8,1,1,7,single-choice,spatial-relational,1|7,7,1/7,240047,1
1,4,24,48,1,803,4,10,3,3,7,single-choice,spatial-relational,3|7,7,3/7,240048,3
1,4,24,49,1,806,2,4,1,1,3,single-choice,spatial-relational,1|3,7,1/3,240049,1
1,4,24,50,1,1093,4,6,1,1,5,single-choice,spatial-relational,1|5,7,1/5,240050,1
1,4,24,51,1,1137,2,12,5,5,7,single-choice,spatial-relational,5|7,7,5/7,240051,5
1,4,24,52,1,2009,5,9,2,2,7,single-choice,spatial-relational,2|7,7,2/7,240052,2
1,4,24,53,1,1197,4,8,2,2,6,single-choice,spatial-relational,2|6,7,2/6,240053,2
1,4,24,54,1,1445,4,6,1,1,5,single-choice,spatial-relational,1|5,7,1/5,240054,1
1,4,24,55,1,1200,1,5,2,2,3,single-choice,spatial-relational,2|3,7,2/3,240055,2
1,4,24,56,1,999,2,4,1,1,3,single-choice,spatial-relational,1|3,7,1/3,240056,1
1,4,24,57,1,692,3,9,3,3,6,single-choice,spatial-relational,3|6,7,3/6,240057,3
1,4,24,58,1,1038,2,6,2,2,4,single-choice,spatial-relational,2|4,7,2/4,240058,2
1,4,24,59,0,1091,1,11,5,6,6,single-choice,spatial-relational,5|6,7,5/6,240059,5
1,4,24,60,1,920,1,7,3,3,4,single-choice,spatial-relational,3|4,7,3/4,240060,3
1,4,24,61,1,899,2,10,4,4,6,single-choice,spatial-relational,4|6,7,4/6,240061,4
1,4,24,62,1,1134,3,7,2,2,5,single-choice,spatial-relational,2|5,7,2/5,240062,2
1,4,24,63,1,889,3,5,1,1,4,single-choice,spatial-relational,1|4,7,1/4,240063,1
1,4,24,64,1,665,3,9,3,3,6,single-choice,spatial-relational,3|6,7,3/6,240064,3
1,4,24,65,1,1415,3,5,1,1,4,single-choice,spatial-relational,1|4,7,1/4,240065,1
1,4,24,66,1,654,1,3,1,1,2,single-choice,spatial-relational,1|2,7,1/2,240066,1
1,4,24,67,1,820,5,7,1,1,6,single-choice,spatial-relational,1|6,7,1/6,240067,1
1,4,24,68,1,1512,2,12,5,5,7,single-choice,spatial-relational,5|7,7,5/7,240068,5
1,4,24,69,1,1154,2,8,3,3,5,single-choice,spatial-relational,3|5,7,3/5,240069,3
1,4,24,70,1,987,3,7,2,2,5,single-choice,spatial-relational,2|5,7,2/5,240070,2
1,4,24,71,1,1050,1,5,2,2,3,single-choice,spatial-relational,2|3,7,2/3,240071,2
1,4,24,72,1,576,1,13,6,6,7,single-choice,spatial-relational,6|7,7,6/7,240072,6
1,4,24,73,1,1015,5,7,1,1,6,single-choice,spatial-relational,1|6,7,1/6,240073,1
1,4,24,74,1,826,5,9,2,2,7,single-choice,spatial-relational,2|7,7,2/7,240074,2
1,4,24,75,1,1051,1,9,4,4,5,single-choice,spatial-relational,4|5,7,4/5,240075,4
1,4,24,76,1,835,1,13,6,6,7,single-choice,spatial-relational,6|7,7,6/7,240076,6
1,4,24,77,1,1091,4,8,2,2,6,single-choice,spatial-relational,2|6,7,2/6,240077,2
1,4,24,78,1,1045,2,6,2,2,4,single-choice,spatial-relational,2|4,7,2/4,240078,2
1,4,24,79,1,913,4,10,3,3,7,single-choice,spatial-relational,3|7,7,3/7,240079,3
1,4,24,80,1,1470,1,9,4,4,5,single-choice,spatial-relational,4|5,7,4/5,240080,4
1,4,24,81,1,898,2,8,3,3,5,single-choice,spatial-relational,3|5,7,3/5,240081,3
1,4,24,82,1,979,1,11,5,5,6,single-choice,spatial-relational,5|6,7,5/6,240082,5
1,4,24,83,0,240,3,11,4,7,7,single-choice,spatial-relational,4|7,7,4/7,240083,4
1,4,24,84,1,781,3,11,4,4,7,single-choice,spatial-relational,4|7,7,4/7,240084,4
1,4,24,85,0,266,5,9,2,7,7,single-choice,spatial-relational,2|7,7,2/7,240085,2
1,4,24,86,1,636,1,13,6,6,7,single-choice,spatial-relational,6|7,7,6/7,240086,6
1,4,24,87,1,1000,1,7,3,3,4,single-choice,spatial-relational,3|4,7,3/4,240087,3
1,4,24,88,1,1050,5,7,1,1,6,single-choice,spatial-relational,1|6,7,1/6,240088,1
1,4,24,89,1,907,2,6,2,2,4,single-choice,spatial-relational,2|4,7,2/4,240089,2
1,4,24,90,1,829,4,10,3,3,7,single-choice,spatial-relational,3|7,7,3/7,240090,3
1,4,24,91,1,820,1,13,6,6,7,single-choice,spatial-relational,6|7,7,6/7,240091,6
1,4,24,92,1,1138,1,7,3,3,4,single-choice,spatial-relational,3|4,7,3/4,240092,3
1,4,24,93,1,924,1,9,4,4,5,single-choice,spatial-relational,4|5,7,4/5,240093,4
1,4,24,94,1,971,3,9,3,3,6,single-choice,spatial-relational,3|6,7,3/6,240094,3
1,4,24,95,1,935,5,7,1,1,6,single-choice,spatial-relational,1|6,7,1/6,240095,1
1,4,24,96,1,1087,2,4,1,1,3,single-choice,spatial-relational,1|3,7,1/3,240096,1
1,4,24,97,1,741,1,11,5,5,6,single-choice,spatial-relational,5|6,7,5/6,240097,5
1,4,24,98,1,1148,2,6,2,2,4,single-choice,spatial-relational,2|4,7,2/4,240098,2
1,4,24,99,1,928,2,10,4,4,6,single-choice,spatial-relational,4|6,7,4/6,240099,4
1,4,24,100,1,1106,1,11,5,5,6,single-choice,spatial-relational,5|6,7,5/6,240100,5
1,4,24,101,1,2532,3,5,1,1,4,single-choice,spatial-relational,1|4,7,1/4,240101,1
1,4,24,102,1,916,2,8,3,3,5,single-choice,spatial-relational,3|5,7,3/5,240102,3
1,4,24,103,1,895,3,9,3,3,6,single-choice,spatial-relational,3|6,7,3/6,240103,3
1,4,24,104,1,957,4,8,2,2,6,single-choice,spatial-relational,2|6,7,2/6,240104,2
1,4,24,105,1,1125,3,5,1,1,4,single-choice,spatial-relational,1|4,7,1/4,240105,1
1,4,24,106,1,970,1,9,4,4,5,single-choice,spatial-relational,4|5,7,4/5,240106,4
1,4,24,107,1,789,4,6,1,1,5,single-choice,spatial-relational,1|5,7,1/5,240107,1
1,4,24,108,1,780,3,11,4,4,7,single-choice,spatial-relational,4|7,7,4/7,240108,4
1,4,24,109,1,768,4,10,3,3,7,single-choice,spatial-relational,3|7,7,3/7,240109,3
1,4,24,110,1,1149,1,5,2,2,3,single-choice,spatial-relational,2|3,7,2/3,240110,2
1,4,24,111,1,860,1,3,1,1,2,single-choice,spatial-relational,1|2,7,1/2,240111,1
1,4,24,112,1,903,2,12,5,5,7,single-choice,spatial-relational,5|7,7,5/7,240112,5
1,4,24,113,1,1037,2,4,1,1,3,single-choice,spatial-relational,1|3,7,1/3,240113,1
1,4,24,114,1,1116,2,10,4,4,6,single-choice,spatial-relational,4|6,7,4/6,240114,4
1,4,24,115,1,1378,4,8,2,2,6,single-choice,spatial-relational,2|6,7,2/6,240115,2
1,4,24,116,0,913,5,9,2,7,7,single-choice,spatial-relational,2|7,7,2/7,240116,2
1,4,24,117,1,920,6,8,1,1,7,single-choice,spatial-relational,1|7,7,1/7,240117,1
1,4,24,118,1,802,2,12,5,5,7,single-choice,spatial-relational,5|7,7,5/7,240118,5
1,4,24,119,1,1249,3,7,2,2,5,single-choice,spatial-relational,2|5,7,2/5,240119,2
1,4,24,120,1,1049,1,5,2,2,3,single-choice,spatial-relational,2|3,7,2/3,240120,2
1,4,24,121,0,970,3,7,2,5,5,single-choice,spatial-relational,2|5,7,2/5,240121,2
1,4,24,122,1,789,3,11,4,4,7,single-choice,spatial-relational,4|7,7,4/7,240122,4
1,4,24,123,1,963,4,6,1,1,5,single-choice,spatial-relational,1|5,7,1/5,240123,1
1,4,24,124,1,1058,1,3,1,1,2,single-choice,spatial-relational,1|2,7,1/2,240124,1
1,4,24,125,1,978,6,8,1,1,7,single-choice,spatial-relational,1|7,7,1/7,240125,1
1,4,24,126,1,1000,2,8,3,3,5,single-choice,spatial-relational,3|5,7,3/5,240126,3
1,4,24,127,1,1274,1,9,4,4,5,single-choice,spatial-relational,4|5,7,4/5,240127,4
1,4,24,128,1,1157,2,8,3,3,5,single-choice,spatial-relational,3|5,7,3/5,240128,3
1,4,24,129,1,1200,4,6,1,1,5,single-choice,spatial-relational,1|5,7,1/5,240129,1
1,4,24,130,1,807,1,13,6,6,7,single-choice,spatial-relational,6|7,7,6/7,240130,6
1,4,24,131,1,876,4,10,3,3,7,single-choice,spatial-relational,3|7,7,3/7,240131,3
1,4,24,132,1,1059,2,12,5,5,7,single-choice,spatial-relational,5|7,7,5/7,240132,5
1,4,24,133,1,916,2,10,4,4,6,single-choice,spatial-relational,4|6,7,4/6,240133,4
1,4,24,134,1,1535,2,4,1,1,3,single-choice,spatial-relational,1|3,7,1/3,240134,1
1,4,24,135,1,1016,3,9,3,3,6,single-choice,spatial-relational,3|6,7,3/6,240135,3
1,4,24,136,1,1008,4,10,3,3,7,single-choice,spatial-relational,3|7,7,3/7,240136,3
1,4,24,137,1,1001,1,5,2,2,3,single-choice,spatial-relational,2|3,7,2/3,240137,2
1,4,24,138,1,983,1,3,1,1,2,single-choice,spatial-relational,1|2,7,1/2,240138,1
1,4,24,139,1,779,1,11,5,5,6,single-choice,spatial-relational,5|6,7,5/6,240139,5
1,4,24,140,1,1065,3,5,1,1,4,single-choice,spatial-relational,1|4,7,1/4,240140,1
1,4,24,141,1,1238,3,7,2,2,5,single-choice,spatial-relational,2|5,7,2/5,240141,2
1,4,24,142,0,1528,2,8,3,5,5,single-choice,spatial-relational,3|5,7,3/5,240142,3
1,4,24,143,1,941,1,5,2,2,3,single-choice,spatial-relational,2|3,7,2/3,240143,2
1,4,24,144,1,762,3,11,4,4,7,single-choice,spatial-relational,4|7,7,4/7,240144,4
1,4,24,145,1,1170,6,8,1,1,7,single-choice,spatial-relational,1|7,7,1/7,240145,1
1,4,24,146,1,875,3,9,3,3,6,single-choice,spatial-relational,3|6,7,3/6,240146,3
1,4,24,147,1,1170,5,9,2,2,7,single-choice,spatial-relational,2|7,7,2/7,240147,2
1,4,24,148,1,717,1,3,1,1,2,single-choice,spatial-relational,1|2,7,1/2,240148,1
1,4,24,149,0,988,2,6,2,4,4,single-choice,spatial-relational,2|4,7,2/4,240149,2
1,4,24,150,1,878,2,4,1,1,3,single-choice,spatial-relational,1|3,7,1/3,240150,1
1,4,24,151,1,917,2,6,2,2,4,single-choice,spatial-relational,2|4,7,2/4,240151,2
1,4,24,152,1,1173,5,7,1,1,6,single-choice,spatial-relational,1|6,7,1/6,240152,1
1,4,24,153,1,931,4,8,2,2,6,single-choice,spatial-relational,2|6,7,2/6,240153,2
1,4,24,154,1,54,2,12,5,5,7,single-choice,spatial-relational,5|7,7,5/7,240154,5
1,4,24,155,1,1448,1,7,3,3,4,single-choice,spatial-relational,3|4,7,3/4,240155,3
1,4,24,156,1,1321,6,8,1,1,7,single-choice,spatial-relational,1|7,7,1/7,240156,1
1,4,24,157,1,831,3,5,1,1,4,single-choice,spatial-relational,1|4,7,1/4,240157,1
1,4,24,158,1,1095,4,8,2,2,6,single-choice,spatial-relational,2|6,7,2/6,240158,2
1,4,24,159,1,679,1,11,5,5,6,single-choice,spatial-relational,5|6,7,5/6,240159,5
1,4,24,160,1,1562,2,10,4,4,6,single-choice,spatial-relational,4|6,7,4/6,240160,4
1,4,24,161,1,1364,1,9,4,4,5,single-choice,spatial-relational,4|5,7,4/5,240161,4
1,4,24,162,1,1136,5,9,2,2,7,single-choice,spatial-relational,2|7,7,2/7,240162,2
1,4,24,163,1,987,5,7,1,1,6,single-choice,spatial-relational,1|6,7,1/6,240163,1
1,4,24,164,1,835,1,7,3,3,4,single-choice,spatial-relational,3|4,7,3/4,240164,3
1,4,24,165,1,926,3,11,4,4,7,single-choice,spatial-relational,4|7,7,4/7,240165,4
1,4,24,166,0,1262,3,7,2,5,5,single-choice,spatial-relational,2|5,7,2/5,240166,2
1,4,24,167,1,687,1,13,6,6,7,single-choice,spatial-relational,6|7,7,6/7,240167,6
1,4,24,168,1,1797,4,6,1,1,5,single-choice,spatial-relational,1|5,7,1/5,240168,1
1,4,24,169,1,1109,1,5,2,2,3,single-choice,spatial-relational,2|3,7,2/3,240169,2
1,4,24,170,1,1436,5,7,1,1,6,single-choice,spatial-relational,1|6,7,1/6,240170,1
1,4,24,171,1,1021,1,7,3,3,4,single-choice,spatial-relational,3|4,7,3/4,240171,3
1,4,24,172,1,970,2,12,5,5,7,single-choice,spatial-relational,5|7,7,5/7,240172,5
1,4,24,173,1,831,4,6,1,1,5,single-choice,spatial-relational,1|5,7,1/5,240173,1
1,4,24,174,1,1026,3,9,3,3,6,single-choice,spatial-relational,3|6,7,3/6,240174,3
1,4,24,175,0,1431,5,9,2,7,7,single-choice,spatial-relational,2|7,7,2/7,240175,2
1,4,24,176,1,1071,1,11,5,5,6,single-choice,spatial-relational,5|6,7,5/6,240176,5
1,4,24,177,1,942,5,9,2,2,7,single-choice,spatial-relational,2|7,7,2/7,240177,2
1,4,24,178,1,1340,2,6,2,2,4,single-choice,spatial-relational,2|4,7,2/4,240178,2
1,4,24,179,1,970,5,7,1,1,6,single-choice,spatial-relational,1|6,7,1/6,240179,1
1,4,24,180,1,856,3,11,4,4,7,single-choice,spatial-relational,4|7,7,4/7,240180,4
1,4,24,181,1,1516,2,12,5,5,7,single-choice,spatial-relational,5|7,7,5/7,240181,5
1,4,24,182,1,1972,2,4,1,1,3,single-choice,spatial-relational,1|3,7,1/3,240182,1
1,4,24,183,1,830,3,11,4,4,7,single-choice,spatial-relational,4|7,7,4/7,240183,4
1,4,24,184,1,1000,1,7,3,3,4,single-choice,spatial-relational,3|4,7,3/4,240184,3
1,4,24,185,1,987,1,9,4,4,5,single-choice,spatial-relational,4|5,7,4/5,240185,4
1,4,24,186,1,1070,4,8,2,2,6,single-choice,spatial-relational,2|6,7,2/6,240186,2
1,4,24,187,1,1518,3,7,2,2,5,single-choice,spatial-relational,2|5,7,2/5,240187,2
1,4,24,188,1,977,2,8,3,3,5,single-choice,spatial-relational,3|5,7,3/5,240188,3
1,4,24,189,1,748,1,3,1,1,2,single-choice,spatial-relational,1|2,7,1/2,240189,1
1,4,24,190,1,873,3,7,2,2,5,single-choice,spatial-relational,2|5,7,2/5,240190,2
1,4,24,191,1,1191,1,9,4,4,5,single-choice,spatial-relational,4|5,7,4/5,240191,4
1,4,24,192,1,1084,3,5,1,1,4,single-choice,spatial-relational,1|4,7,1/4,240192,1
1,4,24,193,1,859,2,10,4,4,6,single-choice,spatial-relational,4|6,7,4/6,240193,4
1,4,24,194,1,863,6,8,1,1,7,single-choice,spatial-relational,1|7,7,1/7,240194,1
1,4,24,195,0,691,1,5,2,3,3,single-choice,spatial-relational,2|3,7,2/3,240195,2
1,4,24,196,0,638,3,9,3,6,6,single-choice,spatial-relational,3|6,7,3/6,240196,3
1,4,24,197,1,1245,4,10,3,3,7,single-choice,spatial-relational,3|7,7,3/7,240197,3
1,4,24,198,1,838,2,10,4,4,6,single-choice,spatial-relational,4|6,7,4/6,240198,4
1,4,24,199,1,1320,4,8,2,2,6,single-choice,spatial-relational,2|6,7,2/6,240199,2
1,4,24,200,1,1002,2,4,1,1,3,single-choice,spatial-relational,1|3,7,1/3,240200,1
1,4,24,201,1,1041,1,13,6,6,7,single-choice,spatial-relational,6|7,7,6/7,240201,6
1,4,24,202,1,833,1,3,1,1,2,single-choice,spatial-relational,1|2,7,1/2,240202,1
1,4,24,203,1,1363,3,5,1,1,4,single-choice,spatial-relational,1|4,7,1/4,240203,1
1,4,24,204,1,1068,2,6,2,2,4,single-choice,spatial-relational,2|4,7,2/4,240204,2
1,4,24,205,1,1169,6,8,1,1,7,single-choice,spatial-relational,1|7,7,1/7,240205,1
1,4,24,206,1,815,4,10,3,3,7,single-choice,spatial-relational,3|7,7,3/7,240206,3
1,4,24,207,0,1778,4,6,1,5,5,single-choice,spatial-relational,1|5,7,1/5,240207,1
1,4,24,208,1,1963,1,11,5,5,6,single-choice,spatial-relational,5|6,7,5/6,240208,5
1,4,24,209,1,850,1,13,6,6,7,single-choice,spatial-relational,6|7,7,6/7,240209,6
1,4,24,210,1,1345,2,8,3,3,5,single-choice,spatial-relational,3|5,7,3/5,240210,3
1,4,24,211,1,1299,4,8,2,2,6,single-choice,spatial-relational,2|6,7,2/6,240211,2
1,4,24,212,1,824,1,13,6,6,7,single-choice,spatial-relational,6|7,7,6/7,240212,6
1,4,24,213,1,1276,1,9,4,4,5,single-choice,spatial-relational,4|5,7,4/5,240213,4
1,4,24,214,1,2108,2,8,3,3,5,single-choice,spatial-relational,3|5,7,3/5,240214,3
1,4,24,215,1,1010,1,5,2,2,3,single-choice,spatial-relational,2|3,7,2/3,240215,2
1,4,24,216,1,858,2,12,5,5,7,single-choice,spatial-relational,5|7,7,5/7,240216,5
1,4,24,217,1,823,1,3,1,1,2,single-choice,spatial-relational,1|2,7,1/2,240217,1
1,4,24,218,1,1068,2,10,4,4,6,single-choice,spatial-relational,4|6,7,4/6,240218,4
1,4,24,219,1,1200,4,8,2,2,6,single-choice,spatial-relational,2|6,7,2/6,240219,2
1,4,24,220,1,962,6,8,1,1,7,single-choice,spatial-relational,1|7,7,1/7,240220,1
1,4,24,221,1,1170,4,10,3,3,7,single-choice,spatial-relational,3|7,7,3/7,240221,3
1,4,24,222,1,915,1,13,6,6,7,single-choice,spatial-relational,6|7,7,6/7,240222,6
1,4,24,223,0,1738,2,6,2,4,4,single-choice,spatial-relational,2|4,7,2/4,240223,2
1,4,24,224,1,1087,3,7,2,2,5,single-choice,spatial-relational,2|5,7,2/5,240224,2
1,4,24,225,1,1358,2,8,3,3,5,single-choice,spatial-relational,3|5,7,3/5,240225,3
1,4,24,226,1,831,4,6,1,1,5,single-choice,spatial-relational,1|5,7,1/5,240226,1
1,4,24,227,1,881,4,10,3,3,7,single-choice,spatial-relational,3|7,7,3/7,240227,3
1,4,24,228,1,1446,3,5,1,1,4,single-choice,spatial-relational,1|4,7,1/4,240228,1
1,4,24,229,1,877,5,7,1,1,6,single-choice,spatial-relational,1|6,7,1/6,240229,1
1,4,24,230,1,912,3,9,3,3,6,single-choice,spatial-relational,3|6,7,3/6,240230,3
1,4,24,231,1,873,3,11,4,4,7,single-choice,spatial-relational,4|7,7,4/7,240231,4
1,4,24,232,1,1365,2,6,2,2,4,single-choice,spatial-relational,2|4,7,2/4,240232,2
1,4,24,233,1,1134,5,9,2,2,7,single-choice,spatial-relational,2|7,7,2/7,240233,2
1,4,24,234,1,826,1,5,2,2,3,single-choice,spatial-relational,2|3,7,2/3,240234,2
1,4,24,235,0,1122,3,7,2,5,5,single-choice,spatial-relational,2|5,7,2/5,240235,2
1,4,24,236,1,910,3,5,1,1,4,single-choice,spatial-relational,1|4,7,1/4,240236,1
1,4,24,237,1,946,1,9,4,4,5,single-choice,spatial-relational,4|5,7,4/5,240237,4
1,4,24,238,1,1151,3,9,3,3,6,single-choice,spatial-relational,3|6,7,3/6,240238,3
1,4,24,239,1,1013,5,7,1,1,6,single-choice,spatial-relational,1|6,7,1/6,240239,1
1,4,24,240,1,1035,5,9,2,2,7,single-choice,spatial-relational,2|7,7,2/7,240240,2
1,4,24,241,1,1111,2,10,4,4,6,single-choice,spatial-relational,4|6,7,4/6,240241,4
1,4,24,242,1,1886,2,12,5,5,7,single-choice,spatial-relational,5|7,7,5/7,240242,5
1,4,24,243,1,931,4,6,1,1,5,single-choice,spatial-relational,1|5,7,1/5,240243,1
1,4,24,244,1,951,3,11,4,4,7,single-choice,spatial-relational,4|7,7,4/7,240244,4
1,4,24,245,1,1140,2,4,1,1,3,single-choice,spatial-relational,1|3,7,1/3,240245,1
1,4,24,246,1,1098,1,11,5,5,6,single-choice,spatial-relational,5|6,7,5/6,240246,5
1,4,24,247,1,1069,1,7,3,3,4,single-choice,spatial-relational,3|4,7,3/4,240247,3
1,4,24,248,1,767,2,4,1,1,3,single-choice,spatial-relational,1|3,7,1/3,240248,1
1,4,24,249,1,746,1,11,5,5,6,single-choice,spatial-relational,5|6,7,5/6,240249,5
1,4,24,250,1,1119,6,8,1,1,7,single-choice,spatial-relational,1|7,7,1/7,240250,1
1,4,24,251,1,1034,1,7,3,3,4,single-choice,spatial-relational,3|4,7,3/4,240251,3
1,4,24,252,1,686,1,3,1,1,2,single-choice,spatial-relational,1|2,7,1/2,240252,1
1,4,24,253,1,688,1,3,1,1,2,single-choice,spatial-relational,1|2,7,1/2,240253,1
1,4,24,254,1,873,1,11,5,5,6,single-choice,spatial-relational,5|6,7,5/6,240254,5
1,4,24,255,1,1079,1,7,3,3,4,single-choice,spatial-relational,3|4,7,3/4,240255,3
1,4,24,256,1,1081,1,5,2,2,3,single-choice,spatial-relational,2|3,7,2/3,240256,2
1,4,24,257,1,1189,3,5,1,1,4,single-choice,spatial-relational,1|4,7,1/4,240257,1
1,4,24,258,0,4,4,8,2,6,6,single-choice,spatial-relational,2|6,7,2/6,240258,2
1,4,24,259,1,994,4,6,1,1,5,single-choice,spatial-relational,1|5,7,1/5,240259,1
1,4,24,260,1,841,4,8,2,2,6,single-choice,spatial-relational,2|6,7,2/6,240260,2
1,4,24,261,1,798,1,13,6,6,7,single-choice,spatial-relational,6|7,7,6/7,240261,6
1,4,24,262,1,1927,3,5,1,1,4,single-choice,spatial-relational,1|4,7,1/4,240262,1
1,4,24,263,0,802,1,5,2,3,3,single-choice,spatial-relational,2|3,7,2/3,240263,2
1,4,24,264,0,1059,2,6,2,4,4,single-choice,spatial-relational,2|4,7,2/4,240264,2
1,4,24,265,1,888,1,9,4,4,5,single-choice,spatial-relational,4|5,7,4/5,240265,4
1,4,24,266,1,963,2,8,3,3,5,single-choice,spatial-relational,3|5,7,3/5,240266,3
1,4,24,267,1,996,2,10,4,4,6,single-choice,spatial-relational,4|6,7,4/6,240267,4
1,4,24,268,1,900,1,3,1,1,2,single-choice,spatial-relational,1|2,7,1/2,240268,1
1,4,24,269,1,770,1,11,5,5,6,single-choice,spatial-relational,5|6,7,5/6,240269,5
1,4,24,270,1,1222,2,6,2,2,4,single-choice,spatial-relational,2|4,7,2/4,240270,2
1,4,24,271,1,972,2,8,3,3,5,single-choice,spatial-relational,3|5,7,3/5,240271,3
1,4,24,272,1,2006,5,7,1,1,6,single-choice,spatial-relational,1|6,7,1/6,240272,1
1,4,24,273,1,948,5,7,1,1,6,single-choice,spatial-relational,1|6,7,1/6,240273,1
1,4,24,274,1,1195,6,8,1,1,7,single-choice,spatial-relational,1|7,7,1/7,240274,1
1,4,24,275,1,1270,4,6,1,1,5,single-choice,spatial-relational,1|5,7,1/5,240275,1
1,4,24,276,1,1002,1,9,4,4,5,single-choice,spatial-relational,4|5,7,4/5,240276,4
1,4,24,277,1,1012,3,7,2,2,5,single-choice,spatial-relational,2|5,7,2/5,240277,2
1,4,24,278,1,764,1,13,6,6,7,single-choice,spatial-relational,6|7,7,6/7,240278,6
1,4,24,279,1,1276,5,9,2,2,7,single-choice,spatial-relational,2|7,7,2/7,240279,2
1,4,24,280,1,1015,1,7,3,3,4,single-choice,spatial-relational,3|4,7,3/4,240280,3
1,4,24,281,1,862,2,12,5,5,7,single-choice,spatial-relational,5|7,7,5/7,240281,5
1,4,24,282,1,1160,2,12,5,5,7,single-choice,spatial-relational,5|7,7,5/7,240282,5
1,4,24,283,1,1146,4,10,3,3,7,single-choice,spatial-relational,3|7,7,3/7,240283,3
1,4,24,284,1,975,4,10,3,3,7,single-choice,spatial-relational,3|7,7,3/7,240284,3
1,4,24,285,1,1030,2,4,1,1,3,single-choice,spatial-relational,1|3,7,1/3,240285,1
1,4,24,286,1,846,6,8,1,1,7,single-choice,spatial-relational,1|7,7,1/7,240286,1
1,4,24,287,1,867,3,9,3,3,6,single-choice,spatial-relational,3|6,7,3/6,240287,3
1,4,24,288,1,986,2,4,1,1,3,single-choice,spatial-relational,1|3,7,1/3,240288,1
1,4,24,289,1,998,3,11,4,4,7,single-choice,spatial-relational,4|7,7,4/7,240289,4
1,4,24,290,1,928,3,9,3,3,6,single-choice,spatial-relational,3|6,7,3/6,240290,3
1,4,24,291,1,1558,5,9,2,2,7,single-choice,spatial-relational,2|7,7,2/7,240291,2
1,4,24,292,1,882,3,11,4,4,7,single-choice,spatial-relational,4|7,7,4/7,240292,4
1,4,24,293,1,1289,3,7,2,2,5,single-choice,spatial-relational,2|5,7,2/5,240293,2
1,4,24,294,1,1102,2,10,4,4,6,single-choice,spatial-relational,4|6,7,4/6,240294,4
1,4,24,295,1,1231,3,11,4,4,7,single-choice,spatial-relational,4|7,7,4/7,240295,4
1,4,24,296,1,1218,3,7,2,2,5,single-choice,spatial-relational,2|5,7,2/5,240296,2
1,4,24,297,0,733,3,7,2,5,5,single-choice,spatial-relational,2|5,7,2/5,240297,2
1,4,24,298,0,626,4,6,1,5,5,single-choice,spatial-relational,1|5,7,1/5,240298,1
1,4,24,299,0,666,4,8,2,6,6,single-choice,spatial-relational,2|6,7,2/6,240299,2
1,4,24,300,1,1243,1,9,4,4,5,single-choice,spatial-relational,4|5,7,4/5,240300,4
1,4,24,301,1,1025,1,13,6,6,7,single-choice,spatial-relational,6|7,7,6/7,240301,6
1,4,24,302,1,1136,5,9,2,2,7,single-choice,spatial-relational,2|7,7,2/7,240302,2
1,4,24,303,1,646,2,12,5,5,7,single-choice,spatial-relational,5|7,7,5/7,240303,5
1,4,24,304,0,1494,2,6,2,4,4,single-choice,spatial-relational,2|4,7,2/4,240304,2
1,4,24,305,1,639,1,3,1,1,2,single-choice,spatial-relational,1|2,7,1/2,240305,1
1,4,24,306,1,783,3,5,1,1,4,single-choice,spatial-relational,1|4,7,1/4,240306,1
1,4,24,307,1,1049,5,7,1,1,6,single-choice,spatial-relational,1|6,7,1/6,240307,1
1,4,24,308,1,893,1,5,2,2,3,single-choice,spatial-relational,2|3,7,2/3,240308,2
1,4,24,309,1,1156,2,6,2,2,4,single-choice,spatial-relational,2|4,7,2/4,240309,2
1,4,24,310,0,1975,4,6,1,5,5,single-choice,spatial-relational,1|5,7,1/5,240310,1
1,4,24,311,0,1042,1,11,5,6,6,single-choice,spatial-relational,5|6,7,5/6,240311,5
1,4,24,312,1,711,4,10,3,3,7,single-choice,spatial-relational,3|7,7,3/7,240312,3
1,4,24,313,1,847,3,9,3,3,6,single-choice,spatial-relational,3|6,7,3/6,240313,3
1,4,24,314,1,1112,6,8,1,1,7,single-choice,spatial-relational,1|7,7,1/7,240314,1
1,4,24,315,1,1478,2,4,1,1,3,single-choice,spatial-relational,1|3,7,1/3,240315,1
1,4,24,316,0,1912,1,7,3,4,4,single-choice,spatial-relational,3|4,7,3/4,240316,3
1,4,24,317,1,859,5,7,1,1,6,single-choice,spatial-relational,1|6,7,1/6,240317,1
1,4,24,318,1,665,3,9,3,3,6,single-choice,spatial-relational,3|6,7,3/6,240318,3
1,4,24,319,1,1088,1,11,5,5,6,single-choice,spatial-relational,5|6,7,5/6,240319,5
1,4,24,320,1,912,3,11,4,4,7,single-choice,spatial-relational,4|7,7,4/7,240320,4
1,4,24,321,1,773,1,3,1,1,2,single-choice,spatial-relational,1|2,7,1/2,240321,1
1,4,24,322,1,978,5,9,2,2,7,single-choice,spatial-relational,2|7,7,2/7,240322,2
1,4,24,323,1,976,4,8,2,2,6,single-choice,spatial-relational,2|6,7,2/6,240323,2
1,4,24,324,1,986,1,5,2,2,3,single-choice,spatial-relational,2|3,7,2/3,240324,2
1,4,24,325,1,746,1,13,6,6,7,single-choice,spatial-relational,6|7,7,6/7,240325,6
1,4,24,326,1,917,2,8,3,3,5,single-choice,spatial-relational,3|5,7,3/5,240326,3
1,4,24,327,1,1553,6,8,1,1,7,single-choice,spatial-relational,1|7,7,1/7,240327,1
1,4,24,328,1,816,1,9,4,4,5,single-choice,spatial-relational,4|5,7,4/5,240328,4
1,4,24,329,1,1162,2,8,3,3,5,single-choice,spatial-relational,3|5,7,3/5,240329,3
1,4,24,330,1,863,4,10,3,3,7,single-choice,spatial-relational,3|7,7,3/7,240330,3
1,4,24,331,0,1231,2,10,4,6,6,single-choice,spatial-relational,4|6,7,4/6,240331,4
1,4,24,332,1,1315,2,10,4,4,6,single-choice,spatial-relational,4|6,7,4/6,240332,4
1,4,24,333,1,1086,2,12,5,5,7,single-choice,spatial-relational,5|7,7,5/7,240333,5
1,4,24,334,1,1048,2,4,1,1,3,single-choice,spatial-relational,1|3,7,1/3,240334,1
1,4,24,335,1,974,3,5,1,1,4,single-choice,spatial-relational,1|4,7,1/4,240335,1
1,4,24,336,1,1146,1,7,3,3,4,single-choice,spatial-relational,3|4,7,3/4,240336,3
1,4,24,337,1,1422,3,7,2,2,5,single-choice,spatial-relational,2|5,7,2/5,240337,2
1,4,24,338,1,936,3,7,2,2,5,single-choice,spatial-relational,2|5,7,2/5,240338,2
1,4,24,339,1,1065,4,6,1,1,5,single-choice,spatial-relational,1|5,7,1/5,240339,1
1,4,24,340,1,751,5,9,2,2,7,single-choice,spatial-relational,2|7,7,2/7,240340,2
1,4,24,341,0,706,1,3,1,2,2,single-choice,spatial-relational,1|2,7,1/2,240341,1
1,4,24,342,1,59,1,11,5,5,6,single-choice,spatial-relational,5|6,7,5/6,240342,5
1,4,24,343,1,911,5,7,1,1,6,single-choice,spatial-relational,1|6,7,1/6,240343,1
1,4,24,344,1,736,3,11,4,4,7,single-choice,spatial-relational,4|7,7,4/7,240344,4
1,4,24,345,1,983,3,11,4,4,7,single-choice,spatial-relational,4|7,7,4/7,240345,4
1,4,24,346,1,1203,4,10,3,3,7,single-choice,spatial-relational,3|7,7,3/7,240346,3
1,4,24,347,1,875,4,10,3,3,7,single-choice,spatial-relational,3|7,7,3/7,240347,3
1,4,24,348,1,1061,1,5,2,2,3,single-choice,spatial-relational,2|3,7,2/3,240348,2
1,4,24,349,0,2184,2,8,3,5,5,single-choice,spatial-relational,3|5,7,3/5,240349,3
1,4,24,350,0,972,3,5,1,4,4,single-choice,spatial-relational,1|4,7,1/4,240350,1
1,4,24,351,1,831,1,5,2,2,3,single-choice,spatial-relational,2|3,7,2/3,240351,2
1,4,24,352,1,1189,2,4,1,1,3,single-choice,spatial-relational,1|3,7,1/3,240352,1
1,4,24,353,1,879,4,8,2,2,6,single-choice,spatial-relational,2|6,7,2/6,240353,2
1,4,24,354,0,927,2,10,4,6,6,single-choice,spatial-relational,4|6,7,4/6,240354,4
1,4,24,355,1,789,1,13,6,6,7,single-choice,spatial-relational,6|7,7,6/7,240355,6
1,4,24,356,1,923,6,8,1,1,7,single-choice,spatial-relational,1|7,7,1/7,240356,1
1,4,24,357,1,908,3,9,3,3,6,single-choice,spatial-relational,3|6,7,3/6,240357,3
1,4,24,358,1,1346,6,8,1,1,7,single-choice,spatial-relational,1|7,7,1/7,240358,1
1,4,24,359,0,794,2,6,2,4,4,single-choice,spatial-relational,2|4,7,2/4,240359,2
1,4,24,360,1,906,4,8,2,2,6,single-choice,spatial-relational,2|6,7,2/6,240360,2
1,4,24,361,1,824,2,4,1,1,3,single-choice,spatial-relational,1|3,7,1/3,240361,1
1,4,24,362,1,1049,4,6,1,1,5,single-choice,spatial-relational,1|5,7,1/5,240362,1
1,4,24,363,1,643,2,10,4,4,6,single-choice,spatial-relational,4|6,7,4/6,240363,4
1,4,24,364,1,1034,3,9,3,3,6,single-choice,spatial-relational,3|6,7,3/6,240364,3
1,4,24,365,1,1023,2,12,5,5,7,single-choice,spatial-relational,5|7,7,5/7,240365,5
1,4,24,366,0,1301,1,7,3,4,4,single-choice,spatial-relational,3|4,7,3/4,240366,3
1,4,24,367,1,1049,2,12,5,5,7,single-choice,spatial-relational,5|7,7,5/7,240367,5
1,4,24,368,1,740,1,3,1,1,2,single-choice,spatial-relational,1|2,7,1/2,240368,1
1,4,24,369,1,979,1,7,3,3,4,single-choice,spatial-relational,3|4,7,3/4,240369,3
1,4,24,370,1,1659,2,8,3,3,5,single-choice,spatial-relational,3|5,7,3/5,240370,3
1,4,24,371,1,858,3,5,1,1,4,single-choice,spatial-relational,1|4,7,1/4,240371,1
1,4,24,372,1,979,5,9,2,2,7,single-choice,spatial-relational,2|7,7,2/7,240372,2
1,4,24,373,1,885,1,13,6,6,7,single-choice,spatial-relational,6|7,7,6/7,240373,6
1,4,24,374,1,973,1,9,4,4,5,single-choice,spatial-relational,4|5,7,4/5,240374,4
1,4,24,375,1,988,2,6,2,2,4,single-choice,spatial-relational,2|4,7,2/4,240375,2
1,4,24,376,1,1123,1,9,4,4,5,single-choice,spatial-relational,4|5,7,4/5,240376,4
1,4,24,377,1,1118,1,11,5,5,6,single-choice,spatial-relational,5|6,7,5/6,240377,5
1,4,24,378,1,1076,5,7,1,1,6,single-choice,spatial-relational,1|6,7,1/6,240378,1
1,4,24,379,0,779,1,11,5,6,6,single-choice,spatial-relational,5|6,7,5/6,240379,5
1,4,24,380,1,747,6,8,1,1,7,single-choice,spatial-relational,1|7,7,1/7,240380,1
1,4,24,381,1,776,5,7,1,1,6,single-choice,spatial-relational,1|6,7,1/6,240381,1
1,4,24,382,1,603,1,13,6,6,7,single-choice,spatial-relational,6|7,7,6/7,240382,6
1,4,24,383,1,976,4,6,1,1,5,single-choice,spatial-relational,1|5,7,1/5,240383,1
1,4,24,384,1,843,1,9,4,4,5,single-choice,spatial-relational,4|5,7,4/5,240384,4
1,4,24,385,1,1210,2,8,3,3,5,single-choice,spatial-relational,3|5,7,3/5,240385,3
1,4,24,386,1,1119,1,7,3,3,4,single-choice,spatial-relational,3|4,7,3/4,240386,3
1,4,24,387,1,1131,3,7,2,2,5,single-choice,spatial-relational,2|5,7,2/5,240387,2
1,4,24,388,1,913,3,11,4,4,7,single-choice,spatial-relational,4|7,7,4/7,240388,4
1,4,24,389,1,2043,1,11,5,5,6,single-choice,spatial-relational,5|6,7,5/6,240389,5
1,4,24,390,1,1247,3,7,2,2,5,single-choice,spatial-relational,2|5,7,2/5,240390,2
1,4,24,391,1,1133,5,9,2,2,7,single-choice,spatial-relational,2|7,7,2/7,240391,2
1,4,24,392,0,923,1,5,2,3,3,single-choice,spatial-relational,2|3,7,2/3,240392,2
1,4,24,393,1,1050,4,10,3,3,7,single-choice,spatial-relational,3|7,7,3/7,240393,3
1,4,24,394,1,1206,3,5,1,1,4,single-choice,spatial-relational,1|4,7,1/4,240394,1
1,4,24,395,1,784,4,8,2,2,6,single-choice,spatial-relational,2|6,7,2/6,240395,2
1,4,24,396,1,835,1,13,6,6,7,single-choice,spatial-relational,6|7,7,6/7,240396,6
1,4,24,397,1,835,1,3,1,1,2,single-choice,spatial-relational,1|2,7,1/2,240397,1
1,4,24,398,1,946,3,9,3,3,6,single-choice,spatial-relational,3|6,7,3/6,240398,3
1,4,24,399,1,947,2,12,5,5,7,single-choice,spatial-relational,5|7,7,5/7,240399,5
1,4,24,400,0,1476,1,7,3,4,4,single-choice,spatial-relational,3|4,7,3/4,240400,3
1,4,24,401,1,977,1,9,4,4,5,single-choice,spatial-relational,4|5,7,4/5,240401,4
1,4,24,402,1,987,4,6,1,1,5,single-choice,spatial-relational,1|5,7,1/5,240402,1
1,4,24,403,1,765,3,9,3,3,6,single-choice,spatial-relational,3|6,7,3/6,240403,3
1,4,24,404,1,1319,5,9,2,2,7,single-choice,spatial-relational,2|7,7,2/7,240404,2
1,4,24,405,1,643,3,11,4,4,7,single-choice,spatial-relational,4|7,7,4/7,240405,4
1,4,24,406,1,1140,5,7,1,1,6,single-choice,spatial-relational,1|6,7,1/6,240406,1
1,4,24,407,1,737,6,8,1,1,7,single-choice,spatial-relational,1|7,7,1/7,240407,1
1,4,24,408,1,966,2,6,2,2,4,single-choice,spatial-relational,2|4,7,2/4,240408,2
1,4,24,409,1,1296,2,8,3,3,5,single-choice,spatial-relational,3|5,7,3/5,240409,3
1,4,24,410,1,1161,2,6,2,2,4,single-choice,spatial-relational,2|4,7,2/4,240410,2
1,4,24,411,1,942,3,5,1,1,4,single-choice,spatial-relational,1|4,7,1/4,240411,1
1,4,24,412,1,861,1,3,1,1,2,single-choice,spatial-relational,1|2,7,1/2,240412,1
1,4,24,413,1,652,2,10,4,4,6,single-choice,spatial-relational,4|6,7,4/6,240413,4
1,4,24,414,1,1076,2,12,5,5,7,single-choice,spatial-relational,5|7,7,5/7,240414,5
1,4,24,415,0,1002,2,10,4,6,6,single-choice,spatial-relational,4|6,7,4/6,240415,4
1,4,24,416,0,18,2,4,1,3,3,single-choice,spatial-relational,1|3,7,1/3,240416,1
1,4,24,417,1,3,1,5,2,2,3,single-choice,spatial-relational,2|3,7,2/3,240417,2
1,4,24,418,1,696,4,10,3,3,7,single-choice,spatial-relational,3|7,7,3/7,240418,3
1,4,24,419,1,875,2,4,1,1,3,single-choice,spatial-relational,1|3,7,1/3,240419,1
1,4,24,420,1,929,4,8,2,2,6,single-choice,spatial-relational,2|6,7,2/6,240420,2
1,4,24,421,1,677,2,4,1,1,3,single-choice,spatial-relational,1|3,7,1/3,240421,1
1,4,24,422,1,782,4,6,1,1,5,single-choice,spatial-relational,1|5,7,1/5,240422,1
1,4,24,423,1,1305,2,10,4,4,6,single-choice,spatial-relational,4|6,7,4/6,240423,4
1,4,24,424,1,867,5,7,1,1,6,single-choice,spatial-relational,1|6,7,1/6,240424,1
1,4,24,425,0,37282,3,7,2,5,5,single-choice,spatial-relational,2|5,7,2/5,240425,2
1,4,24,426,1,1142,1,5,2,2,3,single-choice,spatial-relational,2|3,7,2/3,240426,2
1,4,24,427,1,13776,1,13,6,6,7,single-choice,spatial-relational,6|7,7,6/7,240427,6
1,4,24,428,1,877,1,11,5,5,6,single-choice,spatial-relational,5|6,7,5/6,240428,5
1,4,24,429,1,815,1,13,6,6,7,single-choice,spatial-relational,6|7,7,6/7,240429,6
1,4,24,430,1,726,2,4,1,1,3,single-choice,spatial-relational,1|3,7,1/3,240430,1
1,4,24,431,1,1483,2,8,3,3,5,single-choice,spatial-relational,3|5,7,3/5,240431,3
1,4,24,432,1,831,3,11,4,4,7,single-choice,spatial-relational,4|7,7,4/7,240432,4
1,4,24,433,1,926,1,7,3,3,4,single-choice,spatial-relational,3|4,7,3/4,240433,3
1,4,24,434,1,576,1,3,1,1,2,single-choice,spatial-relational,1|2,7,1/2,240434,1
1,4,24,435,0,6374,1,3,1,2,2,single-choice,spatial-relational,1|2,7,1/2,240435,1
1,4,24,436,1,11077,1,9,4,4,5,single-choice,spatial-relational,4|5,7,4/5,240436,4
1,4,24,437,1,1244,4,6,1,1,5,single-choice,spatial-relational,1|5,7,1/5,240437,1
1,4,24,438,1,781,4,10,3,3,7,single-choice,spatial-relational,3|7,7,3/7,240438,3
1,4,24,439,1,948,4,8,2,2,6,single-choice,spatial-relational,2|6,7,2/6,240439,2
1,4,24,440,1,925,5,7,1,1,6,single-choice,spatial-relational,1|6,7,1/6,240440,1
1,4,24,441,1,1076,6,8,1,1,7,single-choice,spatial-relational,1|7,7,1/7,240441,1
1,4,24,442,1,1131,3,5,1,1,4,single-choice,spatial-relational,1|4,7,1/4,240442,1
1,4,24,443,1,953,5,9,2,2,7,single-choice,spatial-relational,2|7,7,2/7,240443,2
1,4,24,444,1,901,5,9,2,2,7,single-choice,spatial-relational,2|7,7,2/7,240444,2
1,4,24,445,1,825,2,10,4,4,6,single-choice,spatial-relational,4|6,7,4/6,240445,4
1,4,24,446,1,891,3,9,3,3,6,single-choice,spatial-relational,3|6,7,3/6,240446,3
1,4,24,447,0,1469,1,7,3,4,4,single-choice,spatial-relational,3|4,7,3/4,240447,3
1,4,24,448,1,980,4,10,3,3,7,single-choice,spatial-relational,3|7,7,3/7,240448,3
1,4,24,449,0,1091,1,9,4,5,5,single-choice,spatial-relational,4|5,7,4/5,240449,4
1,4,24,450,1,871,2,12,5,5,7,single-choice,spatial-relational,5|7,7,5/7,240450,5
1,4,24,451,1,1221,2,6,2,2,4,single-choice,spatial-relational,2|4,7,2/4,240451,2
1,4,24,452,1,839,3,11,4,4,7,single-choice,spatial-relational,4|7,7,4/7,240452,4
1,4,24,453,1,1303,2,6,2,2,4,single-choice,spatial-relational,2|4,7,2/4,240453,2
1,4,24,454,1,1320,3,5,1,1,4,single-choice,spatial-relational,1|4,7,1/4,240454,1
1,4,24,455,1,748,3,9,3,3,6,single-choice,spatial-relational,3|6,7,3/6,240455,3
1,4,24,456,1,996,2,12,5,5,7,single-choice,spatial-relational,5|7,7,5/7,240456,5
1,4,24,457,1,921,6,8,1,1,7,single-choice,spatial-relational,1|7,7,1/7,240457,1
1,4,24,458,1,892,1,5,2,2,3,single-choice,spatial-relational,2|3,7,2/3,240458,2
1,4,24,459,1,867,4,8,2,2,6,single-choice,spatial-relational,2|6,7,2/6,240459,2
1,4,24,460,1,964,1,11,5,5,6,single-choice,spatial-relational,5|6,7,5/6,240460,5
1,4,24,461,1,825,3,7,2,2,5,single-choice,spatial-relational,2|5,7,2/5,240461,2
1,4,24,462,1,872,2,8,3,3,5,single-choice,spatial-relational,3|5,7,3/5,240462,3
1,4,24,463,1,1254,3,7,2,2,5,single-choice,spatial-relational,2|5,7,2/5,240463,2
1,4,24,464,1,1004,6,8,1,1,7,single-choice,spatial-relational,1|7,7,1/7,240464,1
1,4,24,465,1,2480,2,10,4,4,6,single-choice,spatial-relational,4|6,7,4/6,240465,4
1,4,24,466,1,873,1,13,6,6,7,single-choice,spatial-relational,6|7,7,6/7,240466,6
1,4,24,467,1,1497,2,8,3,3,5,single-choice,spatial-relational,3|5,7,3/5,240467,3
1,4,24,468,1,960,2,6,2,2,4,single-choice,spatial-relational,2|4,7,2/4,240468,2
1,4,24,469,1,1786,3,5,1,1,4,single-choice,spatial-relational,1|4,7,1/4,240469,1
1,4,24,470,1,935,3,9,3,3,6,single-choice,spatial-relational,3|6,7,3/6,240470,3
1,4,24,471,1,1215,3,5,1,1,4,single-choice,spatial-relational,1|4,7,1/4,240471,1
1,4,24,472,1,1341,1,3,1,1,2,single-choice,spatial-relational,1|2,7,1/2,240472,1
1,4,24,473,1,979,1,5,2,2,3,single-choice,spatial-relational,2|3,7,2/3,240473,2
1,4,24,474,1,701,1,7,3,3,4,single-choice,spatial-relational,3|4,7,3/4,240474,3
1,4,24,475,1,895,4,6,1,1,5,single-choice,spatial-relational,1|5,7,1/5,240475,1
1,4,24,476,0,1464,1,11,5,6,6,single-choice,spatial-relational,5|6,7,5/6,240476,5
1,4,24,477,1,987,2,4,1,1,3,single-choice,spatial-relational,1|3,7,1/3,240477,1
1,4,24,478,1,865,4,10,3,3,7,single-choice,spatial-relational,3|7,7,3/7,240478,3
1,4,24,479,1,1496,2,8,3,3,5,single-choice,spatial-relational,3|5,7,3/5,240479,3
1,4,24,480,1,1836,1,7,3,3,4,single-choice,spatial-relational,3|4,7,3/4,240480,3
1,4,24,481,1,1300,1,3,1,1,2,single-choice,spatial-relational,1|2,7,1/2,240481,1
1,4,24,482,1,759,5,9,2,2,7,single-choice,spatial-relational,2|7,7,2/7,240482,2
1,4,24,483,1,982,1,5,2,2,3,single-choice,spatial-relational,2|3,7,2/3,240483,2
1,4,24,484,1,979,2,4,1,1,3,single-choice,spatial-relational,1|3,7,1/3,240484,1
1,4,24,485,1,641,1,13,6,6,7,single-choice,spatial-relational,6|7,7,6/7,240485,6
1,4,24,486,1,1467,4,8,2,2,6,single-choice,spatial-relational,2|6,7,2/6,240486,2
1,4,24,487,1,1171,3,7,2,2,5,single-choice,spatial-relational,2|5,7,2/5,240487,2
1,4,24,488,1,733,1,9,4,4,5,single-choice,spatial-relational,4|5,7,4/5,240488,4
1,4,24,489,1,1303,3,11,4,4,7,single-choice,spatial-relational,4|7,7,4/7,240489,4
1,4,24,490,1,1132,5,7,1,1,6,single-choice,spatial-relational,1|6,7,1/6,240490,1
1,4,24,491,1,653,2,10,4,4,6,single-choice,spatial-relational,4|6,7,4/6,240491,4
1,4,24,492,1,983,4,10,3,3,7,single-choice,spatial-relational,3|7,7,3/7,240492,3
1,4,24,493,1,1757,3,9,3,3,6,single-choice,spatial-relational,3|6,7,3/6,240493,3
1,4,24,494,1,1021,5,7,1,1,6,single-choice,spatial-relational,1|6,7,1/6,240494,1
1,4,24,495,1,819,2,12,5,5,7,single-choice,spatial-relational,5|7,7,5/7,240495,5
1,4,24,496,1,1331,1,9,4,4,5,single-choice,spatial-relational,4|5,7,4/5,240496,4
1,4,24,497,1,927,6,8,1,1,7,single-choice,spatial-relational,1|7,7,1/7,240497,1
1,4,24,498,1,1075,2,6,2,2,4,single-choice,spatial-relational,2|4,7,2/4,240498,2
1,4,24,499,1,923,1,11,5,5,6,single-choice,spatial-relational,5|6,7,5/6,240499,5
1,4,24,500,1,1032,4,8,2,2,6,single-choice,spatial-relational,2|6,7,2/6,240500,2
1,4,24,501,1,946,2,12,5,5,7,single-choice,spatial-relational,5|7,7,5/7,240501,5
1,4,24,502,1,2528,5,9,2,2,7,single-choice,spatial-relational,2|7,7,2/7,240502,2
1,4,24,503,1,901,3,11,4,4,7,single-choice,spatial-relational,4|7,7,4/7,240503,4
1,4,24,504,1,1936,4,6,1,1,5,single-choice,spatial-relational,1|5,7,1/5,240504,1
1,4,24,505,0,1063,3,7,2,5,5,single-choice,spatial-relational,2|5,7,2/5,240505,2
1,4,24,506,1,1828,3,5,1,1,4,single-choice,spatial-relational,1|4,7,1/4,240506,1
1,4,24,507,0,6312,5,9,2,7,7,single-choice,spatial-relational,2|7,7,2/7,240507,2
1,4,24,508,1,1014,3,9,3,3,6,single-choice,spatial-relational,3|6,7,3/6,240508,3
1,4,24,509,1,1620,1,9,4,4,5,single-choice,spatial-relational,4|5,7,4/5,240509,4
1,4,24,510,1,1088,3,9,3,3,6,single-choice,spatial-relational,3|6,7,3/6,240510,3
1,4,24,511,1,1014,4,10,3,3,7,single-choice,spatial-relational,3|7,7,3/7,240511,3
1,4,24,512,1,996,2,6,2,2,4,single-choice,spatial-relational,2|4,7,2/4,240512,2
1,4,24,513,1,844,3,11,4,4,7,single-choice,spatial-relational,4|7,7,4/7,240513,4
1,4,24,514,1,1068,5,7,1,1,6,single-choice,spatial-relational,1|6,7,1/6,240514,1
1,4,24,515,1,998,1,9,4,4,5,single-choice,spatial-relational,4|5,7,4/5,240515,4
1,4,24,516,1,1125,5,9,2,2,7,single-choice,spatial-relational,2|7,7,2/7,240516,2
1,4,24,517,1,959,2,4,1,1,3,single-choice,spatial-relational,1|3,7,1/3,240517,1
1,4,24,518,1,1190,3,11,4,4,7,single-choice,spatial-relational,4|7,7,4/7,240518,4
1,4,24,519,1,1285,3,7,2,2,5,single-choice,spatial-relational,2|5,7,2/5,240519,2
1,4,24,520,1,1462,1,7,3,3,4,single-choice,spatial-relational,3|4,7,3/4,240520,3
1,4,24,521,1,1392,2,12,5,5,7,single-choice,spatial-relational,5|7,7,5/7,240521,5
1,4,24,522,1,1155,2,8,3,3,5,single-choice,spatial-relational,3|5,7,3/5,240522,3
1,4,24,523,1,977,4,6,1,1,5,single-choice,spatial-relational,1|5,7,1/5,240523,1
1,4,24,524,1,1133,4,6,1,1,5,single-choice,spatial-relational,1|5,7,1/5,240524,1
1,4,24,525,1,813,1,5,2,2,3,single-choice,spatial-relational,2|3,7,2/3,240525,2
1,4,24,526,1,924,4,8,2,2,6,single-choice,spatial-relational,2|6,7,2/6,240526,2
1,4,24,527,1,880,1,7,3,3,4,single-choice,spatial-relational,3|4,7,3/4,240527,3
1,4,24,528,1,1202,2,10,4,4,6,single-choice,spatial-relational,4|6,7,4/6,240528,4
1,4,24,529,1,624,1,13,6,6,7,single-choice,spatial-relational,6|7,7,6/7,240529,6
1,4,24,530,1,901,1,13,6,6,7,single-choice,spatial-relational,6|7,7,6/7,240530,6
1,4,24,531,1,953,5,7,1,1,6,single-choice,spatial-relational,1|6,7,1/6,240531,1
1,4,24,532,1,876,2,10,4,4,6,single-choice,spatial-relational,4|6,7,4/6,240532,4
1,4,24,533,1,2368,2,6,2,2,4,single-choice,spatial-relational,2|4,7,2/4,240533,2
1,4,24,534,1,1068,1,11,5,5,6,single-choice,spatial-relational,5|6,7,5/6,240534,5
1,4,24,535,1,953,6,8,1,1,7,single-choice,spatial-relational,1|7,7,1/7,240535,1
1,4,24,536,1,811,2,8,3,3,5,single-choice,spatial-relational,3|5,7,3/5,240536,3
1,4,24,537,1,970,2,12,5,5,7,single-choice,spatial-relational,5|7,7,5/7,240537,5
1,4,24,538,1,1048,2,4,1,1,3,single-choice,spatial-relational,1|3,7,1/3,240538,1
1,4,24,539,1,777,4,10,3,3,7,single-choice,spatial-relational,3|7,7,3/7,240539,3
1,4,24,540,1,901,4,8,2,2,6,single-choice,spatial-relational,2|6,7,2/6,240540,2
1,4,24,541,1,1050,1,5,2,2,3,single-choice,spatial-relational,2|3,7,2/3,240541,2
1,4,24,542,1,882,6,8,1,1,7,single-choice,spatial-relational,1|7,7,1/7,240542,1
1,4,24,543,1,1209,3,5,1,1,4,single-choice,spatial-relational,1|4,7,1/4,240543,1
1,4,24,544,0,854,1,3,1,2,2,single-choice,spatial-relational,1|2,7,1/2,240544,1
1,4,24,545,1,952,1,3,1,1,2,single-choice,spatial-relational,1|2,7,1/2,240545,1
1,4,24,546,1,1031,1,11,5,5,6,single-choice,spatial-relational,5|6,7,5/6,240546,5
1,4,24,547,1,1035,3,5,1,1,4,single-choice,spatial-relational,1|4,7,1/4,240547,1
1,4,24,548,1,996,2,6,2,2,4,single-choice,spatial-relational,2|4,7,2/4,240548,2
1,4,24,549,1,731,3,9,3,3,6,single-choice,spatial-relational,3|6,7,3/6,240549,3
1,4,24,550,1,1639,3,5,1,1,4,single-choice,spatial-relational,1|4,7,1/4,240550,1
1,4,24,551,1,1153,2,4,1,1,3,single-choice,spatial-relational,1|3,7,1/3,240551,1
1,4,24,552,1,1091,2,8,3,3,5,single-choice,spatial-relational,3|5,7,3/5,240552,3
1,4,24,553,1,1057,4,10,3,3,7,single-choice,spatial-relational,3|7,7,3/7,240553,3
1,4,24,554,1,1063,2,4,1,1,3,single-choice,spatial-relational,1|3,7,1/3,240554,1
1,4,24,555,1,959,1,13,6,6,7,single-choice,spatial-relational,6|7,7,6/7,240555,6
1,4,24,556,1,1238,4,10,3,3,7,single-choice,spatial-relational,3|7,7,3/7,240556,3
1,4,24,557,1,969,2,6,2,2,4,single-choice,spatial-relational,2|4,7,2/4,240557,2
1,4,24,558,1,1186,5,7,1,1,6,single-choice,spatial-relational,1|6,7,1/6,240558,1
1,4,24,559,1,970,5,9,2,2,7,single-choice,spatial-relational,2|7,7,2/7,240559,2
1,4,24,560,1,890,4,8,2,2,6,single-choice,spatial-relational,2|6,7,2/6,240560,2
1,4,24,561,1,815,3,11,4,4,7,single-choice,spatial-relational,4|7,7,4/7,240561,4
1,4,24,562,1,775,1,3,1,1,2,single-choice,spatial-relational,1|2,7,1/2,240562,1
1,4,24,563,1,1079,4,6,1,1,5,single-choice,spatial-relational,1|5,7,1/5,240563,1
1,4,24,564,1,657,2,10,4,4,6,single-choice,spatial-relational,4|6,7,4/6,240564,4
1,4,24,565,1,885,3,11,4,4,7,single-choice,spatial-relational,4|7,7,4/7,240565,4
1,4,24,566,1,839,4,6,1,1,5,single-choice,spatial-relational,1|5,7,1/5,240566,1
1,4,24,567,1,11498,6,8,1,1,7,single-choice,spatial-relational,1|7,7,1/7,240567,1
1,4,24,568,1,1090,1,9,4,4,5,single-choice,spatial-relational,4|5,7,4/5,240568,4
1,4,24,569,1,1298,1,5,2,2,3,single-choice,spatial-relational,2|3,7,2/3,240569,2
1,4,24,570,1,1109,3,7,2,2,5,single-choice,spatial-relational,2|5,7,2/5,240570,2
1,4,24,571,1,1782,1,7,3,3,4,single-choice,spatial-relational,3|4,7,3/4,240571,3
1,4,24,572,1,1034,5,9,2,2,7,single-choice,spatial-relational,2|7,7,2/7,240572,2
1,4,24,573,1,1257,2,10,4,4,6,single-choice,spatial-relational,4|6,7,4/6,240573,4
1,4,24,574,1,939,5,7,1,1,6,single-choice,spatial-relational,1|6,7,1/6,240574,1
1,4,24,575,1,854,1,11,5,5,6,single-choice,spatial-relational,5|6,7,5/6,240575,5
1,4,24,576,1,1165,3,9,3,3,6,single-choice,spatial-relational,3|6,7,3/6,240576,3
1,4,24,577,1,725,6,8,1,1,7,single-choice,spatial-relational,1|7,7,1/7,240577,1
1,4,24,578,1,999,1,5,2,2,3,single-choice,spatial-relational,2|3,7,2/3,240578,2
1,4,24,579,1,703,1,3,1,1,2,single-choice,spatial-relational,1|2,7,1/2,240579,1
1,4,24,580,1,769,4,8,2,2,6,single-choice,spatial-relational,2|6,7,2/6,240580,2
1,4,24,581,1,679,1,13,6,6,7,single-choice,spatial-relational,6|7,7,6/7,240581,6
1,4,24,582,1,1353,2,12,5,5,7,single-choice,spatial-relational,5|7,7,5/7,240582,5
1,4,24,583,1,1294,1,7,3,3,4,single-choice,spatial-relational,3|4,7,3/4,240583,3
1,4,24,584,1,2050,3,7,2,2,5,single-choice,spatial-relational,2|5,7,2/5,240584,2
1,4,24,585,1,1947,1,9,4,4,5,single-choice,spatial-relational,4|5,7,4/5,240585,4
1,4,24,586,1,860,2,12,5,5,7,single-choice,spatial-relational,5|7,7,5/7,240586,5
1,4,24,587,1,996,1,11,5,5,6,single-choice,spatial-relational,5|6,7,5/6,240587,5
1,4,24,588,1,822,2,8,3,3,5,single-choice,spatial-relational,3|5,7,3/5,240588,3
1,4,24,589,1,209772,1,3,1,1,2,single-choice,spatial-relational,1|2,7,1/2,240589,1
1,4,24,590,1,904,4,6,1,1,5,single-choice,spatial-relational,1|5,7,1/5,240590,1
1,4,24,591,1,1086,6,8,1,1,7,single-choice,spatial-relational,1|7,7,1/7,240591,1
1,4,24,592,1,867,5,9,2,2,7,single-choice,spatial-relational,2|7,7,2/7,240592,2
1,4,24,593,1,1674,3,5,1,1,4,single-choice,spatial-relational,1|4,7,1/4,240593,1
1,4,24,594,1,1144,5,7,1,1,6,single-choice,spatial-relational,1|6,7,1/6,240594,1
1,4,24,595,1,1093,1,7,3,3,4,single-choice,spatial-relational,3|4,7,3/4,240595,3
1,4,24,596,1,1436,2,12,5,5,7,single-choice,spatial-relational,5|7,7,5/7,240596,5
1,4,24,597,0,4568,3,5,1,4,4,single-choice,spatial-relational,1|4,7,1/4,240597,1
1,4,24,598,1,1158,2,8,3,3,5,single-choice,spatial-relational,3|5,7,3/5,240598,3
1,4,24,599,1,1126,3,7,2,2,5,single-choice,spatial-relational,2|5,7,2/5,240599,2
1,4,24,600,0,923,1,5,2,3,3,single-choice,spatial-relational,2|3,7,2/3,240600,2
2,4,24,1,1,1493,2,12,5,5,7,single-choice,spatial-relational,5|7,7,5/7,240001,5
2,4,24,2,1,1150,2,8,3,3,5,single-choice,spatial-relational,3|5,7,3/5,240002,3
2,4,24,3,1,1046,5,9,2,2,7,single-choice,spatial-relational,2|7,7,2/7,240003,2
2,4,24,4,1,895,3,5,1,1,4,single-choice,spatial-relational,1|4,7,1/4,240004,1
2,4,24,5,1,762,1,9,4,4,5,single-choice,spatial-relational,4|5,7,4/5,240005,4
2,4,24,6,1,1148,4,6,1,1,5,single-choice,spatial-relational,1|5,7,1/5,240006,1
2,4,24,7,0,669,1,11,5,6,6,single-choice,spatial-relational,5|6,7,5/6,240007,5
2,4,24,8,1,832,5,9,2,2,7,single-choice,spatial-relational,2|7,7,2/7,240008,2
2,4,24,9,1,896,2,4,1,1,3,single-choice,spatial-relational,1|3,7,1/3,240009,1
2,4,24,10,1,624,3,11,4,4,7,single-choice,spatial-relational,4|7,7,4/7,240010,4
2,4,24,11,1,1167,3,5,1,1,4,single-choice,spatial-relational,1|4,7,1/4,240011,1
2,4,24,12,1,723,4,10,3,3,7,single-choice,spatial-relational,3|7,7,3/7,240012,3
2,4,24,13,1,893,6,8,1,1,7,single-choice,spatial-relational,1|7,7,1/7,240013,1
2,4,24,14,1,1045,2,6,2,2,4,single-choice,spatial-relational,2|4,7,2/4,240014,2
2,4,24,15,1,778,3,9,3,3,6,single-choice,spatial-relational,3|6,7,3/6,240015,3
2,4,24,16,1,878,4,6,1,1,5,single-choice,spatial-relational,1|5,7,1/5,240016,1
2,4,24,17,1,844,5,7,1,1,6,single-choice,spatial-relational,1|6,7,1/6,240017,1
2,4,24,18,1,1098,4,8,2,2,6,single-choice,spatial-relational,2|6,7,2/6,240018,2
2,4,24,19,1,781,2,10,4,4,6,single-choice,spatial-relational,4|6,7,4/6,240019,4
2,4,24,20,1,888,1,9,4,4,5,single-choice,spatial-relational,4|5,7,4/5,240020,4
2,4,24,21,1,977,1,3,1,1,2,single-choice,spatial-relational,1|2,7,1/2,240021,1
2,4,24,22,1,701,1,7,3,3,4,single-choice,spatial-relational,3|4,7,3/4,240022,3
2,4,24,23,1,1336,4,10,3,3,7,single-choice,spatial-relational,3|7,7,3/7,240023,3
2,4,24,24,1,953,1,5,2,2,3,single-choice,spatial-relational,2|3,7,2/3,240024,2
2,4,24,25,1,940,4,8,2,2,6,single-choice,spatial-relational,2|6,7,2/6,240025,2
2,4,24,26,1,706,1,3,1,1,2,single-choice,spatial-relational,1|2,7,1/2,240026,1
2,4,24,27,1,675,3,11,4,4,7,single-choice,spatial-relational,4|7,7,4/7,240027,4
2,4,24,28,1,1684,2,10,4,4,6,single-choice,spatial-relational,4|6,7,4/6,240028,4
2,4,24,29,1,1005,3,7,2,2,5,single-choice,spatial-relational,2|5,7,2/5,240029,2
2,4,24,30,1,933,3,9,3,3,6,single-choice,spatial-relational,3|6,7,3/6,240030,3
2,4,24,31,1,827,2,12,5,5,7,single-choice,spatial-relational,5|7,7,5/7,240031,5
2,4,24,32,1,1171,2,6,2,2,4,single-choice,spatial-relational,2|4,7,2/4,240032,2
2,4,24,33,1,1330,1,5,2,2,3,single-choice,spatial-relational,2|3,7,2/3,240033,2
2,4,24,34,1,844,6,8,1,1,7,single-choice,spatial-relational,1|7,7,1/7,240034,1
2,4,24,35,1,839,2,8,3,3,5,single-choice,spatial-relational,3|5,7,3/5,240035,3
2,4,24,36,1,897,1,13,6,6,7,single-choice,spatial-relational,6|7,7,6/7,240036,6
2,4,24,37,0,573,1,7,3,4,4,single-choice,spatial-relational,3|4,7,3/4,240037,3
2,4,24,38,1,702,2,4,1,1,3,single-choice,spatial-relational,1|3,7,1/3,240038,1
2,4,24,39,1,5170,1,11,5,5,6,single-choice,spatial-relational,5|6,7,5/6,240039,5
2,4,24,40,1,743,1,13,6,6,7,single-choice,spatial-relational,6|7,7,6/7,240040,6
2,4,24,41,1,1306,3,7,2,2,5,single-choice,spatial-relational,2|5,7,2/5,240041,2
2,4,24,42,1,1002,5,7,1,1,6,single-choice,spatial-relational,1|6,7,1/6,240042,1
2,4,24,43,1,951,4,10,3,3,7,single-choice,spatial-relational,3|7,7,3/7,240043,3
2,4,24,44,1,1442,2,6,2,2,4,single-choice,spatial-relational,2|4,7,2/4,240044,2
2,4,24,45,1,817,6,8,1,1,7,single-choice,spatial-relational,1|7,7,1/7,240045,1
2,4,24,46,1,787,4,10,3,3,7,single-choice,spatial-relational,3|7,7,3/7,240046,3
2,4,24,47,1,837,1,5,2,2,3,single-choice,spatial-relational,2|3,7,2/3,240047,2
2,4,24,48,1,1022,2,6,2,2,4,single-choice,spatial-relational,2|4,7,2/4,240048,2
2,4,24,49,1,784,1,9,4,4,5,single-choice,spatial-relational,4|5,7,4/5,240049,4
2,4,24,50,1,939,3,5,1,1,4,single-choice,spatial-relational,1|4,7,1/4,240050,1
2,4,24,51,1,910,4,6,1,1,5,single-choice,spatial-relational,1|5,7,1/5,240051,1
2,4,24,52,1,758,3,9,3,3,6,single-choice,spatial-relational,3|6,7,3/6,240052,3
2,4,24,53,1,1045,1,11,5,5,6,single-choice,spatial-relational,5|6,7,5/6,240053,5
2,4,24,54,1,756,1,3,1,1,2,single-choice,spatial-relational,1|2,7,1/2,240054,1
2,4,24,55,1,768,2,12,5,5,7,single-choice,spatial-relational,5|7,7,5/7,240055,5
2,4,24,56,1,1072,3,7,2,2,5,single-choice,spatial-relational,2|5,7,2/5,240056,2
2,4,24,57,1,928,3,11,4,4,7,single-choice,spatial-relational,4|7,7,4/7,240057,4
2,4,24,58,0,1431,2,12,5,7,7,single-choice,spatial-relational,5|7,7,5/7,240058,5
2,4,24,59,0,1081,2,4,1,3,3,single-choice,spatial-relational,1|3,7,1/3,240059,1
2,4,24,60,1,1306,3,9,3,3,6,single-choice,spatial-relational,3|6,7,3/6,240060,3
2,4,24,61,1,1500,1,7,3,3,4,single-choice,spatial-relational,3|4,7,3/4,240061,3
2,4,24,62,1,1032,5,9,2,2,7,single-choice,spatial-relational,2|7,7,2/7,240062,2
2,4,24,63,1,1042,1,11,5,5,6,single-choice,spatial-relational,5|6,7,5/6,240063,5
2,4,24,64,1,1110,2,8,3,3,5,single-choice,spatial-relational,3|5,7,3/5,240064,3
2,4,24,65,1,743,1,3,1,1,2,single-choice,spatial-relational,1|2,7,1/2,240065,1
2,4,24,66,1,1252,1,5,2,2,3,single-choice,spatial-relational,2|3,7,2/3,240066,2
2,4,24,67,1,851,1,13,6,6,7,single-choice,spatial-relational,6|7,7,6/7,240067,6
2,4,24,68,1,1012,3,11,4,4,7,single-choice,spatial-relational,4|7,7,4/7,240068,4
2,4,24,69,1,974,1,13,6,6,7,single-choice,spatial-relational,6|7,7,6/7,240069,6
2,4,24,70,1,1051,5,9,2,2,7,single-choice,spatial-relational,2|7,7,2/7,240070,2
2,4,24,71,1,965,3,5,1,1,4,single-choice,spatial-relational,1|4,7,1/4,240071,1
2,4,24,72,1,1003,3,7,2,2,5,single-choice,spatial-relational,2|5,7,2/5,240072,2
2,4,24,73,1,1060,1,7,3,3,4,single-choice,spatial-relational,3|4,7,3/4,240073,3
2,4,24,74,0,1522,2,10,4,6,6,single-choice,spatial-relational,4|6,7,4/6,240074,4
2,4,24,75,1,861,4,6,1,1,5,single-choice,spatial-relational,1|5,7,1/5,240075,1
2,4,24,76,1,744,4,8,2,2,6,single-choice,spatial-relational,2|6,7,2/6,240076,2
2,4,24,77,1,626,2,4,1,1,3,single-choice,spatial-relational,1|3,7,1/3,240077,1
2,4,24,78,1,884,1,9,4,4,5,single-choice,spatial-relational,4|5,7,4/5,240078,4
2,4,24,79,1,895,5,7,1,1,6,single-choice,spatial-relational,1|6,7,1/6,240079,1
2,4,24,80,1,829,2,8,3,3,5,single-choice,spatial-relational,3|5,7,3/5,240080,3
2,4,24,81,1,1126,4,8,2,2,6,single-choice,spatial-relational,2|6,7,2/6,240081,2
2,4,24,82,1,660,2,10,4,4,6,single-choice,spatial-relational,4|6,7,4/6,240082,4
2,4,24,83,1,951,5,7,1,1,6,single-choice,spatial-relational,1|6,7,1/6,240083,1
2,4,24,84,1,886,6,8,1,1,7,single-choice,spatial-relational,1|7,7,1/7,240084,1
2,4,24,85,0,2497,1,5,2,3,3,single-choice,spatial-relational,2|3,7,2/3,240085,2
2,4,24,86,1,885,1,11,5,5,6,single-choice,spatial-relational,5|6,7,5/6,240086,5
2,4,24,87,1,859,1,3,1,1,2,single-choice,spatial-relational,1|2,7,1/2,240087,1
2,4,24,88,1,871,3,7,2,2,5,single-choice,spatial-relational,2|5,7,2/5,240088,2
2,4,24,89,1,1915,2,6,2,2,4,single-choice,spatial-relational,2|4,7,2/4,240089,2
2,4,24,90,1,823,4,8,2,2,6,single-choice,spatial-relational,2|6,7,2/6,240090,2
2,4,24,91,1,734,4,6,1,1,5,single-choice,spatial-relational,1|5,7,1/5,240091,1
2,4,24,92,1,805,1,13,6,6,7,single-choice,spatial-relational,6|7,7,6/7,240092,6
2,4,24,93,1,1033,2,10,4,4,6,single-choice,spatial-relational,4|6,7,4/6,240093,4
2,4,24,94,1,932,4,10,3,3,7,single-choice,spatial-relational,3|7,7,3/7,240094,3
2,4,24,95,1,1063,5,9,2,2,7,single-choice,spatial-relational,2|7,7,2/7,240095,2
2,4,24,96,1,785,5,7,1,1,6,single-choice,spatial-relational,1|6,7,1/6,240096,1
2,4,24,97,1,785,2,10,4,4,6,single-choice,spatial-relational,4|6,7,4/6,240097,4
2,4,24,98,1,913,2,4,1,1,3,single-choice,spatial-relational,1|3,7,1/3,240098,1
2,4,24,99,1,802,1,11,5,5,6,single-choice,spatial-relational,5|6,7,5/6,240099,5
2,4,24,100,1,1002,2,12,5,5,7,single-choice,spatial-relational,5|7,7,5/7,240100,5
2,4,24,101,1,1003,4,10,3,3,7,single-choice,spatial-relational,3|7,7,3/7,240101,3
2,4,24,102,1,1031,3,9,3,3,6,single-choice,spatial-relational,3|6,7,3/6,240102,3
2,4,24,103,1,533,2,12,5,5,7,single-choice,spatial-relational,5|7,7,5/7,240103,5
2,4,24,104,1,9801,3,7,2,2,5,single-choice,spatial-relational,2|5,7,2/5,240104,2
2,4,24,105,1,754,6,8,1,1,7,single-choice,spatial-relational,1|7,7,1/7,240105,1
2,4,24,106,1,842,2,4,1,1,3,single-choice,spatial-relational,1|3,7,1/3,240106,1
2,4,24,107,1,949,4,6,1,1,5,single-choice,spatial-relational,1|5,7,1/5,240107,1
2,4,24,108,1,1020,4,8,2,2,6,single-choice,spatial-relational,2|6,7,2/6,240108,2
2,4,24,109,1,851,3,11,4,4,7,single-choice,spatial-relational,4|7,7,4/7,240109,4
2,4,24,110,1,700,3,11,4,4,7,single-choice,spatial-relational,4|7,7,4/7,240110,4
2,4,24,111,1,964,1,7,3,3,4,single-choice,spatial-relational,3|4,7,3/4,240111,3
2,4,24,112,1,1076,3,9,3,3,6,single-choice,spatial-relational,3|6,7,3/6,240112,3
2,4,24,113,0,597,1,7,3,4,4,single-choice,spatial-relational,3|4,7,3/4,240113,3
2,4,24,114,1,896,1,5,2,2,3,single-choice,spatial-relational,2|3,7,2/3,240114,2
2,4,24,115,0,806,1,3,1,2,2,single-choice,spatial-relational,1|2,7,1/2,240115,1
2,4,24,116,1,854,5,9,2,2,7,single-choice,spatial-relational,2|7,7,2/7,240116,2
2,4,24,117,1,1124,3,5,1,1,4,single-choice,spatial-relational,1|4,7,1/4,240117,1
2,4,24,118,1,734,1,13,6,6,7,single-choice,spatial-relational,6|7,7,6/7,240118,6
2,4,24,119,1,850,2,8,3,3,5,single-choice,spatial-relational,3|5,7,3/5,240119,3
2,4,24,120,1,1835,6,8,1,1,7,single-choice,spatial-relational,1|7,7,1/7,240120,1
2,4,24,121,1,1005,5,7,1,1,6,single-choice,spatial-relational,1|6,7,1/6,240121,1
2,4,24,122,1,1018,2,8,3,3,5,single-choice,spatial-relational,3|5,7,3/5,240122,3
2,4,24,123,1,823,1,9,4,4,5,single-choice,spatial-relational,4|5,7,4/5,240123,4
2,4,24,124,1,1223,1,9,4,4,5,single-choice,spatial-relational,4|5,7,4/5,240124,4
2,4,24,125,1,887,3,5,1,1,4,single-choice,spatial-relational,1|4,7,1/4,240125,1
2,4,24,126,1,801,2,6,2,2,4,single-choice,spatial-relational,2|4,7,2/4,240126,2
2,4,24,127,1,628,3,11,4,4,7,single-choice,spatial-relational,4|7,7,4/7,240127,4
2,4,24,128,1,820,4,6,1,1,5,single-choice,spatial-relational,1|5,7,1/5,240128,1
2,4,24,129,1,915,3,7,2,2,5,single-choice,spatial-relational,2|5,7,2/5,240129,2
2,4,24,130,1,862,6,8,1,1,7,single-choice,spatial-relational,1|7,7,1/7,240130,1
2,4,24,131,1,806,2,6,2,2,4,single-choice,spatial-relational,2|4,7,2/4,240131,2
2,4,24,132,1,938,2,10,4,4,6,single-choice,spatial-relational,4|6,7,4/6,240132,4
2,4,24,133,1,742,2,4,1,1,3,single-choice,spatial-relational,1|3,7,1/3,240133,1
2,4,24,134,1,780,2,10,4,4,6,single-choice,spatial-relational,4|6,7,4/6,240134,4
2,4,24,135,1,1176,1,5,2,2,3,single-choice,spatial-relational,2|3,7,2/3,240135,2
2,4,24,136,0,664,1,3,1,2,2,single-choice,spatial-relational,1|2,7,1/2,240136,1
2,4,24,137,1,760,5,9,2,2,7,single-choice,spatial-relational,2|7,7,2/7,240137,2
2,4,24,138,1,907,5,7,1,1,6,single-choice,spatial-relational,1|6,7,1/6,240138,1
2,4,24,139,1,779,5,7,1,1,6,single-choice,spatial-relational,1|6,7,1/6,240139,1
2,4,24,140,1,706,1,7,3,3,4,single-choice,spatial-relational,3|4,7,3/4,240140,3
2,4,24,141,1,891,1,13,6,6,7,single-choice,spatial-relational,6|7,7,6/7,240141,6
2,4,24,142,1,990,2,4,1,1,3,single-choice,spatial-relational,1|3,7,1/3,240142,1
2,4,24,143,1,797,1,3,1,1,2,single-choice,spatial-relational,1|2,7,1/2,240143,1
2,4,24,144,1,912,2,8,3,3,5,single-choice,spatial-relational,3|5,7,3/5,240144,3
2,4,24,145,1,1057,2,6,2,2,4,single-choice,spatial-relational,2|4,7,2/4,240145,2
2,4,24,146,1,765,4,6,1,1,5,single-choice,spatial-relational,1|5,7,1/5,240146,1
2,4,24,147,1,866,2,8,3,3,5,single-choice,spatial-relational,3|5,7,3/5,240147,3
2,4,24,148,1,1577,3,5,1,1,4,single-choice,spatial-relational,1|4,7,1/4,240148,1
2,4,24,149,1,805,1,11,5,5,6,single-choice,spatial-relational,5|6,7,5/6,240149,5
2,4,24,150,1,733,1,9,4,4,5,single-choice,spatial-relational,4|5,7,4/5,240150,4
2,4,24,151,1,642,1,13,6,6,7,single-choice,spatial-relational,6|7,7,6/7,240151,6
2,4,24,152,1,957,3,5,1,1,4,single-choice,spatial-relational,1|4,7,1/4,240152,1
2,4,24,153,1,798,4,8,2,2,6,single-choice,spatial-relational,2|6,7,2/6,240153,2
2,4,24,154,1,921,4,8,2,2,6,single-choice,spatial-relational,2|6,7,2/6,240154,2
2,4,24,155,1,817,3,9,3,3,6,single-choice,spatial-relational,3|6,7,3/6,240155,3
2,4,24,156,1,861,4,10,3,3,7,single-choice,spatial-relational,3|7,7,3/7,240156,3
2,4,24,157,1,769,6,8,1,1,7,single-choice,spatial-relational,1|7,7,1/7,240157,1
2,4,24,158,1,737,5,9,2,2,7,single-choice,spatial-relational,2|7,7,2/7,240158,2
2,4,24,159,1,842,3,11,4,4,7,single-choice,spatial-relational,4|7,7,4/7,240159,4
2,4,24,160,1,1062,2,12,5,5,7,single-choice,spatial-relational,5|7,7,5/7,240160,5
2,4,24,161,1,1560,1,11,5,5,6,single-choice,spatial-relational,5|6,7,5/6,240161,5
2,4,24,162,1,963,4,10,3,3,7,single-choice,spatial-relational,3|7,7,3/7,240162,3
2,4,24,163,1,1251,1,9,4,4,5,single-choice,spatial-relational,4|5,7,4/5,240163,4
2,4,24,164,1,932,1,5,2,2,3,single-choice,spatial-relational,2|3,7,2/3,240164,2
2,4,24,165,1,651,3,9,3,3,6,single-choice,spatial-relational,3|6,7,3/6,240165,3
2,4,24,166,1,1286,2,12,5,5,7,single-choice,spatial-relational,5|7,7,5/7,240166,5
2,4,24,167,1,1012,3,7,2,2,5,single-choice,spatial-relational,2|5,7,2/5,240167,2
2,4,24,168,1,1027,1,7,3,3,4,single-choice,spatial-relational,3|4,7,3/4,240168,3
2,4,24,169,1,950,2,6,2,2,4,single-choice,spatial-relational,2|4,7,2/4,240169,2
2,4,24,170,1,832,3,5,1,1,4,single-choice,spatial-relational,1|4,7,1/4,240170,1
2,4,24,171,1,806,3,9,3,3,6,single-choice,spatial-relational,3|6,7,3/6,240171,3
2,4,24,172,1,1056,1,9,4,4,5,single-choice,spatial-relational,4|5,7,4/5,240172,4
2,4,24,173,1,786,1,3,1,1,2,single-choice,spatial-relational,1|2,7,1/2,240173,1
2,4,24,174,1,645,4,10,3,3,7,single-choice,spatial-relational,3|7,7,3/7,240174,3
2,4,24,175,1,794,1,5,2,2,3,single-choice,spatial-relational,2|3,7,2/3,240175,2
2,4,24,176,0,818,3,7,2,5,5,single-choice,spatial-relational,2|5,7,2/5,240176,2
2,4,24,177,1,864,5,7,1,1,6,single-choice,spatial-relational,1|6,7,1/6,240177,1
2,4,24,178,1,733,2,8,3,3,5,single-choice,spatial-relational,3|5,7,3/5,240178,3
2,4,24,179,1,1042,5,9,2,2,7,single-choice,spatial-relational,2|7,7,2/7,240179,2
2,4,24,180,0,11701,3,7,2,5,5,single-choice,spatial-relational,2|5,7,2/5,240180,2
2,4,24,181,1,1111,1,7,3,3,4,single-choice,spatial-relational,3|4,7,3/4,240181,3
2,4,24,182,1,739,4,6,1,1,5,single-choice,spatial-relational,1|5,7,1/5,240182,1
2,4,24,183,1,917,4,8,2,2,6,single-choice,spatial-relational,2|6,7,2/6,240183,2
2,4,24,184,1,902,1,9,4,4,5,single-choice,spatial-relational,4|5,7,4/5,240184,4
2,4,24,185,1,1032,1,13,6,6,7,single-choice,spatial-relational,6|7,7,6/7,240185,6
2,4,24,186,0,1333,2,8,3,5,5,single-choice,spatial-relational,3|5,7,3/5,240186,3
2,4,24,187,1,719,2,12,5,5,7,single-choice,spatial-relational,5|7,7,5/7,240187,5
2,4,24,188,1,763,6,8,1,1,7,single-choice,spatial-relational,1|7,7,1/7,240188,1
2,4,24,189,1,1061,1,7,3,3,4,single-choice,spatial-relational,3|4,7,3/4,240189,3
2,4,24,190,1,948,3,11,4,4,7,single-choice,spatial-relational,4|7,7,4/7,240190,4
2,4,24,191,1,1009,4,10,3,3,7,single-choice,spatial-relational,3|7,7,3/7,240191,3
2,4,24,192,1,1119,2,12,5,5,7,single-choice,spatial-relational,5|7,7,5/7,240192,5
2,4,24,193,1,991,4,8,2,2,6,single-choice,spatial-relational,2|6,7,2/6,240193,2
2,4,24,194,1,1532,4,6,1,1,5,single-choice,spatial-relational,1|5,7,1/5,240194,1
2,4,24,195,1,1023,1,11,5,5,6,single-choice,spatial-relational,5|6,7,5/6,240195,5
2,4,24,196,1,802,1,3,1,1,2,single-choice,spatial-relational,1|2,7,1/2,240196,1
2,4,24,197,1,988,5,7,1,1,6,single-choice,spatial-relational,1|6,7,1/6,240197,1
2,4,24,198,1,800,6,8,1,1,7,single-choice,spatial-relational,1|7,7,1/7,240198,1
2,4,24,199,1,790,3,9,3,3,6,single-choice,spatial-relational,3|6,7,3/6,240199,3
2,4,24,200,1,856,2,10,4,4,6,single-choice,spatial-relational,4|6,7,4/6,240200,4
2,4,24,201,1,759,2,4,1,1,3,single-choice,spatial-relational,1|3,7,1/3,240201,1
2,4,24,202,1,840,2,4,1,1,3,single-choice,spatial-relational,1|3,7,1/3,240202,1
2,4,24,203,1,543,1,13,6,6,7,single-choice,spatial-relational,6|7,7,6/7,240203,6
2,4,24,204,1,2000,5,9,2,2,7,single-choice,spatial-relational,2|7,7,2/7,240204,2
2,4,24,205,1,870,3,11,4,4,7,single-choice,spatial-relational,4|7,7,4/7,240205,4
2,4,24,206,1,1397,1,11,5,5,6,single-choice,spatial-relational,5|6,7,5/6,240206,5
2,4,24,207,1,1188,1,5,2,2,3,single-choice,spatial-relational,2|3,7,2/3,240207,2
2,4,24,208,1,1129,2,6,2,2,4,single-choice,spatial-relational,2|4,7,2/4,240208,2
2,4,24,209,0,5239,2,10,4,6,6,single-choice,spatial-relational,4|6,7,4/6,240209,4
2,4,24,210,1,1202,3,5,1,1,4,single-choice,spatial-relational,1|4,7,1/4,240210,1
2,4,24,211,1,1271,4,6,1,1,5,single-choice,spatial-relational,1|5,7,1/5,240211,1
2,4,24,212,1,999,2,6,2,2,4,single-choice,spatial-relational,2|4,7,2/4,240212,2
2,4,24,213,1,994,3,5,1,1,4,single-choice,spatial-relational,1|4,7,1/4,240213,1
2,4,24,214,0,875,1,5,2,3,3,single-choice,spatial-relational,2|3,7,2/3,240214,2
2,4,24,215,1,729,1,7,3,3,4,single-choice,spatial-relational,3|4,7,3/4,240215,3
2,4,24,216,1,911,3,5,1,1,4,single-choice,spatial-relational,1|4,7,1/4,240216,1
2,4,24,217,1,969,6,8,1,1,7,single-choice,spatial-relational,1|7,7,1/7,240217,1
2,4,24,218,1,630,4,10,3,3,7,single-choice,spatial-relational,3|7,7,3/7,240218,3
2,4,24,219,0,1272,1,11,5,6,6,single-choice,spatial-relational,5|6,7,5/6,240219,5
2,4,24,220,1,698,2,12,5,5,7,single-choice,spatial-relational,5|7,7,5/7,240220,5
2,4,24,221,0,1814,3,7,2,5,5,single-choice,spatial-relational,2|5,7,2/5,240221,2
2,4,24,222,1,602,1,13,6,6,7,single-choice,spatial-relational,6|7,7,6/7,240222,6
2,4,24,223,1,2004,4,8,2,2,6,single-choice,spatial-relational,2|6,7,2/6,240223,2
2,4,24,224,1,717,1,3,1,1,2,single-choice,spatial-relational,1|2,7,1/2,240224,1
2,4,24,225,1,848,1,7,3,3,4,single-choice,spatial-relational,3|4,7,3/4,240225,3
2,4,24,226,1,1106,6,8,1,1,7,single-choice,spatial-relational,1|7,7,1/7,240226,1
2,4,24,227,1,662,2,4,1,1,3,single-choice,spatial-relational,1|3,7,1/3,240227,1
2,4,24,228,1,985,3,7,2,2,5,single-choice,spatial-relational,2|5,7,2/5,240228,2
2,4,24,229,1,897,5,7,1,1,6,single-choice,spatial-relational,1|6,7,1/6,240229,1
2,4,24,230,1,1221,2,12,5,5,7,single-choice,spatial-relational,5|7,7,5/7,240230,5
2,4,24,231,1,1078,4,8,2,2,6,single-choice,spatial-relational,2|6,7,2/6,240231,2
2,4,24,232,1,963,1,13,6,6,7,single-choice,spatial-relational,6|7,7,6/7,240232,6
2,4,24,233,0,578,5,9,2,7,7,single-choice,spatial-relational,2|7,7,2/7,240233,2
2,4,24,234,1,718,1,5,2,2,3,single-choice,spatial-relational,2|3,7,2/3,240234,2
2,4,24,235,1,647,3,9,3,3,6,single-choice,spatial-relational,3|6,7,3/6,240235,3
2,4,24,236,1,1810,2,6,2,2,4,single-choice,spatial-relational,2|4,7,2/4,240236,2
2,4,24,237,1,1025,1,11,5,5,6,single-choice,spatial-relational,5|6,7,5/6,240237,5
2,4,24,238,0,513,3,11,4,7,7,single-choice,spatial-relational,4|7,7,4/7,240238,4
2,4,24,239,0,689,2,4,1,3,3,single-choice,spatial-relational,1|3,7,1/3,240239,1
2,4,24,240,1,810,5,9,2,2,7,single-choice,spatial-relational,2|7,7,2/7,240240,2
2,4,24,241,1,674,1,3,1,1,2,single-choice,spatial-relational,1|2,7,1/2,240241,1
2,4,24,242,1,552,3,11,4,4,7,single-choice,spatial-relational,4|7,7,4/7,240242,4
2,4,24,243,1,1586,2,10,4,4,6,single-choice,spatial-relational,4|6,7,4/6,240243,4
2,4,24,244,0,1894,1,9,4,5,5,single-choice,spatial-relational,4|5,7,4/5,240244,4
2,4,24,245,1,874,2,8,3,3,5,single-choice,spatial-relational,3|5,7,3/5,240245,3
2,4,24,246,1,934,4,10,3,3,7,single-choice,spatial-relational,3|7,7,3/7,240246,3
2,4,24,247,1,1116,1,9,4,4,5,single-choice,spatial-relational,4|5,7,4/5,240247,4
2,4,24,248,1,1085,2,10,4,4,6,single-choice,spatial-relational,4|6,7,4/6,240248,4
2,4,24,249,1,1295,2,8,3,3,5,single-choice,spatial-relational,3|5,7,3/5,240249,3
2,4,24,250,1,1230,3,9,3,3,6,single-choice,spatial-relational,3|6,7,3/6,240250,3
2,4,24,251,1,1037,5,7,1,1,6,single-choice,spatial-relational,1|6,7,1/6,240251,1
2,4,24,252,1,767,4,6,1,1,5,single-choice,spatial-relational,1|5,7,1/5,240252,1
2,4,24,253,1,1036,5,9,2,2,7,single-choice,spatial-relational,2|7,7,2/7,240253,2
2,4,24,254,1,833,1,13,6,6,7,single-choice,spatial-relational,6|7,7,6/7,240254,6
2,4,24,255,1,743,1,3,1,1,2,single-choice,spatial-relational,1|2,7,1/2,240255,1
2,4,24,256,1,890,2,4,1,1,3,single-choice,spatial-relational,1|3,7,1/3,240256,1
2,4,24,257,1,857,5,7,1,1,6,single-choice,spatial-relational,1|6,7,1/6,240257,1
2,4,24,258,1,910,1,11,5,5,6,single-choice,spatial-relational,5|6,7,5/6,240258,5
2,4,24,259,1,1376,1,5,2,2,3,single-choice,spatial-relational,2|3,7,2/3,240259,2
2,4,24,260,1,955,2,8,3,3,5,single-choice,spatial-relational,3|5,7,3/5,240260,3
2,4,24,261,0,1392,3,7,2,5,5,single-choice,spatial-relational,2|5,7,2/5,240261,2
2,4,24,262,1,732,3,9,3,3,6,single-choice,spatial-relational,3|6,7,3/6,240262,3
2,4,24,263,1,958,6,8,1,1,7,single-choice,spatial-relational,1|7,7,1/7,240263,1
2,4,24,264,1,758,1,11,5,5,6,single-choice,spatial-relational,5|6,7,5/6,240264,5
2,4,24,265,1,1067,2,6,2,2,4,single-choice,spatial-relational,2|4,7,2/4,240265,2
2,4,24,266,0,1185,4,10,3,7,7,single-choice,spatial-relational,3|7,7,3/7,240266,3
2,4,24,267,1,512,1,3,1,1,2,single-choice,spatial-relational,1|2,7,1/2,240267,1
2,4,24,268,1,737,2,8,3,3,5,single-choice,spatial-relational,3|5,7,3/5,240268,3
2,4,24,269,1,632,4,6,1,1,5,single-choice,spatial-relational,1|5,7,1/5,240269,1
2,4,24,270,1,790,3,9,3,3,6,single-choice,spatial-relational,3|6,7,3/6,240270,3
2,4,24,271,1,913,2,10,4,4,6,single-choice,spatial-relational,4|6,7,4/6,240271,4
2,4,24,272,1,1122,5,9,2,2,7,single-choice,spatial-relational,2|7,7,2/7,240272,2
2,4,24,273,0,685,4,8,2,6,6,single-choice,spatial-relational,2|6,7,2/6,240273,2
2,4,24,274,0,491,3,5,1,4,4,single-choice,spatial-relational,1|4,7,1/4,240274,1
2,4,24,275,1,651,4,10,3,3,7,single-choice,spatial-relational,3|7,7,3/7,240275,3
2,4,24,276,0,467,4,8,2,6,6,single-choice,spatial-relational,2|6,7,2/6,240276,2
2,4,24,277,1,442,3,7,2,2,5,single-choice,spatial-relational,2|5,7,2/5,240277,2
2,4,24,278,0,404,6,8,1,7,7,single-choice,spatial-relational,1|7,7,1/7,240278,1
2,4,24,279,0,2,2,6,2,4,4,single-choice,spatial-relational,2|4,7,2/4,240279,2
2,4,24,280,1,3477,2,10,4,4,6,single-choice,spatial-relational,4|6,7,4/6,240280,4
2,4,24,281,1,944,3,5,1,1,4,single-choice,spatial-relational,1|4,7,1/4,240281,1
2,4,24,282,1,1120,2,12,5,5,7,single-choice,spatial-relational,5|7,7,5/7,240282,5
2,4,24,283,1,1264,1,5,2,2,3,single-choice,spatial-relational,2|3,7,2/3,240283,2
2,4,24,284,1,775,1,7,3,3,4,single-choice,spatial-relational,3|4,7,3/4,240284,3
2,4,24,285,1,813,3,11,4,4,7,single-choice,spatial-relational,4|7,7,4/7,240285,4
2,4,24,286,1,1210,1,13,6,6,7,single-choice,spatial-relational,6|7,7,6/7,240286,6
2,4,24,287,1,961,2,12,5,5,7,single-choice,spatial-relational,5|7,7,5/7,240287,5
2,4,24,288,1,1010,1,7,3,3,4,single-choice,spatial-relational,3|4,7,3/4,240288,3
2,4,24,289,1,1082,1,9,4,4,5,single-choice,spatial-relational,4|5,7,4/5,240289,4
2,4,24,290,1,907,5,7,1,1,6,single-choice,spatial-relational,1|6,7,1/6,240290,1
2,4,24,291,1,809,1,9,4,4,5,single-choice,spatial-relational,4|5,7,4/5,240291,4
2,4,24,292,1,853,4,6,1,1,5,single-choice,spatial-relational,1|5,7,1/5,240292,1
2,4,24,293,1,915,2,4,1,1,3,single-choice,spatial-relational,1|3,7,1/3,240293,1
2,4,24,294,1,817,3,11,4,4,7,single-choice,spatial-relational,4|7,7,4/7,240294,4
2,4,24,295,1,964,1,7,3,3,4,single-choice,spatial-relational,3|4,7,3/4,240295,3
2,4,24,296,1,799,6,8,1,1,7,single-choice,spatial-relational,1|7,7,1/7,240296,1
2,4,24,297,1,924,2,6,2,2,4,single-choice,spatial-relational,2|4,7,2/4,240297,2
2,4,24,298,1,918,4,10,3,3,7,single-choice,spatial-relational,3|7,7,3/7,240298,3
2,4,24,299,1,983,2,10,4,4,6,single-choice,spatial-relational,4|6,7,4/6,240299,4
2,4,24,300,1,1161,2,8,3,3,5,single-choice,spatial-relational,3|5,7,3/5,240300,3
2,4,24,301,1,1161,1,5,2,2,3,single-choice,spatial-relational,2|3,7,2/3,240301,2
2,4,24,302,1,855,2,4,1,1,3,single-choice,spatial-relational,1|3,7,1/3,240302,1
2,4,24,303,1,803,5,7,1,1,6,single-choice,spatial-relational,1|6,7,1/6,240303,1
2,4,24,304,1,648,1,3,1,1,2,single-choice,spatial-relational,1|2,7,1/2,240304,1
2,4,24,305,1,686,1,13,6,6,7,single-choice,spatial-relational,6|7,7,6/7,240305,6
2,4,24,306,1,1076,4,6,1,1,5,single-choice,spatial-relational,1|5,7,1/5,240306,1
2,4,24,307,1,811,6,8,1,1,7,single-choice,spatial-relational,1|7,7,1/7,240307,1
2,4,24,308,1,782,1,13,6,6,7,single-choice,spatial-relational,6|7,7,6/7,240308,6
2,4,24,309,1,1948,3,7,2,2,5,single-choice,spatial-relational,2|5,7,2/5,240309,2
2,4,24,310,1,997,2,10,4,4,6,single-choice,spatial-relational,4|6,7,4/6,240310,4
2,4,24,311,1,852,4,6,1,1,5,single-choice,spatial-relational,1|5,7,1/5,240311,1
2,4,24,312,1,913,3,9,3,3,6,single-choice,spatial-relational,3|6,7,3/6,240312,3
2,4,24,313,1,1114,1,11,5,5,6,single-choice,spatial-relational,5|6,7,5/6,240313,5
2,4,24,314,1,780,5,7,1,1,6,single-choice,spatial-relational,1|6,7,1/6,240314,1
2,4,24,315,1,862,3,9,3,3,6,single-choice,spatial-relational,3|6,7,3/6,240315,3
2,4,24,316,1,980,3,5,1,1,4,single-choice,spatial-relational,1|4,7,1/4,240316,1
2,4,24,317,1,2227,2,12,5,5,7,single-choice,spatial-relational,5|7,7,5/7,240317,5
2,4,24,318,1,675,2,4,1,1,3,single-choice,spatial-relational,1|3,7,1/3,240318,1
2,4,24,319,1,727,4,10,3,3,7,single-choice,spatial-relational,3|7,7,3/7,240319,3
2,4,24,320,1,1065,4,8,2,2,6,single-choice,spatial-relational,2|6,7,2/6,240320,2
2,4,24,321,0,741,3,7,2,5,5,single-choice,spatial-relational,2|5,7,2/5,240321,2
2,4,24,322,1,1014,5,9,2,2,7,single-choice,spatial-relational,2|7,7,2/7,240322,2
2,4,24,323,0,1267,1,3,1,2,2,single-choice,spatial-relational,1|2,7,1/2,240323,1
2,4,24,324,1,1362,1,9,4,4,5,single-choice,spatial-relational,4|5,7,4/5,240324,4
2,4,24,325,1,789,1,7,3,3,4,single-choice,spatial-relational,3|4,7,3/4,240325,3
2,4,24,326,1,926,3,5,1,1,4,single-choice,spatial-relational,1|4,7,1/4,240326,1
2,4,24,327,1,898,5,9,2,2,7,single-choice,spatial-relational,2|7,7,2/7,240327,2
2,4,24,328,0,848,1,5,2,3,3,single-choice,spatial-relational,2|3,7,2/3,240328,2
2,4,24,329,1,828,2,6,2,2,4,single-choice,spatial-relational,2|4,7,2/4,240329,2
2,4,24,330,1,893,4,8,2,2,6,single-choice,spatial-relational,2|6,7,2/6,240330,2
2,4,24,331,1,965,3,11,4,4,7,single-choice,spatial-relational,4|7,7,4/7,240331,4
2,4,24,332,1,2191,1,9,4,4,5,single-choice,spatial-relational,4|5,7,4/5,240332,4
2,4,24,333,1,984,2,8,3,3,5,single-choice,spatial-relational,3|5,7,3/5,240333,3
2,4,24,334,1,1695,2,12,5,5,7,single-choice,spatial-relational,5|7,7,5/7,240334,5
2,4,24,335,1,1067,1,11,5,5,6,single-choice,spatial-relational,5|6,7,5/6,240335,5
2,4,24,336,1,627,3,11,4,4,7,single-choice,spatial-relational,4|7,7,4/7,240336,4
2,4,24,337,1,1077,1,7,3,3,4,single-choice,spatial-relational,3|4,7,3/4,240337,3
2,4,24,338,1,798,2,4,1,1,3,single-choice,spatial-relational,1|3,7,1/3,240338,1
2,4,24,339,1,1003,2,6,2,2,4,single-choice,spatial-relational,2|4,7,2/4,240339,2
2,4,24,340,1,986,4,10,3,3,7,single-choice,spatial-relational,3|7,7,3/7,240340,3
2,4,24,341,1,991,1,5,2,2,3,single-choice,spatial-relational,2|3,7,2/3,240341,2
2,4,24,342,1,839,4,8,2,2,6,single-choice,spatial-relational,2|6,7,2/6,240342,2
2,4,24,343,1,749,1,3,1,1,2,single-choice,spatial-relational,1|2,7,1/2,240343,1
2,4,24,344,1,724,2,12,5,5,7,single-choice,spatial-relational,5|7,7,5/7,240344,5
2,4,24,345,1,1205,2,10,4,4,6,single-choice,spatial-relational,4|6,7,4/6,240345,4
2,4,24,346,1,734,3,5,1,1,4,single-choice,spatial-relational,1|4,7,1/4,240346,1
2,4,24,347,1,674,3,5,1,1,4,single-choice,spatial-relational,1|4,7,1/4,240347,1
2,4,24,348,1,643,3,11,4,4,7,single-choice,spatial-relational,4|7,7,4/7,240348,4
2,4,24,349,1,1931,2,10,4,4,6,single-choice,spatial-relational,4|6,7,4/6,240349,4
2,4,24,350,1,1063,2,8,3,3,5,single-choice,spatial-relational,3|5,7,3/5,240350,3
2,4,24,351,1,643,1,13,6,6,7,single-choice,spatial-relational,6|7,7,6/7,240351,6
2,4,24,352,0,479,4,6,1,5,5,single-choice,spatial-relational,1|5,7,1/5,240352,1
2,4,24,353,0,522,6,8,1,7,7,single-choice,spatial-relational,1|7,7,1/7,240353,1
2,4,24,354,1,868,6,8,1,1,7,single-choice,spatial-relational,1|7,7,1/7,240354,1
2,4,24,355,1,852,1,13,6,6,7,single-choice,spatial-relational,6|7,7,6/7,240355,6
2,4,24,356,1,940,1,11,5,5,6,single-choice,spatial-relational,5|6,7,5/6,240356,5
2,4,24,357,1,1065,2,4,1,1,3,single-choice,spatial-relational,1|3,7,1/3,240357,1
2,4,24,358,1,786,1,11,5,5,6,single-choice,spatial-relational,5|6,7,5/6,240358,5
2,4,24,359,1,943,4,10,3,3,7,single-choice,spatial-relational,3|7,7,3/7,240359,3
2,4,24,360,1,1026,2,8,3,3,5,single-choice,spatial-relational,3|5,7,3/5,240360,3
2,4,24,361,1,898,1,3,1,1,2,single-choice,spatial-relational,1|2,7,1/2,240361,1
2,4,24,362,1,831,1,9,4,4,5,single-choice,spatial-relational,4|5,7,4/5,240362,4
2,4,24,363,1,695,1,9,4,4,5,single-choice,spatial-relational,4|5,7,4/5,240363,4
2,4,24,364,1,887,3,9,3,3,6,single-choice,spatial-relational,3|6,7,3/6,240364,3
2,4,24,365,1,982,3,9,3,3,6,single-choice,spatial-relational,3|6,7,3/6,240365,3
2,4,24,366,1,826,5,7,1,1,6,single-choice,spatial-relational,1|6,7,1/6,240366,1
2,4,24,367,1,789,2,6,2,2,4,single-choice,spatial-relational,2|4,7,2/4,240367,2
2,4,24,368,1,890,2,12,5,5,7,single-choice,spatial-relational,5|7,7,5/7,240368,5
2,4,24,369,0,805,3,7,2,5,5,single-choice,spatial-relational,2|5,7,2/5,240369,2
2,4,24,370,1,919,1,5,2,2,3,single-choice,spatial-relational,2|3,7,2/3,240370,2
2,4,24,371,1,790,5,7,1,1,6,single-choice,spatial-relational,1|6,7,1/6,240371,1
2,4,24,372,1,781,1,7,3,3,4,single-choice,spatial-relational,3|4,7,3/4,240372,3
2,4,24,373,1,833,3,11,4,4,7,single-choice,spatial-relational,4|7,7,4/7,240373,4
2,4,24,374,1,855,4,6,1,1,5,single-choice,spatial-relational,1|5,7,1/5,240374,1
2,4,24,375,1,1006,4,8,2,2,6,single-choice,spatial-relational,2|6,7,2/6,240375,2
2,4,24,376,1,953,3,7,2,2,5,single-choice,spatial-relational,2|5,7,2/5,240376,2
2,4,24,377,1,1014,5,9,2,2,7,single-choice,spatial-relational,2|7,7,2/7,240377,2
2,4,24,378,1,1051,5,9,2,2,7,single-choice,spatial-relational,2|7,7,2/7,240378,2
2,4,24,379,1,864,5,7,1,1,6,single-choice,spatial-relational,1|6,7,1/6,240379,1
2,4,24,380,1,802,3,5,1,1,4,single-choice,spatial-relational,1|4,7,1/4,240380,1
2,4,24,381,1,892,2,6,2,2,4,single-choice,spatial-relational,2|4,7,2/4,240381,2
2,4,24,382,1,1047,3,7,2,2,5,single-choice,spatial-relational,2|5,7,2/5,240382,2
2,4,24,383,1,680,2,10,4,4,6,single-choice,spatial-relational,4|6,7,4/6,240383,4
2,4,24,384,0,992,4,8,2,6,6,single-choice,spatial-relational,2|6,7,2/6,240384,2
2,4,24,385,1,958,5,7,1,1,6,single-choice,spatial-relational,1|6,7,1/6,240385,1
2,4,24,386,1,850,1,11,5,5,6,single-choice,spatial-relational,5|6,7,5/6,240386,5
2,4,24,387,1,1229,1,9,4,4,5,single-choice,spatial-relational,4|5,7,4/5,240387,4
2,4,24,388,1,1020,2,6,2,2,4,single-choice,spatial-relational,2|4,7,2/4,240388,2
2,4,24,389,1,936,2,4,1,1,3,single-choice,spatial-relational,1|3,7,1/3,240389,1
2,4,24,390,1,764,3,11,4,4,7,single-choice,spatial-relational,4|7,7,4/7,240390,4
2,4,24,391,1,874,5,9,2,2,7,single-choice,spatial-relational,2|7,7,2/7,240391,2
2,4,24,392,1,753,2,4,1,1,3,single-choice,spatial-relational,1|3,7,1/3,240392,1
2,4,24,393,1,737,3,9,3,3,6,single-choice,spatial-relational,3|6,7,3/6,240393,3
2,4,24,394,1,788,1,3,1,1,2,single-choice,spatial-relational,1|2,7,1/2,240394,1
2,4,24,395,1,707,1,3,1,1,2,single-choice,spatial-relational,1|2,7,1/2,240395,1
2,4,24,396,1,1379,4,6,1,1,5,single-choice,spatial-relational,1|5,7,1/5,240396,1
2,4,24,397,1,820,2,8,3,3,5,single-choice,spatial-relational,3|5,7,3/5,240397,3
2,4,24,398,0,1081,1,5,2,3,3,single-choice,spatial-relational,2|3,7,2/3,240398,2
2,4,24,399,1,1023,1,7,3,3,4,single-choice,spatial-relational,3|4,7,3/4,240399,3
2,4,24,400,1,733,1,13,6,6,7,single-choice,spatial-relational,6|7,7,6/7,240400,6
2,4,24,401,1,752,3,5,1,1,4,single-choice,spatial-relational,1|4,7,1/4,240401,1
2,4,24,402,1,732,2,10,4,4,6,single-choice,spatial-relational,4|6,7,4/6,240402,4
2,4,24,403,1,967,2,8,3,3,5,single-choice,spatial-relational,3|5,7,3/5,240403,3
2,4,24,404,1,775,1,13,6,6,7,single-choice,spatial-relational,6|7,7,6/7,240404,6
2,4,24,405,1,596,3,11,4,4,7,single-choice,spatial-relational,4|7,7,4/7,240405,4
2,4,24,406,0,12861,6,8,1,7,7,single-choice,spatial-relational,1|7,7,1/7,240406,1
2,4,24,407,0,4997,2,12,5,7,7,single-choice,spatial-relational,5|7,7,5/7,240407,5
2,4,24,408,1,679,4,6,1,1,5,single-choice,spatial-relational,1|5,7,1/5,240408,1
2,4,24,409,1,788,1,7,3,3,4,single-choice,spatial-relational,3|4,7,3/4,240409,3
2,4,24,410,1,961,1,5,2,2,3,single-choice,spatial-relational,2|3,7,2/3,240410,2
2,4,24,411,1,764,4,10,3,3,7,single-choice,spatial-relational,3|7,7,3/7,240411,3
2,4,24,412,0,1214,3,7,2,5,5,single-choice,spatial-relational,2|5,7,2/5,240412,2
2,4,24,413,1,757,1,11,5,5,6,single-choice,spatial-relational,5|6,7,5/6,240413,5
2,4,24,414,1,899,6,8,1,1,7,single-choice,spatial-relational,1|7,7,1/7,240414,1
2,4,24,415,1,785,5,9,2,2,7,single-choice,spatial-relational,2|7,7,2/7,240415,2
2,4,24,416,1,931,2,12,5,5,7,single-choice,spatial-relational,5|7,7,5/7,240416,5
2,4,24,417,1,905,3,9,3,3,6,single-choice,spatial-relational,3|6,7,3/6,240417,3
2,4,24,418,1,571,1,9,4,4,5,single-choice,spatial-relational,4|5,7,4/5,240418,4
2,4,24,419,1,915,4,10,3,3,7,single-choice,spatial-relational,3|7,7,3/7,240419,3
2,4,24,420,1,923,4,8,2,2,6,single-choice,spatial-relational,2|6,7,2/6,240420,2
2,4,24,421,1,681,1,3,1,1,2,single-choice,spatial-relational,1|2,7,1/2,240421,1
2,4,24,422,1,1157,4,8,2,2,6,single-choice,spatial-relational,2|6,7,2/6,240422,2
2,4,24,423,1,990,1,9,4,4,5,single-choice,spatial-relational,4|5,7,4/5,240423,4
2,4,24,424,1,1077,2,10,4,4,6,single-choice,spatial-relational,4|6,7,4/6,240424,4
2,4,24,425,1,730,6,8,1,1,7,single-choice,spatial-relational,1|7,7,1/7,240425,1
2,4,24,426,1,737,1,5,2,2,3,single-choice,spatial-relational,2|3,7,2/3,240426,2
2,4,24,427,1,868,5,7,1,1,6,single-choice,spatial-relational,1|6,7,1/6,240427,1
2,4,24,428,1,704,5,9,2,2,7,single-choice,spatial-relational,2|7,7,2/7,240428,2
2,4,24,429,1,903,1,11,5,5,6,single-choice,spatial-relational,5|6,7,5/6,240429,5
2,4,24,430,1,1014,3,5,1,1,4,single-choice,spatial-relational,1|4,7,1/4,240430,1
2,4,24,431,1,547,4,10,3,3,7,single-choice,spatial-relational,3|7,7,3/7,240431,3
2,4,24,432,1,1310,2,8,3,3,5,single-choice,spatial-relational,3|5,7,3/5,240432,3
2,4,24,433,1,920,2,12,5,5,7,single-choice,spatial-relational,5|7,7,5/7,240433,5
2,4,24,434,1,555,1,9,4,4,5,single-choice,spatial-relational,4|5,7,4/5,240434,4
2,4,24,435,0,539,1,7,3,4,4,single-choice,spatial-relational,3|4,7,3/4,240435,3
2,4,24,436,1,1140,1,13,6,6,7,single-choice,spatial-relational,6|7,7,6/7,240436,6
2,4,24,437,1,863,3,9,3,3,6,single-choice,spatial-relational,3|6,7,3/6,240437,3
2,4,24,438,1,1088,2,6,2,2,4,single-choice,spatial-relational,2|4,7,2/4,240438,2
2,4,24,439,1,966,5,9,2,2,7,single-choice,spatial-relational,2|7,7,2/7,240439,2
2,4,24,440,1,678,1,3,1,1,2,single-choice,spatial-relational,1|2,7,1/2,240440,1
2,4,24,441,1,1166,4,8,2,2,6,single-choice,spatial-relational,2|6,7,2/6,240441,2
2,4,24,442,1,2294,2,8,3,3,5,single-choice,spatial-relational,3|5,7,3/5,240442,3
2,4,24,443,1,1395,1,7,3,3,4,single-choice,spatial-relational,3|4,7,3/4,240443,3
2,4,24,444,1,942,4,6,1,1,5,single-choice,spatial-relational,1|5,7,1/5,240444,1
2,4,24,445,1,743,3,11,4,4,7,single-choice,spatial-relational,4|7,7,4/7,240445,4
2,4,24,446,1,1591,2,10,4,4,6,single-choice,spatial-relational,4|6,7,4/6,240446,4
2,4,24,447,1,1353,3,9,3,3,6,single-choice,spatial-relational,3|6,7,3/6,240447,3
2,4,24,448,1,1430,2,12,5,5,7,single-choice,spatial-relational,5|7,7,5/7,240448,5
2,4,24,449,1,1017,5,7,1,1,6,single-choice,spatial-relational,1|6,7,1/6,240449,1
2,4,24,450,1,943,2,4,1,1,3,single-choice,spatial-relational,1|3,7,1/3,240450,1
2,4,24,451,1,746,1,5,2,2,3,single-choice,spatial-relational,2|3,7,2/3,240451,2
2,4,24,452,1,1024,2,4,1,1,3,single-choice,spatial-relational,1|3,7,1/3,240452,1
2,4,24,453,1,1244,1,11,5,5,6,single-choice,spatial-relational,5|6,7,5/6,240453,5
2,4,24,454,0,1366,3,7,2,5,5,single-choice,spatial-relational,2|5,7,2/5,240454,2
2,4,24,455,1,1211,3,5,1,1,4,single-choice,spatial-relational,1|4,7,1/4,240455,1
2,4,24,456,1,1132,3,7,2,2,5,single-choice,spatial-relational,2|5,7,2/5,240456,2
2,4,24,457,1,621,3,11,4,4,7,single-choice,spatial-relational,4|7,7,4/7,240457,4
2,4,24,458,1,883,4,6,1,1,5,single-choice,spatial-relational,1|5,7,1/5,240458,1
2,4,24,459,1,682,1,13,6,6,7,single-choice,spatial-relational,6|7,7,6/7,240459,6
2,4,24,460,1,1232,2,6,2,2,4,single-choice,spatial-relational,2|4,7,2/4,240460,2
2,4,24,461,1,694,4,10,3,3,7,single-choice,spatial-relational,3|7,7,3/7,240461,3
2,4,24,462,1,771,6,8,1,1,7,single-choice,spatial-relational,1|7,7,1/7,240462,1
2,4,24,463,0,743,3,5,1,4,4,single-choice,spatial-relational,1|4,7,1/4,240463,1
2,4,24,464,1,803,4,6,1,1,5,single-choice,spatial-relational,1|5,7,1/5,240464,1
2,4,24,465,1,746,3,9,3,3,6,single-choice,spatial-relational,3|6,7,3/6,240465,3
2,4,24,466,1,913,2,10,4,4,6,single-choice,spatial-relational,4|6,7,4/6,240466,4
2,4,24,467,1,593,1,9,4,4,5,single-choice,spatial-relational,4|5,7,4/5,240467,4
2,4,24,468,1,856,4,8,2,2,6,single-choice,spatial-relational,2|6,7,2/6,240468,2
2,4,24,469,0,914,2,12,5,7,7,single-choice,spatial-relational,5|7,7,5/7,240469,5
2,4,24,470,1,522,2,8,3,3,5,single-choice,spatial-relational,3|5,7,3/5,240470,3
2,4,24,471,1,1200,4,10,3,3,7,single-choice,spatial-relational,3|7,7,3/7,240471,3
2,4,24,472,1,536,1,3,1,1,2,single-choice,spatial-relational,1|2,7,1/2,240472,1
2,4,24,473,1,924,3,5,1,1,4,single-choice,spatial-relational,1|4,7,1/4,240473,1
2,4,24,474,1,1268,1,11,5,5,6,single-choice,spatial-relational,5|6,7,5/6,240474,5
2,4,24,475,1,803,3,7,2,2,5,single-choice,spatial-relational,2|5,7,2/5,240475,2
2,4,24,476,1,743,1,7,3,3,4,single-choice,spatial-relational,3|4,7,3/4,240476,3
2,4,24,477,1,780,2,4,1,1,3,single-choice,spatial-relational,1|3,7,1/3,240477,1
2,4,24,478,1,841,5,9,2,2,7,single-choice,spatial-relational,2|7,7,2/7,240478,2
2,4,24,479,1,569,3,11,4,4,7,single-choice,spatial-relational,4|7,7,4/7,240479,4
2,4,24,480,1,676,1,3,1,1,2,single-choice,spatial-relational,1|2,7,1/2,240480,1
2,4,24,481,1,859,6,8,1,1,7,single-choice,spatial-relational,1|7,7,1/7,240481,1
2,4,24,482,1,1061,4,6,1,1,5,single-choice,spatial-relational,1|5,7,1/5,240482,1
2,4,24,483,1,629,3,9,3,3,6,single-choice,spatial-relational,3|6,7,3/6,240483,3
2,4,24,484,1,838,1,5,2,2,3,single-choice,spatial-relational,2|3,7,2/3,240484,2
2,4,24,485,1,849,5,7,1,1,6,single-choice,spatial-relational,1|6,7,1/6,240485,1
2,4,24,486,1,633,2,4,1,1,3,single-choice,spatial-relational,1|3,7,1/3,240486,1
2,4,24,487,1,783,3,7,2,2,5,single-choice,spatial-relational,2|5,7,2/5,240487,2
2,4,24,488,1,838,5,9,2,2,7,single-choice,spatial-relational,2|7,7,2/7,240488,2
2,4,24,489,1,1278,2,12,5,5,7,single-choice,spatial-relational,5|7,7,5/7,240489,5
2,4,24,490,1,728,6,8,1,1,7,single-choice,spatial-relational,1|7,7,1/7,240490,1
2,4,24,491,0,692,1,7,3,4,4,single-choice,spatial-relational,3|4,7,3/4,240491,3
2,4,24,492,1,666,1,13,6,6,7,single-choice,spatial-relational,6|7,7,6/7,240492,6
2,4,24,493,1,816,2,8,3,3,5,single-choice,spatial-relational,3|5,7,3/5,240493,3
2,4,24,494,1,1002,3,11,4,4,7,single-choice,spatial-relational,4|7,7,4/7,240494,4
2,4,24,495,1,1186,4,10,3,3,7,single-choice,spatial-relational,3|7,7,3/7,240495,3
2,4,24,496,1,1150,1,5,2,2,3,single-choice,spatial-relational,2|3,7,2/3,240496,2
2,4,24,497,1,921,2,10,4,4,6,single-choice,spatial-relational,4|6,7,4/6,240497,4
2,4,24,498,1,935,2,6,2,2,4,single-choice,spatial-relational,2|4,7,2/4,240498,2
2,4,24,499,1,1136,1,11,5,5,6,single-choice,spatial-relational,5|6,7,5/6,240499,5
2,4,24,500,1,844,1,13,6,6,7,single-choice,spatial-relational,6|7,7,6/7,240500,6
2,4,24,501,1,1406,4,8,2,2,6,single-choice,spatial-relational,2|6,7,2/6,240501,2
2,4,24,502,1,802,1,9,4,4,5,single-choice,spatial-relational,4|5,7,4/5,240502,4
2,4,24,503,1,1174,2,6,2,2,4,single-choice,spatial-relational,2|4,7,2/4,240503,2
2,4,24,504,0,888,5,7,1,6,6,single-choice,spatial-relational,1|6,7,1/6,240504,1
2,4,24,505,1,905,2,10,4,4,6,single-choice,spatial-relational,4|6,7,4/6,240505,4
2,4,24,506,1,1046,4,6,1,1,5,single-choice,spatial-relational,1|5,7,1/5,240506,1
2,4,24,507,1,880,2,6,2,2,4,single-choice,spatial-relational,2|4,7,2/4,240507,2
2,4,24,508,0,811,4,8,2,6,6,single-choice,spatial-relational,2|6,7,2/6,240508,2
2,4,24,509,1,1382,1,7,3,3,4,single-choice,spatial-relational,3|4,7,3/4,240509,3
2,4,24,510,1,1119,1,11,5,5,6,single-choice,spatial-relational,5|6,7,5/6,240510,5
2,4,24,511,1,712,3,11,4,4,7,single-choice,spatial-relational,4|7,7,4/7,240511,4
2,4,24,512,1,672,5,7,1,1,6,single-choice,spatial-relational,1|6,7,1/6,240512,1
2,4,24,513,1,742,1,13,6,6,7,single-choice,spatial-relational,6|7,7,6/7,240513,6
2,4,24,514,1,770,6,8,1,1,7,single-choice,spatial-relational,1|7,7,1/7,240514,1
2,4,24,515,0,782,3,7,2,5,5,single-choice,spatial-relational,2|5,7,2/5,240515,2
2,4,24,516,0,783,1,3,1,2,2,single-choice,spatial-relational,1|2,7,1/2,240516,1
2,4,24,517,1,1042,3,5,1,1,4,single-choice,spatial-relational,1|4,7,1/4,240517,1
2,4,24,518,1,986,2,10,4,4,6,single-choice,spatial-relational,4|6,7,4/6,240518,4
2,4,24,519,0,1344,2,12,5,7,7,single-choice,spatial-relational,5|7,7,5/7,240519,5
2,4,24,520,0,994,2,6,2,4,4,single-choice,spatial-relational,2|4,7,2/4,240520,2
2,4,24,521,1,738,1,3,1,1,2,single-choice,spatial-relational,1|2,7,1/2,240521,1
2,4,24,522,1,659,5,9,2,2,7,single-choice,spatial-relational,2|7,7,2/7,240522,2
2,4,24,523,1,835,1,9,4,4,5,single-choice,spatial-relational,4|5,7,4/5,240523,4
2,4,24,524,1,973,3,9,3,3,6,single-choice,spatial-relational,3|6,7,3/6,240524,3
2,4,24,525,1,794,6,8,1,1,7,single-choice,spatial-relational,1|7,7,1/7,240525,1
2,4,24,526,1,883,1,5,2,2,3,single-choice,spatial-relational,2|3,7,2/3,240526,2
2,4,24,527,1,850,3,11,4,4,7,single-choice,spatial-relational,4|7,7,4/7,240527,4
2,4,24,528,0,815,1,5,2,3,3,single-choice,spatial-relational,2|3,7,2/3,240528,2
2,4,24,529,1,799,3,9,3,3,6,single-choice,spatial-relational,3|6,7,3/6,240529,3
2,4,24,530,1,762,5,9,2,2,7,single-choice,spatial-relational,2|7,7,2/7,240530,2
2,4,24,531,1,810,1,9,4,4,5,single-choice,spatial-relational,4|5,7,4/5,240531,4
2,4,24,532,1,1016,4,10,3,3,7,single-choice,spatial-relational,3|7,7,3/7,240532,3
2,4,24,533,1,984,5,7,1,1,6,single-choice,spatial-relational,1|6,7,1/6,240533,1
2,4,24,534,1,1108,2,12,5,5,7,single-choice,spatial-relational,5|7,7,5/7,240534,5
2,4,24,535,1,836,3,7,2,2,5,single-choice,spatial-relational,2|5,7,2/5,240535,2
2,4,24,536,1,1636,1,11,5,5,6,single-choice,spatial-relational,5|6,7,5/6,240536,5
2,4,24,537,1,660,4,6,1,1,5,single-choice,spatial-relational,1|5,7,1/5,240537,1
2,4,24,538,1,562,1,13,6,6,7,single-choice,spatial-relational,6|7,7,6/7,240538,6
2,4,24,539,1,855,2,8,3,3,5,single-choice,spatial-relational,3|5,7,3/5,240539,3
2,4,24,540,1,684,2,4,1,1,3,single-choice,spatial-relational,1|3,7,1/3,240540,1
2,4,24,541,1,710,2,8,3,3,5,single-choice,spatial-relational,3|5,7,3/5,240541,3
2,4,24,542,1,978,1,7,3,3,4,single-choice,spatial-relational,3|4,7,3/4,240542,3
2,4,24,543,1,872,4,8,2,2,6,single-choice,spatial-relational,2|6,7,2/6,240543,2
2,4,24,544,1,656,2,4,1,1,3,single-choice,spatial-relational,1|3,7,1/3,240544,1
2,4,24,545,0,642,3,5,1,4,4,single-choice,spatial-relational,1|4,7,1/4,240545,1
2,4,24,546,1,708,4,10,3,3,7,single-choice,spatial-relational,3|7,7,3/7,240546,3
2,4,24,547,1,811,4,8,2,2,6,single-choice,spatial-relational,2|6,7,2/6,240547,2
2,4,24,548,1,765,3,9,3,3,6,single-choice,spatial-relational,3|6,7,3/6,240548,3
2,4,24,549,1,579,3,11,4,4,7,single-choice,spatial-relational,4|7,7,4/7,240549,4
2,4,24,550,1,961,1,13,6,6,7,single-choice,spatial-relational,6|7,7,6/7,240550,6
2,4,24,551,1,1003,2,8,3,3,5,single-choice,spatial-relational,3|5,7,3/5,240551,3
2,4,24,552,1,952,1,7,3,3,4,single-choice,spatial-relational,3|4,7,3/4,240552,3
2,4,24,553,1,1087,5,9,2,2,7,single-choice,spatial-relational,2|7,7,2/7,240553,2
2,4,24,554,1,763,3,7,2,2,5,single-choice,spatial-relational,2|5,7,2/5,240554,2
2,4,24,555,1,925,2,6,2,2,4,single-choice,spatial-relational,2|4,7,2/4,240555,2
2,4,24,556,1,669,4,10,3,3,7,single-choice,spatial-relational,3|7,7,3/7,240556,3
2,4,24,557,1,929,3,9,3,3,6,single-choice,spatial-relational,3|6,7,3/6,240557,3
2,4,24,558,1,979,1,5,2,2,3,single-choice,spatial-relational,2|3,7,2/3,240558,2
2,4,24,559,1,825,1,3,1,1,2,single-choice,spatial-relational,1|2,7,1/2,240559,1
2,4,24,560,0,683,2,6,2,4,4,single-choice,spatial-relational,2|4,7,2/4,240560,2
2,4,24,561,1,929,5,7,1,1,6,single-choice,spatial-relational,1|6,7,1/6,240561,1
2,4,24,562,1,852,2,4,1,1,3,single-choice,spatial-relational,1|3,7,1/3,240562,1
2,4,24,563,1,678,5,9,2,2,7,single-choice,spatial-relational,2|7,7,2/7,240563,2
2,4,24,564,1,662,6,8,1,1,7,single-choice,spatial-relational,1|7,7,1/7,240564,1
2,4,24,565,1,637,4,6,1,1,5,single-choice,spatial-relational,1|5,7,1/5,240565,1
2,4,24,566,1,922,3,5,1,1,4,single-choice,spatial-relational,1|4,7,1/4,240566,1
2,4,24,567,1,793,4,8,2,2,6,single-choice,spatial-relational,2|6,7,2/6,240567,2
2,4,24,568,1,947,2,12,5,5,7,single-choice,spatial-relational,5|7,7,5/7,240568,5
2,4,24,569,1,728,3,11,4,4,7,single-choice,spatial-relational,4|7,7,4/7,240569,4
2,4,24,570,1,648,6,8,1,1,7,single-choice,spatial-relational,1|7,7,1/7,240570,1
2,4,24,571,1,1218,1,11,5,5,6,single-choice,spatial-relational,5|6,7,5/6,240571,5
2,4,24,572,1,1085,2,4,1,1,3,single-choice,spatial-relational,1|3,7,1/3,240572,1
2,4,24,573,1,887,1,7,3,3,4,single-choice,spatial-relational,3|4,7,3/4,240573,3
2,4,24,574,1,788,1,13,6,6,7,single-choice,spatial-relational,6|7,7,6/7,240574,6
2,4,24,575,1,695,1,3,1,1,2,single-choice,spatial-relational,1|2,7,1/2,240575,1
2,4,24,576,1,1679,1,9,4,4,5,single-choice,spatial-relational,4|5,7,4/5,240576,4
2,4,24,577,1,725,3,7,2,2,5,single-choice,spatial-relational,2|5,7,2/5,240577,2
2,4,24,578,1,894,4,6,1,1,5,single-choice,spatial-relational,1|5,7,1/5,240578,1
2,4,24,579,1,685,1,11,5,5,6,single-choice,spatial-relational,5|6,7,5/6,240579,5
2,4,24,580,1,1047,1,9,4,4,5,single-choice,spatial-relational,4|5,7,4/5,240580,4
2,4,24,581,1,1057,5,7,1,1,6,single-choice,spatial-relational,1|6,7,1/6,240581,1
2,4,24,582,1,755,2,12,5,5,7,single-choice,spatial-relational,5|7,7,5/7,240582,5
2,4,24,583,1,911,4,10,3,3,7,single-choice,spatial-relational,3|7,7,3/7,240583,3
2,4,24,584,1,1161,3,5,1,1,4,single-choice,spatial-relational,1|4,7,1/4,240584,1
2,4,24,585,0,824,2,10,4,6,6,single-choice,spatial-relational,4|6,7,4/6,240585,4
2,4,24,586,1,760,1,5,2,2,3,single-choice,spatial-relational,2|3,7,2/3,240586,2
2,4,24,587,1,935,2,8,3,3,5,single-choice,spatial-relational,3|5,7,3/5,240587,3
2,4,24,588,1,791,2,10,4,4,6,single-choice,spatial-relational,4|6,7,4/6,240588,4
2,4,24,589,1,929,2,6,2,2,4,single-choice,spatial-relational,2|4,7,2/4,240589,2
2,4,24,590,1,724,1,3,1,1,2,single-choice,spatial-relational,1|2,7,1/2,240590,1
2,4,24,591,0,1468,2,6,2,4,4,single-choice,spatial-relational,2|4,7,2/4,240591,2
2,4,24,592,1,786,3,9,3,3,6,single-choice,spatial-relational,3|6,7,3/6,240592,3
2,4,24,593,1,962,5,9,2,2,7,single-choice,spatial-relational,2|7,7,2/7,240593,2
2,4,24,594,1,909,2,4,1,1,3,single-choice,spatial-relational,1|3,7,1/3,240594,1
2,4,24,595,1,821,1,7,3,3,4,single-choice,spatial-relational,3|4,7,3/4,240595,3
2,4,24,596,1,887,1,5,2,2,3,single-choice,spatial-relational,2|3,7,2/3,240596,2
2,4,24,597,1,978,1,9,4,4,5,single-choice,spatial-relational,4|5,7,4/5,240597,4
2,4,24,598,1,1900,2,12,5,5,7,single-choice,spatial-relational,5|7,7,5/7,240598,5
2,4,24,599,1,670,4,10,3,3,7,single-choice,spatial-relational,3|7,7,3/7,240599,3
2,4,24,600,0,1070,4,6,1,5,5,single-choice,spatial-relational,1|5,7,1/5,240600,1
3,4,24,1,1,9,3,7,2,2,5,single-choice,spatial-relational,2|5,7,2/5,240001,2
3,4,24,2,0,758,2,6,2,4,4,single-choice,spatial-relational,2|4,7,2/4,240002,2
3,4,24,3,0,221,1,3,1,2,2,single-choice,spatial-relational,1|2,7,1/2,240003,1
3,4,24,4,1,243,1,5,2,2,3,single-choice,spatial-relational,2|3,7,2/3,240004,2
3,4,24,5,0,792,4,6,1,5,5,single-choice,spatial-relational,1|5,7,1/5,240005,1
3,4,24,6,1,1250,3,9,3,3,6,single-choice,spatial-relational,3|6,7,3/6,240006,3
3,4,24,7,1,598,4,6,1,1,5,single-choice,spatial-relational,1|5,7,1/5,240007,1
3,4,24,8,1,635,1,13,6,6,7,single-choice,spatial-relational,6|7,7,6/7,240008,6
3,4,24,9,1,522,1,9,4,4,5,single-choice,spatial-relational,4|5,7,4/5,240009,4
3,4,24,10,0,536,3,5,1,4,4,single-choice,spatial-relational,1|4,7,1/4,240010,1
3,4,24,11,0,720,4,8,2,6,6,single-choice,spatial-relational,2|6,7,2/6,240011,2
3,4,24,12,1,1580,3,11,4,4,7,single-choice,spatial-relational,4|7,7,4/7,240012,4
3,4,24,13,1,1031,3,5,1,1,4,single-choice,spatial-relational,1|4,7,1/4,240013,1
3,4,24,14,1,670,4,10,3,3,7,single-choice,spatial-relational,3|7,7,3/7,240014,3
3,4,24,15,1,866,5,9,2,2,7,single-choice,spatial-relational,2|7,7,2/7,240015,2
3,4,24,16,1,1103,2,10,4,4,6,single-choice,spatial-relational,4|6,7,4/6,240016,4
3,4,24,17,1,903,5,9,2,2,7,single-choice,spatial-relational,2|7,7,2/7,240017,2
3,4,24,18,1,647,1,3,1,1,2,single-choice,spatial-relational,1|2,7,1/2,240018,1
3,4,24,19,1,548,2,10,4,4,6,single-choice,spatial-relational,4|6,7,4/6,240019,4
3,4,24,20,0,1392,2,4,1,3,3,single-choice,spatial-relational,1|3,7,1/3,240020,1
3,4,24,21,1,768,6,8,1,1,7,single-choice,spatial-relational,1|7,7,1/7,240021,1
3,4,24,22,1,913,4,10,3,3,7,single-choice,spatial-relational,3|7,7,3/7,240022,3
3,4,24,23,1,844,2,8,3,3,5,single-choice,spatial-relational,3|5,7,3/5,240023,3
3,4,24,24,1,739,1,5,2,2,3,single-choice,spatial-relational,2|3,7,2/3,240024,2
3,4,24,25,1,722,3,7,2,2,5,single-choice,spatial-relational,2|5,7,2/5,240025,2
3,4,24,26,1,819,2,8,3,3,5,single-choice,spatial-relational,3|5,7,3/5,240026,3
3,4,24,27,1,831,5,7,1,1,6,single-choice,spatial-relational,1|6,7,1/6,240027,1
3,4,24,28,1,677,1,13,6,6,7,single-choice,spatial-relational,6|7,7,6/7,240028,6
3,4,24,29,1,957,2,12,5,5,7,single-choice,spatial-relational,5|7,7,5/7,240029,5
3,4,24,30,1,607,2,4,1,1,3,single-choice,spatial-relational,1|3,7,1/3,240030,1
3,4,24,31,0,512,1,11,5,6,6,single-choice,spatial-relational,5|6,7,5/6,240031,5
3,4,24,32,0,1382,1,7,3,4,4,single-choice,spatial-relational,3|4,7,3/4,240032,3
3,4,24,33,1,773,1,9,4,4,5,single-choice,spatial-relational,4|5,7,4/5,240033,4
3,4,24,34,1,1644,3,9,3,3,6,single-choice,spatial-relational,3|6,7,3/6,240034,3
3,4,24,35,1,904,6,8,1,1,7,single-choice,spatial-relational,1|7,7,1/7,240035,1
3,4,24,36,1,5942,1,11,5,5,6,single-choice,spatial-relational,5|6,7,5/6,240036,5
3,4,24,37,1,1300,1,7,3,3,4,single-choice,spatial-relational,3|4,7,3/4,240037,3
3,4,24,38,1,1436,2,6,2,2,4,single-choice,spatial-relational,2|4,7,2/4,240038,2
3,4,24,39,1,826,4,8,2,2,6,single-choice,spatial-relational,2|6,7,2/6,240039,2
3,4,24,40,1,303,5,7,1,1,6,single-choice,spatial-relational,1|6,7,1/6,240040,1
3,4,24,41,0,578,3,11,4,7,7,single-choice,spatial-relational,4|7,7,4/7,240041,4
3,4,24,42,1,941,2,12,5,5,7,single-choice,spatial-relational,5|7,7,5/7,240042,5
3,4,24,43,1,876,4,6,1,1,5,single-choice,spatial-relational,1|5,7,1/5,240043,1
3,4,24,44,1,1100,3,5,1,1,4,single-choice,spatial-relational,1|4,7,1/4,240044,1
3,4,24,45,1,721,1,9,4,4,5,single-choice,spatial-relational,4|5,7,4/5,240045,4
3,4,24,46,1,771,3,9,3,3,6,single-choice,spatial-relational,3|6,7,3/6,240046,3
3,4,24,47,1,766,1,13,6,6,7,single-choice,spatial-relational,6|7,7,6/7,240047,6
3,4,24,48,0,971,2,8,3,5,5,single-choice,spatial-relational,3|5,7,3/5,240048,3
3,4,24,49,1,797,3,11,4,4,7,single-choice,spatial-relational,4|7,7,4/7,240049,4
3,4,24,50,1,1429,2,12,5,5,7,single-choice,spatial-relational,5|7,7,5/7,240050,5
3,4,24,51,1,890,2,12,5,5,7,single-choice,spatial-relational,5|7,7,5/7,240051,5
3,4,24,52,1,607,1,13,6,6,7,single-choice,spatial-relational,6|7,7,6/7,240052,6
3,4,24,53,0,148,1,3,1,2,2,single-choice,spatial-relational,1|2,7,1/2,240053,1
3,4,24,54,1,580,3,9,3,3,6,single-choice,spatial-relational,3|6,7,3/6,240054,3
3,4,24,55,0,149,3,7,2,5,5,single-choice,spatial-relational,2|5,7,2/5,240055,2
3,4,24,56,0,478,1,7,3,4,4,single-choice,spatial-relational,3|4,7,3/4,240056,3
3,4,24,57,0,131,1,11,5,6,6,single-choice,spatial-relational,5|6,7,5/6,240057,5
3,4,24,58,0,278,2,6,2,4,4,single-choice,spatial-relational,2|4,7,2/4,240058,2
3,4,24,59,0,613,5,7,1,6,6,single-choice,spatial-relational,1|6,7,1/6,240059,1
3,4,24,60,1,128,1,3,1,1,2,single-choice,spatial-relational,1|2,7,1/2,240060,1
3,4,24,61,1,173,3,5,1,1,4,single-choice,spatial-relational,1|4,7,1/4,240061,1
3,4,24,62,0,117,2,10,4,6,6,single-choice,spatial-relational,4|6,7,4/6,240062,4
3,4,24,63,1,118,1,11,5,5,6,single-choice,spatial-relational,5|6,7,5/6,240063,5
3,4,24,64,1,209,1,7,3,3,4,single-choice,spatial-relational,3|4,7,3/4,240064,3
3,4,24,65,0,619,2,4,1,3,3,single-choice,spatial-relational,1|3,7,1/3,240065,1
3,4,24,66,0,581,6,8,1,7,7,single-choice,spatial-relational,1|7,7,1/7,240066,1
3,4,24,67,0,6,4,10,3,7,7,single-choice,spatial-relational,3|7,7,3/7,240067,3
3,4,24,68,1,105,2,10,4,4,6,single-choice,spatial-relational,4|6,7,4/6,240068,4
3,4,24,69,1,118,5,7,1,1,6,single-choice,spatial-relational,1|6,7,1/6,240069,1
3,4,24,70,0,72,2,8,3,5,5,single-choice,spatial-relational,3|5,7,3/5,240070,3
3,4,24,71,0,108,4,6,1,5,5,single-choice,spatial-relational,1|5,7,1/5,240071,1
3,4,24,72,0,95,2,4,1,3,3,single-choice,spatial-relational,1|3,7,1/3,240072,1
3,4,24,73,0,25,1,5,2,3,3,single-choice,spatial-relational,2|3,7,2/3,240073,2
3,4,24,74,1,987,1,9,4,4,5,single-choice,spatial-relational,4|5,7,4/5,240074,4
3,4,24,75,1,798,4,8,2,2,6,single-choice,spatial-relational,2|6,7,2/6,240075,2
3,4,24,76,1,871,4,10,3,3,7,single-choice,spatial-relational,3|7,7,3/7,240076,3
3,4,24,77,1,552,3,11,4,4,7,single-choice,spatial-relational,4|7,7,4/7,240077,4
3,4,24,78,1,693,6,8,1,1,7,single-choice,spatial-relational,1|7,7,1/7,240078,1
3,4,24,79,1,826,1,5,2,2,3,single-choice,spatial-relational,2|3,7,2/3,240079,2
3,4,24,80,0,754,2,6,2,4,4,single-choice,spatial-relational,2|4,7,2/4,240080,2
3,4,24,81,1,655,4,8,2,2,6,single-choice,spatial-relational,2|6,7,2/6,240081,2
3,4,24,82,0,2,5,9,2,7,7,single-choice,spatial-relational,2|7,7,2/7,240082,2
3,4,24,83,1,148,3,7,2,2,5,single-choice,spatial-relational,2|5,7,2/5,240083,2
3,4,24,84,1,186,5,9,2,2,7,single-choice,spatial-relational,2|7,7,2/7,240084,2
3,4,24,85,1,161,4,8,2,2,6,single-choice,spatial-relational,2|6,7,2/6,240085,2
3,4,24,86,1,2,4,6,1,1,5,single-choice,spatial-relational,1|5,7,1/5,240086,1
3,4,24,87,1,902,2,8,3,3,5,single-choice,spatial-relational,3|5,7,3/5,240087,3
3,4,24,88,1,1303,1,7,3,3,4,single-choice,spatial-relational,3|4,7,3/4,240088,3
3,4,24,89,1,633,1,5,2,2,3,single-choice,spatial-relational,2|3,7,2/3,240089,2
3,4,24,90,1,202,5,7,1,1,6,single-choice,spatial-relational,1|6,7,1/6,240090,1
3,4,24,91,1,54,1,11,5,5,6,single-choice,spatial-relational,5|6,7,5/6,240091,5
3,4,24,92,0,68,3,7,2,5,5,single-choice,spatial-relational,2|5,7,2/5,240092,2
3,4,24,93,1,190,2,4,1,1,3,single-choice,spatial-relational,1|3,7,1/3,240093,1
3,4,24,94,0,153,2,4,1,3,3,single-choice,spatial-relational,1|3,7,1/3,240094,1
3,4,24,95,1,109,2,8,3,3,5,single-choice,spatial-relational,3|5,7,3/5,240095,3
3,4,24,96,1,175,1,13,6,6,7,single-choice,spatial-relational,6|7,7,6/7,240096,6
3,4,24,97,0,367,2,12,5,7,7,single-choice,spatial-relational,5|7,7,5/7,240097,5
3,4,24,98,1,122,4,10,3,3,7,single-choice,spatial-relational,3|7,7,3/7,240098,3
3,4,24,99,0,171,1,3,1,2,2,single-choice,spatial-relational,1|2,7,1/2,240099,1
3,4,24,100,1,74,3,7,2,2,5,single-choice,spatial-relational,2|5,7,2/5,240100,2
3,4,24,101,0,352,1,11,5,6,6,single-choice,spatial-relational,5|6,7,5/6,240101,5
3,4,24,102,0,86,3,11,4,7,7,single-choice,spatial-relational,4|7,7,4/7,240102,4
3,4,24,103,1,137,1,9,4,4,5,single-choice,spatial-relational,4|5,7,4/5,240103,4
3,4,24,104,1,264,5,9,2,2,7,single-choice,spatial-relational,2|7,7,2/7,240104,2
3,4,24,105,0,59,5,7,1,6,6,single-choice,spatial-relational,1|6,7,1/6,240105,1
3,4,24,106,0,130,1,13,6,7,7,single-choice,spatial-relational,6|7,7,6/7,240106,6
3,4,24,107,0,532,2,6,2,4,4,single-choice,spatial-relational,2|4,7,2/4,240107,2
3,4,24,108,1,774,1,9,4,4,5,single-choice,spatial-relational,4|5,7,4/5,240108,4
3,4,24,109,1,865,3,5,1,1,4,single-choice,spatial-relational,1|4,7,1/4,240109,1
3,4,24,110,1,751,3,11,4,4,7,single-choice,spatial-relational,4|7,7,4/7,240110,4
3,4,24,111,1,802,2,6,2,2,4,single-choice,spatial-relational,2|4,7,2/4,240111,2
3,4,24,112,1,594,2,10,4,4,6,single-choice,spatial-relational,4|6,7,4/6,240112,4
3,4,24,113,1,1060,6,8,1,1,7,single-choice,spatial-relational,1|7,7,1/7,240113,1
3,4,24,114,0,643,2,10,4,6,6,single-choice,spatial-relational,4|6,7,4/6,240114,4
3,4,24,115,1,810,1,7,3,3,4,single-choice,spatial-relational,3|4,7,3/4,240115,3
3,4,24,116,1,884,3,5,1,1,4,single-choice,spatial-relational,1|4,7,1/4,240116,1
3,4,24,117,1,753,1,3,1,1,2,single-choice,spatial-relational,1|2,7,1/2,240117,1
3,4,24,118,0,223,1,5,2,3,3,single-choice,spatial-relational,2|3,7,2/3,240118,2
3,4,24,119,1,1040,4,6,1,1,5,single-choice,spatial-relational,1|5,7,1/5,240119,1
3,4,24,120,1,727,4,10,3,3,7,single-choice,spatial-relational,3|7,7,3/7,240120,3
3,4,24,121,1,1018,4,8,2,2,6,single-choice,spatial-relational,2|6,7,2/6,240121,2
3,4,24,122,0,364,3,9,3,6,6,single-choice,spatial-relational,3|6,7,3/6,240122,3
3,4,24,123,1,683,3,9,3,3,6,single-choice,spatial-relational,3|6,7,3/6,240123,3
3,4,24,124,1,718,5,9,2,2,7,single-choice,spatial-relational,2|7,7,2/7,240124,2
3,4,24,125,1,680,6,8,1,1,7,single-choice,spatial-relational,1|7,7,1/7,240125,1
3,4,24,126,1,146,2,12,5,5,7,single-choice,spatial-relational,5|7,7,5/7,240126,5
3,4,24,127,1,269,1,11,5,5,6,single-choice,spatial-relational,5|6,7,5/6,240127,5
3,4,24,128,1,756,3,11,4,4,7,single-choice,spatial-relational,4|7,7,4/7,240128,4
3,4,24,129,0,689,6,8,1,7,7,single-choice,spatial-relational,1|7,7,1/7,240129,1
3,4,24,130,1,670,1,13,6,6,7,single-choice,spatial-relational,6|7,7,6/7,240130,6
3,4,24,131,1,812,3,9,3,3,6,single-choice,spatial-relational,3|6,7,3/6,240131,3
3,4,24,132,1,938,2,6,2,2,4,single-choice,spatial-relational,2|4,7,2/4,240132,2
3,4,24,133,1,459,1,3,1,1,2,single-choice,spatial-relational,1|2,7,1/2,240133,1
3,4,24,134,1,692,5,9,2,2,7,single-choice,spatial-relational,2|7,7,2/7,240134,2
3,4,24,135,1,990,1,7,3,3,4,single-choice,spatial-relational,3|4,7,3/4,240135,3
3,4,24,136,0,157,2,8,3,5,5,single-choice,spatial-relational,3|5,7,3/5,240136,3
3,4,24,137,1,882,2,12,5,5,7,single-choice,spatial-relational,5|7,7,5/7,240137,5
3,4,24,138,1,492,2,8,3,3,5,single-choice,spatial-relational,3|5,7,3/5,240138,3
3,4,24,139,1,226,6,8,1,1,7,single-choice,spatial-relational,1|7,7,1/7,240139,1
3,4,24,140,0,1,4,10,3,7,7,single-choice,spatial-relational,3|7,7,3/7,240140,3
3,4,24,141,0,233,2,12,5,7,7,single-choice,spatial-relational,5|7,7,5/7,240141,5
3,4,24,142,0,99,1,9,4,5,5,single-choice,spatial-relational,4|5,7,4/5,240142,4
3,4,24,143,1,276,5,7,1,1,6,single-choice,spatial-relational,1|6,7,1/6,240143,1
3,4,24,144,0,102,1,3,1,2,2,single-choice,spatial-relational,1|2,7,1/2,240144,1
3,4,24,145,0,205,4,6,1,5,5,single-choice,spatial-relational,1|5,7,1/5,240145,1
3,4,24,146,1,205,3,9,3,3,6,single-choice,spatial-relational,3|6,7,3/6,240146,3
3,4,24,147,0,157,1,5,2,3,3,single-choice,spatial-relational,2|3,7,2/3,240147,2
3,4,24,148,1,62,5,9,2,2,7,single-choice,spatial-relational,2|7,7,2/7,240148,2
3,4,24,149,0,83,2,6,2,4,4,single-choice,spatial-relational,2|4,7,2/4,240149,2
3,4,24,150,1,87,1,13,6,6,7,single-choice,spatial-relational,6|7,7,6/7,240150,6
3,4,24,151,0,61,3,11,4,7,7,single-choice,spatial-relational,4|7,7,4/7,240151,4
3,4,24,152,0,115,3,7,2,5,5,single-choice,spatial-relational,2|5,7,2/5,240152,2
3,4,24,153,1,168,1,9,4,4,5,single-choice,spatial-relational,4|5,7,4/5,240153,4
3,4,24,154,1,115,2,10,4,4,6,single-choice,spatial-relational,4|6,7,4/6,240154,4
3,4,24,155,0,144,4,8,2,6,6,single-choice,spatial-relational,2|6,7,2/6,240155,2
3,4,24,156,1,112,4,8,2,2,6,single-choice,spatial-relational,2|6,7,2/6,240156,2
3,4,24,157,0,160,2,4,1,3,3,single-choice,spatial-relational,1|3,7,1/3,240157,1
3,4,24,158,1,103,3,7,2,2,5,single-choice,spatial-relational,2|5,7,2/5,240158,2
3,4,24,159,0,152,1,7,3,4,4,single-choice,spatial-relational,3|4,7,3/4,240159,3
3,4,24,160,0,170,5,7,1,6,6,single-choice,spatial-relational,1|6,7,1/6,240160,1
3,4,24,161,1,183,3,5,1,1,4,single-choice,spatial-relational,1|4,7,1/4,240161,1
3,4,24,162,1,119,2,4,1,1,3,single-choice,spatial-relational,1|3,7,1/3,240162,1
3,4,24,163,1,84,4,6,1,1,5,single-choice,spatial-relational,1|5,7,1/5,240163,1
3,4,24,164,1,145,1,5,2,2,3,single-choice,spatial-relational,2|3,7,2/3,240164,2
3,4,24,165,0,112,2,10,4,6,6,single-choice,spatial-relational,4|6,7,4/6,240165,4
3,4,24,166,0,126,3,5,1,4,4,single-choice,spatial-relational,1|4,7,1/4,240166,1
3,4,24,167,0,73,1,11,5,6,6,single-choice,spatial-relational,5|6,7,5/6,240167,5
3,4,24,168,1,438,4,10,3,3,7,single-choice,spatial-relational,3|7,7,3/7,240168,3
3,4,24,169,0,74,6,8,1,7,7,single-choice,spatial-relational,1|7,7,1/7,240169,1
3,4,24,170,1,369,3,11,4,4,7,single-choice,spatial-relational,4|7,7,4/7,240170,4
3,4,24,171,1,161,6,8,1,1,7,single-choice,spatial-relational,1|7,7,1/7,240171,1
3,4,24,172,1,132,1,9,4,4,5,single-choice,spatial-relational,4|5,7,4/5,240172,4
3,4,24,173,1,16,5,7,1,1,6,single-choice,spatial-relational,1|6,7,1/6,240173,1
3,4,24,174,0,335,5,9,2,7,7,single-choice,spatial-relational,2|7,7,2/7,240174,2
3,4,24,175,0,149,2,12,5,7,7,single-choice,spatial-relational,5|7,7,5/7,240175,5
3,4,24,176,1,95,1,13,6,6,7,single-choice,spatial-relational,6|7,7,6/7,240176,6
3,4,24,177,0,98,3,5,1,4,4,single-choice,spatial-relational,1|4,7,1/4,240177,1
3,4,24,178,0,95,2,8,3,5,5,single-choice,spatial-relational,3|5,7,3/5,240178,3
3,4,24,179,0,112,2,10,4,6,6,single-choice,spatial-relational,4|6,7,4/6,240179,4
3,4,24,180,1,385,4,8,2,2,6,single-choice,spatial-relational,2|6,7,2/6,240180,2
3,4,24,181,1,84,2,8,3,3,5,single-choice,spatial-relational,3|5,7,3/5,240181,3
3,4,24,182,1,140,1,5,2,2,3,single-choice,spatial-relational,2|3,7,2/3,240182,2
3,4,24,183,0,67,1,9,4,5,5,single-choice,spatial-relational,4|5,7,4/5,240183,4
3,4,24,184,1,182,3,7,2,2,5,single-choice,spatial-relational,2|5,7,2/5,240184,2
3,4,24,185,1,193,5,9,2,2,7,single-choice,spatial-relational,2|7,7,2/7,240185,2
3,4,24,186,0,75,1,3,1,2,2,single-choice,spatial-relational,1|2,7,1/2,240186,1
3,4,24,187,0,163,5,7,1,6,6,single-choice,spatial-relational,1|6,7,1/6,240187,1
3,4,24,188,0,124,1,11,5,6,6,single-choice,spatial-relational,5|6,7,5/6,240188,5
3,4,24,189,1,164,1,7,3,3,4,single-choice,spatial-relational,3|4,7,3/4,240189,3
3,4,24,190,0,206,1,7,3,4,4,single-choice,spatial-relational,3|4,7,3/4,240190,3
3,4,24,191,0,1242,3,5,1,4,4,single-choice,spatial-relational,1|4,7,1/4,240191,1
3,4,24,192,0,120,1,13,6,7,7,single-choice,spatial-relational,6|7,7,6/7,240192,6
3,4,24,193,1,115,2,10,4,4,6,single-choice,spatial-relational,4|6,7,4/6,240193,4
3,4,24,194,0,215,4,8,2,6,6,single-choice,spatial-relational,2|6,7,2/6,240194,2
3,4,24,195,1,142,4,6,1,1,5,single-choice,spatial-relational,1|5,7,1/5,240195,1
3,4,24,196,0,208,4,6,1,5,5,single-choice,spatial-relational,1|5,7,1/5,240196,1
3,4,24,197,0,134,3,9,3,6,6,single-choice,spatial-relational,3|6,7,3/6,240197,3
3,4,24,198,0,260,3,11,4,7,7,single-choice,spatial-relational,4|7,7,4/7,240198,4
3,4,24,199,1,353,2,4,1,1,3,single-choice,spatial-relational,1|3,7,1/3,240199,1
3,4,24,200,0,701,2,6,2,4,4,single-choice,spatial-relational,2|4,7,2/4,240200,2
3,4,24,201,0,5,2,4,1,3,3,single-choice,spatial-relational,1|3,7,1/3,240201,1
3,4,24,202,0,196,1,5,2,3,3,single-choice,spatial-relational,2|3,7,2/3,240202,2
3,4,24,203,1,155,3,9,3,3,6,single-choice,spatial-relational,3|6,7,3/6,240203,3
3,4,24,204,1,165,1,3,1,1,2,single-choice,spatial-relational,1|2,7,1/2,240204,1
3,4,24,205,1,84,1,11,5,5,6,single-choice,spatial-relational,5|6,7,5/6,240205,5
3,4,24,206,1,126,2,12,5,5,7,single-choice,spatial-relational,5|7,7,5/7,240206,5
3,4,24,207,1,2,4,10,3,3,7,single-choice,spatial-relational,3|7,7,3/7,240207,3
3,4,24,208,1,128,2,6,2,2,4,single-choice,spatial-relational,2|4,7,2/4,240208,2
3,4,24,209,0,572,4,10,3,7,7,single-choice,spatial-relational,3|7,7,3/7,240209,3
3,4,24,210,0,74,3,7,2,5,5,single-choice,spatial-relational,2|5,7,2/5,240210,2
3,4,24,211,1,241,2,8,3,3,5,single-choice,spatial-relational,3|5,7,3/5,240211,3
3,4,24,212,1,91,1,3,1,1,2,single-choice,spatial-relational,1|2,7,1/2,240212,1
3,4,24,213,1,200,2,10,4,4,6,single-choice,spatial-relational,4|6,7,4/6,240213,4
3,4,24,214,0,167,3,5,1,4,4,single-choice,spatial-relational,1|4,7,1/4,240214,1
3,4,24,215,0,80,2,10,4,6,6,single-choice,spatial-relational,4|6,7,4/6,240215,4
3,4,24,216,1,1,1,13,6,6,7,single-choice,spatial-relational,6|7,7,6/7,240216,6
3,4,24,217,0,100,1,3,1,2,2,single-choice,spatial-relational,1|2,7,1/2,240217,1
3,4,24,218,1,101,5,9,2,2,7,single-choice,spatial-relational,2|7,7,2/7,240218,2
3,4,24,219,0,113,1,7,3,4,4,single-choice,spatial-relational,3|4,7,3/4,240219,3
3,4,24,220,1,103,2,12,5,5,7,single-choice,spatial-relational,5|7,7,5/7,240220,5
3,4,24,221,0,75,4,8,2,6,6,single-choice,spatial-relational,2|6,7,2/6,240221,2
3,4,24,222,0,127,2,6,2,4,4,single-choice,spatial-relational,2|4,7,2/4,240222,2
3,4,24,223,0,205,1,13,6,7,7,single-choice,spatial-relational,6|7,7,6/7,240223,6
3,4,24,224,1,272,1,11,5,5,6,single-choice,spatial-relational,5|6,7,5/6,240224,5
3,4,24,225,1,290,2,4,1,1,3,single-choice,spatial-relational,1|3,7,1/3,240225,1
3,4,24,226,0,6,4,6,1,5,5,single-choice,spatial-relational,1|5,7,1/5,240226,1
3,4,24,227,1,255,6,8,1,1,7,single-choice,spatial-relational,1|7,7,1/7,240227,1
3,4,24,228,1,111,5,7,1,1,6,single-choice,spatial-relational,1|6,7,1/6,240228,1
3,4,24,229,1,93,1,7,3,3,4,single-choice,spatial-relational,3|4,7,3/4,240229,3
3,4,24,230,0,141,6,8,1,7,7,single-choice,spatial-relational,1|7,7,1/7,240230,1
3,4,24,231,0,148,1,11,5,6,6,single-choice,spatial-relational,5|6,7,5/6,240231,5
3,4,24,232,1,124,2,6,2,2,4,single-choice,spatial-relational,2|4,7,2/4,240232,2
3,4,24,233,1,104,3,5,1,1,4,single-choice,spatial-relational,1|4,7,1/4,240233,1
3,4,24,234,1,7,4,6,1,1,5,single-choice,spatial-relational,1|5,7,1/5,240234,1
3,4,24,235,0,106,2,12,5,7,7,single-choice,spatial-relational,5|7,7,5/7,240235,5
3,4,24,236,0,214,3,9,3,6,6,single-choice,spatial-relational,3|6,7,3/6,240236,3
3,4,24,237,0,137,2,4,1,3,3,single-choice,spatial-relational,1|3,7,1/3,240237,1
3,4,24,238,1,165,4,8,2,2,6,single-choice,spatial-relational,2|6,7,2/6,240238,2
3,4,24,239,0,113,2,8,3,5,5,single-choice,spatial-relational,3|5,7,3/5,240239,3
3,4,24,240,1,112,3,7,2,2,5,single-choice,spatial-relational,2|5,7,2/5,240240,2
3,4,24,241,1,112,3,11,4,4,7,single-choice,spatial-relational,4|7,7,4/7,240241,4
3,4,24,242,0,215,4,10,3,7,7,single-choice,spatial-relational,3|7,7,3/7,240242,3
3,4,24,243,0,101,3,11,4,7,7,single-choice,spatial-relational,4|7,7,4/7,240243,4
3,4,24,244,1,96,1,9,4,4,5,single-choice,spatial-relational,4|5,7,4/5,240244,4
3,4,24,245,1,6,4,10,3,3,7,single-choice,spatial-relational,3|7,7,3/7,240245,3
3,4,24,246,1,127,1,5,2,2,3,single-choice,spatial-relational,2|3,7,2/3,240246,2
3,4,24,247,0,93,5,7,1,6,6,single-choice,spatial-relational,1|6,7,1/6,240247,1
3,4,24,248,0,178,1,5,2,3,3,single-choice,spatial-relational,2|3,7,2/3,240248,2
3,4,24,249,1,314,3,9,3,3,6,single-choice,spatial-relational,3|6,7,3/6,240249,3
3,4,24,250,0,73,5,9,2,7,7,single-choice,spatial-relational,2|7,7,2/7,240250,2
3,4,24,251,0,132,1,9,4,5,5,single-choice,spatial-relational,4|5,7,4/5,240251,4
3,4,24,252,0,170,3,7,2,5,5,single-choice,spatial-relational,2|5,7,2/5,240252,2
3,4,24,253,0,222,1,11,5,6,6,single-choice,spatial-relational,5|6,7,5/6,240253,5
3,4,24,254,1,162,2,4,1,1,3,single-choice,spatial-relational,1|3,7,1/3,240254,1
3,4,24,255,0,192,2,12,5,7,7,single-choice,spatial-relational,5|7,7,5/7,240255,5
3,4,24,256,0,114,4,8,2,6,6,single-choice,spatial-relational,2|6,7,2/6,240256,2
3,4,24,257,1,160,1,5,2,2,3,single-choice,spatial-relational,2|3,7,2/3,240257,2
3,4,24,258,1,62,5,7,1,1,6,single-choice,spatial-relational,1|6,7,1/6,240258,1
3,4,24,259,0,152,2,8,3,5,5,single-choice,spatial-relational,3|5,7,3/5,240259,3
3,4,24,260,0,200,1,5,2,3,3,single-choice,spatial-relational,2|3,7,2/3,240260,2
3,4,24,261,1,138,2,12,5,5,7,single-choice,spatial-relational,5|7,7,5/7,240261,5
3,4,24,262,1,94,4,8,2,2,6,single-choice,spatial-relational,2|6,7,2/6,240262,2
3,4,24,263,0,218,3,11,4,7,7,single-choice,spatial-relational,4|7,7,4/7,240263,4
3,4,24,264,1,249,6,8,1,1,7,single-choice,spatial-relational,1|7,7,1/7,240264,1
3,4,24,265,1,2,1,13,6,6,7,single-choice,spatial-relational,6|7,7,6/7,240265,6
3,4,24,266,1,222,1,7,3,3,4,single-choice,spatial-relational,3|4,7,3/4,240266,3
3,4,24,267,1,55,3,11,4,4,7,single-choice,spatial-relational,4|7,7,4/7,240267,4
3,4,24,268,0,134,4,6,1,5,5,single-choice,spatial-relational,1|5,7,1/5,240268,1
3,4,24,269,1,165,4,10,3,3,7,single-choice,spatial-relational,3|7,7,3/7,240269,3
3,4,24,270,0,141,2,10,4,6,6,single-choice,spatial-relational,4|6,7,4/6,240270,4
3,4,24,271,0,224,3,7,2,5,5,single-choice,spatial-relational,2|5,7,2/5,240271,2
3,4,24,272,1,271,2,6,2,2,4,single-choice,spatial-relational,2|4,7,2/4,240272,2
3,4,24,273,1,68,3,7,2,2,5,single-choice,spatial-relational,2|5,7,2/5,240273,2
3,4,24,274,1,277,1,9,4,4,5,single-choice,spatial-relational,4|5,7,4/5,240274,4
3,4,24,275,0,90,3,5,1,4,4,single-choice,spatial-relational,1|4,7,1/4,240275,1
3,4,24,276,1,51,2,8,3,3,5,single-choice,spatial-relational,3|5,7,3/5,240276,3
3,4,24,277,0,115,1,9,4,5,5,single-choice,spatial-relational,4|5,7,4/5,240277,4
3,4,24,278,1,124,1,11,5,5,6,single-choice,spatial-relational,5|6,7,5/6,240278,5
3,4,24,279,0,161,1,7,3,4,4,single-choice,spatial-relational,3|4,7,3/4,240279,3
3,4,24,280,1,316,1,3,1,1,2,single-choice,spatial-relational,1|2,7,1/2,240280,1
3,4,24,281,0,148,2,4,1,3,3,single-choice,spatial-relational,1|3,7,1/3,240281,1
3,4,24,282,1,400,5,9,2,2,7,single-choice,spatial-relational,2|7,7,2/7,240282,2
3,4,24,283,1,85,2,10,4,4,6,single-choice,spatial-relational,4|6,7,4/6,240283,4
3,4,24,284,0,72,1,3,1,2,2,single-choice,spatial-relational,1|2,7,1/2,240284,1
3,4,24,285,1,936,3,9,3,3,6,single-choice,spatial-relational,3|6,7,3/6,240285,3
3,4,24,286,0,146,1,13,6,7,7,single-choice,spatial-relational,6|7,7,6/7,240286,6
3,4,24,287,1,155,3,5,1,1,4,single-choice,spatial-relational,1|4,7,1/4,240287,1
3,4,24,288,0,6,3,9,3,6,6,single-choice,spatial-relational,3|6,7,3/6,240288,3
3,4,24,289,0,82,2,6,2,4,4,single-choice,spatial-relational,2|4,7,2/4,240289,2
3,4,24,290,1,148,4,6,1,1,5,single-choice,spatial-relational,1|5,7,1/5,240290,1
3,4,24,291,0,2,6,8,1,7,7,single-choice,spatial-relational,1|7,7,1/7,240291,1
3,4,24,292,0,287,4,10,3,7,7,single-choice,spatial-relational,3|7,7,3/7,240292,3
3,4,24,293,0,95,5,7,1,6,6,single-choice,spatial-relational,1|6,7,1/6,240293,1
3,4,24,294,0,122,5,9,2,7,7,single-choice,spatial-relational,2|7,7,2/7,240294,2
3,4,24,295,0,139,2,10,4,6,6,single-choice,spatial-relational,4|6,7,4/6,240295,4
3,4,24,296,1,327,4,6,1,1,5,single-choice,spatial-relational,1|5,7,1/5,240296,1
3,4,24,297,1,76,2,12,5,5,7,single-choice,spatial-relational,5|7,7,5/7,240297,5
3,4,24,298,0,3,2,6,2,4,4,single-choice,spatial-relational,2|4,7,2/4,240298,2
3,4,24,299,0,194,2,8,3,5,5,single-choice,spatial-relational,3|5,7,3/5,240299,3
3,4,24,300,1,87,3,7,2,2,5,single-choice,spatial-relational,2|5,7,2/5,240300,2
3,4,24,301,1,105,3,11,4,4,7,single-choice,spatial-relational,4|7,7,4/7,240301,4
3,4,24,302,1,123,6,8,1,1,7,single-choice,spatial-relational,1|7,7,1/7,240302,1
3,4,24,303,1,105,1,13,6,6,7,single-choice,spatial-relational,6|7,7,6/7,240303,6
3,4,24,304,1,85,2,6,2,2,4,single-choice,spatial-relational,2|4,7,2/4,240304,2
3,4,24,305,0,63,1,7,3,4,4,single-choice,spatial-relational,3|4,7,3/4,240305,3
3,4,24,306,0,154,4,8,2,6,6,single-choice,spatial-relational,2|6,7,2/6,240306,2
3,4,24,307,0,904,3,5,1,4,4,single-choice,spatial-relational,1|4,7,1/4,240307,1
3,4,24,308,0,192,3,7,2,5,5,single-choice,spatial-relational,2|5,7,2/5,240308,2
3,4,24,309,0,181,1,13,6,7,7,single-choice,spatial-relational,6|7,7,6/7,240309,6
3,4,24,310,1,342,2,8,3,3,5,single-choice,spatial-relational,3|5,7,3/5,240310,3
3,4,24,311,1,89,4,8,2,2,6,single-choice,spatial-relational,2|6,7,2/6,240311,2
3,4,24,312,1,110,4,10,3,3,7,single-choice,spatial-relational,3|7,7,3/7,240312,3
3,4,24,313,0,90,1,11,5,6,6,single-choice,spatial-relational,5|6,7,5/6,240313,5
3,4,24,314,1,852,1,7,3,3,4,single-choice,spatial-relational,3|4,7,3/4,240314,3
3,4,24,315,0,124,1,3,1,2,2,single-choice,spatial-relational,1|2,7,1/2,240315,1
3,4,24,316,0,349,3,11,4,7,7,single-choice,spatial-relational,4|7,7,4/7,240316,4
3,4,24,317,1,708,5,9,2,2,7,single-choice,spatial-relational,2|7,7,2/7,240317,2
3,4,24,318,1,128,2,4,1,1,3,single-choice,spatial-relational,1|3,7,1/3,240318,1
3,4,24,319,1,118,2,10,4,4,6,single-choice,spatial-relational,4|6,7,4/6,240319,4
3,4,24,320,0,83,4,10,3,7,7,single-choice,spatial-relational,3|7,7,3/7,240320,3
3,4,24,321,0,144,5,9,2,7,7,single-choice,spatial-relational,2|7,7,2/7,240321,2
3,4,24,322,0,343,6,8,1,7,7,single-choice,spatial-relational,1|7,7,1/7,240322,1
3,4,24,323,0,782,4,6,1,5,5,single-choice,spatial-relational,1|5,7,1/5,240323,1
3,4,24,324,0,1184,3,9,3,6,6,single-choice,spatial-relational,3|6,7,3/6,240324,3
3,4,24,325,0,632,2,12,5,7,7,single-choice,spatial-relational,5|7,7,5/7,240325,5
3,4,24,326,1,139,1,5,2,2,3,single-choice,spatial-relational,2|3,7,2/3,240326,2
3,4,24,327,1,78,1,11,5,5,6,single-choice,spatial-relational,5|6,7,5/6,240327,5
3,4,24,328,1,499,3,9,3,3,6,single-choice,spatial-relational,3|6,7,3/6,240328,3
3,4,24,329,0,61,1,9,4,5,5,single-choice,spatial-relational,4|5,7,4/5,240329,4
3,4,24,330,1,258,1,9,4,4,5,single-choice,spatial-relational,4|5,7,4/5,240330,4
3,4,24,331,1,420,5,7,1,1,6,single-choice,spatial-relational,1|6,7,1/6,240331,1
3,4,24,332,1,117,3,5,1,1,4,single-choice,spatial-relational,1|4,7,1/4,240332,1
3,4,24,333,0,108,1,5,2,3,3,single-choice,spatial-relational,2|3,7,2/3,240333,2
3,4,24,334,0,99,5,7,1,6,6,single-choice,spatial-relational,1|6,7,1/6,240334,1
3,4,24,335,0,79,2,4,1,3,3,single-choice,spatial-relational,1|3,7,1/3,240335,1
3,4,24,336,1,2,1,3,1,1,2,single-choice,spatial-relational,1|2,7,1/2,240336,1
3,4,24,337,1,575,5,7,1,1,6,single-choice,spatial-relational,1|6,7,1/6,240337,1
3,4,24,338,0,132,4,8,2,6,6,single-choice,spatial-relational,2|6,7,2/6,240338,2
3,4,24,339,1,352,1,11,5,5,6,single-choice,spatial-relational,5|6,7,5/6,240339,5
3,4,24,340,1,105,4,8,2,2,6,single-choice,spatial-relational,2|6,7,2/6,240340,2
3,4,24,341,1,107,2,10,4,4,6,single-choice,spatial-relational,4|6,7,4/6,240341,4
3,4,24,342,1,235,2,12,5,5,7,single-choice,spatial-relational,5|7,7,5/7,240342,5
3,4,24,343,1,295,1,7,3,3,4,single-choice,spatial-relational,3|4,7,3/4,240343,3
3,4,24,344,0,74,3,7,2,5,5,single-choice,spatial-relational,2|5,7,2/5,240344,2
3,4,24,345,1,686,4,6,1,1,5,single-choice,spatial-relational,1|5,7,1/5,240345,1
3,4,24,346,0,99,1,13,6,7,7,single-choice,spatial-relational,6|7,7,6/7,240346,6
3,4,24,347,1,303,6,8,1,1,7,single-choice,spatial-relational,1|7,7,1/7,240347,1
3,4,24,348,0,287,1,3,1,2,2,single-choice,spatial-relational,1|2,7,1/2,240348,1
3,4,24,349,0,714,3,11,4,7,7,single-choice,spatial-relational,4|7,7,4/7,240349,4
3,4,24,350,1,62,4,10,3,3,7,single-choice,spatial-relational,3|7,7,3/7,240350,3
3,4,24,351,1,6,5,9,2,2,7,single-choice,spatial-relational,2|7,7,2/7,240351,2
3,4,24,352,1,163,2,8,3,3,5,single-choice,spatial-relational,3|5,7,3/5,240352,3
3,4,24,353,0,192,1,7,3,4,4,single-choice,spatial-relational,3|4,7,3/4,240353,3
3,4,24,354,0,479,2,12,5,7,7,single-choice,spatial-relational,5|7,7,5/7,240354,5
3,4,24,355,1,351,3,7,2,2,5,single-choice,spatial-relational,2|5,7,2/5,240355,2
3,4,24,356,0,213,5,9,2,7,7,single-choice,spatial-relational,2|7,7,2/7,240356,2
3,4,24,357,1,3,1,9,4,4,5,single-choice,spatial-relational,4|5,7,4/5,240357,4
3,4,24,358,1,88,1,3,1,1,2,single-choice,spatial-relational,1|2,7,1/2,240358,1
3,4,24,359,0,109,3,9,3,6,6,single-choice,spatial-relational,3|6,7,3/6,240359,3
3,4,24,360,1,1146,3,11,4,4,7,single-choice,spatial-relational,4|7,7,4/7,240360,4
3,4,24,361,1,664,4,6,1,1,5,single-choice,spatial-relational,1|5,7,1/5,240361,1
3,4,24,362,1,603,2,10,4,4,6,single-choice,spatial-relational,4|6,7,4/6,240362,4
3,4,24,363,0,116,2,6,2,4,4,single-choice,spatial-relational,2|4,7,2/4,240363,2
3,4,24,364,0,135,4,10,3,7,7,single-choice,spatial-relational,3|7,7,3/7,240364,3
3,4,24,365,1,30,2,6,2,2,4,single-choice,spatial-relational,2|4,7,2/4,240365,2
3,4,24,366,1,3,1,13,6,6,7,single-choice,spatial-relational,6|7,7,6/7,240366,6
3,4,24,367,0,15,2,4,1,3,3,single-choice,spatial-relational,1|3,7,1/3,240367,1
3,4,24,368,0,626,3,5,1,4,4,single-choice,spatial-relational,1|4,7,1/4,240368,1
3,4,24,369,1,85,2,4,1,1,3,single-choice,spatial-relational,1|3,7,1/3,240369,1
3,4,24,370,1,1397,3,9,3,3,6,single-choice,spatial-relational,3|6,7,3/6,240370,3
3,4,24,371,1,762,6,8,1,1,7,single-choice,spatial-relational,1|7,7,1/7,240371,1
3,4,24,372,1,12,1,5,2,2,3,single-choice,spatial-relational,2|3,7,2/3,240372,2
3,4,24,373,0,2,5,7,1,6,6,single-choice,spatial-relational,1|6,7,1/6,240373,1
3,4,24,374,0,4,1,11,5,6,6,single-choice,spatial-relational,5|6,7,5/6,240374,5
3,4,24,375,0,6,2,8,3,5,5,single-choice,spatial-relational,3|5,7,3/5,240375,3
3,4,24,376,1,1457,1,9,4,4,5,single-choice,spatial-relational,4|5,7,4/5,240376,4
3,4,24,377,1,668,3,5,1,1,4,single-choice,spatial-relational,1|4,7,1/4,240377,1
3,4,24,378,0,5,1,5,2,3,3,single-choice,spatial-relational,2|3,7,2/3,240378,2
3,4,24,379,0,4,3,5,1,4,4,single-choice,spatial-relational,1|4,7,1/4,240379,1
3,4,24,380,1,1161,2,12,5,5,7,single-choice,spatial-relational,5|7,7,5/7,240380,5
3,4,24,381,1,715,1,13,6,6,7,single-choice,spatial-relational,6|7,7,6/7,240381,6
3,4,24,382,1,941,5,7,1,1,6,single-choice,spatial-relational,1|6,7,1/6,240382,1
3,4,24,383,1,642,4,6,1,1,5,single-choice,spatial-relational,1|5,7,1/5,240383,1
3,4,24,384,1,659,4,10,3,3,7,single-choice,spatial-relational,3|7,7,3/7,240384,3
3,4,24,385,1,920,2,10,4,4,6,single-choice,spatial-relational,4|6,7,4/6,240385,4
3,4,24,386,1,964,4,6,1,1,5,single-choice,spatial-relational,1|5,7,1/5,240386,1
3,4,24,387,1,797,4,8,2,2,6,single-choice,spatial-relational,2|6,7,2/6,240387,2
3,4,24,388,1,11,4,10,3,3,7,single-choice,spatial-relational,3|7,7,3/7,240388,3
3,4,24,389,1,63,2,4,1,1,3,single-choice,spatial-relational,1|3,7,1/3,240389,1
3,4,24,390,1,183,2,6,2,2,4,single-choice,spatial-relational,2|4,7,2/4,240390,2
3,4,24,391,1,179,3,9,3,3,6,single-choice,spatial-relational,3|6,7,3/6,240391,3
3,4,24,392,0,4,2,10,4,6,6,single-choice,spatial-relational,4|6,7,4/6,240392,4
3,4,24,393,1,322,1,5,2,2,3,single-choice,spatial-relational,2|3,7,2/3,240393,2
3,4,24,394,0,239,5,7,1,6,6,single-choice,spatial-relational,1|6,7,1/6,240394,1
3,4,24,395,1,176,5,9,2,2,7,single-choice,spatial-relational,2|7,7,2/7,240395,2
3,4,24,396,0,294,4,8,2,6,6,single-choice,spatial-relational,2|6,7,2/6,240396,2
3,4,24,397,1,722,3,5,1,1,4,single-choice,spatial-relational,1|4,7,1/4,240397,1
3,4,24,398,1,187,1,11,5,5,6,single-choice,spatial-relational,5|6,7,5/6,240398,5
3,4,24,399,0,114,2,4,1,3,3,single-choice,spatial-relational,1|3,7,1/3,240399,1
3,4,24,400,0,429,2,6,2,4,4,single-choice,spatial-relational,2|4,7,2/4,240400,2
3,4,24,401,0,1014,6,8,1,7,7,single-choice,spatial-relational,1|7,7,1/7,240401,1
3,4,24,402,1,848,3,11,4,4,7,single-choice,spatial-relational,4|7,7,4/7,240402,4
3,4,24,403,0,152,3,7,2,5,5,single-choice,spatial-relational,2|5,7,2/5,240403,2
3,4,24,404,1,244,3,11,4,4,7,single-choice,spatial-relational,4|7,7,4/7,240404,4
3,4,24,405,1,95,2,12,5,5,7,single-choice,spatial-relational,5|7,7,5/7,240405,5
3,4,24,406,0,80,3,9,3,6,6,single-choice,spatial-relational,3|6,7,3/6,240406,3
3,4,24,407,0,71,5,9,2,7,7,single-choice,spatial-relational,2|7,7,2/7,240407,2
3,4,24,408,1,11,3,7,2,2,5,single-choice,spatial-relational,2|5,7,2/5,240408,2
3,4,24,409,0,594,2,8,3,5,5,single-choice,spatial-relational,3|5,7,3/5,240409,3
3,4,24,410,1,172,2,8,3,3,5,single-choice,spatial-relational,3|5,7,3/5,240410,3
3,4,24,411,1,214,1,13,6,6,7,single-choice,spatial-relational,6|7,7,6/7,240411,6
3,4,24,412,1,141,1,9,4,4,5,single-choice,spatial-relational,4|5,7,4/5,240412,4
3,4,24,413,1,339,1,7,3,3,4,single-choice,spatial-relational,3|4,7,3/4,240413,3
3,4,24,414,0,103,1,7,3,4,4,single-choice,spatial-relational,3|4,7,3/4,240414,3
3,4,24,415,1,327,6,8,1,1,7,single-choice,spatial-relational,1|7,7,1/7,240415,1
3,4,24,416,0,588,1,9,4,5,5,single-choice,spatial-relational,4|5,7,4/5,240416,4
3,4,24,417,1,14,1,5,2,2,3,single-choice,spatial-relational,2|3,7,2/3,240417,2
3,4,24,418,0,302,1,3,1,2,2,single-choice,spatial-relational,1|2,7,1/2,240418,1
3,4,24,419,1,135,1,3,1,1,2,single-choice,spatial-relational,1|2,7,1/2,240419,1
3,4,24,420,0,201,1,11,5,6,6,single-choice,spatial-relational,5|6,7,5/6,240420,5
3,4,24,421,1,250,5,7,1,1,6,single-choice,spatial-relational,1|6,7,1/6,240421,1
3,4,24,422,1,231,1,13,6,6,7,single-choice,spatial-relational,6|7,7,6/7,240422,6
3,4,24,423,1,250,2,4,1,1,3,single-choice,spatial-relational,1|3,7,1/3,240423,1
3,4,24,424,0,1257,2,6,2,4,4,single-choice,spatial-relational,2|4,7,2/4,240424,2
3,4,24,425,0,326,2,10,4,6,6,single-choice,spatial-relational,4|6,7,4/6,240425,4
3,4,24,426,0,958,1,11,5,6,6,single-choice,spatial-relational,5|6,7,5/6,240426,5
3,4,24,427,1,186,1,11,5,5,6,single-choice,spatial-relational,5|6,7,5/6,240427,5
3,4,24,428,0,98,3,7,2,5,5,single-choice,spatial-relational,2|5,7,2/5,240428,2
3,4,24,429,0,462,6,8,1,7,7,single-choice,spatial-relational,1|7,7,1/7,240429,1
3,4,24,430,1,322,2,10,4,4,6,single-choice,spatial-relational,4|6,7,4/6,240430,4
3,4,24,431,0,118,4,6,1,5,5,single-choice,spatial-relational,1|5,7,1/5,240431,1
3,4,24,432,0,133,4,10,3,7,7,single-choice,spatial-relational,3|7,7,3/7,240432,3
3,4,24,433,0,237,5,9,2,7,7,single-choice,spatial-relational,2|7,7,2/7,240433,2
3,4,24,434,0,5,1,7,3,4,4,single-choice,spatial-relational,3|4,7,3/4,240434,3
3,4,24,435,0,330,2,8,3,5,5,single-choice,spatial-relational,3|5,7,3/5,240435,3
3,4,24,436,1,6,4,10,3,3,7,single-choice,spatial-relational,3|7,7,3/7,240436,3
3,4,24,437,1,9,2,6,2,2,4,single-choice,spatial-relational,2|4,7,2/4,240437,2
3,4,24,438,0,114,1,3,1,2,2,single-choice,spatial-relational,1|2,7,1/2,240438,1
3,4,24,439,1,124,1,9,4,4,5,single-choice,spatial-relational,4|5,7,4/5,240439,4
3,4,24,440,1,117,4,6,1,1,5,single-choice,spatial-relational,1|5,7,1/5,240440,1
3,4,24,441,0,107,2,4,1,3,3,single-choice,spatial-relational,1|3,7,1/3,240441,1
3,4,24,442,1,105,3,9,3,3,6,single-choice,spatial-relational,3|6,7,3/6,240442,3
3,4,24,443,0,139,2,12,5,7,7,single-choice,spatial-relational,5|7,7,5/7,240443,5
3,4,24,444,0,109,1,9,4,5,5,single-choice,spatial-relational,4|5,7,4/5,240444,4
3,4,24,445,1,54,1,5,2,2,3,single-choice,spatial-relational,2|3,7,2/3,240445,2
3,4,24,446,1,145,3,5,1,1,4,single-choice,spatial-relational,1|4,7,1/4,240446,1
3,4,24,447,0,142,4,8,2,6,6,single-choice,spatial-relational,2|6,7,2/6,240447,2
3,4,24,448,0,5,1,13,6,7,7,single-choice,spatial-relational,6|7,7,6/7,240448,6
3,4,24,449,0,4,3,5,1,4,4,single-choice,spatial-relational,1|4,7,1/4,240449,1
3,4,24,450,1,119,1,3,1,1,2,single-choice,spatial-relational,1|2,7,1/2,240450,1
3,4,24,451,1,102,3,11,4,4,7,single-choice,spatial-relational,4|7,7,4/7,240451,4
3,4,24,452,1,111,4,8,2,2,6,single-choice,spatial-relational,2|6,7,2/6,240452,2
3,4,24,453,1,109,1,7,3,3,4,single-choice,spatial-relational,3|4,7,3/4,240453,3
3,4,24,454,1,123,6,8,1,1,7,single-choice,spatial-relational,1|7,7,1/7,240454,1
3,4,24,455,1,110,3,7,2,2,5,single-choice,spatial-relational,2|5,7,2/5,240455,2
3,4,24,456,0,130,5,7,1,6,6,single-choice,spatial-relational,1|6,7,1/6,240456,1
3,4,24,457,1,292,2,8,3,3,5,single-choice,spatial-relational,3|5,7,3/5,240457,3
3,4,24,458,1,5,5,9,2,2,7,single-choice,spatial-relational,2|7,7,2/7,240458,2
3,4,24,459,0,337,1,5,2,3,3,single-choice,spatial-relational,2|3,7,2/3,240459,2
3,4,24,460,0,6,3,11,4,7,7,single-choice,spatial-relational,4|7,7,4/7,240460,4
3,4,24,461,1,1848,3,9,3,3,6,single-choice,spatial-relational,3|6,7,3/6,240461,3
3,4,24,462,1,323,2,12,5,5,7,single-choice,spatial-relational,5|7,7,5/7,240462,5
3,4,24,463,1,693,2,4,1,1,3,single-choice,spatial-relational,1|3,7,1/3,240463,1
3,4,24,464,0,118,1,13,6,7,7,single-choice,spatial-relational,6|7,7,6/7,240464,6
3,4,24,465,0,598,1,11,5,6,6,single-choice,spatial-relational,5|6,7,5/6,240465,5
3,4,24,466,1,147,3,11,4,4,7,single-choice,spatial-relational,4|7,7,4/7,240466,4
3,4,24,467,1,103,1,5,2,2,3,single-choice,spatial-relational,2|3,7,2/3,240467,2
3,4,24,468,0,266,4,6,1,5,5,single-choice,spatial-relational,1|5,7,1/5,240468,1
3,4,24,469,0,136,1,3,1,2,2,single-choice,spatial-relational,1|2,7,1/2,240469,1
3,4,24,470,1,121,2,12,5,5,7,single-choice,spatial-relational,5|7,7,5/7,240470,5
3,4,24,471,1,307,3,7,2,2,5,single-choice,spatial-relational,2|5,7,2/5,240471,2
3,4,24,472,1,110,3,9,3,3,6,single-choice,spatial-relational,3|6,7,3/6,240472,3
3,4,24,473,1,8,2,4,1,1,3,single-choice,spatial-relational,1|3,7,1/3,240473,1
3,4,24,474,1,89,1,3,1,1,2,single-choice,spatial-relational,1|2,7,1/2,240474,1
3,4,24,475,1,103,5,7,1,1,6,single-choice,spatial-relational,1|6,7,1/6,240475,1
3,4,24,476,1,93,2,10,4,4,6,single-choice,spatial-relational,4|6,7,4/6,240476,4
3,4,24,477,0,137,1,7,3,4,4,single-choice,spatial-relational,3|4,7,3/4,240477,3
3,4,24,478,1,134,4,10,3,3,7,single-choice,spatial-relational,3|7,7,3/7,240478,3
3,4,24,479,0,363,4,10,3,7,7,single-choice,spatial-relational,3|7,7,3/7,240479,3
3,4,24,480,0,5,4,8,2,6,6,single-choice,spatial-relational,2|6,7,2/6,240480,2
3,4,24,481,0,128,3,9,3,6,6,single-choice,spatial-relational,3|6,7,3/6,240481,3
3,4,24,482,0,139,2,10,4,6,6,single-choice,spatial-relational,4|6,7,4/6,240482,4
3,4,24,483,0,224,2,12,5,7,7,single-choice,spatial-relational,5|7,7,5/7,240483,5
3,4,24,484,0,115,5,9,2,7,7,single-choice,spatial-relational,2|7,7,2/7,240484,2
3,4,24,485,1,322,4,6,1,1,5,single-choice,spatial-relational,1|5,7,1/5,240485,1
3,4,24,486,0,83,3,11,4,7,7,single-choice,spatial-relational,4|7,7,4/7,240486,4
3,4,24,487,1,136,2,6,2,2,4,single-choice,spatial-relational,2|4,7,2/4,240487,2
3,4,24,488,1,92,1,9,4,4,5,single-choice,spatial-relational,4|5,7,4/5,240488,4
3,4,24,489,1,210,1,13,6,6,7,single-choice,spatial-relational,6|7,7,6/7,240489,6
3,4,24,490,0,24,5,7,1,6,6,single-choice,spatial-relational,1|6,7,1/6,240490,1
3,4,24,491,1,113,6,8,1,1,7,single-choice,spatial-relational,1|7,7,1/7,240491,1
3,4,24,492,0,423,1,9,4,5,5,single-choice,spatial-relational,4|5,7,4/5,240492,4
3,4,24,493,1,485,5,9,2,2,7,single-choice,spatial-relational,2|7,7,2/7,240493,2
3,4,24,494,1,182,1,7,3,3,4,single-choice,spatial-relational,3|4,7,3/4,240494,3
3,4,24,495,0,5,3,5,1,4,4,single-choice,spatial-relational,1|4,7,1/4,240495,1
3,4,24,496,1,1000,2,8,3,3,5,single-choice,spatial-relational,3|5,7,3/5,240496,3
3,4,24,497,0,109,2,6,2,4,4,single-choice,spatial-relational,2|4,7,2/4,240497,2
3,4,24,498,1,111,1,11,5,5,6,single-choice,spatial-relational,5|6,7,5/6,240498,5
3,4,24,499,0,3,2,8,3,5,5,single-choice,spatial-relational,3|5,7,3/5,240499,3
3,4,24,500,1,102,4,8,2,2,6,single-choice,spatial-relational,2|6,7,2/6,240500,2
3,4,24,501,0,109,6,8,1,7,7,single-choice,spatial-relational,1|7,7,1/7,240501,1
3,4,24,502,1,113,3,5,1,1,4,single-choice,spatial-relational,1|4,7,1/4,240502,1
3,4,24,503,0,137,1,5,2,3,3,single-choice,spatial-relational,2|3,7,2/3,240503,2
3,4,24,504,0,5,3,7,2,5,5,single-choice,spatial-relational,2|5,7,2/5,240504,2
3,4,24,505,0,118,3,5,1,4,4,single-choice,spatial-relational,1|4,7,1/4,240505,1
3,4,24,506,0,95,1,9,4,5,5,single-choice,spatial-relational,4|5,7,4/5,240506,4
3,4,24,507,1,237,2,10,4,4,6,single-choice,spatial-relational,4|6,7,4/6,240507,4
3,4,24,508,0,6,5,7,1,6,6,single-choice,spatial-relational,1|6,7,1/6,240508,1
3,4,24,509,0,536,2,6,2,4,4,single-choice,spatial-relational,2|4,7,2/4,240509,2
3,4,24,510,1,281,2,6,2,2,4,single-choice,spatial-relational,2|4,7,2/4,240510,2
3,4,24,511,0,431,2,8,3,5,5,single-choice,spatial-relational,3|5,7,3/5,240511,3
3,4,24,512,0,465,1,11,5,6,6,single-choice,spatial-relational,5|6,7,5/6,240512,5
3,4,24,513,1,600,3,9,3,3,6,single-choice,spatial-relational,3|6,7,3/6,240513,3
3,4,24,514,1,51,1,13,6,6,7,single-choice,spatial-relational,6|7,7,6/7,240514,6
3,4,24,515,1,96,2,12,5,5,7,single-choice,spatial-relational,5|7,7,5/7,240515,5
3,4,24,516,0,176,3,11,4,7,7,single-choice,spatial-relational,4|7,7,4/7,240516,4
3,4,24,517,1,95,6,8,1,1,7,single-choice,spatial-relational,1|7,7,1/7,240517,1
3,4,24,518,0,124,1,3,1,2,2,single-choice,spatial-relational,1|2,7,1/2,240518,1
3,4,24,519,1,1306,4,8,2,2,6,single-choice,spatial-relational,2|6,7,2/6,240519,2
3,4,24,520,1,570,1,5,2,2,3,single-choice,spatial-relational,2|3,7,2/3,240520,2
3,4,24,521,0,256,4,8,2,6,6,single-choice,spatial-relational,2|6,7,2/6,240521,2
3,4,24,522,0,130,2,12,5,7,7,single-choice,spatial-relational,5|7,7,5/7,240522,5
3,4,24,523,1,664,2,8,3,3,5,single-choice,spatial-relational,3|5,7,3/5,240523,3
3,4,24,524,1,591,4,10,3,3,7,single-choice,spatial-relational,3|7,7,3/7,240524,3
3,4,24,525,0,120,1,7,3,4,4,single-choice,spatial-relational,3|4,7,3/4,240525,3
3,4,24,526,1,177,1,11,5,5,6,single-choice,spatial-relational,5|6,7,5/6,240526,5
3,4,24,527,1,132,1,3,1,1,2,single-choice,spatial-relational,1|2,7,1/2,240527,1
3,4,24,528,0,155,2,4,1,3,3,single-choice,spatial-relational,1|3,7,1/3,240528,1
3,4,24,529,0,6,1,13,6,7,7,single-choice,spatial-relational,6|7,7,6/7,240529,6
3,4,24,530,0,213,1,5,2,3,3,single-choice,spatial-relational,2|3,7,2/3,240530,2
3,4,24,531,0,212,3,7,2,5,5,single-choice,spatial-relational,2|5,7,2/5,240531,2
3,4,24,532,0,122,2,10,4,6,6,single-choice,spatial-relational,4|6,7,4/6,240532,4
3,4,24,533,1,116,2,4,1,1,3,single-choice,spatial-relational,1|3,7,1/3,240533,1
3,4,24,534,0,519,3,9,3,6,6,single-choice,spatial-relational,3|6,7,3/6,240534,3
3,4,24,535,0,377,4,6,1,5,5,single-choice,spatial-relational,1|5,7,1/5,240535,1
3,4,24,536,1,120,1,7,3,3,4,single-choice,spatial-relational,3|4,7,3/4,240536,3
3,4,24,537,1,104,5,7,1,1,6,single-choice,spatial-relational,1|6,7,1/6,240537,1
3,4,24,538,1,7,5,9,2,2,7,single-choice,spatial-relational,2|7,7,2/7,240538,2
3,4,24,539,0,108,4,10,3,7,7,single-choice,spatial-relational,3|7,7,3/7,240539,3
3,4,24,540,1,145,4,6,1,1,5,single-choice,spatial-relational,1|5,7,1/5,240540,1
3,4,24,541,1,156,3,5,1,1,4,single-choice,spatial-relational,1|4,7,1/4,240541,1
3,4,24,542,0,117,6,8,1,7,7,single-choice,spatial-relational,1|7,7,1/7,240542,1
3,4,24,543,1,239,3,7,2,2,5,single-choice,spatial-relational,2|5,7,2/5,240543,2
3,4,24,544,1,135,1,9,4,4,5,single-choice,spatial-relational,4|5,7,4/5,240544,4
3,4,24,545,1,4,3,11,4,4,7,single-choice,spatial-relational,4|7,7,4/7,240545,4
3,4,24,546,0,234,5,9,2,7,7,single-choice,spatial-relational,2|7,7,2/7,240546,2
3,4,24,547,0,157,3,7,2,5,5,single-choice,spatial-relational,2|5,7,2/5,240547,2
3,4,24,548,0,3,3,9,3,6,6,single-choice,spatial-relational,3|6,7,3/6,240548,3
3,4,24,549,0,144,4,10,3,7,7,single-choice,spatial-relational,3|7,7,3/7,240549,3
3,4,24,550,1,469,2,8,3,3,5,single-choice,spatial-relational,3|5,7,3/5,240550,3
3,4,24,551,0,124,3,11,4,7,7,single-choice,spatial-relational,4|7,7,4/7,240551,4
3,4,24,552,0,110,1,11,5,6,6,single-choice,spatial-relational,5|6,7,5/6,240552,5
3,4,24,553,0,996,5,9,2,7,7,single-choice,spatial-relational,2|7,7,2/7,240553,2
3,4,24,554,1,394,4,6,1,1,5,single-choice,spatial-relational,1|5,7,1/5,240554,1
3,4,24,555,1,87,2,6,2,2,4,single-choice,spatial-relational,2|4,7,2/4,240555,2
3,4,24,556,1,4,1,9,4,4,5,single-choice,spatial-relational,4|5,7,4/5,240556,4
3,4,24,557,1,116,5,7,1,1,6,single-choice,spatial-relational,1|6,7,1/6,240557,1
3,4,24,558,0,175,1,3,1,2,2,single-choice,spatial-relational,1|2,7,1/2,240558,1
3,4,24,559,0,152,2,6,2,4,4,single-choice,spatial-relational,2|4,7,2/4,240559,2
3,4,24,560,0,355,4,8,2,6,6,single-choice,spatial-relational,2|6,7,2/6,240560,2
3,4,24,561,1,876,3,5,1,1,4,single-choice,spatial-relational,1|4,7,1/4,240561,1
3,4,24,562,1,5,1,5,2,2,3,single-choice,spatial-relational,2|3,7,2/3,240562,2
3,4,24,563,1,124,2,10,4,4,6,single-choice,spatial-relational,4|6,7,4/6,240563,4
3,4,24,564,1,97,1,11,5,5,6,single-choice,spatial-relational,5|6,7,5/6,240564,5
3,4,24,565,1,148,3,7,2,2,5,single-choice,spatial-relational,2|5,7,2/5,240565,2
3,4,24,566,1,6,2,4,1,1,3,single-choice,spatial-relational,1|3,7,1/3,240566,1
3,4,24,567,0,155,3,5,1,4,4,single-choice,spatial-relational,1|4,7,1/4,240567,1
3,4,24,568,1,213,3,9,3,3,6,single-choice,spatial-relational,3|6,7,3/6,240568,3
3,4,24,569,1,95,3,11,4,4,7,single-choice,spatial-relational,4|7,7,4/7,240569,4
3,4,24,570,1,149,5,9,2,2,7,single-choice,spatial-relational,2|7,7,2/7,240570,2
3,4,24,571,1,350,4,8,2,2,6,single-choice,spatial-relational,2|6,7,2/6,240571,2
3,4,24,572,0,92,2,4,1,3,3,single-choice,spatial-relational,1|3,7,1/3,240572,1
3,4,24,573,0,222,1,13,6,7,7,single-choice,spatial-relational,6|7,7,6/7,240573,6
3,4,24,574,1,206,1,7,3,3,4,single-choice,spatial-relational,3|4,7,3/4,240574,3
3,4,24,575,1,157,1,13,6,6,7,single-choice,spatial-relational,6|7,7,6/7,240575,6
3,4,24,576,0,108,1,7,3,4,4,single-choice,spatial-relational,3|4,7,3/4,240576,3
3,4,24,577,0,220,4,6,1,5,5,single-choice,spatial-relational,1|5,7,1/5,240577,1
3,4,24,578,1,839,4,10,3,3,7,single-choice,spatial-relational,3|7,7,3/7,240578,3
3,4,24,579,0,522,2,10,4,6,6,single-choice,spatial-relational,4|6,7,4/6,240579,4
3,4,24,580,1,6,6,8,1,1,7,single-choice,spatial-relational,1|7,7,1/7,240580,1
3,4,24,581,0,90,2,8,3,5,5,single-choice,spatial-relational,3|5,7,3/5,240581,3
3,4,24,582,0,9,2,12,5,7,7,single-choice,spatial-relational,5|7,7,5/7,240582,5
3,4,24,583,0,5,1,5,2,3,3,single-choice,spatial-relational,2|3,7,2/3,240583,2
3,4,24,584,1,478,1,3,1,1,2,single-choice,spatial-relational,1|2,7,1/2,240584,1
3,4,24,585,0,483,5,7,1,6,6,single-choice,spatial-relational,1|6,7,1/6,240585,1
3,4,24,586,0,509,6,8,1,7,7,single-choice,spatial-relational,1|7,7,1/7,240586,1
3,4,24,587,0,145,1,9,4,5,5,single-choice,spatial-relational,4|5,7,4/5,240587,4
3,4,24,588,1,148,2,12,5,5,7,single-choice,spatial-relational,5|7,7,5/7,240588,5
3,4,24,589,1,290,3,5,1,1,4,single-choice,spatial-relational,1|4,7,1/4,240589,1
3,4,24,590,0,545,6,8,1,7,7,single-choice,spatial-relational,1|7,7,1/7,240590,1
3,4,24,591,1,588,1,5,2,2,3,single-choice,spatial-relational,2|3,7,2/3,240591,2
3,4,24,592,1,129,1,11,5,5,6,single-choice,spatial-relational,5|6,7,5/6,240592,5
3,4,24,593,0,136,1,3,1,2,2,single-choice,spatial-relational,1|2,7,1/2,240593,1
3,4,24,594,0,314,2,10,4,6,6,single-choice,spatial-relational,4|6,7,4/6,240594,4
3,4,24,595,1,12,6,8,1,1,7,single-choice,spatial-relational,1|7,7,1/7,240595,1
3,4,24,596,1,1914,2,4,1,1,3,single-choice,spatial-relational,1|3,7,1/3,240596,1
3,4,24,597,1,101,1,3,1,1,2,single-choice,spatial-relational,1|2,7,1/2,240597,1
3,4,24,598,1,6,2,6,2,2,4,single-choice,spatial-relational,2|4,7,2/4,240598,2
3,4,24,599,1,210,4,8,2,2,6,single-choice,spatial-relational,2|6,7,2/6,240599,2
3,4,24,600,0,337,1,7,3,4,4,single-choice,spatial-relational,3|4,7,3/4,240600,3
